remote_unit_id,time_stamp,entries,exits,num_people_exited,sum_exit_entry,week_num,z_score_num_people_exited,z_score_sum_exit_entry
144,1546300800,0,0,0,0,1,-0.27856431940846976,-1.2454493195037015
144,1546315200,105,124,19,229,1,2.013129772219972,-0.8956440527420323
144,1546329600,74,73,0,147,1,-0.27856431940846976,-1.0209018338531977
144,1546344000,230,94,0,324,1,-0.27856431940846976,-0.7505283307229992
144,1546358400,441,172,0,613,1,-0.27856431940846976,-0.30907102900194067
144,1546372800,426,197,0,623,1,-0.27856431940846976,-0.29379568984204246
144,1546387200,170,139,0,309,1,-0.27856431940846976,-0.7734413394628465
144,1546401600,29,21,0,50,1,-0.27856431940846976,-1.1690726237042104
144,1546416000,353,263,0,616,1,-0.27856431940846976,-0.30448842725397124
144,1546430400,997,560,0,1557,1,-0.27856431940846976,1.132920987692451
144,1546444800,1074,330,0,1404,1,-0.27856431940846976,0.8992082985460084
144,1546459200,1517,465,0,1982,1,-0.27856431940846976,1.7821229019881253
144,1546473600,339,214,0,553,1,-0.27856431940846976,-0.40072306396133
144,1546488000,38,36,0,74,1,-0.27856431940846976,-1.1324118097204547
144,1546502400,355,273,0,628,1,-0.27856431940846976,-0.28615802026209336
144,1546516800,1134,610,0,1744,1,-0.27856431940846976,1.4185698299825478
144,1546531200,1149,360,0,1509,1,-0.27856431940846976,1.0595993597249398
144,1546545600,1564,521,0,2085,1,-0.27856431940846976,1.9394588953350769
144,1546560000,374,231,0,605,1,-0.27856431940846976,-0.32129130032985925
144,1546574400,43,48,5,91,1,0.3245130731253308,-1.1064437331486277
144,1546588800,365,279,0,644,1,-0.27856431940846976,-0.2617174776062562
144,1546603200,1146,596,0,1742,1,-0.27856431940846976,1.4155147621505682
144,1546617600,1137,359,0,1496,1,-0.27856431940846976,1.039741418817072
144,1546632000,1534,461,0,1995,1,-0.27856431940846976,1.801980842895993
144,1546646400,410,242,0,652,1,-0.27856431940846976,-0.24949720627833763
144,1546660800,58,89,31,147,1,3.4605155143010937,-1.0209018338531977
144,1546675200,113,105,0,218,1,-0.27856431940846976,-0.9124469258179203
144,1546689600,486,181,0,667,1,-0.27856431940846976,-0.2265841975384903
144,1546704000,628,202,0,830,1,-0.27856431940846976,0.02240383076785066
144,1546718400,690,279,0,969,1,-0.27856431940846976,0.2347310450904359
144,1546732800,303,209,0,512,1,-0.27856431940846976,-0.4633519545169127
144,1546747200,48,90,42,138,1,4.7872857778754545,-1.034649639097106
144,1546761600,94,91,0,185,1,-0.27856431940846976,-0.9628555450455845
144,1546776000,366,148,0,514,1,-0.27856431940846976,-0.46029688668493307
144,1546790400,592,255,0,847,1,-0.27856431940846976,0.04837190733967763
144,1546804800,531,301,0,832,1,-0.27856431940846976,0.025458898599830308
144,1546819200,237,147,0,384,1,-0.27856431940846976,-0.6588762957636098
144,1546833600,39,29,0,68,1,-0.27856431940846976,-1.1415770132163936
144,1546848000,401,290,0,691,1,-0.27856431940846976,-0.18992338355473457
144,1546862400,1198,628,0,1826,1,-0.27856431940846976,1.5438276110937132
144,1546876800,1166,364,0,1530,1,-0.27856431940846976,1.091677571960726
144,1546891200,1668,546,0,2214,1,-0.27856431940846976,2.1365107704977637
144,1546905600,368,215,0,583,2,-0.2957558557254611,-0.5478118289098622
144,1546920000,45,32,0,77,2,-0.2957558557254611,-1.2727244682618168
144,1546934400,439,317,0,756,2,-0.2957558557254611,-0.2999662032025734
144,1546948800,1188,628,0,1816,2,-0.2957558557254611,1.218625491882549
144,1546963200,1093,367,0,1460,2,-0.2957558557254611,0.7086079037218852
144,1546977600,1504,483,0,1987,2,-0.2957558557254611,1.4636058502406206
144,1546992000,317,237,0,554,2,-0.2957558557254611,-0.5893582054735118
144,1547006400,43,37,0,80,2,-0.2957558557254611,-1.268426567237991
144,1547020800,342,282,0,624,2,-0.2957558557254611,-0.48907384825090944
144,1547035200,1277,686,0,1963,2,-0.2957558557254611,1.429222642050014
144,1547049600,1258,386,0,1644,2,-0.2957558557254611,0.9722124998498688
144,1547064000,1736,426,0,2162,2,-0.2957558557254611,1.714316743297127
144,1547078400,388,246,0,634,2,-0.2957558557254611,-0.47474751150482336
144,1547092800,42,36,0,78,2,-0.2957558557254611,-1.2712918345872084
144,1547107200,408,291,0,699,2,-0.2957558557254611,-0.38162632265526397
144,1547121600,1256,590,0,1846,2,-0.2957558557254611,1.261604502120807
144,1547136000,1208,398,0,1606,2,-0.2957558557254611,0.9177724202147417
144,1547150400,1692,525,0,2217,2,-0.2957558557254611,1.7931115954006003
144,1547164800,434,255,0,689,2,-0.2957558557254611,-0.39595265940135
144,1547179200,33,46,13,79,2,3.0684670031516594,-1.2698592009125997
144,1547193600,398,344,0,742,2,-0.2957558557254611,-0.3200230746470939
144,1547208000,1197,642,0,1839,2,-0.2957558557254611,1.251576066398547
144,1547222400,1162,396,0,1558,2,-0.2957558557254611,0.8490060038335286
144,1547236800,1508,459,0,1967,2,-0.2957558557254611,1.4349531767484485
144,1547251200,401,207,0,608,2,-0.2957558557254611,-0.5119959870446471
144,1547265600,51,59,8,110,2,1.7745351343527669,-1.225447556999733
144,1547280000,98,105,7,203,2,1.5157487605929885,-1.0922126252611326
144,1547294400,504,197,0,701,2,-0.2957558557254611,-0.37876105530604676
144,1547308800,678,205,0,883,2,-0.2957558557254611,-0.11802172652728045
144,1547323200,700,260,0,960,2,-0.2957558557254611,-0.007708933582417776
144,1547337600,352,197,0,549,2,-0.2957558557254611,-0.5965213738465549
144,1547352000,63,83,20,146,2,4.879971619470108,-1.173872744713823
144,1547366400,79,78,0,157,2,-0.2957558557254611,-1.1581137742931285
144,1547380800,397,184,0,581,2,-0.2957558557254611,-0.5506770962590795
144,1547395200,589,204,0,793,2,-0.2957558557254611,-0.246958757242055
144,1547409600,526,239,0,765,2,-0.2957558557254611,-0.287072500131096
144,1547424000,211,135,0,346,2,-0.2957558557254611,-0.8873460097921019
144,1547438400,33,22,0,55,2,-0.2957558557254611,-1.3042424091032063
144,1547452800,379,291,0,670,2,-0.2957558557254611,-0.42317269921891354
144,1547467200,1198,568,0,1766,2,-0.2957558557254611,1.1469938081521187
144,1547481600,1087,386,0,1473,2,-0.2957558557254611,0.7272321414917972
144,1547496000,1639,481,0,2120,2,-0.2957558557254611,1.6541461289635655
144,1547510400,428,207,0,635,3,-0.21052175987963231,-0.3815040516042309
144,1547524800,79,41,0,120,3,-0.21052175987963231,-1.1342802453826941
144,1547539200,403,290,0,693,3,-0.21052175987963231,-0.29672537346995737
144,1547553600,1223,617,0,1840,3,-0.21052175987963231,1.3798460717026588
144,1547568000,1181,418,0,1599,3,-0.21052175987963231,1.027576047041281
144,1547582400,1713,522,0,2235,3,-0.21052175987963231,1.9572181038240046
144,1547596800,414,246,0,660,3,-0.21052175987963231,-0.3449615179256647
144,1547611200,41,31,0,72,3,-0.21052175987963231,-1.2044419100455412
144,1547625600,392,267,0,659,3,-0.21052175987963231,-0.3464232192728074
144,1547640000,1276,661,0,1937,3,-0.21052175987963231,1.5216311023754956
144,1547654401,1201,362,0,1563,3,-0.21052175987963231,0.9749547985441457
144,1547668800,1726,537,0,2263,3,-0.21052175987963231,1.9981457415439987
144,1547683200,449,269,0,718,3,-0.21052175987963231,-0.2601828397913912
144,1547697600,44,26,0,70,3,-0.21052175987963231,-1.2073653127398265
144,1547712000,386,232,0,618,3,-0.21052175987963231,-0.4063529745056559
144,1547726400,1276,679,0,1955,3,-0.21052175987963231,1.5479417266240634
144,1547740800,1233,432,0,1665,3,-0.21052175987963231,1.1240483359526956
144,1547755200,1680,529,0,2209,3,-0.21052175987963231,1.9192138687982958
144,1547769600,412,287,0,699,3,-0.21052175987963231,-0.2879551653871015
144,1547784000,53,35,0,88,3,-0.21052175987963231,-1.181054688491259
144,1547798400,393,296,0,689,3,-0.21052175987963231,-0.30257217885852794
144,1547812800,1160,606,0,1766,3,-0.21052175987963231,1.271680172014103
144,1547827200,1208,419,0,1627,3,-0.21052175987963231,1.068503684761275
144,1547841600,1553,453,0,2006,3,-0.21052175987963231,1.6224884953283383
144,1547856000,424,248,0,672,3,-0.21052175987963231,-0.327421101759953
144,1547870400,48,67,19,115,3,2.414421433619533,-1.1415887521184074
144,1547884800,129,127,0,256,3,-0.21052175987963231,-0.9354888621712942
144,1547899200,474,206,0,680,3,-0.21052175987963231,-0.3157274909828118
144,1547913600,661,225,0,886,3,-0.21052175987963231,-0.014617013471426472
144,1547928000,639,247,0,886,3,-0.21052175987963231,-0.014617013471426472
144,1547942400,276,165,0,441,3,-0.21052175987963231,-0.6650741129499045
144,1547956800,40,84,44,124,3,5.868294056644751,-1.1284334399941236
144,1547971200,85,75,0,160,3,-0.21052175987963231,-1.0758121914969883
144,1547985600,360,136,0,496,3,-0.21052175987963231,-0.5846805388570588
144,1548000000,472,185,0,657,3,-0.21052175987963231,-0.34934662196709265
144,1548014400,447,219,0,666,3,-0.21052175987963231,-0.33619130984280887
144,1548028800,195,150,0,345,3,-0.21052175987963231,-0.8053974422755986
144,1548043200,40,38,0,78,3,-0.21052175987963231,-1.1956717019626855
144,1548057600,144,145,1,289,3,-0.0723668549586236,-0.8872527177155868
144,1548072000,504,257,0,761,3,-0.21052175987963231,-0.19732968186425737
144,1548086400,593,247,0,840,3,-0.21052175987963231,-0.08185527543998825
144,1548100800,594,300,0,894,3,-0.21052175987963231,-0.0029234026942852945
144,1548115200,200,158,0,358,4,-0.3152196968967478,-0.8544709035359825
144,1548129600,39,25,0,64,4,-0.3152196968967478,-1.2682845567839063
144,1548144000,377,296,0,673,4,-0.3152196968967478,-0.4110991321989213
144,1548158400,1143,568,0,1711,4,-0.3152196968967478,1.0499164190641566
144,1548172800,1098,375,0,1473,4,-0.3152196968967478,0.7149244140539325
144,1548187200,1633,511,0,2144,4,-0.3152196968967478,1.6593766634735136
144,1548201600,377,266,0,643,4,-0.3152196968967478,-0.45332501518340335
144,1548216000,33,39,6,72,4,1.0311423983232597,-1.2570243213213776
144,1548230400,398,297,0,695,4,-0.3152196968967478,-0.38013348467696784
144,1548244800,1258,731,0,1989,4,-0.3152196968967478,1.441209601387023
144,1548259200,1177,381,0,1558,4,-0.3152196968967478,0.8345644158432982
144,1548273600,1725,482,0,2207,4,-0.3152196968967478,1.7480510177409259
144,1548288000,439,275,0,714,4,-0.3152196968967478,-0.35339042545346255
144,1548302400,40,36,0,76,4,-0.3152196968967478,-1.2513942035901136
144,1548316800,394,270,0,664,4,-0.3152196968967478,-0.4237668970942659
144,1548331200,1240,698,0,1938,4,-0.3152196968967478,1.3694256003134038
144,1548345600,1207,353,0,1560,4,-0.3152196968967478,0.8373794747089303
144,1548360000,1646,533,0,2179,4,-0.3152196968967478,1.708640193622076
144,1548374400,413,253,0,666,4,-0.3152196968967478,-0.4209518382286338
144,1548388800,39,29,0,68,4,-0.3152196968967478,-1.262654439052642
144,1548403200,369,336,0,705,4,-0.3152196968967478,-0.36605819034880716
144,1548417600,1200,604,0,1804,4,-0.3152196968967478,1.1808166563160507
144,1548432000,952,424,0,1376,4,-0.3152196968967478,0.5783940590707739
144,1548446400,1651,502,0,2153,4,-0.3152196968967478,1.6720444283688582
144,1548460800,412,274,0,686,4,-0.3152196968967478,-0.39280124957231244
144,1548475200,51,72,21,123,4,4.397047636373279,-1.1852403202477584
144,1548489600,124,142,18,266,4,3.723866588763275,-0.9839636113550607
144,1548504000,452,199,0,651,4,-0.3152196968967478,-0.4420647797208748
144,1548518400,667,249,0,916,4,-0.3152196968967478,-0.06906948002461699
144,1548532800,661,269,0,930,4,-0.3152196968967478,-0.04936406796519205
144,1548547200,287,173,0,460,4,-0.3152196968967478,-0.7109029013887437
144,1548561600,66,76,10,142,4,1.9287171284699316,-1.158497261024253
144,1548576000,82,86,4,168,4,0.582355033249924,-1.1219014957710354
144,1548590400,405,152,0,557,4,-0.3152196968967478,-0.5743725464055851
144,1548604800,577,239,0,816,4,-0.3152196968967478,-0.20982242330622372
144,1548619200,518,265,0,783,4,-0.3152196968967478,-0.2562708945891539
144,1548633600,176,144,0,320,4,-0.3152196968967478,-0.9079570219829931
144,1548648000,30,30,0,60,4,-0.3152196968967478,-1.2739146745151706
144,1548662400,400,319,0,719,4,-0.3152196968967478,-0.3463527782893822
144,1548676800,1168,607,0,1775,4,-0.3152196968967478,1.1399983027643847
144,1548691200,1078,430,0,1508,4,-0.3152196968967478,0.7641879442024948
144,1548705600,1679,484,0,2163,4,-0.3152196968967478,1.686119722697019
144,1548720000,419,260,0,679,5,-0.1561737618886061,-0.38617525015925264
144,1548734400,32,30,0,62,5,-0.1561737618886061,-1.2700602026965142
144,1548748800,434,315,0,749,5,-0.1561737618886061,-0.285896568347894
144,1548763200,1195,661,0,1856,5,-0.1561737618886061,1.299939156868878
144,1548777600,1200,407,0,1607,5,-0.1561737618886061,0.9432335601399023
144,1548792000,1677,541,0,2218,5,-0.1561737618886061,1.818523197093333
144,1548806400,421,266,0,687,5,-0.1561737618886061,-0.3747148293808117
144,1548820800,30,23,0,53,5,-0.1561737618886061,-1.2829531760722603
144,1548835200,420,308,0,728,5,-0.1561737618886061,-0.3159801728913016
144,1548849600,1242,623,0,1865,5,-0.1561737618886061,1.3128321302446242
144,1548864000,1199,388,0,1587,5,-0.1561737618886061,0.9145825081937998
144,1548878400,1633,515,0,2148,5,-0.1561737618886061,1.7182445152819745
144,1548892800,359,218,0,577,5,-0.1561737618886061,-0.5322956150843753
144,1548907200,41,32,0,73,5,-0.1561737618886061,-1.2543021241261578
144,1548921600,380,258,0,638,5,-0.1561737618886061,-0.44490990664876273
144,1548936000,1204,698,0,1902,5,-0.1561737618886061,1.3658365763449138
144,1548950400,1059,358,0,1417,5,-0.1561737618886061,0.6710485666519288
144,1548964800,1494,511,0,2005,5,-0.1561737618886061,1.5133894938673418
144,1548979200,370,226,0,596,5,-0.1561737618886061,-0.5050771157355779
144,1548993600,41,29,0,70,5,-0.1561737618886061,-1.2585997819180732
144,1549008000,368,298,0,666,5,-0.1561737618886061,-0.40479843392421927
144,1549022400,1166,646,0,1812,5,-0.1561737618886061,1.2369068425874528
144,1549036800,1005,339,0,1344,5,-0.1561737618886061,0.5664722270486547
144,1549051200,1450,375,0,1825,5,-0.1561737618886061,1.2555300263524194
144,1549065600,393,243,0,636,5,-0.1561737618886061,-0.447775011843373
144,1549080000,49,48,0,97,5,-0.1561737618886061,-1.2199208617908348
144,1549094400,128,87,0,215,5,-0.1561737618886061,-1.0508796553088302
144,1549108800,480,191,0,671,5,-0.1561737618886061,-0.39763567093769364
144,1549123200,594,198,0,792,5,-0.1561737618886061,-0.22429680666377366
144,1549137600,658,217,0,875,5,-0.1561737618886061,-0.10539494108744837
144,1549152000,252,170,0,422,5,-0.1561737618886061,-0.7543412676666695
144,1549166400,54,83,29,137,5,6.403124237432849,-1.1626187578986298
144,1549180800,83,59,0,142,5,-0.1561737618886061,-1.1554559949121042
144,1549195200,395,151,0,546,5,-0.1561737618886061,-0.5767047456008342
144,1549209600,526,184,0,710,5,-0.1561737618886061,-0.3417661196427938
144,1549224000,547,265,0,812,5,-0.1561737618886061,-0.19564575471767118
144,1549238400,208,114,0,322,5,-0.1561737618886061,-0.8975965273971819
144,1549252800,37,25,0,62,5,-0.1561737618886061,-1.2700602026965142
144,1549267200,370,315,0,685,5,-0.1561737618886061,-0.37757993457542194
144,1549281600,1172,672,0,1844,5,-0.1561737618886061,1.2827485257012168
144,1549296000,1092,430,0,1522,5,-0.1561737618886061,0.8214665893689668
144,1549310400,1711,475,0,2186,5,-0.1561737618886061,1.7726815139795693
144,1549324800,406,266,0,672,6,-0.2474614188231312,-0.4107673360850425
144,1549339200,44,40,0,84,6,-0.2474614188231312,-1.2430328481913182
144,1549353600,417,296,0,713,6,-0.2474614188231312,-0.3527352170436185
144,1549355438,205,86,0,291,6,-0.2474614188231312,-0.950041417909007
144,1549368000,994,512,0,1506,6,-0.2474614188231312,0.7696908902697773
144,1549382400,1103,398,0,1501,6,-0.2474614188231312,0.7626138025817988
144,1549396800,1576,510,0,2086,6,-0.2474614188231312,1.5906330620752875
144,1549411200,410,320,0,730,6,-0.2474614188231312,-0.32867311890449147
144,1549425600,41,40,0,81,6,-0.2474614188231312,-1.2472791008041055
144,1549440000,371,322,0,693,6,-0.2474614188231312,-0.3810435677955326
144,1549454400,1218,588,0,1806,6,-0.2474614188231312,1.1943161515484895
144,1549468800,1186,422,0,1608,6,-0.2474614188231312,0.9140634791045394
144,1549483200,1757,529,0,2286,6,-0.2474614188231312,1.873716569594429
144,1549497600,415,269,0,684,6,-0.2474614188231312,-0.393782325633894
144,1549512000,32,41,9,73,6,1.0294395023042258,-1.258602441104871
144,1549526400,420,319,0,739,6,-0.2474614188231312,-0.3159343610661301
144,1549540800,1262,675,0,1937,6,-0.2474614188231312,1.3797358489735272
144,1549555200,1245,460,0,1705,6,-0.2474614188231312,1.051358980251323
144,1549569600,1503,488,0,1991,6,-0.2474614188231312,1.4561683960036953
144,1549584000,481,284,0,765,6,-0.2474614188231312,-0.2791335050886417
144,1549598400,47,41,0,88,6,-0.2474614188231312,-1.2373711780409355
144,1549612800,374,279,0,653,6,-0.2474614188231312,-0.4376602692993609
144,1549627200,1228,595,0,1823,6,-0.2474614188231312,1.2183782496876165
144,1549641600,1225,385,0,1610,6,-0.2474614188231312,0.9168943141797309
144,1549656000,1536,466,0,2002,6,-0.2474614188231312,1.4717379889172482
144,1549670400,411,265,0,676,6,-0.2474614188231312,-0.4051056659346597
144,1549684800,46,81,35,127,6,4.718264385561034,-1.182169894074703
144,1549699200,98,84,0,182,6,-0.2474614188231312,-1.104321929506939
144,1549713600,502,190,0,692,6,-0.2474614188231312,-0.38245898533312833
144,1549728000,617,181,0,798,6,-0.2474614188231312,-0.2324247263479834
144,1549742400,632,268,0,900,6,-0.2474614188231312,-0.08805213751322125
144,1549756800,321,156,0,477,6,-0.2474614188231312,-0.6867737559162054
144,1549771200,46,77,31,123,6,4.150752865059987,-1.1878315642250856
144,1549785600,84,66,0,150,6,-0.2474614188231312,-1.1496152907100017
144,1549800000,390,142,0,532,6,-0.2474614188231312,-0.6089257913484415
144,1549814400,575,202,0,777,6,-0.2474614188231312,-0.26214849463749323
144,1549828800,512,273,0,785,6,-0.2474614188231312,-0.2508251543367276
144,1549843200,204,151,0,355,6,-0.2474614188231312,-0.8594546955028817
144,1549857600,39,24,0,63,6,-0.2474614188231312,-1.2727566164808282
144,1549872000,414,304,0,718,6,-0.2474614188231312,-0.34565812935563994
144,1549886400,1297,716,0,2013,6,-0.2474614188231312,1.4873075818308008
144,1549900800,1188,400,0,1588,6,-0.2474614188231312,0.8857551283526253
144,1549915200,1751,541,0,2292,6,-0.2474614188231312,1.882209074820003
144,1549929600,412,268,0,680,7,-0.15617376188860602,-0.3342468499414596
144,1549944000,41,41,0,82,7,-0.15617376188860602,-1.207810209268171
144,1549958400,389,291,0,680,7,-0.15617376188860602,-0.3342468499414596
144,1549972800,1184,701,0,1885,7,-0.15617376188860602,1.4260271433506597
144,1549987200,1143,391,0,1534,7,-0.15617376188860602,0.9132834324415029
144,1550001600,1591,517,0,2108,7,-0.15617376188860602,1.751787392731691
144,1550016000,390,255,0,645,7,-0.15617376188860602,-0.3853751402030564
144,1550030400,38,32,0,70,7,-0.15617376188860602,-1.2253399087864327
144,1550044800,409,279,0,688,7,-0.15617376188860602,-0.32256038359595174
144,1550059200,1299,742,0,2041,7,-0.15617376188860602,1.6539132370880627
144,1550073600,1206,421,0,1627,7,-0.15617376188860602,1.0491386037080317
144,1550088000,1795,524,0,2319,7,-0.15617376188860602,2.0600179425944605
144,1550102400,446,331,0,777,7,-0.15617376188860602,-0.19254844550217695
144,1550116800,43,33,0,76,7,-0.15617376188860602,-1.216575059027302
144,1550131200,411,295,0,706,7,-0.15617376188860602,-0.2962658343185591
144,1550145600,1241,665,0,1906,7,-0.15617376188860602,1.4567041175076176
144,1550160000,1322,410,0,1732,7,-0.15617376188860602,1.2025234744928222
144,1550174400,1721,502,0,2223,7,-0.15617376188860602,1.919780346448366
144,1550188800,428,277,0,705,7,-0.15617376188860602,-0.2977266426117475
144,1550203200,43,39,0,82,7,-0.15617376188860602,-1.207810209268171
144,1550217600,372,297,0,669,7,-0.15617376188860602,-0.35031574116653286
144,1550232000,1213,637,0,1850,7,-0.15617376188860602,1.374898853089063
144,1550246400,1218,387,0,1605,7,-0.15617376188860602,1.0170008212578852
144,1550260800,1478,471,0,1949,7,-0.15617376188860602,1.5195188741147223
144,1550275200,411,283,0,694,7,-0.15617376188860602,-0.31379553383682085
144,1550289600,62,62,0,124,7,-0.15617376188860602,-1.1464562609542548
144,1550304000,137,127,0,264,7,-0.15617376188860602,-0.9419430999078675
144,1550318400,432,183,0,615,7,-0.15617376188860602,-0.4291993889987108
144,1550332800,623,288,0,911,7,-0.15617376188860602,0.003199865785079466
144,1550347200,593,306,0,899,7,-0.15617376188860602,-0.014329833733182301
144,1550361600,306,227,0,533,7,-0.15617376188860602,-0.5489856690401662
144,1550376000,44,84,40,128,7,6.403124237432848,-1.140613027781501
144,1550390400,91,77,0,168,7,-0.15617376188860602,-1.0821806960539617
144,1550404800,350,162,0,512,7,-0.15617376188860602,-0.5796626431971243
144,1550419200,538,228,0,766,7,-0.15617376188860602,-0.20861733672725022
144,1550433600,478,243,0,721,7,-0.15617376188860602,-0.2743537099207319
144,1550448000,210,135,0,345,7,-0.15617376188860602,-0.8236176281596006
144,1550462400,46,33,0,79,7,-0.15617376188860602,-1.2121926341477365
144,1550476800,157,112,0,269,7,-0.15617376188860602,-0.9346390584419251
144,1550491200,543,222,0,765,7,-0.15617376188860602,-0.2100781450204387
144,1550505600,672,189,0,861,7,-0.15617376188860602,-0.06984054887434457
144,1550520000,593,284,0,877,7,-0.15617376188860602,-0.046467616183328876
144,1550534400,250,153,0,403,8,-0.29897403710077436,-1.0028332803424227
144,1550548800,40,28,0,68,8,-0.29897403710077436,-1.4800055342308691
144,1550563200,370,347,0,717,8,-0.29897403710077436,-0.5555733169962372
144,1550577600,1168,687,0,1855,8,-0.29897403710077436,1.0653879514367537
144,1550592000,1007,385,0,1392,8,-0.29897403710077436,0.40589316471928905
144,1550606400,1543,512,0,2055,8,-0.29897403710077436,1.350266908982095
144,1550620800,377,287,0,664,8,-0.29897403710077436,-0.6310662407457526
144,1550635200,34,29,0,63,8,-0.29897403710077436,-1.4871275081695026
144,1550649600,375,289,0,664,8,-0.29897403710077436,-0.6310662407457526
144,1550664000,1245,709,0,1954,8,-0.29897403710077436,1.2064030354216975
144,1550678400,1020,412,0,1432,8,-0.29897403710077436,0.4628689562283572
144,1550692800,1579,507,0,2086,8,-0.29897403710077436,1.3944231474016227
144,1550707200,406,253,0,659,8,-0.29897403710077436,-0.6381882146843861
144,1550721600,40,47,7,87,8,2.8402533524573563,-1.4529420332640617
144,1550736000,400,314,0,714,8,-0.29897403710077436,-0.5598465013594174
144,1550750400,1208,714,0,1922,8,-0.29897403710077436,1.1608224022144429
144,1550764800,1011,406,0,1417,8,-0.29897403710077436,0.44150303441245664
144,1550779200,1427,477,0,1904,8,-0.29897403710077436,1.1351832960353623
144,1550793600,419,324,0,743,8,-0.29897403710077436,-0.5185390525153428
144,1550808000,41,50,9,91,8,3.7371754637596797,-1.4472444541131548
144,1550822400,349,296,0,645,8,-0.29897403710077436,-0.65812974171256
144,1550836800,1210,592,0,1802,8,-0.29897403710077436,0.9898950276872382
144,1550851200,944,419,0,1363,8,-0.29897403710077436,0.36458571587521454
144,1550865600,1455,414,0,1869,8,-0.29897403710077436,1.0853294784649277
144,1551499200,50,86,36,136,9,1.5237105722134983,-1.0119624107028082
144,1551513600,109,107,0,216,9,-0.3413111681758236,-0.8684066707887769
144,1551528000,473,181,0,654,9,-0.3413111681758236,-0.0824389947594549
144,1551542400,624,238,0,862,9,-0.3413111681758236,0.2908059290170268
144,1551556800,709,281,0,990,9,-0.3413111681758236,0.520495112879477
144,1551571200,275,214,0,489,9,-0.3413111681758236,-0.3785227083321447
144,1551585600,51,127,76,178,9,3.5959569504238553,-0.9365956472479419
144,1551600000,88,57,0,145,9,-0.3413111681758236,-0.9958123899624798
144,1551614400,368,168,0,536,9,-0.3413111681758236,-0.29418371113265124
144,1551628800,557,224,0,781,9,-0.3413111681758236,0.14545574235406997
144,1551643200,496,292,0,788,9,-0.3413111681758236,0.1580168695965477
144,1551657600,156,124,0,280,9,-0.3413111681758236,-0.7535620788575518
144,1551672000,37,30,0,67,9,-0.3413111681758236,-1.1357792363786603
144,1551686400,347,285,0,632,9,-0.3413111681758236,-0.12191682323581354
144,1551700800,1042,695,0,1737,9,-0.3413111681758236,1.8609468343267455
144,1551715200,926,407,0,1333,9,-0.3413111681758236,1.1359903477608868
144,1551729600,1569,506,0,2075,9,-0.3413111681758236,2.467469835463528
144,1551744000,371,245,0,616,10,-0.23401019421924776,-0.5575861867577998
144,1551758400,33,29,0,62,10,-0.23401019421924776,-1.3287872444455182
144,1551772800,423,309,0,732,10,-0.23401019421924776,-0.39610726493149057
144,1551787200,1273,644,0,1917,10,-0.23401019421924776,1.2534834451045136
144,1551801600,1271,384,0,1655,10,-0.23401019421924776,0.8887638113244013
144,1551816000,1734,465,0,2199,10,-0.23401019421924776,1.6460442723029551
144,1551830400,476,289,0,765,10,-0.23401019421924776,-0.3501692957912474
144,1551844800,45,45,0,90,10,-0.23401019421924776,-1.2898095736598574
144,1551859200,410,317,0,727,10,-0.23401019421924776,-0.40306756328607285
144,1551873600,1226,732,0,1958,10,-0.23401019421924776,1.3105578916120884
144,1551888000,1199,417,0,1616,10,-0.23401019421924776,0.8344734841586594
144,1551902400,1728,508,0,2236,10,-0.23401019421924776,1.6975504801268642
144,1551916800,421,265,0,686,10,-0.23401019421924776,-0.46014200979364767
144,1551931200,35,53,18,88,10,1.3043524738655463,-1.2925936930016904
144,1551945600,422,330,0,752,10,-0.23401019421924776,-0.3682660715131614
144,1551960000,1286,745,0,2031,10,-0.23401019421924776,1.41217824758899
144,1551974400,1285,470,0,1755,10,-0.23401019421924776,1.0279697784160473
144,1551988800,1648,508,0,2156,10,-0.23401019421924776,1.5861857064535474
144,1552003200,421,300,0,721,10,-0.23401019421924776,-0.4114199213115716
144,1552017600,53,43,0,96,10,-0.23401019421924776,-1.2814572156343587
144,1552032000,376,300,0,676,10,-0.23401019421924776,-0.4740626065028123
144,1552046400,1182,677,0,1859,10,-0.23401019421924776,1.172743984191359
144,1552060800,1262,387,0,1649,10,-0.23401019421924776,0.8804114532989026
144,1552075200,1599,462,0,2061,10,-0.23401019421924776,1.4539400377164837
144,1552089600,428,241,0,669,10,-0.23401019421924776,-0.4838070241992275
144,1552104000,52,63,11,115,10,0.7061003251659042,-1.255008081886946
144,1552118400,109,92,0,201,10,-0.23401019421924776,-1.1352909501881303
144,1552132800,519,193,0,712,10,-0.23401019421924776,-0.42394845834981976
144,1552147200,729,243,0,972,10,-0.23401019421924776,-0.062012943911540344
144,1552161600,715,287,0,1002,10,-0.23401019421924776,-0.02025115378404657
144,1552176000,311,215,0,526,10,-0.23401019421924776,-0.6828715571402811
144,1552194000,59,133,74,192,10,6.090369663462683,-1.1478194872263785
144,1552208400,120,103,0,223,10,-0.23401019421924776,-1.1046656374279684
144,1552222800,416,182,0,598,10,-0.23401019421924776,-0.5826432608342961
144,1552237200,536,213,0,749,10,-0.23401019421924776,-0.37244225052591073
144,1552251600,419,258,0,677,10,-0.23401019421924776,-0.4726705468318958
144,1552266000,152,120,0,272,10,-0.23401019421924776,-1.0364547135530617
144,1552280400,19,31,12,50,10,0.7915649178372816,-1.3454919604965159
144,1552294800,807,498,0,1305,10,-0.23401019421924776,0.4015429265036406
144,1552309200,1006,524,0,1530,10,-0.23401019421924776,0.7147563524598439
144,1552323600,1455,438,0,1893,10,-0.23401019421924776,1.2200740130025185
144,1552338000,1400,506,0,1906,10,-0.23401019421924776,1.2381707887244326
144,1552352400,255,240,0,495,11,-0.38210249606238267,-0.7234202524460964
144,1552366800,23,47,24,70,11,2.7474989002580847,-1.3601847796328999
144,1552381200,881,537,0,1418,11,-0.38210249606238267,0.6594824736560672
144,1552395600,1017,566,0,1583,11,-0.38210249606238267,0.9066969371521202
144,1552410000,1448,460,0,1908,11,-0.38210249606238267,1.3936345167655582
144,1552424400,1437,518,0,1955,11,-0.38210249606238267,1.4640531821250398
144,1552438800,293,240,0,533,11,-0.38210249606238267,-0.6664860123682176
144,1552453200,35,44,9,79,11,0.7914980275577927,-1.346700354351297
144,1552467600,874,502,0,1376,11,-0.38210249606238267,0.5965551556752536
144,1552482000,988,541,0,1529,11,-0.38210249606238267,0.8257903854625028
144,1552496400,1526,430,0,1956,11,-0.38210249606238267,1.4655514516007735
144,1552510800,1486,537,0,2023,11,-0.38210249606238267,1.5659355064749283
144,1552525200,310,231,0,541,11,-0.38210249606238267,-0.6544998565623483
144,1552539600,25,41,16,66,11,1.704298434817929,-1.3661778575358345
144,1552551775,602,339,0,941,11,-0.38210249606238267,-0.05519206626888632
144,1552554000,301,147,0,448,11,-0.38210249606238267,-0.7938389178055782
144,1552568400,1008,579,0,1587,11,-0.38210249606238267,0.9126900150550548
144,1552582800,1436,369,0,1805,11,-0.38210249606238267,1.2393127607649916
144,1552597200,1324,530,0,1854,11,-0.38210249606238267,1.3127279650759407
144,1552611600,289,258,0,547,11,-0.38210249606238267,-0.6455102397079464
144,1552626000,24,49,25,73,11,2.8778989584381045,-1.355689971205699
144,1552640400,819,523,0,1342,11,-0.38210249606238267,0.5456139935003094
144,1552654800,1045,526,0,1571,11,-0.38210249606238267,0.8887177034433164
144,1552669200,1405,386,0,1791,11,-0.38210249606238267,1.2183369881047204
144,1552683600,1155,473,0,1628,11,-0.38210249606238267,0.9741190635601347
144,1552698000,280,221,0,501,11,-0.38210249606238267,-0.7144306355916945
144,1552712400,31,55,24,86,11,2.7474989002580847,-1.3362124680211613
144,1552726800,218,130,0,348,11,-0.38210249606238267,-0.9436658653789437
144,1552741200,641,225,0,866,11,-0.38210249606238267,-0.16756227694891046
144,1552755600,691,271,0,962,11,-0.38210249606238267,-0.02372840727847957
144,1552770000,607,272,0,879,11,-0.38210249606238267,-0.14808477376437293
144,1552784400,227,184,0,411,11,-0.38210249606238267,-0.8492748884077235
144,1552798800,29,57,28,86,11,3.269099132978163,-1.3362124680211613
144,1552813200,159,90,0,249,11,-0.38210249606238267,-1.0919945434765757
144,1552827600,446,156,0,602,11,-0.38210249606238267,-0.5631054185425953
144,1552842000,514,202,0,716,11,-0.38210249606238267,-0.3923026983089587
144,1552856400,423,219,0,642,11,-0.38210249606238267,-0.5031746395132491
144,1552870800,135,96,0,231,11,-0.38210249606238267,-1.1189633940397814
144,1552885200,17,15,0,32,11,-0.38210249606238267,-1.4171190197107788
144,1552899600,793,470,0,1263,11,-0.38210249606238267,0.42725070491735057
144,1552914000,998,494,0,1492,11,-0.38210249606238267,0.7703544148603576
144,1552928400,1423,359,0,1782,11,-0.38210249606238267,1.2048525628231175
144,1552942800,1283,497,0,1780,11,-0.38210249606238267,1.2018560238716502
144,1552957200,258,198,0,456,12,-0.3369428752035831,-0.7753494723752803
144,1552971600,22,30,8,52,12,0.6144252430182985,-1.395132288942094
144,1552986000,841,487,0,1328,12,-0.3369428752035831,0.5623995772441791
144,1553000400,1029,530,0,1559,12,-0.3369428752035831,0.9167803461227285
144,1553014800,1384,367,0,1751,12,-0.3369428752035831,1.211330595580224
144,1553029200,1359,513,0,1872,12,-0.3369428752035831,1.39695861737375
144,1553043600,281,253,0,534,12,-0.3369428752035831,-0.6556884335331726
144,1553058000,30,26,0,56,12,-0.3369428752035831,-1.3889958254117296
144,1553072400,859,476,0,1335,12,-0.3369428752035831,0.5731383884223169
144,1553086800,1007,486,0,1493,12,-0.3369428752035831,0.8155286978717143
144,1553101200,1442,490,0,1932,12,-0.3369428752035831,1.4890055703292173
144,1553115600,1379,543,0,1922,12,-0.3369428752035831,1.4736644115033062
144,1553130000,245,207,0,452,12,-0.3369428752035831,-0.7814859359056447
144,1553144400,27,27,0,54,12,-0.3369428752035831,-1.3920640571769118
144,1553158800,874,468,0,1342,12,-0.3369428752035831,0.5838771996004548
144,1553173200,959,527,0,1486,12,-0.3369428752035831,0.8047898866935765
144,1553187600,1445,400,0,1845,12,-0.3369428752035831,1.3555374885437896
144,1553202000,1289,465,0,1754,12,-0.3369428752035831,1.2159329432279975
144,1553216400,267,194,0,461,12,-0.3369428752035831,-0.7676788929623246
144,1553230800,32,38,6,70,12,0.37658321346282814,-1.3675182030554538
144,1553245200,783,469,0,1252,12,-0.3369428752035831,0.44580677016725373
144,1553259600,948,550,0,1498,12,-0.3369428752035831,0.82319927728467
144,1553274000,1283,393,0,1676,12,-0.3369428752035831,1.09627190438589
144,1553288400,1147,461,0,1608,12,-0.3369428752035831,0.9919520243696935
144,1553302800,279,208,0,487,12,-0.3369428752035831,-0.7277918800149554
144,1553317200,25,64,39,89,12,4.300976701128089,-1.3383700012862225
144,1553331600,189,139,0,328,12,-0.3369428752035831,-0.9717163053469441
144,1553346000,490,195,0,685,12,-0.3369428752035831,-0.4240369352619131
144,1553360400,615,248,0,863,12,-0.3369428752035831,-0.15096430816069317
144,1553374800,551,282,0,833,12,-0.3369428752035831,-0.19698778463842687
144,1553389200,210,235,25,445,12,2.636082494239797,-0.7922247470837827
144,1553403600,31,62,31,93,12,3.3496085829062086,-1.332233537755858
144,1553418000,156,75,0,231,12,-0.3369428752035831,-1.120525545958283
144,1553432400,445,199,0,644,12,-0.3369428752035831,-0.4869356864481491
144,1553446800,522,193,0,715,12,-0.3369428752035831,-0.3780134587841794
144,1553461200,390,244,0,634,12,-0.3369428752035831,-0.5022768452740604
144,1553475600,129,112,0,241,12,-0.3369428752035831,-1.1051843871323717
144,1553490000,23,33,10,56,12,0.8522672725737689,-1.3889958254117296
144,1553504400,785,495,0,1280,12,-0.3369428752035831,0.48876201487980514
144,1553518800,924,512,0,1436,12,-0.3369428752035831,0.7280840925640204
144,1553533200,1433,342,0,1775,12,-0.3369428752035831,1.248149376762411
144,1553547600,1266,490,0,1756,12,-0.3369428752035831,1.2190011749931797
144,1553562000,255,164,0,419,13,-0.31282367017005264,-0.7656193403472433
144,1553576400,30,38,8,68,13,0.5809582446015265,-1.3115274967568096
144,1553590800,861,506,0,1367,13,-0.31282367017005264,0.7087992701264566
144,1553605200,948,534,0,1482,13,-0.31282367017005264,0.8876580678105025
144,1553619600,1377,397,0,1774,13,-0.31282367017005264,1.3418038845386886
144,1553634000,1364,579,0,1943,13,-0.31282367017005264,1.6046485524395908
144,1553648400,273,207,0,480,13,-0.31282367017005264,-0.6707464128800538
144,1553662800,30,35,5,65,13,0.24579002656218427,-1.3161933784355238
144,1553677200,840,506,0,1346,13,-0.31282367017005264,0.676138098375457
144,1553691600,969,472,0,1441,13,-0.31282367017005264,0.823891018201408
144,1553706000,1498,371,0,1869,13,-0.31282367017005264,1.4895568043646397
144,1553720400,1418,546,0,1964,13,-0.31282367017005264,1.6373097241905905
144,1553734800,284,214,0,498,13,-0.31282367017005264,-0.6427511228077684
144,1553749200,21,28,7,49,13,0.46923550525507907,-1.3410780807219997
144,1553763600,858,466,0,1324,13,-0.31282367017005264,0.6419216327315526
144,1553778000,1171,577,0,1748,13,-0.31282367017005264,1.3013662433231652
144,1553792400,1375,390,0,1765,13,-0.31282367017005264,1.3278062395025458
144,1553806800,1303,513,0,1816,13,-0.31282367017005264,1.407126228040688
144,1553821200,245,197,0,442,13,-0.31282367017005264,-0.7298475808104342
144,1553835600,29,53,24,82,13,2.3685220741446846,-1.289753382256143
144,1553850000,773,515,0,1288,13,-0.31282367017005264,0.5859310525869816
144,1553852895,244,166,0,410,13,-0.31282367017005264,-0.7796169853833861
144,1553857279,255,128,0,383,13,-0.31282367017005264,-0.8216099204918142
144,1553864400,463,221,0,684,13,-0.31282367017005264,-0.35346645872748544
144,1553878800,1452,361,0,1813,13,-0.31282367017005264,1.4024603463619738
144,1553893200,1088,437,0,1525,13,-0.31282367017005264,0.9545357052054066
144,1553907600,294,206,0,500,13,-0.31282367017005264,-0.6396405350219588
144,1553922000,29,45,16,74,13,1.4747401593731053,-1.302195733399381
144,1553936400,218,164,0,382,13,-0.31282367017005264,-0.823165214384719
144,1553950800,579,214,0,793,13,-0.31282367017005264,-0.18393942440086805
144,1553965200,591,236,0,827,13,-0.31282367017005264,-0.13105943204210665
144,1553979600,610,248,0,858,13,-0.31282367017005264,-0.08284532136205949
144,1553994000,222,228,6,450,13,0.3575127659086317,-0.7174052296671962
144,1554008400,22,76,54,98,13,5.720204254538107,-1.2648686799696671
144,1554022800,140,97,0,237,13,-0.31282367017005264,-1.0486828288559074
144,1554037200,449,167,0,616,13,-0.31282367017005264,-0.45922644344500824
144,1554051600,481,249,0,730,13,-0.31282367017005264,-0.2819229396538671
144,1554066000,396,247,0,643,13,-0.31282367017005264,-0.4172335083365801
144,1554080400,142,114,0,256,13,-0.31282367017005264,-1.0191322448907172
144,1554094800,19,25,6,44,13,0.3575127659086317,-1.3488545501865234
144,1554109200,839,474,0,1313,13,-0.31282367017005264,0.6248133999096003
144,1554123600,918,582,0,1500,13,-0.31282367017005264,0.915653357882788
144,1554128193,305,107,0,412,13,-0.31282367017005264,-0.7765063975975766
144,1554138000,1113,243,0,1356,13,-0.31282367017005264,0.6916910373045044
144,1554152400,1348,525,0,1873,13,-0.31282367017005264,1.4957779799362585
144,1554166800,260,186,0,446,14,-0.3303500531705905,-0.8266577738391386
144,1554181200,26,32,6,58,14,0.4333950238843527,-1.3998765765489212
144,1554195600,928,512,0,1440,14,-0.3303500531705905,0.6418460660926243
144,1554210000,1008,502,0,1510,14,-0.3303500531705905,0.7452618294681005
144,1554224400,1566,429,0,1995,14,-0.3303500531705905,1.4617853328553287
144,1554238800,1440,502,0,1942,14,-0.3303500531705905,1.3834848262996111
144,1554253200,279,217,0,496,14,-0.3303500531705905,-0.7527893714280841
144,1554267600,22,25,3,47,14,0.05152248535688107,-1.4161276250793533
144,1554282000,875,538,0,1413,14,-0.3303500531705905,0.6019571287906549
144,1554296400,1028,519,0,1547,14,-0.3303500531705905,0.7999244472522808
144,1554310800,1461,424,0,1885,14,-0.3303500531705905,1.299274847551009
144,1554325200,1389,499,0,1888,14,-0.3303500531705905,1.3037069516956723
144,1554339600,287,240,0,527,14,-0.3303500531705905,-0.7069909619332303
144,1554354000,30,27,0,57,14,-0.3303500531705905,-1.4013539445971424
144,1554368400,891,553,0,1444,14,-0.3303500531705905,0.6477555382855086
144,1554382800,1029,474,0,1503,14,-0.3303500531705905,0.7349202531305529
144,1554397200,1510,344,0,1854,14,-0.3303500531705905,1.2534764380561552
144,1554411600,1450,507,0,1957,14,-0.3303500531705905,1.4056453470229275
144,1554426000,305,250,0,555,14,-0.3303500531705905,-0.6656246565830398
144,1554440400,31,38,7,69,14,0.5606858700601766,-1.3836255280184893
144,1554454800,838,505,0,1343,14,-0.3303500531705905,0.4985413654151786
144,1554469200,1027,497,0,1524,14,-0.3303500531705905,0.7659449821431957
144,1554483600,1578,408,0,1986,14,-0.3303500531705905,1.448489020421339
144,1554498000,1320,486,0,1806,14,-0.3303500531705905,1.182562771741543
144,1554512400,294,211,0,505,14,-0.3303500531705905,-0.7394930589940943
144,1554526800,32,50,18,82,14,1.9608851779942391,-1.3644197433916152
144,1554541200,211,139,0,350,14,-0.3303500531705905,-0.9684851064683632
144,1554555600,576,195,0,771,14,-0.3303500531705905,-0.34651315816728456
144,1554570000,688,284,0,972,14,-0.3303500531705905,-0.04956218047484558
144,1554584400,647,265,0,912,14,-0.3303500531705905,-0.13820426336811092
144,1554598800,202,213,11,415,14,1.0698492547634721,-0.8724561833339923
144,1554613200,22,66,44,88,14,5.27044717856566,-1.3555555351022885
144,1554627600,167,96,0,263,14,-0.3303500531705905,-1.0970161266635978
144,1554642000,503,167,0,670,14,-0.3303500531705905,-0.49572733103761457
144,1554656400,565,220,0,785,14,-0.3303500531705905,-0.32583000549218927
144,1554670800,457,245,0,702,14,-0.3303500531705905,-0.4484515534945397
144,1554685200,120,102,0,222,14,-0.3303500531705905,-1.1575882166406626
144,1554699600,24,44,20,68,14,2.2154668703458866,-1.3851028960667104
144,1554714000,859,522,0,1381,14,-0.3303500531705905,0.55468135124758
144,1554728400,896,533,0,1429,14,-0.3303500531705905,0.6255950175621923
144,1554742800,1299,282,0,1581,14,-0.3303500531705905,0.8501549608917979
144,1554757200,1250,495,0,1745,14,-0.3303500531705905,1.0924433208000566
144,1554771600,238,221,0,459,15,-0.34885140465470055,-0.7436647100259037
144,1554786000,23,34,11,57,15,1.1722664318576874,-1.3336069170913467
144,1554800400,883,441,0,1324,15,-0.34885140465470055,0.5257382977144154
144,1554814800,1047,555,0,1602,15,-0.34885140465470055,0.9337082817049457
144,1554829200,1425,413,0,1838,15,-0.34885140465470055,1.2800425127184893
144,1554843600,1441,569,0,2010,15,-0.34885140465470055,1.5324555963385298
144,1554858000,279,217,0,496,15,-0.34885140465470055,-0.6893665466890345
144,1554872400,29,24,0,53,15,-0.34885140465470055,-1.3394769888034408
144,1554886800,878,573,0,1451,15,-0.34885140465470055,0.7121130745733987
144,1554887403,48,32,0,80,15,-0.34885140465470055,-1.2998540047468066
144,1554894656,551,277,0,828,15,-0.34885140465470055,-0.2021505945852358
144,1554901200,387,172,0,559,15,-0.34885140465470055,-0.5969129172235547
144,1554915600,1458,364,0,1822,15,-0.34885140465470055,1.2565622258701135
144,1554930000,1468,520,0,1988,15,-0.34885140465470055,1.500170201922013
144,1554944400,294,211,0,505,15,-0.34885140465470055,-0.6761588853368231
144,1554958800,24,33,9,57,15,0.8956995524917986,-1.3336069170913467
144,1554973200,886,530,0,1416,15,-0.34885140465470055,0.6607499470925765
144,1554987600,1031,620,0,1651,15,-0.34885140465470055,1.0056166601780967
144,1555002000,1457,437,0,1894,15,-0.34885140465470055,1.3622235166878047
144,1555016400,1456,574,0,2030,15,-0.34885140465470055,1.5618059548989995
144,1555030800,298,239,0,537,15,-0.34885140465470055,-0.6291983116400715
144,1555045200,28,42,14,70,15,1.5871167509065205,-1.3145291840270414
144,1555059600,782,494,0,1276,15,-0.34885140465470055,0.45529743716928783
144,1555074000,992,484,0,1476,15,-0.34885140465470055,0.7488010227739859
144,1555088400,1441,426,0,1867,15,-0.34885140465470055,1.3226005326311705
144,1555102800,1207,500,0,1707,15,-0.34885140465470055,1.087797664147412
144,1555117200,305,229,0,534,15,-0.34885140465470055,-0.633600865424142
144,1555131600,32,45,13,77,15,1.448833311223576,-1.304256558530877
144,1555146000,223,130,0,353,15,-0.34885140465470055,-0.8992216103963937
144,1555160400,600,201,0,801,15,-0.34885140465470055,-0.24177357864187002
144,1555174800,676,247,0,923,15,-0.34885140465470055,-0.0627363914230042
144,1555189200,648,278,0,926,15,-0.34885140465470055,-0.05833383763893374
144,1555203600,239,181,0,420,15,-0.34885140465470055,-0.8008979092188198
144,1555218000,18,60,42,78,15,5.459053062028962,-1.3027890406028535
144,1555232400,160,98,0,258,15,-0.34885140465470055,-1.0386358135586253
144,1555246800,475,193,0,668,15,-0.34885140465470055,-0.43695346306899424
144,1555261200,550,234,0,784,15,-0.34885140465470055,-0.26672138341826934
144,1555275600,471,244,0,715,15,-0.34885140465470055,-0.36798012045189016
144,1555290000,135,148,13,283,15,1.448833311223576,-1.001947865358038
144,1555304400,19,28,9,47,15,0.8956995524917986,-1.3482820963715816
144,1555318800,820,530,0,1350,15,-0.34885140465470055,0.5638937638430261
144,1555333200,959,524,0,1483,15,-0.34885140465470055,0.7590736482701503
144,1555347600,1407,420,0,1827,15,-0.34885140465470055,1.263899815510231
144,1555362000,1358,555,0,1913,15,-0.34885140465470055,1.3901063573202512
144,1555376400,196,176,0,372,16,-0.36616691861841205,-0.8586328618603961
144,1555390800,22,41,19,63,16,1.663008088725288,-1.3334842395918582
144,1555405200,898,531,0,1429,16,-0.36616691861841205,0.7656969318682624
144,1555419600,1017,488,0,1505,16,-0.36616691861841205,0.8824888564882983
144,1555434000,1475,415,0,1890,16,-0.36616691861841205,1.4741321588397964
144,1555448400,1458,440,0,1898,16,-0.36616691861841205,1.4864260456419056
144,1555462800,272,182,0,454,16,-0.36616691861841205,-0.7326205221387784
144,1555477200,29,32,3,61,16,-0.04577086482730149,-1.3365577112923854
144,1555491600,833,451,0,1284,16,-0.36616691861841205,0.5428702335800358
144,1555506000,1068,541,0,1609,16,-0.36616691861841205,1.0423093849157161
144,1555520400,1467,380,0,1847,16,-0.36616691861841205,1.4080525172784604
144,1555534800,1411,518,0,1929,16,-0.36616691861841205,1.534064857000078
144,1555549200,312,221,0,533,16,-0.36616691861841205,-0.6112183899679514
144,1555563600,29,49,20,78,16,1.7698067733223253,-1.3104332018379037
144,1555578000,840,535,0,1375,16,-0.36616691861841205,0.6827131959540262
144,1555592400,1037,540,0,1577,16,-0.36616691861841205,0.9931338377072798
144,1555606800,1426,422,0,1848,16,-0.36616691861841205,1.409589253128724
144,1555621200,1364,482,0,1846,16,-0.36616691861841205,1.4065157814281968
144,1555635600,313,193,0,506,16,-0.36616691861841205,-0.6527102579250695
144,1555650000,29,45,16,74,16,1.3426120349341777,-1.3165801452389583
144,1555664400,549,430,0,979,16,-0.36616691861841205,0.0741657992496282
144,1555678800,867,391,0,1258,16,-0.36616691861841205,0.5029151014731814
144,1555693200,1173,339,0,1512,16,-0.36616691861841205,0.8932460074401438
144,1555707600,1065,349,0,1414,16,-0.36616691861841205,0.7426458941143079
144,1555722000,284,194,0,478,16,-0.36616691861841205,-0.6957388617324511
144,1555736400,29,48,19,77,16,1.663008088725288,-1.3119699376881675
144,1555750800,168,134,0,302,16,-0.36616691861841205,-0.9662043713788503
144,1555765200,418,193,0,611,16,-0.36616691861841205,-0.49135299364738816
144,1555779600,549,259,0,808,16,-0.36616691861841205,-0.18861603114545278
144,1555794000,464,218,0,682,16,-0.36616691861841205,-0.38224474827867033
144,1555808400,173,159,0,332,16,-0.36616691861841205,-0.9201022958709414
144,1555822800,23,73,50,96,16,4.973767311233431,-1.2827719565331583
144,1555837200,126,96,0,222,16,-0.36616691861841205,-1.0891432393999407
144,1555851600,395,205,0,600,16,-0.36616691861841205,-0.5082570880002881
144,1555866000,405,215,0,620,16,-0.36616691861841205,-0.4775223709950155
144,1555880400,351,263,0,614,16,-0.36616691861841205,-0.48674278609659727
144,1555894800,123,116,0,239,16,-0.36616691861841205,-1.063018729945459
144,1555909200,22,39,17,61,16,1.4494107195312145,-1.3365577112923854
144,1555923600,689,517,0,1206,16,-0.36616691861841205,0.4230048372594725
144,1555938000,926,470,0,1396,16,-0.36616691861841205,0.7149846488095626
144,1555952400,1194,424,0,1618,16,-0.36616691861841205,1.0561400075680887
144,1555966800,1244,544,0,1788,16,-0.36616691861841205,1.3173851021129062
144,1555981200,257,177,0,434,17,-0.3236299445936838,-0.800898860488781
144,1555995600,24,28,4,52,17,0.3018121955199523,-1.4060306306078574
144,1556010000,838,552,0,1390,17,-0.3236299445936838,0.7135146793903732
144,1556024400,973,570,0,1543,17,-0.3236299445936838,0.9558842103542964
144,1556038800,1342,372,0,1714,17,-0.3236299445936838,1.2267678037845635
144,1556053200,1275,488,0,1763,17,-0.3236299445936838,1.3043894182762774
144,1556067600,287,208,0,495,17,-0.3236299445936838,-0.7042678710195045
144,1556082000,35,33,0,68,17,-0.3236299445936838,-1.3806847973044405
144,1556096400,794,549,0,1343,17,-0.3236299445936838,0.6390612940615863
144,1556110800,940,464,0,1404,17,-0.3236299445936838,0.7356922835308629
144,1556125200,1275,385,0,1660,17,-0.3236299445936838,1.1412256163855319
144,1556139600,1294,477,0,1771,17,-0.3236299445936838,1.317062334927986
144,1556154000,267,223,0,490,17,-0.3236299445936838,-0.7121884439268222
144,1556168400,23,34,11,57,17,1.3963359407188156,-1.3981100577005396
144,1556182800,834,517,0,1351,17,-0.3236299445936838,0.6517342107132947
144,1556197200,984,484,0,1468,17,-0.3236299445936838,0.8370756167445301
144,1556211600,1361,443,0,1804,17,-0.3236299445936838,1.369338116116283
144,1556226000,1332,433,0,1765,17,-0.3236299445936838,1.3075576474392046
144,1556240400,317,205,0,522,17,-0.3236299445936838,-0.6614967773199886
144,1556254800,28,31,3,59,17,0.1454516604915433,-1.3949418285376125
144,1556269200,731,463,0,1194,17,-0.3236299445936838,0.4030282214235173
144,1556283600,855,488,0,1343,17,-0.3236299445936838,0.6390612940615863
144,1556298000,1253,423,0,1676,17,-0.3236299445936838,1.1665714496889485
144,1556312400,1157,520,0,1677,17,-0.3236299445936838,1.1681555642704122
144,1556326800,255,214,0,469,17,-0.3236299445936838,-0.7454548501375567
144,1556341200,27,59,32,86,17,4.679907176315406,-1.3521707348380967
144,1556355600,202,134,0,336,17,-0.3236299445936838,-0.956142089472209
144,1556370000,535,203,0,738,17,-0.3236299445936838,-0.3193280277238617
144,1556384400,680,265,0,945,17,-0.3236299445936838,0.00858369063909322
144,1556398800,652,272,0,924,17,-0.3236299445936838,-0.02468271557164134
144,1556413200,206,231,25,437,17,3.5853834311165427,-0.7961465167443904
144,1556427600,55,67,12,122,17,1.5526964757472246,-1.2951426099054089
144,1556442000,145,94,0,239,17,-0.3236299445936838,-1.1098012038741734
144,1556456400,455,177,0,632,17,-0.3236299445936838,-0.48724417335899806
144,1556470800,578,218,0,796,17,-0.3236299445936838,-0.2274493819989758
144,1556485200,482,255,0,737,17,-0.3236299445936838,-0.3209121423053253
144,1556499600,138,127,0,265,17,-0.3236299445936838,-1.068614224756121
144,1556514000,23,25,2,48,17,-0.010908874536865766,-1.4123670889337114
144,1556526784,604,381,0,985,17,-0.3236299445936838,0.07194827389763524
144,1556528400,211,139,0,350,17,-0.3236299445936838,-0.9339644853317193
144,1556542800,967,554,0,1521,17,-0.3236299445936838,0.9210336895620983
144,1556557200,1411,391,0,1802,17,-0.3236299445936838,1.3661698869533558
144,1556571600,1435,492,0,1927,17,-0.3236299445936838,1.5641842096362997
144,1556586000,269,81,0,350,18,-0.20652851724645424,-0.876471167173491
144,1556600400,26,30,4,56,18,2.822556402368208,-1.3091708969203246
144,1556614800,936,514,0,1450,18,-0.20652851724645424,0.7424733999064986
144,1556629200,978,535,0,1513,18,-0.20652851724645424,0.8351947705665344
144,1556643600,1331,348,0,1679,18,-0.20652851724645424,1.0795082234167874
144,1556658000,1345,445,0,1790,18,-0.20652851724645424,1.242874447913041
144,1556672400,283,99,0,382,18,-0.20652851724645424,-0.8293745979493459
144,1556686800,26,24,0,50,18,-0.20652851724645424,-1.3180015036498518
144,1556701200,884,603,0,1487,18,-0.20652851724645424,0.7969288080719165
144,1556715600,1130,541,0,1671,18,-0.20652851724645424,1.067734081110751
144,1556730000,1524,438,0,1962,18,-0.20652851724645424,1.496018507492821
144,1556744400,1487,539,0,2026,18,-0.20652851724645424,1.5902116459411113
144,1556758800,306,91,0,397,18,-0.20652851724645424,-0.8072980811255278
144,1556773200,33,30,0,63,18,-0.20652851724645424,-1.298868522402543
144,1556787600,870,510,0,1380,18,-0.20652851724645424,0.6394496547286811
144,1556790260,193,153,0,346,18,-0.20652851724645424,-0.8823582383265092
144,1556802000,799,377,0,1176,18,-0.20652851724645424,0.3392090259247557
144,1556816400,1465,416,0,1881,18,-0.20652851724645424,1.3768053166442036
144,1556830800,1425,513,0,1938,18,-0.20652851724645424,1.4606960805747122
144,1556845200,342,96,0,438,18,-0.20652851724645424,-0.7469556018070919
144,1556859600,53,40,0,93,18,-0.20652851724645424,-1.2547154887549068
144,1556874000,825,550,0,1375,18,-0.20652851724645424,0.6320908157874083
144,1556878212,353,205,0,558,18,-0.20652851724645424,-0.5703434672165476
144,1556888400,714,336,0,1050,18,-0.20652851724645424,0.15376628460468417
144,1556902800,1564,490,0,2054,18,-0.20652851724645424,1.6314211440122384
144,1556917200,1177,513,0,1690,18,-0.20652851724645424,1.0956976690875873
144,1556931600,285,96,0,381,18,-0.20652851724645424,-0.8308463657376004
144,1556946000,22,20,0,42,18,-0.20652851724645424,-1.3297756459558883
144,1556960400,213,128,0,341,18,-0.20652851724645424,-0.8897170772677819
144,1556974800,565,210,0,775,18,-0.20652851724645424,-0.2509698571653132
144,1556989200,709,253,0,962,18,-0.20652851724645424,0.024250719238285
144,1557003600,609,244,0,853,18,-0.20652851724645424,-0.13617196968145942
144,1557018000,207,82,0,289,18,-0.20652851724645424,-0.9662490022570177
144,1557032400,19,27,8,46,18,5.8516413219828705,-1.32388857480287
144,1557046800,165,92,0,257,18,-0.20652851724645424,-1.013345571481163
144,1557061200,482,190,0,672,18,-0.20652851724645424,-0.4025619393555305
144,1557075600,518,248,0,766,18,-0.20652851724645424,-0.26421576725960405
144,1557090000,446,271,0,717,18,-0.20652851724645424,-0.33633238888407635
144,1557104400,188,51,0,239,18,-0.20652851724645424,-1.0398373916697445
144,1557118800,32,28,0,60,18,-0.20652851724645424,-1.3032838257673065
144,1557133200,772,475,0,1247,18,-0.20652851724645424,0.4437045388908278
144,1557147600,959,560,0,1519,18,-0.20652851724645424,0.8440253772960615
144,1557162000,1365,449,0,1814,18,-0.20652851724645424,1.2781968748311496
144,1557176400,1314,454,0,1768,18,-0.20652851724645424,1.210495556571441
144,1557190800,196,205,9,401,19,-0.05700839432648204,-0.7514050477386733
144,1557205200,17,50,33,67,19,1.1715806752401516,-1.2342493232772629
144,1557219600,917,539,0,1456,19,-0.5177292954139697,0.7737467806841171
144,1557226460,515,332,0,847,19,-0.5177292954139697,-0.10664891932486807
144,1557227076,39,14,0,53,19,-0.5177292954139697,-1.2544883048866649
144,1557234000,442,203,0,645,19,-0.5177292954139697,-0.39866851111766777
144,1557248400,1411,462,0,1873,19,-0.5177292954139697,1.3765793043355896
144,1557262800,1348,559,0,1907,19,-0.5177292954139697,1.425731116815566
144,1557277200,183,232,49,415,19,1.9906400549512409,-0.7311660661292714
144,1557291600,24,47,23,71,19,0.659668562920721,-1.228466757103148
144,1557306000,868,527,0,1395,19,-0.5177292954139697,0.6855626465288657
144,1557320400,1070,529,0,1599,19,-0.5177292954139697,0.9804735214087228
144,1557334800,1478,404,0,1882,19,-0.5177292954139697,1.389590078227348
144,1557349200,1485,551,0,2036,19,-0.5177292954139697,1.6122188759307696
144,1557363600,193,284,91,477,19,4.14067092669285,-0.6415362904304912
144,1557378000,28,55,27,83,19,0.8644334078484932,-1.2111190585808034
144,1557392400,893,511,0,1404,19,-0.5177292954139697,0.6985734204206241
144,1557406800,1062,543,0,1605,19,-0.5177292954139697,0.9891473706698951
144,1557421200,1538,430,0,1968,19,-0.5177292954139697,1.5139152509708174
144,1557435600,1353,486,0,1839,19,-0.5177292954139697,1.3274274918556135
144,1557450000,210,232,22,442,19,0.6084773516887779,-0.6921337444539961
144,1557464400,21,38,17,59,19,0.35252129552906253,-1.2458144556254926
144,1557478800,806,493,0,1299,19,-0.5177292954139697,0.5467810583501094
144,1557493200,928,476,0,1404,19,-0.5177292954139697,0.6985734204206241
144,1557507600,1479,361,0,1840,19,-0.5177292954139697,1.3288731333991421
144,1557522000,1246,395,0,1641,19,-0.5177292954139697,1.0411904662369287
144,1557536400,196,225,29,421,19,0.9668158303123794,-0.7224922168680991
144,1557550800,28,89,61,117,19,2.6049345897345577,-1.1619672461008272
144,1557565200,158,147,0,305,19,-0.5177292954139697,-0.8901866359174296
144,1557579600,375,201,0,576,19,-0.5177292954139697,-0.4984177776211488
144,1557594000,500,210,0,710,19,-0.5177292954139697,-0.3047018107883015
144,1557608400,448,286,0,734,19,-0.5177292954139697,-0.27000641374361245
144,1557622800,150,175,25,325,19,0.7620509853846071,-0.8612738050468554
144,1557637200,25,70,45,95,19,1.7858752100234687,-1.193771360058459
144,1557651600,113,92,0,205,19,-0.5177292954139697,-1.0347507902703008
144,1557666000,255,178,0,433,19,-0.5177292954139697,-0.7051445183457545
144,1557680400,293,198,0,491,19,-0.5177292954139697,-0.6212973088210892
144,1557694800,269,244,0,513,19,-0.5177292954139697,-0.5894931948634576
144,1557709200,145,137,0,282,19,-0.5177292954139697,-0.9234363914185899
144,1557723600,28,42,14,70,19,0.1989476618332333,-1.2299123986466767
144,1557738000,832,480,0,1312,19,-0.5177292954139697,0.5655743984159827
144,1557752400,963,565,0,1528,19,-0.5177292954139697,0.8778329718181843
144,1557766800,1400,442,0,1842,19,-0.5177292954139697,1.3317644164861997
144,1557781200,1334,513,0,1847,19,-0.5177292954139697,1.3389926242038432
144,1557795600,250,201,0,451,20,-0.2812090088492059,-0.8209224347246431
144,1557810000,27,29,2,56,20,-0.01278222767496392,-1.4070180233153315
144,1557824400,875,535,0,1410,20,-0.2812090088492059,0.6020286271955347
144,1557838800,1036,525,0,1561,20,-0.2812090088492059,0.8260803585302029
144,1557853200,1504,410,0,1914,20,-0.2812090088492059,1.3498569225112487
144,1557867600,1398,550,0,1948,20,-0.2812090088492059,1.4003056567190546
144,1557882000,290,218,0,508,20,-0.2812090088492059,-0.7363466156115565
144,1557896400,24,26,2,50,20,-0.01278222767496392,-1.4159207411167092
144,1557910800,829,523,0,1352,20,-0.2812090088492059,0.5159690217822184
144,1557925200,1007,554,0,1561,20,-0.2812090088492059,0.8260803585302029
144,1557939600,1465,387,0,1852,20,-0.2812090088492059,1.257862171897014
144,1557954000,1447,418,0,1865,20,-0.2812090088492059,1.2771513937999985
144,1557968400,257,255,0,512,20,-0.2812090088492059,-0.730411470410638
144,1557982800,30,42,12,72,20,1.3293516781962462,-1.383277442511658
144,1557997200,874,567,0,1441,20,-0.2812090088492059,0.648026002502652
144,1558011600,1052,551,0,1603,20,-0.2812090088492059,0.8883993831398458
144,1558026000,1489,377,0,1866,20,-0.2812090088492059,1.2786351801002283
144,1558040400,1501,530,0,2031,20,-0.2812090088492059,1.5234599196381107
144,1558054800,299,279,0,578,20,-0.2812090088492059,-0.632481574595485
144,1558069200,41,46,5,87,20,0.3898579440863991,-1.3610206480082143
144,1558083600,1004,504,0,1508,20,-0.2812090088492059,0.7474396846180346
144,1558098000,856,489,0,1345,20,-0.2812090088492059,0.5055825176806112
144,1558112400,1495,349,0,1844,20,-0.2812090088492059,1.2459918814951771
144,1558126800,1295,369,0,1664,20,-0.2812090088492059,0.9789103474538509
144,1558141200,266,220,0,486,20,-0.2812090088492059,-0.7689899142166075
144,1558155600,30,47,17,77,20,2.0004186311318515,-1.3758585110105102
144,1558170000,249,166,0,415,20,-0.2812090088492059,-0.8743387415329084
144,1558184400,543,211,0,754,20,-0.2812090088492059,-0.371335185755077
144,1558198800,658,236,0,894,20,-0.2812090088492059,-0.16360510372293427
144,1558213200,640,257,0,897,20,-0.2812090088492059,-0.1591537448222455
144,1558227600,207,177,0,384,20,-0.2812090088492059,-0.9203361168400257
144,1558242000,23,68,45,91,20,5.75839356757124,-1.355085502807296
144,1558256400,173,103,0,276,20,-0.2812090088492059,-1.0805850372648216
144,1558270800,511,194,0,705,20,-0.2812090088492059,-0.444040714466327
144,1558285200,523,222,0,745,20,-0.2812090088492059,-0.38468926245714335
144,1558299600,499,233,0,732,20,-0.2812090088492059,-0.403978484360128
144,1558314000,136,106,0,242,20,-0.2812090088492059,-1.1310337714726275
144,1558328400,21,26,5,47,20,0.3898579440863991,-1.4203721000173979
144,1558342800,839,519,0,1358,20,-0.2812090088492059,0.524871739583596
144,1558357200,777,565,0,1342,20,-0.2812090088492059,0.5011311587799225
144,1558371600,1344,426,0,1770,20,-0.2812090088492059,1.1361916952781874
144,1558386000,1371,514,0,1885,20,-0.2812090088492059,1.3068271198045904
144,1558400400,276,195,0,471,21,-0.36313274791032324,-0.5927663494805284
144,1558414800,29,30,1,59,21,-0.14209542309534387,-1.169793178430296
144,1558429200,859,529,0,1388,21,-0.36313274791032324,0.691538510099415
144,1558443600,1047,448,0,1495,21,-0.36313274791032324,0.8413974195596702
144,1558458000,1473,420,0,1893,21,-0.36313274791032324,1.3988165407295912
144,1558472400,1435,564,0,1999,21,-0.36313274791032324,1.547274899634143
144,1558486800,288,240,0,528,21,-0.36313274791032324,-0.5129349678054392
144,1558501200,24,25,1,49,21,-0.14209542309534387,-1.1837986839873291
144,1558515600,831,514,0,1345,21,-0.36313274791032324,0.6313148362041724
144,1558530000,1008,573,0,1581,21,-0.36313274791032324,0.9618447673501557
144,1558544400,1510,416,0,1926,21,-0.36313274791032324,1.4450347090678006
144,1558558800,1496,536,0,2032,21,-0.36313274791032324,1.5934930679723525
144,1558573200,288,190,0,478,21,-0.36313274791032324,-0.5829624955906052
144,1558587600,25,37,12,62,21,2.289315149869429,-1.165591526763186
144,1558602000,789,482,0,1271,21,-0.36313274791032324,0.5276740950821267
144,1558616400,1031,590,0,1621,21,-0.36313274791032324,1.0178667895782885
144,1558630800,1449,229,0,1678,21,-0.36313274791032324,1.0976981712533775
144,1558645200,2154,825,0,2979,21,-0.36313274791032324,2.919814444223395
144,1558659600,256,212,0,468,21,-0.36313274791032324,-0.5969680011476384
144,1558674000,25,45,20,70,21,4.057613748389264,-1.1543871223175595
144,1558688400,712,516,0,1228,21,-0.36313274791032324,0.467450421186884
144,1558702800,922,533,0,1455,21,-0.36313274791032324,0.7853753973315375
144,1558717200,1534,380,0,1914,21,-0.36313274791032324,1.4282281023993608
144,1558731600,1089,400,0,1489,21,-0.36313274791032324,0.8329941162254503
144,1558746000,287,167,0,454,21,-0.36313274791032324,-0.6165757089274849
144,1558760400,29,38,9,67,21,1.6262031754244912,-1.1585887739846694
144,1558774800,199,136,0,335,21,-0.36313274791032324,-0.7832412250561799
144,1558789200,478,156,0,634,21,-0.36313274791032324,-0.36447660890088746
144,1558803600,516,240,0,756,21,-0.36313274791032324,-0.19360944110508255
144,1558818000,531,245,0,776,21,-0.36313274791032324,-0.16559842999101618
144,1558832400,172,158,0,330,21,-0.36313274791032324,-0.7902439778346965
144,1558846800,20,35,15,55,21,2.9524271243143674,-1.1753953806531092
144,1558861200,163,113,0,276,21,-0.36313274791032324,-0.8658737078426757
144,1558875600,384,158,0,542,21,-0.36313274791032324,-0.4933272600255928
144,1558890000,462,202,0,664,21,-0.36313274791032324,-0.3224600922297879
144,1558904400,395,224,0,619,21,-0.36313274791032324,-0.38548486723643727
144,1558918800,133,132,0,265,21,-0.36313274791032324,-0.8812797639554122
144,1558933200,16,27,11,43,21,2.06827782505445,-1.192201987321549
144,1558947600,147,123,0,270,21,-0.36313274791032324,-0.8742770111768956
144,1558962000,351,170,0,521,21,-0.36313274791032324,-0.5227388216953626
144,1558976400,524,255,0,779,21,-0.36313274791032324,-0.1613967783239062
144,1558990800,451,242,0,693,21,-0.36313274791032324,-0.28184412611439164
144,1559005200,149,136,0,285,22,-0.4295102089648037,-1.0369598941988436
144,1559019600,18,29,11,47,22,0.5880985938133465,-1.3874400667233286
144,1559034000,849,545,0,1394,22,-0.4295102089648037,0.5961599013039034
144,1559048400,977,565,0,1542,22,-0.4295102089648037,0.8141055548065242
144,1559062800,1471,412,0,1883,22,-0.4295102089648037,1.316264121322698
144,1559077200,1355,529,0,1884,22,-0.4295102089648037,1.3177367270896077
144,1559091600,190,210,20,400,22,1.4206876142681968,-0.8676102310042396
144,1559106000,28,39,11,67,22,0.5880985938133465,-1.3579879513851365
144,1559120400,901,547,0,1448,22,-0.4295102089648037,0.6756806127170217
144,1559134800,1005,499,0,1504,22,-0.4295102089648037,0.7581465356639594
144,1559149200,1406,415,0,1821,22,-0.4295102089648037,1.224962563774303
144,1559163600,1281,468,0,1749,22,-0.4295102089648037,1.1189349485568116
144,1559178000,205,259,54,464,22,4.5660239137642975,-0.7733634619220252
144,1559192400,22,47,25,69,22,1.883237070076447,-1.3550427398513174
144,1559206800,873,492,0,1365,22,-0.4295102089648037,0.553454334063525
144,1559221200,1057,595,0,1652,22,-0.4295102089648037,0.9760921891665802
144,1559235600,1466,469,0,1935,22,-0.4295102089648037,1.3928396212019973
144,1559250000,1332,487,0,1819,22,-0.4295102089648037,1.2220173522404836
144,1559264400,207,224,17,431,22,1.1431579407832468,-0.821959452230042
144,1559278800,24,48,24,72,22,1.790727178914797,-1.3506249225505886
144,1559293200,814,487,0,1301,22,-0.4295102089648037,0.4592075649813105
144,1559307600,989,543,0,1532,22,-0.4295102089648037,0.7993794971374283
144,1559322000,1351,393,0,1744,22,-0.4295102089648037,1.1115719197222635
144,1559336400,1296,427,0,1723,22,-0.4295102089648037,1.080647198617162
144,1559350800,306,258,0,564,22,-0.4295102089648037,-0.6261028852310652
144,1559365200,56,56,0,112,22,-0.4295102089648037,-1.2917206918742046
144,1559379600,214,128,0,342,22,-0.4295102089648037,-0.9530213654849965
144,1559394000,547,179,0,726,22,-0.4295102089648037,-0.3875407509917098
144,1559408400,654,206,0,860,22,-0.4295102089648037,-0.19021157822582335
144,1559422800,595,243,0,838,22,-0.4295102089648037,-0.22260890509783457
144,1559437200,226,175,0,401,22,-0.4295102089648037,-0.86613762523733
144,1559451600,29,56,27,85,22,2.068256852399747,-1.3314810475807637
144,1559466000,167,102,0,269,22,-0.4295102089648037,-1.0605215864693973
144,1559480400,451,151,0,602,22,-0.4295102089648037,-0.5701438660885003
144,1559494800,544,255,0,799,22,-0.4295102089648037,-0.280040530007309
144,1559509200,483,221,0,704,22,-0.4295102089648037,-0.41993807786372106
144,1559523600,148,132,0,280,22,-0.4295102089648037,-1.0443229230333917
144,1559538000,26,32,6,58,22,0.12554913800509643,-1.371241403287323
144,1559552400,844,544,0,1388,22,-0.4295102089648037,0.5873242667024458
144,1559566800,970,541,0,1511,22,-0.4295102089648037,0.7684547760323266
144,1559581200,1432,451,0,1883,22,-0.4295102089648037,1.316264121322698
144,1559595600,1433,559,0,1992,22,-0.4295102089648037,1.4767781499158446
144,1559610000,260,166,0,426,23,-0.4050154383038751,-0.8449404219339687
144,1559624400,21,37,16,58,23,1.4216313706907833,-1.4027721745891915
144,1559638800,849,547,0,1396,23,-0.4050154383038751,0.6254313174018087
144,1559653200,1022,465,0,1487,23,-0.4050154383038751,0.7633734084116599
144,1559667600,1339,407,0,1746,23,-0.4050154383038751,1.155977821285852
144,1559682000,1348,499,0,1847,23,-0.4050154383038751,1.3090783838352473
144,1559696400,284,219,0,503,23,-0.4050154383038751,-0.7282201910794791
144,1559710800,24,34,10,58,23,0.7366388173177864,-1.4027721745891915
144,1559725200,880,533,0,1413,23,-0.4050154383038751,0.6512007190190336
144,1559739600,839,520,0,1359,23,-0.4050154383038751,0.5693449727054954
144,1559754000,1434,462,0,1896,23,-0.4050154383038751,1.3833548943790135
144,1559768400,1415,552,0,1967,23,-0.4050154383038751,1.4909800423097765
144,1559782800,290,204,0,494,23,-0.4050154383038751,-0.7418628154650688
144,1559797200,21,40,19,61,23,1.7641276473772816,-1.3982246331273283
144,1559811600,831,490,0,1321,23,-0.4050154383038751,0.511742780855228
144,1559826000,1026,536,0,1562,23,-0.4050154383038751,0.8770619449582406
144,1559840400,1441,380,0,1821,23,-0.4050154383038751,1.2696663578324328
144,1559854800,1392,506,0,1898,23,-0.4050154383038751,1.3863865886869222
144,1559869200,339,224,0,563,23,-0.4050154383038751,-0.6372693618422146
144,1559883600,24,43,19,67,23,1.7641276473772816,-1.3891295502036018
144,1559898000,758,550,0,1308,23,-0.4050154383038751,0.4920367678538206
144,1559912400,1012,568,0,1580,23,-0.4050154383038751,0.90434719372942
144,1559926800,1481,351,0,1832,23,-0.4050154383038751,1.2863406765259313
144,1559941200,1271,356,0,1627,23,-0.4050154383038751,0.9755920099652773
144,1559955600,246,206,0,452,23,-0.4050154383038751,-0.805528395931154
144,1559970000,39,67,28,106,23,2.791616477436777,-1.3300115111993798
144,1559984400,225,148,0,373,23,-0.4050154383038751,-0.9252803210935524
144,1559998800,518,197,0,715,23,-0.4050154383038751,-0.4068605944411443
144,1560013200,657,260,0,917,23,-0.4050154383038751,-0.10065946934235356
144,1560027600,605,260,0,865,23,-0.4050154383038751,-0.17948352134798287
144,1560042000,230,202,0,432,23,-0.4050154383038751,-0.8358453390102423
144,1560056400,24,64,40,88,23,4.16160158418277,-1.3572967599705592
144,1560070800,141,100,0,241,23,-0.4050154383038751,-1.1253721454155345
144,1560085200,430,182,0,612,23,-0.4050154383038751,-0.5629928512984484
144,1560099600,582,303,0,885,23,-0.4050154383038751,-0.14916657826889468
144,1560114000,449,219,0,668,23,-0.4050154383038751,-0.4781054106770016
144,1560128400,125,120,0,245,23,-0.4050154383038751,-1.1193087567997169
144,1560142800,20,37,17,57,23,1.5357967962529493,-1.404288021743146
144,1560157200,837,460,0,1297,23,-0.4050154383038751,0.4753624491603221
144,1560171600,994,527,0,1521,23,-0.4050154383038751,0.8149122116461098
144,1560186000,1255,438,0,1693,23,-0.4050154383038751,1.0756379221262682
144,1560200400,1312,534,0,1846,23,-0.4050154383038751,1.307562536681293
144,1560214800,175,201,26,376,24,1.8269602381046741,-1.1041628378064365
144,1560229200,17,24,7,41,24,0.0913480119052337,-1.5954950606760454
144,1560243600,888,532,0,1420,24,-0.5480880714314023,0.4270337015245234
144,1560258000,1056,546,0,1602,24,-0.5480880714314023,0.6939664315611467
144,1560272400,1498,321,0,1819,24,-0.5480880714314023,1.0122323789125052
144,1560286800,1435,453,0,1888,24,-0.5480880714314023,1.113432150190126
144,1560301200,254,237,0,491,24,-0.5480880714314023,-0.9354965523437351
144,1560315600,20,32,12,52,24,0.5480880714314023,-1.5793617638057
144,1560327498,552,353,0,905,24,-0.5480880714314023,-0.32829792467800956
144,1560330000,340,157,0,497,24,-0.5480880714314023,-0.9266965722326376
144,1560344400,1047,505,0,1552,24,-0.5480880714314023,0.6206332639686678
144,1560358800,1518,334,0,1852,24,-0.5480880714314023,1.0606322695235413
144,1560373200,1408,462,0,1870,24,-0.5480880714314023,1.0870322098568337
144,1560387600,202,242,40,444,24,3.1058324047779458,-1.0044297298806653
144,1560402000,22,41,19,63,24,1.1875241547680382,-1.5632284669353547
144,1560416400,819,519,0,1338,24,-0.5480880714314023,0.30676730667285795
144,1560430800,1105,577,0,1682,24,-0.5480880714314023,0.811299499709113
144,1560445200,1402,386,0,1788,24,-0.5480880714314023,0.9667658150051683
144,1560459600,1377,422,0,1799,24,-0.5480880714314023,0.9828991118755137
144,1560474000,209,234,25,443,24,1.7356122261994404,-1.005896393232515
144,1560488400,30,51,21,81,24,1.3702201785785055,-1.5368285266020623
144,1560502800,768,507,0,1275,24,-0.5480880714314023,0.2143675155063345
144,1560517200,1092,534,0,1626,24,-0.5480880714314023,0.7291663520055366
144,1560531600,1389,329,0,1718,24,-0.5480880714314023,0.8640993803756978
144,1560546000,1186,413,0,1599,24,-0.5480880714314023,0.689566441505598
144,1561179600,28,64,36,92,25,2.526356371176858,-1.244115084924412
144,1561194000,246,192,0,438,25,-0.4469707425928288,-0.610257576953395
144,1561208400,546,216,0,762,25,-0.4469707425928288,-0.016703147523887744
144,1561222800,709,340,0,1049,25,-0.4469707425928288,0.5090688316312623
144,1561237200,663,298,0,961,25,-0.4469707425928288,0.3478565174652232
144,1561251600,222,223,1,445,25,-0.36437832276589305,-0.5974338701447328
144,1561266000,30,67,37,97,25,2.608948791003794,-1.2349552943467963
144,1561280400,179,106,0,285,25,-0.4469707425928288,-0.8905471686284401
144,1561294800,447,183,0,630,25,-0.4469707425928288,-0.25852161877294627
144,1561309200,542,267,0,809,25,-0.4469707425928288,0.06939888390570127
144,1561323600,476,326,0,802,25,-0.4469707425928288,0.05657517709703908
144,1561338000,161,154,0,315,25,-0.4469707425928288,-0.835588425162745
144,1561352400,23,41,18,64,25,1.0396928142920148,-1.2954099121590608
144,1561366800,801,522,0,1323,25,-0.4469707425928288,1.011025355284611
144,1561381200,922,570,0,1492,25,-0.4469707425928288,1.3206262768080268
144,1561395600,1257,409,0,1666,25,-0.4469707425928288,1.6393869889090584
144,1561410000,1323,556,0,1879,25,-0.4469707425928288,2.029594067515494
144,1561424400,252,193,0,445,26,-0.3807716856440606,-0.8164437236800847
144,1561438800,26,30,4,56,26,0.05737655537102282,-1.4288889742533273
144,1561453200,848,499,0,1347,26,-0.3807716856440606,0.6036735411452748
144,1561467600,997,575,0,1572,26,-0.3807716856440606,0.9579156526593611
144,1561482000,1367,420,0,1787,26,-0.3807716856440606,1.2964136703283768
144,1561496400,1236,531,0,1767,26,-0.3807716856440606,1.264925482638236
144,1561510800,249,228,0,477,26,-0.3807716856440606,-0.7660626233758591
144,1561525200,26,49,23,75,26,2.1385807001926693,-1.3989751959476933
144,1561539600,834,526,0,1360,26,-0.3807716856440606,0.6241408631438664
144,1561554000,1074,530,0,1604,26,-0.3807716856440606,1.0082967529635867
144,1561568400,1311,394,0,1705,26,-0.3807716856440606,1.1673121007987988
144,1561582800,1340,520,0,1860,26,-0.3807716856440606,1.4113455553973917
144,1561597200,291,213,0,504,26,-0.3807716856440606,-0.7235535699941688
144,1561611600,33,43,10,76,26,0.714598916893648,-1.3974007865631863
144,1561626000,803,532,0,1335,26,-0.3807716856440606,0.5847806285311902
144,1561640400,1012,558,0,1570,26,-0.3807716856440606,0.954766833890347
144,1561654800,1312,443,0,1755,26,-0.3807716856440606,1.2460325700241512
144,1561669200,1313,469,0,1782,26,-0.3807716856440606,1.2885416234058418
144,1561683600,272,268,0,540,26,-0.3807716856440606,-0.6668748321519149
144,1561698000,30,53,23,83,26,2.1385807001926693,-1.386379920871637
144,1561712400,696,480,0,1176,26,-0.3807716856440606,0.33444953639456915
144,1561726800,930,526,0,1456,26,-0.3807716856440606,0.7752841640565433
144,1561741200,1360,443,0,1803,26,-0.3807716856440606,1.3216042204804896
144,1561755600,1133,438,0,1571,26,-0.3807716856440606,0.956341243274854
144,1561770000,341,239,0,580,26,-0.3807716856440606,-0.6038984567716329
144,1561784400,27,54,27,81,26,2.5767289412077528,-1.389528739640651
144,1561798800,199,162,0,361,26,-0.3807716856440606,-0.9486941119786769
144,1561813200,499,173,0,672,26,-0.3807716856440606,-0.45905279339698424
144,1561827600,575,267,0,842,26,-0.3807716856440606,-0.19140319803078568
144,1561842000,548,244,0,792,26,-0.3807716856440606,-0.2701236672561382
144,1561856400,206,164,0,370,26,-0.3807716856440606,-0.9345244275181135
144,1561870800,25,68,43,93,26,4.3293219052680865,-1.3706358270265664
144,1561885200,146,100,0,246,26,-0.3807716856440606,-1.1297511911969877
144,1561899600,531,167,0,698,26,-0.3807716856440606,-0.4181181493998009
144,1561914000,579,217,0,796,26,-0.3807716856440606,-0.26382602971811
144,1561928400,420,265,0,685,26,-0.3807716856440606,-0.4385854713983926
144,1561942800,152,131,0,283,26,-0.3807716856440606,-1.0714980439702269
144,1561957200,23,39,16,62,26,1.371821278416273,-1.419442517946285
144,1561971600,813,552,0,1365,26,-0.3807716856440606,0.6320129100664017
144,1561986000,946,546,0,1492,26,-0.3807716856440606,0.8319629018987971
144,1562000400,1220,408,0,1628,26,-0.3807716856440606,1.046082578191756
144,1562014800,1210,508,0,1718,26,-0.3807716856440606,1.1877794227973906
144,1562029200,194,183,0,377,27,-0.584762557823774,-0.4621068909534615
144,1562043600,18,40,22,58,27,0.6602157910913576,-0.9665469504301425
144,1562058000,827,531,0,1358,27,-0.584762557823774,1.0891648906973974
144,1562063214,419,290,0,709,27,-0.584762557823774,0.06289028693449483
144,1562072400,514,276,0,790,27,-0.584762557823774,0.19097694780474925
144,1562086800,1295,419,0,1714,27,-0.584762557823774,1.65211367180617
144,1562101200,1274,518,0,1792,27,-0.584762557823774,1.7754563822738225
144,1562115600,187,178,0,365,27,-0.584762557823774,-0.4810826925638696
144,1562130000,22,35,13,57,27,0.15090646653516743,-0.9681282672310098
144,1562144400,769,493,0,1262,27,-0.584762557823774,0.937358477814133
144,1562158800,914,542,0,1456,27,-0.584762557823774,1.2441339371823965
144,1562173200,1356,422,0,1778,27,-0.584762557823774,1.7533179470616798
144,1562187600,875,376,0,1251,27,-0.584762557823774,0.9199639930045922
144,1562202000,216,194,0,410,27,-0.584762557823774,-0.40992343652483937
144,1562216400,24,41,17,65,27,0.3772661663379186,-0.9554777328240711
144,1562230271,198,120,0,318,27,-0.584762557823774,-0.5554045822046345
144,1562230351,3,3,0,6,27,-0.584762557823774,-1.048775424075244
144,1562230434,3,6,3,9,27,-0.41499278297171055,-1.044031473672642
144,1562230521,2,0,0,2,27,-0.584762557823774,-1.0551006912787133
144,1562230603,3,0,0,3,27,-0.584762557823774,-1.0535193744778462
144,1562230800,9,2,0,11,27,-0.584762557823774,-1.0408688400709074
144,1562245200,339,156,0,495,27,-0.584762557823774,-0.2755115084511156
144,1562259600,519,228,0,747,27,-0.584762557823774,0.1229803253674537
144,1562274000,505,177,0,682,27,-0.584762557823774,0.020194733311076695
144,1562288400,146,210,64,356,27,3.036992639020245,-0.4953145437716756
144,1562302800,25,44,19,69,27,0.4904460162392942,-0.9491524656206017
144,1562317200,417,395,0,812,27,-0.584762557823774,0.22576591742383068
144,1562331600,629,398,0,1027,27,-0.584762557823774,0.5657490296103085
144,1562346000,992,321,0,1313,27,-0.584762557823774,1.0180056346583672
144,1562360400,836,344,0,1180,27,-0.584762557823774,0.8076905001430112
144,1562374800,147,197,50,344,27,2.244733689710616,-0.5142903453820836
144,1562389200,12,52,40,64,27,1.6788344402037378,-0.9570590496249384
144,1562403600,86,150,64,236,27,3.036992639020245,-0.6850725598757562
144,1562418000,141,164,23,305,27,0.7168057160420453,-0.5759617006159099
144,1562432400,294,259,0,553,27,-0.584762557823774,-0.18379513400080996
144,1562446800,272,216,0,488,27,-0.584762557823774,-0.28658072605718693
144,1562461200,119,133,14,252,27,0.20749639148585522,-0.6597714910618788
144,1562475600,17,41,24,58,27,0.7733956409927332,-0.9665469504301425
144,1562490000,67,118,51,185,27,2.3013236146613036,-0.7657197167199905
144,1562504400,160,194,34,354,27,1.3392948904996111,-0.4984771773734103
144,1562518800,223,257,34,480,27,1.3392948904996111,-0.2992312604641257
144,1562533200,231,241,10,472,27,-0.018863308316895967,-0.3118817948710644
144,1562547600,103,93,0,196,27,-0.584762557823774,-0.7483252319104498
144,1562562000,15,29,14,44,27,0.20749639148585522,-0.9886853856422851
144,1562576400,1126,494,0,1620,27,-0.584762557823774,1.5034698925246401
144,1562590800,1197,463,0,1660,27,-0.584762557823774,1.5667225645593337
144,1562605200,1722,359,0,2081,27,-0.584762557823774,2.2324569377244834
144,1562619600,1713,546,0,2259,27,-0.584762557823774,2.5139313282788693
144,1562634000,319,177,0,496,28,-0.3726731722754416,-0.6650334336338465
144,1562648400,27,32,5,59,28,0.04682804258958429,-1.236360789342419
144,1562662800,1192,531,0,1723,28,-0.3726731722754416,0.9391282722115052
144,1562677200,1161,545,0,1706,28,-0.3726731722754416,0.9169027229047644
144,1562691600,1254,441,0,1695,28,-0.3726731722754416,0.9025214851180497
144,1562706000,1324,463,0,1787,28,-0.3726731722754416,1.0228009284251176
144,1562720400,262,203,0,465,28,-0.3726731722754416,-0.705562376487315
144,1562734800,27,24,0,51,28,-0.3726731722754416,-1.2468198713691208
144,1562748910,783,575,0,1358,28,-0.3726731722754416,0.4619326547432466
144,1562749200,39,3,0,42,28,-0.3726731722754416,-1.25858633864916
144,1562763600,1007,527,0,1534,28,-0.3726731722754416,0.6920324593306809
144,1562778000,1323,379,0,1702,28,-0.3726731722754416,0.9116731818914137
144,1562792400,1253,545,0,1798,28,-0.3726731722754416,1.0371821662118323
144,1562806800,175,215,40,390,28,2.9833365466447654,-0.8036162704876422
144,1562821200,30,22,0,52,28,-0.3726731722754416,-1.2455124861157831
144,1562835600,1041,511,0,1552,28,-0.3726731722754416,0.7155653938907593
144,1562850000,1221,554,0,1775,28,-0.3726731722754416,1.0071123053850655
144,1562864400,1801,428,0,2229,28,-0.3726731722754416,1.6006652104003787
144,1562878800,1638,525,0,2163,28,-0.3726731722754416,1.514377783680091
144,1562893200,287,227,0,514,28,-0.3726731722754416,-0.641500499073768
144,1562907600,37,38,1,75,28,-0.2887729293024364,-1.215442625289016
144,1562922000,968,482,0,1450,28,-0.3726731722754416,0.5822120980503145
144,1562936400,1092,560,0,1652,28,-0.3726731722754416,0.8463039192245289
144,1562950800,1671,416,0,2087,28,-0.3726731722754416,1.415016504426426
144,1562965200,1548,376,0,1924,28,-0.3726731722754416,1.201912708132382
144,1562979600,229,210,0,439,28,-0.3726731722754416,-0.7395543930740951
144,1562994000,35,55,20,90,28,1.305331687184662,-1.1958318464889506
144,1563008400,141,192,51,333,28,3.9062392193478224,-0.8781372299278908
144,1563022800,299,224,0,523,28,-0.3726731722754416,-0.6297340317937288
144,1563037200,351,219,0,570,28,-0.3726731722754416,-0.5682869248868571
144,1563051600,316,209,0,525,28,-0.3726731722754416,-0.6271192612870533
144,1563066000,223,165,0,388,28,-0.3726731722754416,-0.8062310409943175
144,1563080400,36,78,42,114,28,3.1511370325907757,-1.164454600408846
144,1563094800,77,99,22,176,28,1.4731321731306724,-1.083396714701909
144,1563109200,342,176,0,518,28,-0.3726731722754416,-0.6362709580604172
144,1563123600,461,215,0,676,28,-0.3726731722754416,-0.4297040880330614
144,1563138000,409,228,0,637,28,-0.3726731722754416,-0.4806921129132315
144,1563152400,131,140,9,271,28,0.382429014481605,-0.9591951156348278
144,1563166800,24,25,1,49,28,-0.2887729293024364,-1.2494346418757962
144,1563181200,1077,516,0,1593,28,-0.3726731722754416,0.7691681892776049
144,1563195600,1193,566,0,1759,28,-0.3726731722754416,0.9861941413316623
144,1563210000,1685,428,0,2113,28,-0.3726731722754416,1.4490085210132062
144,1563224400,1679,469,0,2148,28,-0.3726731722754416,1.4947670048800255
144,1563238800,299,213,0,512,29,-0.3868449546780673,-0.5817312921480841
144,1563253200,30,44,14,74,29,0.7870293905519301,-1.2754890559029033
144,1563267600,1104,479,0,1583,29,-0.3868449546780673,1.1146489931976038
144,1563279527,1046,498,0,1544,29,-0.3868449546780673,1.052876041630394
144,1563282000,199,75,0,274,29,-0.3868449546780673,-0.9587046888915703
144,1563291433,960,272,0,1232,29,-0.3868449546780673,0.5586924290927145
144,1563296400,803,160,0,963,29,-0.3868449546780673,0.1326174554624717
144,1563310800,1725,503,0,2228,29,-0.3868449546780673,2.136278576809153
144,1563325200,314,210,0,524,29,-0.3868449546780673,-0.5627242301274041
144,1563339600,32,29,0,61,29,-0.3868449546780673,-1.2960800397586398
144,1563354000,1113,453,0,1566,29,-0.3868449546780673,1.0877223220016405
144,1563368400,812,505,0,1317,29,-0.3868449546780673,0.693325785072531
144,1563382800,1245,442,0,1687,29,-0.3868449546780673,1.279376864043497
144,1563397200,1189,472,0,1661,29,-0.3868449546780673,1.2381948963320237
144,1563411600,191,210,19,401,29,1.206270228134072,-0.7575466158393739
144,1563426000,23,49,26,72,29,1.7932074007490706,-1.2786568995730165
144,1563440400,671,521,0,1192,29,-0.3868449546780673,0.4953355556904479
144,1563454800,836,563,0,1399,29,-0.3868449546780673,0.8232073755471775
144,1563469200,920,377,0,1297,29,-0.3868449546780673,0.6616473483713977
144,1563483600,1108,493,0,1601,29,-0.3868449546780673,1.1431595862286237
144,1563498000,328,223,0,551,29,-0.3868449546780673,-0.5199583405808742
144,1563512400,38,42,4,80,29,-0.05145228461235375,-1.2659855248925633
144,1563526800,918,490,0,1408,29,-0.3868449546780673,0.8374626720626875
144,1563541200,1162,487,0,1649,29,-0.3868449546780673,1.2191878343113436
144,1563555600,1680,353,0,2033,29,-0.3868449546780673,1.827413818973103
144,1563570000,1013,326,0,1339,29,-0.3868449546780673,0.7281720654437777
144,1563584400,248,190,0,438,29,-0.3868449546780673,-0.6989415079422773
144,1563598800,41,61,20,102,29,1.2901183956505005,-1.2311392445213167
144,1563613200,146,144,0,290,29,-0.3868449546780673,-0.9333619395306637
144,1563627600,298,176,0,474,29,-0.3868449546780673,-0.6419203218802374
144,1563642000,362,246,0,608,29,-0.3868449546780673,-0.4296747959826443
144,1563656400,308,254,0,562,29,-0.3868449546780673,-0.5025352003952509
144,1563670800,127,189,62,316,29,4.811741431340493,-0.8921799718191904
144,1563685200,30,48,18,78,29,1.1224220606176436,-1.2691533685626766
144,1563699600,125,106,0,231,29,-0.3868449546780673,-1.0268133277990068
144,1563714000,257,159,0,416,29,-0.3868449546780673,-0.7337877883135239
144,1563728400,290,216,0,506,29,-0.3868449546780673,-0.5912348231584241
144,1563742800,261,202,0,463,29,-0.3868449546780673,-0.6593434620658607
144,1563757200,123,160,37,283,29,2.7155372434297833,-0.9444493923760603
144,1563771600,18,21,3,39,29,-0.13530045212878214,-1.3309263201298864
144,1563786000,632,551,0,1183,29,-0.3868449546780673,0.4810802591749379
144,1563800400,851,488,0,1339,29,-0.3868449546780673,0.7281720654437777
144,1563814800,1132,401,0,1533,29,-0.3868449546780673,1.0354529014447706
144,1563829200,935,644,0,1579,29,-0.3868449546780673,1.108313305857377
144,1563843600,151,198,47,349,30,2.0064490872474594,-0.9153643284163605
144,1563858000,22,40,18,62,30,0.4837980042148079,-1.3779587278265069
144,1563872400,730,579,0,1309,30,-0.46129577146063083,0.6319897602029442
144,1563886800,910,560,0,1470,30,-0.46129577146063083,0.8914939354818067
144,1563901200,1241,434,0,1675,30,-0.46129577146063083,1.221918506489054
144,1563915600,1172,587,0,1759,30,-0.46129577146063083,1.3573119892432433
144,1563930000,197,286,89,483,30,4.211667897156816,-0.6993794868799159
144,1563944400,28,40,12,68,30,0.1687667456563283,-1.3682877647726361
144,1563958800,752,579,0,1331,30,-0.46129577146063083,0.6674499580671366
144,1563973200,922,519,0,1441,30,-0.46129577146063083,0.8447509473880985
144,1563987600,1331,469,0,1800,30,-0.46129577146063083,1.4233969034446927
144,1564002000,1237,572,0,1809,30,-0.46129577146063083,1.4379033480254986
144,1564016400,255,214,0,469,30,-0.46129577146063083,-0.7219450673389475
144,1564030800,30,37,7,67,30,-0.09375930314240467,-1.3698995919482813
144,1564045200,701,539,0,1240,30,-0.46129577146063083,0.5207736850834316
144,1564059600,599,598,0,1197,30,-0.46129577146063083,0.45146511653069193
144,1564074000,1079,462,0,1541,30,-0.46129577146063083,1.0059336649526094
144,1564088400,1119,455,0,1574,30,-0.46129577146063083,1.0591239617488981
144,1564102800,211,259,48,470,30,2.058954297007206,-0.7203332401633024
144,1564117200,22,72,50,94,30,2.163964716526699,-1.3263802582058632
144,1564131600,649,540,0,1189,30,-0.46129577146063083,0.4385704991255311
144,1564146000,852,514,0,1366,30,-0.46129577146063083,0.7238639092147153
144,1564160400,1350,423,0,1773,30,-0.46129577146063083,1.3798775697022747
144,1564174800,1420,436,0,1856,30,-0.46129577146063083,1.5136592252808188
144,1564189200,285,248,0,533,30,-0.46129577146063083,-0.6187881280976605
144,1564203600,38,62,24,100,30,0.7988292627732875,-1.3167092951519928
144,1564218000,173,157,0,330,30,-0.46129577146063083,-0.9459890447536176
144,1564232400,505,194,0,699,30,-0.46129577146063083,-0.3512248169405724
144,1564246800,507,247,0,754,30,-0.46129577146063083,-0.26257432228009137
144,1564261200,549,207,0,756,30,-0.46129577146063083,-0.2593506679288012
144,1564275600,168,164,0,332,30,-0.46129577146063083,-0.9427653904023274
144,1564290000,24,69,45,93,30,1.901438667727966,-1.3279920853815084
144,1564304400,126,113,0,239,30,-0.46129577146063083,-1.0926653177373225
144,1564318800,381,157,0,538,30,-0.46129577146063083,-0.6107289922194349
144,1564333200,474,218,0,692,30,-0.46129577146063083,-0.3625076071700881
144,1564347600,425,252,0,677,30,-0.46129577146063083,-0.38668501480476475
144,1564362000,128,141,13,269,30,0.2212719554160749,-1.0443105024679693
144,1564376400,15,31,16,46,30,0.3787875846953147,-1.4037479626368286
144,1564390800,714,542,0,1256,30,-0.46129577146063083,0.5465629198937534
144,1564405200,892,525,0,1417,30,-0.46129577146063083,0.8060670951726159
144,1564419600,1225,427,0,1652,30,-0.46129577146063083,1.1848464814492166
144,1564434000,1220,515,0,1735,30,-0.46129577146063083,1.3186281370277606
144,1564448400,162,225,63,387,31,2.530445125474893,-1.100154359284521
144,1564462800,17,38,21,55,31,0.4397166939349814,-1.619130733375994
144,1564477200,808,588,0,1396,31,-0.6056475218349743,0.4770961270356471
144,1564491600,828,569,0,1397,31,-0.6056475218349743,0.4786593088853202
144,1564506000,1263,415,0,1678,31,-0.6056475218349743,0.9179134086434642
144,1564520400,1225,523,0,1748,31,-0.6056475218349743,1.0273361381205819
144,1564534800,170,219,49,389,31,1.8335356482949225,-1.097027995585175
144,1564549200,21,40,19,61,31,0.34015819719498563,-1.6097516422779552
144,1564563600,779,582,0,1361,31,-0.6056475218349743,0.4223847622970882
144,1564578000,956,560,0,1516,31,-0.6056475218349743,0.6646779489964203
144,1564592400,1267,405,0,1672,31,-0.6056475218349743,0.9085343175454256
144,1564606800,1270,542,0,1812,31,-0.6056475218349743,1.127379776499661
144,1564621200,164,209,45,373,31,1.6344186548149309,-1.1220389051799446
144,1564635600,20,31,11,51,31,-0.05807578976499751,-1.6253834607746862
144,1564650000,737,572,0,1309,31,-0.6056475218349743,0.3410993061140865
144,1564664400,872,574,0,1446,31,-0.6056475218349743,0.5552552195193026
144,1564678800,1240,407,0,1647,31,-0.6056475218349743,0.8694547713035977
144,1564693200,1237,466,0,1703,31,-0.6056475218349743,0.9569929548852919
144,1564707600,160,216,56,376,31,2.1819903868849075,-1.1173493596309254
144,1564722000,19,47,28,66,31,0.7881714325249667,-1.6019357330295896
144,1564736400,649,538,0,1187,31,-0.6056475218349743,0.15039112045396705
144,1564750800,879,456,0,1335,31,-0.6056475218349743,0.38174203420558733
144,1564765200,1203,467,0,1670,31,-0.6056475218349743,0.9054079538460793
144,1564779600,1155,389,0,1544,31,-0.6056475218349743,0.7084470407872674
144,1565398800,9932,4583,0,14515,32,-0.3865633591148215,4.071771836095506
144,1565413200,33,67,34,100,32,3.092506872918572,-0.42513221732962786
144,1565427600,194,132,0,326,32,-0.3865633591148215,-0.3546292470851547
144,1565442000,512,190,0,702,32,-0.3865633591148215,-0.23733227004125249
144,1565456400,593,252,0,845,32,-0.3865633591148215,-0.19272198355913012
144,1565470800,611,206,0,817,32,-0.3865633591148215,-0.20145686482835687
144,1565485200,190,173,0,363,32,-0.3865633591148215,-0.3430867254079622
144,1565499600,23,51,28,74,32,2.4785533025597375,-0.43324317850819555
144,1565514000,177,142,0,319,32,-0.3865633591148215,-0.3568129674024614
144,1565528400,458,140,0,598,32,-0.3865633591148215,-0.2697761147555233
144,1565542800,442,206,0,648,32,-0.3865633591148215,-0.254178112489047
144,1565557200,418,237,0,655,32,-0.3865633591148215,-0.2519943921717403
144,1565571600,142,123,0,265,32,-0.3865633591148215,-0.37365880985025585
144,1565586000,22,28,6,50,32,0.22739021124401265,-0.4407302195961042
144,1565600400,722,541,0,1263,32,-0.3865633591148215,-0.06232268461138777
144,1565614800,869,584,0,1453,32,-0.3865633591148215,-0.0030502759987776143
144,1565629200,1218,399,0,1617,32,-0.3865633591148215,0.04811117143526484
144,1565643600,1218,502,0,1720,32,-0.3865633591148215,0.08024305610420614
144,1565658000,235,180,0,415,33,-0.4085603744036053,-0.7627844417561076
144,1565672400,23,34,11,57,33,0.9672041516493514,-1.381756756101088
144,1565684052,427,310,0,737,33,-0.4085603744036053,-0.20605515343464492
144,1565686800,345,204,0,549,33,-0.4085603744036053,-0.5311020671130144
144,1565688140,114,119,5,233,33,0.21678713743864772,-1.0774575177638908
144,1565701200,852,486,0,1338,33,-0.4085603744036053,0.8330575865690789
144,1565706033,320,133,0,453,33,-0.4085603744036053,-0.6970834698423947
144,1565715600,952,267,0,1219,33,-0.4085603744036053,0.6273098061024514
144,1565730000,1150,533,0,1683,33,-0.4085603744036053,1.429553252627789
144,1565744400,225,189,0,414,33,-0.4085603744036053,-0.7645134147012053
144,1565758800,27,41,14,68,33,1.3424126587547034,-1.362738053705013
144,1565773200,749,501,0,1250,33,-0.4085603744036053,0.6809079674004804
144,1565787600,949,572,0,1521,33,-0.4085603744036053,1.14945963552196
144,1565802000,1180,404,0,1584,33,-0.4085603744036053,1.2583849310631157
144,1565816400,1320,476,0,1796,33,-0.4085603744036053,1.6249271954238302
144,1565830800,245,213,0,458,33,-0.4085603744036053,-0.688438605116906
144,1565845200,26,39,13,65,33,1.2173431563862527,-1.3679249725403062
144,1565859600,728,493,0,1221,33,-0.4085603744036053,0.6307677519926468
144,1565874000,954,555,0,1509,33,-0.4085603744036053,1.1287119601807873
144,1565888400,1267,407,0,1674,33,-0.4085603744036053,1.4139924961219095
144,1565902800,1289,482,0,1771,33,-0.4085603744036053,1.5817028717963875
144,1565917200,226,223,0,449,33,-0.4085603744036053,-0.7039993616227854
144,1565931600,23,53,30,76,33,3.3435246966499133,-1.3489062701442314
144,1565946000,623,505,0,1128,33,-0.4085603744036053,0.46997326809855977
144,1565960400,799,444,0,1243,33,-0.4085603744036053,0.6688051567847965
144,1565974800,1224,364,0,1588,33,-0.4085603744036053,1.2653008228435065
144,1565989200,1132,378,0,1510,33,-0.4085603744036053,1.1304409331258851
144,1566003600,276,189,0,465,33,-0.4085603744036053,-0.676335794501222
144,1566018000,40,71,31,111,33,3.4685941990183635,-1.2883922170658115
144,1566032400,200,144,0,344,33,-0.4085603744036053,-0.885541520858045
144,1566046800,522,173,0,695,33,-0.4085603744036053,-0.2786720171287488
144,1566061200,623,240,0,863,33,-0.4085603744036053,0.011795437647666553
144,1566075600,636,250,0,886,33,-0.4085603744036053,0.05156181538491389
144,1566090000,236,205,0,441,33,-0.4085603744036053,-0.7178311451835672
144,1566104400,33,49,16,82,33,1.5925516634916046,-1.3385324324736452
144,1566118800,154,120,0,274,33,-0.4085603744036053,-1.0065696270148847
144,1566133200,454,202,0,656,33,-0.4085603744036053,-0.34610196198755944
144,1566147600,536,255,0,791,33,-0.4085603744036053,-0.11269061439936857
144,1566162000,434,230,0,664,33,-0.4085603744036053,-0.33227017842677775
144,1566176400,147,108,0,255,33,-0.4085603744036053,-1.0394201129717413
144,1566190800,16,43,27,59,33,2.968316189544561,-1.3782988102108924
144,1566205200,702,529,0,1231,33,-0.4085603744036053,0.6480574814436239
144,1566219600,895,544,0,1439,33,-0.4085603744036053,1.0076838540239477
144,1566234000,1186,386,0,1572,33,-0.4085603744036053,1.237637255721943
144,1566248400,1233,458,0,1691,33,-0.4085603744036053,1.4433850361885705
144,1566262800,221,146,0,367,34,-0.36423286881106215,-0.6644199445354682
144,1566277200,25,36,11,61,34,1.7467511773089646,-1.1787896599611605
144,1566291600,745,507,0,1252,34,-0.36423286881106215,0.8232179579211909
144,1566306000,915,574,0,1489,34,-0.36423286881106215,1.221602345358737
144,1566320400,1201,410,0,1611,34,-0.36423286881106215,1.426677852816039
144,1566334800,1208,515,0,1723,34,-0.36423286881106215,1.6149438924489723
144,1566349200,236,195,0,431,34,-0.36423286881106215,-0.5568393504595064
144,1566363600,28,32,4,60,34,0.4033976934144021,-1.1804706067435975
144,1566378000,731,467,0,1198,34,-0.36423286881106215,0.7324468316695982
144,1566392400,912,519,0,1431,34,-0.36423286881106215,1.1241074319773965
144,1566406800,1223,402,0,1625,34,-0.36423286881106215,1.4502111077701558
144,1566421200,1206,532,0,1738,34,-0.36423286881106215,1.6401580941855258
144,1566435600,259,227,0,486,34,-0.36423286881106215,-0.46438727742547675
144,1566450000,21,33,12,54,34,1.9386588178653308,-1.1905562874382187
144,1566464400,692,484,0,1176,34,-0.36423286881106215,0.6954660024559863
144,1566478800,895,478,0,1373,34,-0.36423286881106215,1.0266125185960562
144,1566493200,1139,403,0,1542,34,-0.36423286881106215,1.310692524827893
144,1566507600,1077,486,0,1563,34,-0.36423286881106215,1.3459924072590679
144,1566522000,251,190,0,441,34,-0.36423286881106215,-0.5400298826351374
144,1566536400,27,29,2,56,34,0.019582412301669988,-1.1871943938733451
144,1566550800,597,366,0,963,34,-0.36423286881106215,0.337424337796926
144,1566565200,784,474,0,1258,34,-0.36423286881106215,0.8333036386158124
144,1566571300,399,144,0,543,34,-0.36423286881106215,-0.36857331082657324
144,1566571374,6,1,0,7,34,-0.36423286881106215,-1.2695607862127534
144,1566571456,5,7,2,12,34,0.019582412301669988,-1.2611560523005687
144,1566571538,6,1,0,7,34,-0.36423286881106215,-1.2695607862127534
144,1566571621,5,9,4,14,34,0.4033976934144021,-1.257794158735695
144,1566571702,9,6,0,15,34,-0.36423286881106215,-1.256113211953258
144,1566571789,7,6,0,13,34,-0.36423286881106215,-1.259475105518132
144,1566579600,789,141,0,930,34,-0.36423286881106215,0.2819530939765082
144,1566594000,1129,424,0,1553,34,-0.36423286881106215,1.3291829394346988
144,1566608400,283,214,0,497,34,-0.36423286881106215,-0.4458968628186708
144,1566622800,28,40,12,68,34,1.9386588178653308,-1.1670230324841022
144,1566637200,232,186,0,418,34,-0.36423286881106215,-0.5786916586311861
144,1566651600,520,168,0,688,34,-0.36423286881106215,-0.12483602737322233
144,1566666000,716,259,0,975,34,-0.36423286881106215,0.35759569918616885
144,1566680400,630,238,0,868,34,-0.36423286881106215,0.1777343934654202
144,1566694800,196,219,23,415,34,4.049642863985357,-0.5837344989784968
144,1566709200,36,59,23,95,34,4.049642863985357,-1.1216374693583058
144,1566723600,161,124,0,285,34,-0.36423286881106215,-0.8022575806952943
144,1566738000,435,224,0,659,34,-0.36423286881106215,-0.1735834840638925
144,1566752400,508,195,0,703,34,-0.36423286881106215,-0.09962182563666878
144,1566766800,490,237,0,727,34,-0.36423286881106215,-0.059279102858183115
144,1566781200,169,138,0,307,34,-0.36423286881106215,-0.7652767514816824
144,1566795600,32,28,0,60,34,-0.36423286881106215,-1.1804706067435975
144,1566810000,703,441,0,1144,34,-0.36423286881106215,0.6416757054180054
144,1566824400,871,459,0,1330,34,-0.36423286881106215,0.9543318069512694
144,1566838800,1106,358,0,1464,34,-0.36423286881106215,1.1795786757978144
144,1566853200,1143,513,0,1656,34,-0.36423286881106215,1.5023204580256997
144,1566867600,215,185,0,400,35,-0.39510107717239223,-0.6728188208719533
144,1566882000,25,34,9,59,35,0.9949363488795695,-1.2584152101665134
144,1566896400,756,527,0,1283,35,-0.39510107717239223,0.8435495420227576
144,1566910800,898,547,0,1445,35,-0.39510107717239223,1.1217507592242786
144,1566925200,1261,407,0,1668,35,-0.39510107717239223,1.5047067557424219
144,1566939600,1304,489,0,1793,35,-0.39510107717239223,1.719368188768287
144,1566954000,258,212,0,470,35,-0.39510107717239223,-0.5526084183774689
144,1566968400,23,40,17,63,35,2.230525172036869,-1.2515460443096855
144,1566982800,730,494,0,1224,35,-0.39510107717239223,0.7422293456345492
144,1566997200,964,531,0,1495,35,-0.39510107717239223,1.2076153324346246
144,1567011600,1265,381,0,1646,35,-0.39510107717239223,1.4669263435298696
144,1567026000,1277,470,0,1747,35,-0.39510107717239223,1.6403727814147686
144,1567040400,262,238,0,500,35,-0.39510107717239223,-0.5010896744512613
144,1567054800,31,38,7,69,35,0.6860391430902447,-1.241242295524444
144,1567069200,707,547,0,1254,35,-0.39510107717239223,0.7937480895607568
144,1567083600,966,560,0,1526,35,-0.39510107717239223,1.2608513678250393
144,1567098000,1242,404,0,1646,35,-0.39510107717239223,1.4669263435298696
144,1567112400,1266,520,0,1786,35,-0.39510107717239223,1.7073471485188385
144,1567126800,281,204,0,485,35,-0.39510107717239223,-0.5268490464143651
144,1567141200,30,42,12,72,35,1.4582821575635567,-1.2360904211318233
144,1567155600,616,437,0,1053,35,-0.39510107717239223,0.4485725052551658
144,1567156989,123,83,0,206,35,-0.39510107717239223,-1.005973364928096
144,1567170000,752,339,0,1091,35,-0.39510107717239223,0.5138295808950287
144,1567184400,1313,386,0,1699,35,-0.39510107717239223,1.5579427911328365
144,1567198800,1024,384,0,1408,35,-0.39510107717239223,1.0582109750486226
144,1567213200,266,193,0,459,35,-0.39510107717239223,-0.571498624483745
144,1567227600,34,63,29,97,35,4.083908406772818,-1.1931581345266502
144,1567242000,199,158,0,357,35,-0.39510107717239223,-0.746662353832851
144,1567256400,442,172,0,614,35,-0.39510107717239223,-0.30531844753167237
144,1567270800,527,210,0,737,35,-0.39510107717239223,-0.09409159743422113
144,1567285200,485,201,0,686,35,-0.39510107717239223,-0.18167346210877408
144,1567299600,177,199,22,376,35,3.0027681865101807,-0.7140338160129195
144,1567314000,27,41,14,68,35,1.7671793633528814,-1.242959586988651
144,1567328400,154,110,0,264,35,-0.39510107717239223,-0.9063704600040946
144,1567342800,375,124,0,499,35,-0.39510107717239223,-0.5028069659154683
144,1567357200,443,243,0,686,35,-0.39510107717239223,-0.18167346210877408
144,1567371600,430,244,0,674,35,-0.39510107717239223,-0.20228095967925713
144,1567386000,162,109,0,271,35,-0.39510107717239223,-0.8943494197546461
144,1567400400,25,24,0,49,35,-0.39510107717239223,-1.2755881248085825
144,1567414800,154,135,0,289,35,-0.39510107717239223,-0.8634381733989216
144,1567429200,364,179,0,543,35,-0.39510107717239223,-0.4272461414903637
144,1567443600,456,237,0,693,35,-0.39510107717239223,-0.16965242185932564
144,1567458000,370,227,0,597,35,-0.39510107717239223,-0.33451240242319
144,1567472400,132,141,9,273,36,0.7328954713011188,-1.0601797985070174
144,1567486800,15,31,16,46,36,1.6779448948209823,-1.3870799989910376
144,1567501200,811,535,0,1346,36,-0.48216807322442023,0.4850356866002675
144,1567515600,962,555,0,1517,36,-0.48216807322442023,0.73129090370497
144,1567530000,1347,426,0,1773,36,-0.48216807322442023,1.0999536848675655
144,1567544400,1366,591,0,1957,36,-0.48216807322442023,1.364930058828181
144,1567558800,248,206,0,454,36,-0.48216807322442023,-0.7995236915131512
144,1567573200,28,40,12,68,36,1.1379166528096316,-1.3553980412348772
144,1567587600,820,549,0,1369,36,-0.48216807322442023,0.5181577333453444
144,1567602000,1061,570,0,1631,36,-0.48216807322442023,0.8954610484414383
144,1567616400,1415,410,0,1825,36,-0.48216807322442023,1.1748383122912176
144,1567630800,1333,536,0,1869,36,-0.48216807322442023,1.2382022278035387
144,1567645200,272,190,0,462,36,-0.48216807322442023,-0.78800297960182
144,1567659600,28,39,11,67,36,1.002909592306794,-1.3568381302237935
144,1567674000,882,559,0,1441,36,-0.48216807322442023,0.6218441405473244
144,1567688400,1031,544,0,1575,36,-0.48216807322442023,0.8148160650621206
144,1567702800,1549,450,0,1999,36,-0.48216807322442023,1.4254137963626694
144,1567717200,1475,568,0,2043,36,-0.48216807322442023,1.4887777118749903
144,1567731600,286,244,0,530,36,-0.48216807322442023,-0.6900769283555056
144,1567746000,28,41,13,69,36,1.2729237133124693,-1.3539579522459608
144,1567760400,874,506,0,1380,36,-0.48216807322442023,0.5339987122234248
144,1567774800,1001,558,0,1559,36,-0.48216807322442023,0.7917746412394583
144,1567789200,1563,395,0,1958,36,-0.48216807322442023,1.3663701478170973
144,1567803600,1263,412,0,1675,36,-0.48216807322442023,0.9588249639537594
144,1567818000,269,189,0,458,36,-0.48216807322442023,-0.7937633355574856
144,1567832400,36,55,19,91,36,2.082966076329495,-1.3222759944898002
144,1567846800,215,156,0,371,36,-0.48216807322442023,-0.9190510775932114
144,1567861200,568,181,0,749,36,-0.48216807322442023,-0.3746974397828165
144,1567875600,655,258,0,913,36,-0.48216807322442023,-0.13852284560052874
144,1567890000,645,284,0,929,36,-0.48216807322442023,-0.11548142177786654
144,1567904400,207,210,3,417,36,-0.07714689171590726,-0.8528069841030576
144,1567918800,24,57,33,81,36,3.9730649233692223,-1.336676884378964
144,1567933200,167,128,0,295,36,-0.48216807322442023,-1.028497840750857
144,1567947600,470,188,0,658,36,-0.48216807322442023,-0.5057455377742078
144,1567962000,571,228,0,799,36,-0.48216807322442023,-0.30269299033699704
144,1567976400,414,214,0,628,36,-0.48216807322442023,-0.5489482074416995
144,1567990800,119,140,21,259,36,2.3529801973351705,-1.0803410443518469
144,1568005200,19,32,13,51,36,1.2729237133124693,-1.3798795540464557
144,1568019600,896,577,0,1473,36,-0.48216807322442023,0.6679269881926488
144,1568034000,1028,585,0,1613,36,-0.48216807322442023,0.8695394466409433
144,1568048400,1491,403,0,1894,36,-0.48216807322442023,1.2742044525264484
144,1568062800,1294,527,0,1821,36,-0.48216807322442023,1.1690779563355522
144,1568077200,235,195,0,430,37,-0.3425177889602085,-0.8358884504662208
144,1568091600,22,33,11,55,37,1.5413300503209384,-1.3618880147653531
144,1568106000,921,578,0,1499,37,-0.3425177889602085,0.6635609741625054
144,1568120400,928,534,0,1462,37,-0.3425177889602085,0.6116623504849911
144,1568134800,1528,409,0,1937,37,-0.3425177889602085,1.2779284652638918
144,1568149200,1294,549,0,1843,37,-0.3425177889602085,1.1460779078129093
144,1568163600,301,181,0,482,37,-0.3425177889602085,-0.7629498442167412
144,1568178000,26,36,10,62,37,1.370071155840834,-1.3520693562317692
144,1568192400,885,571,0,1456,37,-0.3425177889602085,0.6032463574562049
144,1568206800,1032,551,0,1583,37,-0.3425177889602085,0.781384876565511
144,1568221200,1597,399,0,1996,37,-0.3425177889602085,1.3606857300469553
144,1568235600,1471,582,0,2053,37,-0.3425177889602085,1.4406376638204235
144,1568250000,333,228,0,561,37,-0.3425177889602085,-0.6521392693377239
144,1568264400,24,48,24,72,37,3.7676956785622937,-1.3380427011837923
144,1568278800,976,599,0,1575,37,-0.3425177889602085,0.7701635525271295
144,1568293200,1170,507,0,1677,37,-0.3425177889602085,0.9132354340164935
144,1568307600,1580,444,0,2024,37,-0.3425177889602085,1.3999603641812906
144,1568322000,1512,557,0,2069,37,-0.3425177889602085,1.4630803118971865
144,1568336400,269,246,0,515,37,-0.3425177889602085,-0.7166618825584176
144,1568350800,36,43,7,79,37,0.8562944724005214,-1.3282240426502085
144,1568365200,808,595,0,1403,37,-0.3425177889602085,0.5289050857019275
144,1568379600,796,568,0,1364,37,-0.3425177889602085,0.4742011310148178
144,1568394000,1702,394,0,2096,37,-0.3425177889602085,1.500952280526724
144,1568408400,1401,473,0,1874,37,-0.3425177889602085,1.1895605384616377
144,1568422800,277,233,0,510,37,-0.3425177889602085,-0.723675210082406
144,1568437200,38,43,5,81,37,0.5137766834403128,-1.3254187116406133
144,1568451600,177,160,0,337,37,-0.3425177889602085,-0.9663363424124056
144,1568466000,455,214,0,669,37,-0.3425177889602085,-0.5006513948195739
144,1568480400,718,248,0,966,37,-0.3425177889602085,-0.08405973989466119
144,1568494800,589,233,0,822,37,-0.3425177889602085,-0.2860435725855279
144,1568509200,232,150,0,382,37,-0.3425177889602085,-0.9032163946965097
144,1568523600,38,65,27,103,37,4.2814723620026065,-1.2945600705350642
144,1568538000,147,107,0,254,37,-0.3425177889602085,-1.0827575793106134
144,1568552400,539,164,0,703,37,-0.3425177889602085,-0.4529607676564526
144,1568566800,540,182,0,722,37,-0.3425177889602085,-0.42631012306529653
144,1568581200,437,198,0,635,37,-0.3425177889602085,-0.5483420219826952
144,1568595600,135,119,0,254,37,-0.3425177889602085,-1.0827575793106134
144,1568610000,21,21,0,42,37,-0.3425177889602085,-1.380122666327723
144,1568624400,914,502,0,1416,37,-0.3425177889602085,0.5471397372642974
144,1568638800,855,453,0,1308,37,-0.3425177889602085,0.3956518627461474
144,1568653200,1420,386,0,1806,37,-0.3425177889602085,1.094179284135395
144,1568667600,1355,557,0,1912,37,-0.3425177889602085,1.2428618276439496
144,1568682000,283,215,0,498,38,-0.44511497483680545,-0.7698013542859539
144,1568696400,20,34,14,54,38,1.4514618744678442,-1.403028335085445
144,1568710800,896,567,0,1463,38,-0.44511497483680545,0.6064689981273548
144,1568725200,1068,532,0,1600,38,-0.44511497483680545,0.8018566025632339
144,1568739600,1583,430,0,2013,38,-0.44511497483680545,1.390871789658256
144,1568754000,1545,538,0,2083,38,-0.44511497483680545,1.4907048722167344
144,1568768400,264,198,0,462,38,-0.44511497483680545,-0.8211440824588856
144,1568782800,26,26,0,52,38,-0.44511497483680545,-1.4058807088728302
144,1568797200,921,534,0,1455,38,-0.44511497483680545,0.5950595029778144
144,1568811600,1083,566,0,1649,38,-0.44511497483680545,0.8717397603541687
144,1568826000,1523,434,0,1957,38,-0.44511497483680545,1.3110053236114734
144,1568840400,1497,567,0,2064,38,-0.44511497483680545,1.463607321236576
144,1568854800,265,274,9,539,38,0.7741129997161835,-0.7113276916445594
144,1568869200,26,33,7,59,38,0.5031734498155193,-1.3958974006169824
144,1568883600,918,551,0,1469,38,-0.44511497483680545,0.61502611948951
144,1568898000,1032,544,0,1576,38,-0.44511497483680545,0.7676281171146127
144,1568912400,1519,489,0,2008,38,-0.44511497483680545,1.3837408551897934
144,1568926800,1495,542,0,2037,38,-0.44511497483680545,1.4251002751068773
144,1568941200,287,234,0,521,38,-0.44511497483680545,-0.7369990557310253
144,1568955600,28,46,18,74,38,1.9933409742691726,-1.3745045972115941
144,1568970000,831,497,0,1328,38,-0.44511497483680545,0.41393376747886085
144,1568984400,1083,548,0,1631,38,-0.44511497483680545,0.8460683962677028
144,1568998800,1532,420,0,1952,38,-0.44511497483680545,1.3038743891430107
144,1569013200,1331,442,0,1773,38,-0.44511497483680545,1.0485869351720447
144,1569027600,324,227,0,551,38,-0.44511497483680545,-0.6942134489202488
144,1569042000,29,57,28,86,38,3.348038723772494,-1.3573903544872836
144,1569056400,232,155,0,387,38,-0.44511497483680545,-0.9281080994858267
144,1569070800,619,237,0,856,38,-0.44511497483680545,-0.25922644634402175
144,1569085200,772,252,0,1024,38,-0.44511497483680545,-0.01962704820367371
144,1569099600,608,254,0,862,38,-0.44511497483680545,-0.25066932498186645
144,1569114000,181,200,19,381,38,2.1288107492195047,-0.936665220847982
144,1569128400,38,67,29,105,38,3.4835084987228258,-1.330292803507125
144,1569142800,168,119,0,287,38,-0.44511497483680545,-1.0707267888550815
144,1569157200,570,180,0,750,38,-0.44511497483680545,-0.4104022570754318
144,1569171600,602,251,0,853,38,-0.44511497483680545,-0.2635050070250994
144,1569186000,496,261,0,757,38,-0.44511497483680545,-0.400418948819584
144,1569200400,131,140,9,271,38,0.7741129997161835,-1.0935457791541623
144,1569214800,22,27,5,49,38,0.23223389991485505,-1.4101592695539078
144,1569229200,948,529,0,1477,38,-0.44511497483680545,0.6264356146390505
144,1569243600,1043,556,0,1599,38,-0.44511497483680545,0.8004304156695413
144,1569258000,1459,416,0,1875,38,-0.44511497483680545,1.1940579983286845
144,1569272400,788,311,0,1099,38,-0.44511497483680545,0.08733696882326737
144,1569286800,1682,728,0,2410,39,-0.4505446535261783,1.8328972914117256
144,1569301200,22,32,10,54,39,1.2389977971969905,-1.4379566811720992
144,1569315600,969,581,0,1550,39,-0.4505446535261783,0.6389522929303635
144,1569330000,1137,602,0,1739,39,-0.4505446535261783,0.9013425309687094
144,1569344400,1648,443,0,2091,39,-0.4505446535261783,1.3900269954634066
144,1569358800,1538,583,0,2121,39,-0.4505446535261783,1.4316762395964773
144,1569373200,267,235,0,502,39,-0.4505446535261783,-0.8159946354515756
144,1569387600,23,37,14,60,39,1.914814777486258,-1.429626832345485
144,1569402000,954,538,0,1492,39,-0.4505446535261783,0.55843042093976
144,1569416400,1072,581,0,1653,39,-0.4505446535261783,0.7819480311205732
144,1569430800,1597,414,0,2011,39,-0.4505446535261783,1.2789623444418845
144,1569445200,1556,509,0,2065,39,-0.4505446535261783,1.3539309838814118
144,1569459600,290,200,0,490,39,-0.4505446535261783,-0.832654333104804
144,1569474000,24,36,12,60,39,1.5769062873416242,-1.429626832345485
144,1569488400,913,514,0,1427,39,-0.4505446535261783,0.4681903919847733
144,1569502800,1169,474,0,1643,39,-0.4505446535261783,0.7680649497428829
144,1569517200,1427,390,0,1817,39,-0.4505446535261783,1.0096305657146933
144,1569531600,1440,531,0,1971,39,-0.4505446535261783,1.2234300189311234
144,1569546000,321,263,0,584,39,-0.4505446535261783,-0.7021533681545155
144,1569560400,164,33,0,197,39,-0.4505446535261783,-1.2394286174711284
144,1569574800,856,543,0,1399,39,-0.4505446535261783,0.4293177641272406
144,1569589200,1087,542,0,1629,39,-0.4505446535261783,0.7486286358141165
144,1569603600,1539,466,0,2005,39,-0.4505446535261783,1.2706324956152704
144,1569618000,1269,448,0,1717,39,-0.4505446535261783,0.8707997519377908
144,1569632400,269,232,0,501,39,-0.4505446535261783,-0.8173829435893446
144,1569646800,35,61,26,96,39,3.94226571835406,-1.3796477393858002
144,1569661200,200,160,0,360,39,-0.4505446535261783,-1.0131343910147772
144,1569675600,601,275,0,876,39,-0.4505446535261783,-0.2967673919259599
144,1569690000,712,301,0,1013,39,-0.4505446535261783,-0.10656917705160339
144,1569704400,662,306,0,968,39,-0.4505446535261783,-0.16904304325120956
144,1569718800,221,233,12,454,39,1.5769062873416242,-0.8826334260644888
144,1569733200,34,51,17,85,39,2.4216775127032086,-1.3949191289012595
144,1569747600,173,101,0,274,39,-0.4505446535261783,-1.1325288908629134
144,1569762000,477,172,0,649,39,-0.4505446535261783,-0.6119133391995288
144,1569776400,568,289,0,857,39,-0.4505446535261783,-0.3231452465435714
144,1569790800,410,312,0,722,39,-0.4505446535261783,-0.5105668451423899
144,1569805200,154,164,10,318,39,1.2389977971969905,-1.0714433328010764
144,1569819600,21,32,11,53,39,1.4079520422693073,-1.4393449893098682
144,1569834000,714,490,0,1204,39,-0.4505446535261783,0.15859767726228055
144,1569848400,857,509,0,1366,39,-0.4505446535261783,0.3835035955808627
144,1569862800,1170,417,0,1587,39,-0.4505446535261783,0.6903196940278175
144,1569877200,1159,541,0,1700,39,-0.4505446535261783,0.8471985135957174
144,1569891600,265,167,0,432,40,-0.26018297421571207,-0.8407447529188941
144,1569906000,27,29,2,56,40,0.0031347346291049536,-1.3894281622128513
144,1569920400,830,540,0,1370,40,-0.26018297421571207,0.5280452415431587
144,1569934800,963,548,0,1511,40,-0.26018297421571207,0.7338015200283926
144,1569949200,1266,394,0,1660,40,-0.26018297421571207,0.9512319136049874
144,1569963600,1343,553,0,1896,40,-0.26018297421571207,1.2956183088001307
144,1569978000,249,199,0,448,40,-0.26018297421571207,-0.8173965227361725
144,1569992400,24,25,1,49,40,-0.12852411979330355,-1.399643012917792
144,1570006800,925,491,0,1416,40,-0.26018297421571207,0.5951714033184832
144,1570021200,974,547,0,1521,40,-0.26018297421571207,0.7483941638925936
144,1570035600,1477,401,0,1878,40,-0.26018297421571207,1.2693515498445689
144,1570050000,1444,535,0,1979,40,-0.26018297421571207,1.416737252872999
144,1570064400,258,247,0,505,40,-0.26018297421571207,-0.7342184527102268
144,1570078800,27,37,10,64,40,1.056405570008373,-1.3777540471214904
144,1570093200,889,534,0,1423,40,-0.26018297421571207,0.6053862540234239
144,1570107600,1090,561,0,1651,40,-0.26018297421571207,0.9380985341272065
144,1570122000,1573,403,0,1976,40,-0.26018297421571207,1.4123594597137386
144,1570136400,1483,483,0,1966,40,-0.26018297421571207,1.3977668158495375
144,1570150800,300,223,0,523,40,-0.26018297421571207,-0.707951693754665
144,1570165200,30,34,4,64,40,0.266452443473922,-1.3777540471214904
144,1570179600,819,549,0,1368,40,-0.26018297421571207,0.5251267127703184
144,1570194000,1003,570,0,1573,40,-0.26018297421571207,0.8242759119864387
144,1570208400,1535,385,0,1920,40,-0.26018297421571207,1.330640654074213
144,1570222800,1328,451,0,1779,40,-0.26018297421571207,1.124884375588979
144,1570237200,297,198,0,495,40,-0.26018297421571207,-0.7488110965744278
144,1570251600,30,51,21,81,40,2.504652968654867,-1.3529465525523487
144,1570266000,239,137,0,376,40,-0.26018297421571207,-0.9224635585584195
144,1570280400,596,199,0,795,40,-0.26018297421571207,-0.31103178064839815
144,1570294800,688,294,0,982,40,-0.26018297421571207,-0.03814934038783968
144,1570309200,585,269,0,854,40,-0.26018297421571207,-0.22493518184961234
144,1570323600,207,168,0,375,40,-0.26018297421571207,-0.9239228229448396
144,1570338000,27,72,45,99,40,5.664465474792671,-1.326679793596787
144,1570352400,137,100,0,237,40,-0.26018297421571207,-1.1253013082708132
144,1570366800,489,186,0,675,40,-0.26018297421571207,-0.48614350701881004
144,1570381200,607,217,0,824,40,-0.26018297421571207,-0.26871311344221527
144,1570395600,469,227,0,696,40,-0.26018297421571207,-0.45549895490398795
144,1570410000,118,110,0,228,40,-0.26018297421571207,-1.1384346877485942
144,1570424400,24,24,0,48,40,-0.26018297421571207,-1.4011022773042119
144,1570438800,841,526,0,1367,40,-0.26018297421571207,0.5236674483838983
144,1570453200,955,556,0,1511,40,-0.26018297421571207,0.7338015200283926
144,1570467600,1470,400,0,1870,40,-0.26018297421571207,1.257677434753208
144,1570482000,1268,533,0,1801,40,-0.26018297421571207,1.1569881920902212
144,1570496400,244,77,0,321,41,-0.3922322702763681,-0.9674576937586773
144,1570510800,32,33,1,65,41,-0.24514516892273006,-1.3478879729267752
144,1570525200,875,502,0,1377,41,-0.3922322702763681,0.6018172078097261
144,1570539600,1010,599,0,1609,41,-0.3922322702763681,0.9465821483058148
144,1570554000,1513,396,0,1909,41,-0.3922322702763681,1.3923988817059294
144,1570568400,1368,489,0,1857,41,-0.3922322702763681,1.3151239812499096
144,1570582800,296,78,0,374,41,-0.3922322702763681,-0.888696737524657
144,1570597200,23,31,8,54,41,0.7844645405527363,-1.3642345864847794
144,1570611600,691,531,0,1222,41,-0.3922322702763681,0.37147856221966696
144,1570626000,882,506,0,1388,41,-0.3922322702763681,0.6181638213677304
144,1570640400,1198,364,0,1562,41,-0.3922322702763681,0.8767375267397969
144,1570654800,1313,554,0,1867,41,-0.3922322702763681,1.3299845390299134
144,1570669200,267,104,0,371,41,-0.3922322702763681,-0.8931549048586582
144,1570683600,23,30,7,53,41,0.6373774391990983,-1.3657206422627797
144,1570698000,883,594,0,1477,41,-0.3922322702763681,0.7504227856097644
144,1570712400,1091,573,0,1664,41,-0.3922322702763681,1.0283152160958358
144,1570726800,1605,502,0,2107,41,-0.3922322702763681,1.686637925750005
144,1570741200,1460,525,0,1985,41,-0.3922322702763681,1.5053391208339586
144,1570755600,287,91,0,378,41,-0.3922322702763681,-0.8827525144126556
144,1570770000,25,38,13,63,41,1.5199000473209265,-1.3508600844827758
144,1570784400,808,567,0,1375,41,-0.3922322702763681,0.5988450962537254
144,1570798800,1011,537,0,1548,41,-0.3922322702763681,0.8559327458477916
144,1570813200,1492,470,0,1962,41,-0.3922322702763681,1.4711598379399498
144,1570827600,1251,539,0,1790,41,-0.3922322702763681,1.215558244123884
144,1570842000,268,217,0,485,41,-0.3922322702763681,-0.7237445461666147
144,1570856400,32,57,25,89,41,3.2849452635645826,-1.312222634254766
144,1570870800,239,154,0,393,41,-0.3922322702763681,-0.8604616777426498
144,1570885200,547,208,0,755,41,-0.3922322702763681,-0.3225094861065115
144,1570899600,652,252,0,904,41,-0.3922322702763681,-0.10108717518445455
144,1570914000,642,292,0,934,41,-0.3922322702763681,-0.05650550184444309
144,1570928400,206,228,22,434,41,2.8436839595036685,-0.7995333908446342
144,1570942800,28,56,28,84,41,3.7262065676254967,-1.3196529131447678
144,1570957200,179,99,0,278,41,-0.3922322702763681,-1.0313580922126937
144,1570971600,452,202,0,654,41,-0.3922322702763681,-0.4726011196845501
144,1570986000,610,248,0,858,41,-0.3922322702763681,-0.16944574097247214
144,1571000400,486,240,0,726,41,-0.3922322702763681,-0.36560510366852256
144,1571014800,140,130,0,270,41,-0.3922322702763681,-1.043246538436697
144,1571029200,22,30,8,52,41,0.7844645405527363,-1.3672066980407802
144,1571043600,556,481,0,1037,41,-0.3922322702763681,0.09655824328959627
144,1571058000,818,506,0,1324,41,-0.3922322702763681,0.5230562515757059
144,1571072400,1156,326,0,1482,41,-0.3922322702763681,0.7578530644997663
144,1571086800,1223,465,0,1688,41,-0.3922322702763681,1.063980554767845
144,1571101200,224,177,0,401,42,-0.3246914620388362,-0.9263577371720683
144,1571115600,23,29,6,52,42,0.21361280397291854,-1.4257711658185126
144,1571130000,914,569,0,1483,42,-0.3246914620388362,0.6219669900355329
144,1571144400,1025,566,0,1591,42,-0.3246914620388362,0.7765132659490458
144,1571158800,1569,430,0,1999,42,-0.3246914620388362,1.3603547527334277
144,1571173200,1374,533,0,1907,42,-0.3246914620388362,1.2287042213996946
144,1571187600,487,100,0,587,42,-0.3246914620388362,-0.6601947064321294
144,1571202000,110,173,63,283,42,5.327503331084588,-1.0952138534479434
144,1571216400,948,563,0,1511,42,-0.3246914620388362,0.6620345430501473
144,1571230800,1077,512,0,1589,42,-0.3246914620388362,0.7736512978765733
144,1571245200,1533,391,0,1924,42,-0.3246914620388362,1.2530309500157104
144,1571259600,1332,544,0,1876,42,-0.3246914620388362,1.1843437162763715
144,1571274000,267,228,0,495,42,-0.3246914620388362,-0.7918452377658626
144,1571288400,22,31,9,53,42,0.48276493697879597,-1.4243401817822763
144,1571302800,883,508,0,1391,42,-0.3246914620388362,0.4903164587017997
144,1571317200,1134,555,0,1689,42,-0.3246914620388362,0.9167497015001963
144,1571331600,1563,440,0,2003,42,-0.3246914620388362,1.3660786888783727
144,1571346000,1539,476,0,2015,42,-0.3246914620388362,1.3832504973132074
144,1571360400,307,231,0,538,42,-0.3246914620388362,-0.7303129242077047
144,1571374800,26,45,19,71,42,1.3799387136650538,-1.3985824691300242
144,1571389200,789,576,0,1365,42,-0.3246914620388362,0.45311087375965775
144,1571403600,1051,536,0,1587,42,-0.3246914620388362,0.7707893298041009
144,1571418000,1570,396,0,1966,42,-0.3246914620388362,1.3131322795376321
144,1571432400,1348,428,0,1776,42,-0.3246914620388362,1.0412453126527483
144,1571446800,290,216,0,506,42,-0.3246914620388362,-0.7761044133672641
144,1571461200,26,50,24,76,42,1.8285256020081826,-1.391427548948843
144,1571475600,217,135,0,352,42,-0.3246914620388362,-0.9964759549476435
144,1571490000,696,209,0,905,42,-0.3246914620388362,-0.2051417829090082
144,1571504400,746,328,0,1074,42,-0.3246914620388362,0.03669451921491471
144,1571518800,656,271,0,927,42,-0.3246914620388362,-0.17366013411181114
144,1571533200,196,196,0,392,42,-0.3246914620388362,-0.9392365934981943
144,1571547600,26,53,27,79,42,2.09767773501406,-1.3871345968401343
144,1571562000,156,98,0,254,42,-0.3246914620388362,-1.1367123904987941
144,1571576400,504,182,0,686,42,-0.3246914620388362,-0.5185272868447426
144,1571590800,561,257,0,818,42,-0.3246914620388362,-0.32963739406156023
144,1571605200,432,270,0,702,42,-0.3246914620388362,-0.4956315422649629
144,1571619600,129,122,0,251,42,-0.3246914620388362,-1.1410053426075029
144,1571634000,26,30,4,56,42,0.034178048635666966,-1.4200472296735678
144,1571648400,879,566,0,1445,42,-0.3246914620388362,0.5675895966585561
144,1571662800,992,541,0,1533,42,-0.3246914620388362,0.6935161918473444
144,1571677200,1436,458,0,1894,42,-0.3246914620388362,1.2101014289286236
144,1571691600,1393,536,0,1929,42,-0.3246914620388362,1.2601858701968915
144,1571706000,269,176,0,445,43,-0.3484067784027662,-0.860005177849101
144,1571720400,23,26,3,49,43,0.1742033892013831,-1.4130580378416098
144,1571734800,930,564,0,1494,43,-0.3484067784027662,0.6050262618785291
144,1571749200,1051,559,0,1610,43,-0.3484067784027662,0.7670316451086578
144,1571763600,1559,428,0,1987,43,-0.3484067784027662,1.2935491406065764
144,1571778000,1519,534,0,2053,43,-0.3484067784027662,1.3857246172719946
144,1571792400,273,212,0,485,43,-0.3484067784027662,-0.8041412525973325
144,1571806800,31,30,0,61,43,-0.3484067784027662,-1.396298860266079
144,1571821200,904,520,0,1424,43,-0.3484067784027662,0.5072643926879341
144,1571835600,1102,567,0,1669,43,-0.3484067784027662,0.8494309348550165
144,1571850000,1612,416,0,2028,43,-0.3484067784027662,1.3508096639896392
144,1571864400,1448,537,0,1985,43,-0.3484067784027662,1.290755944343988
144,1571878800,282,243,0,525,43,-0.3484067784027662,-0.748277327345564
144,1571893200,28,35,7,63,43,0.8710169460069155,-1.3935056640034906
144,1571907600,948,510,0,1458,43,-0.3484067784027662,0.5547487291519374
144,1571922000,1162,500,0,1662,43,-0.3484067784027662,0.839654747935957
144,1571936400,1571,450,0,2021,43,-0.3484067784027662,1.3410334770705796
144,1571950800,1611,466,0,2077,43,-0.3484067784027662,1.4192429724230557
144,1571965200,290,271,0,561,43,-0.3484067784027662,-0.6979997946189723
144,1571979600,28,51,23,79,43,3.658271173229045,-1.3711600939027833
144,1571994000,866,578,0,1444,43,-0.3484067784027662,0.5351963553138184
144,1572008400,1089,516,0,1605,43,-0.3484067784027662,0.7600486544521868
144,1572022800,1562,399,0,1961,43,-0.3484067784027662,1.2572375891929268
144,1572037200,1360,457,0,1817,43,-0.3484067784027662,1.05612745828656
144,1572051600,322,234,0,556,43,-0.3484067784027662,-0.7049827852754433
144,1572066000,45,69,24,114,43,3.8324745624304284,-1.3222791593074859
144,1572080400,250,147,0,397,43,-0.3484067784027662,-0.9270418881512233
144,1572094800,620,240,0,860,43,-0.3484067784027662,-0.2804169533620024
144,1572109200,734,286,0,1020,43,-0.3484067784027662,-0.056961252354928195
144,1572123600,721,295,0,1016,43,-0.3484067784027662,-0.06254764488010506
144,1572138000,247,221,0,468,43,-0.3484067784027662,-0.8278834208293342
144,1572152400,39,56,17,95,43,2.6130508380207464,-1.348814523802076
144,1572166800,161,130,0,291,43,-0.3484067784027662,-1.07508129006841
144,1572181200,417,175,0,592,43,-0.3484067784027662,-0.6547052525488517
144,1572195600,503,226,0,729,43,-0.3484067784027662,-0.4633713085615444
144,1572210000,487,248,0,735,43,-0.3484067784027662,-0.4549917197737791
144,1572224400,147,144,0,291,43,-0.3484067784027662,-1.07508129006841
144,1572238800,23,33,10,56,43,1.3936271136110647,-1.4032818509225502
144,1572253200,800,537,0,1337,43,-0.3484067784027662,0.38576035526533753
144,1572267600,1049,559,0,1608,43,-0.3484067784027662,0.7642384488460695
144,1572282000,1480,393,0,1873,43,-0.3484067784027662,1.1343369536390362
144,1572296400,1444,508,0,1952,43,-0.3484067784027662,1.244668206011279
144,1572310800,280,195,0,475,44,-0.45969008550759005,-0.7521226628613586
144,1572325200,23,38,15,61,44,0.20914306430714832,-1.3110554289880918
144,1572339600,943,544,0,1487,44,-0.45969008550759005,0.6141574321151004
144,1572354000,1133,573,0,1706,44,-0.45969008550759005,0.9098247649212708
144,1572368400,1623,428,0,2051,44,-0.45969008550759005,1.3756020700268818
144,1572382800,1480,519,0,1999,44,-0.45969008550759005,1.3053979544747318
144,1572397200,295,213,0,508,44,-0.45969008550759005,-0.707570051068648
144,1572411600,34,30,0,64,44,-0.45969008550759005,-1.3070051915523908
144,1572426000,915,601,0,1516,44,-0.45969008550759005,0.6533097273268764
144,1572440400,1086,532,0,1618,44,-0.45969008550759005,0.7910178001407092
144,1572454800,1568,363,0,1931,44,-0.45969008550759005,1.2135925725988432
144,1572469200,1480,541,0,2021,44,-0.45969008550759005,1.3350996956698722
144,1572483600,298,239,0,537,44,-0.45969008550759005,-0.668417755856872
144,1572498000,30,25,0,55,44,-0.45969008550759005,-1.3191559038594938
144,1572512400,907,540,0,1447,44,-0.45969008550759005,0.5601542663057542
144,1572526800,1066,552,0,1618,44,-0.45969008550759005,0.7910178001407092
144,1572541200,1565,345,0,1910,44,-0.45969008550759005,1.1852409105489365
144,1572555600,1412,484,0,1896,44,-0.45969008550759005,1.1663398025156653
144,1572570000,286,223,0,509,44,-0.45969008550759005,-0.7062199719234143
144,1572584400,28,58,30,86,44,0.8779762141218868,-1.2773034503572505
144,1572598800,807,439,0,1246,44,-0.45969008550759005,0.2887883581137895
144,1572613200,1082,537,0,1619,44,-0.45969008550759005,0.7923678792859429
144,1572627600,1550,418,0,1968,44,-0.45969008550759005,1.2635455009724885
144,1572642000,1358,426,0,1784,44,-0.45969008550759005,1.015130938249496
144,1572656400,209,237,28,446,44,0.7887984608132549,-0.7912749580731346
144,1572670800,32,77,45,109,44,1.5468093639366252,-1.2462516300168764
144,1572685200,104,179,75,283,44,2.8844756635661017,-1.0113378587462205
144,1572699600,236,274,38,510,44,1.2346872273564138,-0.7048698927781807
144,1572714000,306,248,0,554,44,-0.45969008550759005,-0.6454664103878999
144,1572728400,236,300,64,536,44,2.393998020368627,-0.6697678350021057
144,1572742800,109,201,92,310,44,3.642486566689472,-0.9748857218249117
144,1572753600,27,72,45,99,44,1.5468093639366252,-1.259752421469213
144,1572768000,103,95,0,198,44,-0.45969008550759005,-1.1260945860910812
144,1572782400,390,234,0,624,44,-0.45969008550759005,-0.550960870221544
144,1572796800,1045,418,0,1463,44,-0.45969008550759005,0.5817555326294926
144,1572811200,647,318,0,965,44,-0.45969008550759005,-0.0905838816968676
144,1572825600,187,154,0,341,44,-0.45969008550759005,-0.9330332683226684
144,1572840000,29,30,1,59,44,-0.4151012088532742,-1.3137555872785591
144,1572854400,452,322,0,774,44,-0.45969008550759005,-0.34844899843649574
144,1572868800,1324,717,0,2041,44,-0.45969008550759005,1.3621012785745454
144,1572883200,1247,432,0,1679,44,-0.45969008550759005,0.8733726279999622
144,1572897600,1716,529,0,2245,44,-0.45969008550759005,1.637517424202211
144,1572912000,400,231,0,631,45,-0.2596656552882734,-0.5436467187214823
144,1572926400,30,40,10,70,45,1.255050667226655,-1.2949314100127178
144,1572940800,413,341,0,754,45,-0.2596656552882734,-0.3789265457645804
144,1572955200,1324,690,0,2014,45,-0.2596656552882734,1.3084508357451465
144,1572969600,1308,426,0,1734,45,-0.2596656552882734,0.9334780842985405
144,1572984000,1828,587,0,2415,45,-0.2596656552882734,1.8454653833526071
144,1572998400,429,292,0,721,45,-0.2596656552882734,-0.423119762899359
144,1573012800,34,36,2,70,45,0.04327760921471225,-1.2949314100127178
144,1573027200,455,324,0,779,45,-0.2596656552882734,-0.3454468358139906
144,1573041600,1321,631,0,1952,45,-0.2596656552882734,1.2254211550676837
144,1573056000,1355,397,0,1752,45,-0.2596656552882734,0.9575834754629652
144,1573070400,1765,521,0,2286,45,-0.2596656552882734,1.6727100800075636
144,1573084800,445,312,0,757,45,-0.2596656552882734,-0.37490898057050964
144,1573099200,41,34,0,75,45,-0.2596656552882734,-1.2882354680225998
144,1573113600,479,329,0,808,45,-0.2596656552882734,-0.3066103722713064
144,1573128000,1355,653,0,2008,45,-0.2596656552882734,1.300415705357005
144,1573142400,1388,408,0,1796,45,-0.2596656552882734,1.0165077649760033
144,1573156800,1857,504,0,2361,45,-0.2596656552882734,1.773149209859333
144,1573171200,517,284,0,801,45,-0.2596656552882734,-0.31598469105747157
144,1573185600,49,36,0,85,45,-0.2596656552882734,-1.274843584042364
144,1573200000,390,347,0,737,45,-0.2596656552882734,-0.40169274853098147
144,1573214400,1305,576,0,1881,45,-0.2596656552882734,1.1303387788080086
144,1573228800,1214,339,0,1553,45,-0.2596656552882734,0.6910849842562702
144,1573243200,1607,453,0,2060,45,-0.2596656552882734,1.3700535020542317
144,1573257600,440,281,0,721,45,-0.2596656552882734,-0.423119762899359
144,1573272000,57,72,15,129,45,2.0124088284841193,-1.2159192945293258
144,1573286400,122,121,0,243,45,-0.2596656552882734,-1.0632518171546363
144,1573300800,507,209,0,716,45,-0.2596656552882734,-0.42981570488947696
144,1573315200,743,238,0,981,45,-0.2596656552882734,-0.07493077941322485
144,1573329600,776,311,0,1087,45,-0.2596656552882734,0.06702319077727599
144,1573344000,311,206,0,517,45,-0.2596656552882734,-0.6963141960961718
144,1573358400,45,85,40,130,45,5.79919963477144,-1.2145801061313022
144,1573372800,97,85,0,182,45,-0.2596656552882734,-1.1449423094340754
144,1573387200,419,143,0,562,45,-0.2596656552882734,-0.6360507181851102
144,1573401600,583,254,0,837,45,-0.2596656552882734,-0.2677739087286222
144,1573416000,583,299,0,882,45,-0.2596656552882734,-0.20751043081756054
144,1573430400,178,153,0,331,45,-0.2596656552882734,-0.9454032381285602
144,1573444800,26,31,5,57,45,0.49769250596919073,-1.3123408591870245
144,1573459200,317,296,0,613,45,-0.2596656552882734,-0.567752109885907
144,1573473600,1130,671,0,1801,45,-0.2596656552882734,1.0232037069661213
144,1573488000,1056,442,0,1498,45,-0.2596656552882734,0.6174296223649726
144,1573502400,1653,512,0,2165,45,-0.2596656552882734,1.510668283846709
144,1573516800,328,238,0,566,46,-0.2880158528288216,-0.6109282748261665
144,1573531200,33,41,8,74,46,0.5184285350918788,-1.269743736208481
144,1573545600,430,315,0,745,46,-0.2880158528288216,-0.3712372837947961
144,1573560000,1355,713,0,2068,46,-0.2880158528288216,1.4003335605320368
144,1573574400,1277,416,0,1693,46,-0.2880158528288216,0.8981876296003949
144,1573588800,1817,559,0,2376,46,-0.2880158528288216,1.8127627518038922
144,1573603200,341,280,0,621,46,-0.2880158528288216,-0.5372802049561923
144,1573617600,34,38,4,72,46,0.11520634113152863,-1.2724218478401161
144,1573632000,406,201,0,607,46,-0.2880158528288216,-0.5560269863776404
144,1573646400,1309,596,0,1905,46,-0.2880158528288216,1.1820674625537497
144,1573660800,1251,362,0,1613,46,-0.2880158528288216,0.7910631643349779
144,1573675200,1836,470,0,2306,46,-0.2880158528288216,1.7190288446966524
144,1573689600,358,351,0,709,46,-0.2880158528288216,-0.41944329316423373
144,1573704000,37,37,0,74,46,-0.2880158528288216,-1.269743736208481
144,1573718400,410,254,0,664,46,-0.2880158528288216,-0.47970080487603073
144,1573732800,1302,657,0,1959,46,-0.2880158528288216,1.2543764766079062
144,1573747200,1215,356,0,1571,46,-0.2880158528288216,0.734822820070634
144,1573761600,1784,523,0,2307,46,-0.2880158528288216,1.7203679005124701
144,1573776000,344,304,0,648,46,-0.2880158528288216,-0.5011256979291141
144,1573790400,43,54,11,97,46,0.8208451805621414,-1.2389454524446735
144,1573804800,416,306,0,722,46,-0.2880158528288216,-0.4020355675586035
144,1573819200,1338,687,0,2025,46,-0.2880158528288216,1.3427541604518753
144,1573833600,1271,403,0,1674,46,-0.2880158528288216,0.8727455690998583
144,1573848000,1663,457,0,2120,46,-0.2880158528288216,1.4699644629545578
144,1573862400,455,316,0,771,46,-0.2880158528288216,-0.3364218325835356
144,1573876800,43,92,49,135,46,4.651456023185468,-1.1880613314436004
144,1573891200,116,112,0,228,46,-0.2880158528288216,-1.063529140572553
144,1573905600,559,222,0,781,46,-0.2880158528288216,-0.32303127442535845
144,1573920000,769,207,0,976,46,-0.2880158528288216,-0.06191539034090461
144,1573934400,738,317,0,1055,46,-0.2880158528288216,0.04387001910869464
144,1573948800,298,265,0,563,46,-0.2880158528288216,-0.6149454422736197
144,1573963200,57,100,43,157,46,4.046622732244943,-1.1586021034956107
144,1573977600,107,103,0,210,46,-0.2880158528288216,-1.087632145257272
144,1573992000,428,164,0,592,46,-0.2880158528288216,-0.576112823614906
144,1574006400,597,208,0,805,46,-0.2880158528288216,-0.29089393484573334
144,1574020800,563,244,0,807,46,-0.2880158528288216,-0.28821582321409794
144,1574035200,182,162,0,344,46,-0.2880158528288216,-0.9081986659376986
144,1574049600,25,30,5,55,46,0.21601188962161616,-1.2951857967090172
144,1574064000,418,286,0,704,46,-0.2880158528288216,-0.42613857224332224
144,1574078400,1271,627,0,1898,46,-0.2880158528288216,1.1726940718430259
144,1574092800,1128,373,0,1501,46,-0.2880158528288216,0.6410889129633942
144,1574107200,1617,519,0,2136,46,-0.2880158528288216,1.4913893560076412
144,1574121600,396,263,0,659,47,-0.3058906733656147,-0.45484984059463307
144,1574136000,38,30,0,68,47,-0.3058906733656147,-1.24548588704001
144,1574150400,448,328,0,776,47,-0.3058906733656147,-0.298327983684127
144,1574164800,1337,710,0,2047,47,-0.3058906733656147,1.402007743950516
144,1574179200,1230,406,0,1636,47,-0.3058906733656147,0.8521745542905331
144,1574193600,1856,481,0,2337,47,-0.3058906733656147,1.7899679021047619
144,1574208000,396,300,0,696,47,-0.3058906733656147,-0.4053514755887465
144,1574222400,39,49,10,88,47,2.055370664895271,-1.218730014063855
144,1574236800,464,331,0,795,47,-0.3058906733656147,-0.27290990435677986
144,1574251200,1283,660,0,1943,47,-0.3058906733656147,1.2628772044745107
144,1574265600,1322,422,0,1744,47,-0.3058906733656147,0.9966562683617696
144,1574280000,1871,506,0,2377,47,-0.3058906733656147,1.8434796480570717
144,1574294400,406,295,0,701,47,-0.3058906733656147,-0.3986625073447078
144,1574308800,34,53,19,87,47,4.180505869330068,-1.2200678077126628
144,1574323200,436,335,0,771,47,-0.3058906733656147,-0.3050169519281657
144,1574337600,1358,577,0,1935,47,-0.3058906733656147,1.2521748552840486
144,1574352000,1320,412,0,1732,47,-0.3058906733656147,0.9806027445760765
144,1574366400,1816,530,0,2346,47,-0.3058906733656147,1.8020080449440317
144,1574380800,387,342,0,729,47,-0.3058906733656147,-0.36120428517809094
144,1574395200,56,62,6,118,47,1.1108661295909168,-1.1785962045996228
144,1574409600,418,336,0,754,47,-0.3058906733656147,-0.32775944395789736
144,1574424000,1198,662,0,1860,47,-0.3058906733656147,1.1518403316234678
144,1574438400,1372,365,0,1737,47,-0.3058906733656147,0.9872917128201153
144,1574452800,1649,483,0,2132,47,-0.3058906733656147,1.5157202040991744
144,1574467200,421,264,0,685,47,-0.3058906733656147,-0.4200672057256317
144,1574481600,58,59,1,117,47,-0.06976453953952616,-1.1799339982484305
144,1574496000,138,140,2,278,47,0.16636159428656241,-0.9645492207903836
144,1574510400,516,228,0,744,47,-0.3058906733656147,-0.3411373804459748
144,1574524800,751,253,0,1004,47,-0.3058906733656147,0.0066889682440387215
144,1574539200,745,287,0,1032,47,-0.3058906733656147,0.04414719041065556
144,1574553600,324,221,0,545,47,-0.3058906733656147,-0.607358316558716
144,1574568000,48,67,19,115,47,4.180505869330068,-1.182609585546046
144,1574582400,104,99,0,203,47,-0.3058906733656147,-1.0648837444509645
144,1574596800,388,152,0,540,47,-0.3058906733656147,-0.6140472848027546
144,1574611200,560,214,0,774,47,-0.3058906733656147,-0.30100357098174246
144,1574625600,542,291,0,833,47,-0.3058906733656147,-0.22207374570208555
144,1574640000,194,148,0,342,47,-0.3058906733656147,-0.878930427266688
144,1574654400,41,33,0,74,47,-0.3058906733656147,-1.2374591251471636
144,1574668800,413,317,0,730,47,-0.3058906733656147,-0.35986649152928324
144,1574679023,960,570,0,1530,47,-0.3058906733656147,0.7103684275169122
144,1574679520,36,11,0,47,47,-0.3058906733656147,-1.2735795536649726
144,1574683200,308,109,0,417,47,-0.3058906733656147,-0.7785959036061072
144,1574697600,1218,371,0,1589,47,-0.3058906733656147,0.7892982527965692
144,1574712000,1748,541,0,2289,47,-0.3058906733656147,1.7257538069619902
144,1574726400,452,249,0,701,48,-0.33836499375649126,-0.036787258018469396
144,1574740800,33,37,4,70,48,0.3233265495895361,-1.1628748342310204
144,1574755200,400,308,0,708,48,-0.33836499375649126,-0.024295002814843633
144,1574769600,1314,618,0,1932,48,-0.33836499375649126,2.160065049933433
144,1574784000,1334,416,0,1750,48,-0.33836499375649126,1.8352664146391628
144,1574798400,1717,509,0,2226,48,-0.33836499375649126,2.6847397684857146
144,1574812800,441,279,0,720,48,-0.33836499375649126,-0.002879708180056607
144,1574827200,45,50,5,95,48,0.48874943542604293,-1.118259637075214
144,1574841600,350,277,0,627,48,-0.33836499375649126,-0.16884824159965606
144,1574847583,558,302,0,860,48,-0.33836499375649126,0.24696539589245867
144,1574856000,537,296,0,833,48,-0.33836499375649126,0.19878098296418786
144,1574863336,540,196,0,736,48,-0.33836499375649126,0.025674017999659425
144,1574870400,686,161,0,847,48,-0.33836499375649126,0.2237654933714394
144,1574884800,1232,329,0,1561,48,-0.33836499375649126,1.4979755241412673
144,1574899200,343,162,0,505,48,-0.33836499375649126,-0.3865704037199908
144,1574913600,40,39,0,79,48,-0.33836499375649126,-1.1468133632549302
144,1574928000,116,81,0,197,48,-0.33836499375649126,-0.9362296326795244
144,1574942400,306,128,0,434,48,-0.33836499375649126,-0.5132775636424807
144,1574956800,429,163,0,592,48,-0.33836499375649126,-0.23130951761778487
144,1574971200,379,157,0,536,48,-0.33836499375649126,-0.331247559246791
144,1574985600,194,106,0,300,48,-0.33836499375649126,-0.7524150203976024
144,1575000000,28,34,6,62,48,0.6541723212625498,-1.1771516973208784
144,1575014400,171,198,27,369,48,4.128052923829193,-0.6292770762475771
144,1575028800,510,357,0,867,48,-0.33836499375649126,0.25945765109608443
144,1575043200,798,322,0,1120,48,-0.33836499375649126,0.7109634463128442
144,1575057600,834,309,0,1143,48,-0.33836499375649126,0.7520094276961861
144,1575072000,320,174,0,494,48,-0.33836499375649126,-0.4062010904685456
144,1575086400,36,59,23,95,48,3.466361380483166,-1.118259637075214
144,1575100800,102,106,4,208,48,0.3233265495895361,-0.9165989459309697
144,1575115200,395,176,0,571,48,-0.33836499375649126,-0.26878628322866216
144,1575129600,571,225,0,796,48,-0.33836499375649126,0.13275049117359455
144,1575144000,580,205,0,785,48,-0.33836499375649126,0.11311980442503977
144,1575158400,254,200,0,454,48,-0.33836499375649126,-0.47758540591783566
144,1575172800,39,60,21,99,48,3.1355156088101523,-1.111121205530285
144,1575187200,113,87,0,200,48,-0.33836499375649126,-0.9308758090208277
144,1575201600,332,141,0,473,48,-0.33836499375649126,-0.44367785607942284
144,1575216000,517,183,0,700,48,-0.33836499375649126,-0.03857186590470165
144,1575230400,459,226,0,685,48,-0.33836499375649126,-0.06534098419818543
144,1575244800,185,129,0,314,48,-0.33836499375649126,-0.727430509990351
144,1575259200,27,24,0,51,48,-0.33836499375649126,-1.1967823840694332
144,1575273600,393,280,0,673,48,-0.33836499375649126,-0.08675627883297245
144,1575288000,1168,635,0,1803,48,-0.33836499375649126,1.9298506326094722
144,1575302400,1223,305,0,1528,48,-0.33836499375649126,1.4390834638956032
144,1575316800,1477,475,0,1952,48,-0.33836499375649126,2.195757207658078
144,1575331200,355,269,0,624,49,-0.3664514720035369,-0.5596450634198441
144,1575345600,38,21,0,59,49,-0.3664514720035369,-1.3526927975027834
144,1575360000,427,318,0,745,49,-0.3664514720035369,-0.3898065221383651
144,1575374400,1254,699,0,1953,49,-0.3664514720035369,1.3057716420602026
144,1575388800,1229,429,0,1658,49,-0.3664514720035369,0.8917024711673405
144,1575403200,1672,483,0,2155,49,-0.3664514720035369,1.5893037522987046
144,1575417600,448,325,0,773,49,-0.3664514720035369,-0.35050504151124595
144,1575432000,44,33,0,77,49,-0.3664514720035369,-1.3274275599567782
144,1575446400,409,320,0,729,49,-0.3664514720035369,-0.41226451106814743
144,1575460800,1152,669,0,1821,49,-0.3664514720035369,1.1204932333894981
144,1575475200,1225,446,0,1671,49,-0.3664514720035369,0.9099495871727886
144,1575489600,1760,513,0,2273,49,-0.3664514720035369,1.7549314206558495
144,1575504000,468,292,0,760,49,-0.3664514720035369,-0.3687521575166941
144,1575518400,43,47,4,90,49,0.07966336347902978,-1.3091804439513302
144,1575532800,444,304,0,748,49,-0.3664514720035369,-0.3855956492140309
144,1575547200,1288,676,0,1964,49,-0.3664514720035369,1.321211509449428
144,1575561600,1211,433,0,1644,49,-0.3664514720035369,0.8720517308537808
144,1575576000,1788,522,0,2310,49,-0.3664514720035369,1.8068655200559711
144,1575590400,470,288,0,758,49,-0.3664514720035369,-0.3715594061329169
144,1575604800,39,64,25,103,49,2.4217662497625048,-1.290933327945882
144,1575619200,375,280,0,655,49,-0.3664514720035369,-0.5161327098683908
144,1575633600,1229,601,0,1830,49,-0.3664514720035369,1.1331258521625007
144,1575648000,1332,378,0,1710,49,-0.3664514720035369,0.9646909351891331
144,1575662400,1689,393,0,2082,49,-0.3664514720035369,1.4868391778065726
144,1575676800,453,237,0,690,49,-0.3664514720035369,-0.4670058590844919
144,1575691200,68,98,30,166,49,2.979409794115713,-1.202504996534864
144,1575705600,123,142,19,265,49,1.7525939965386548,-1.0635461900318357
144,1575720000,536,264,0,800,49,-0.3664514720035369,-0.31260718519223823
144,1575734400,686,275,0,961,49,-0.3664514720035369,-0.0866236715863033
144,1575748800,727,276,0,1003,49,-0.3664514720035369,-0.027671450645624616
144,1575763200,358,248,0,606,49,-0.3664514720035369,-0.5849103009658493
144,1575777600,59,97,38,156,49,3.8716394650808463,-1.2165412396159778
144,1575792000,95,117,22,212,49,2.08718012315058,-1.1379382783617398
144,1575806400,432,172,0,604,49,-0.3664514720035369,-0.587717549582072
144,1575820800,657,200,0,857,49,-0.3664514720035369,-0.23260059962988858
144,1575835200,555,286,0,841,49,-0.3664514720035369,-0.25505858855967095
144,1575849600,224,149,0,373,49,-0.3664514720035369,-0.9119547647558047
144,1575864000,35,30,0,65,49,-0.3664514720035369,-1.344271051654115
144,1575878400,395,322,0,717,49,-0.3664514720035369,-0.42910800276548416
144,1575892800,1186,592,0,1778,49,-0.3664514720035369,1.0601373881407081
144,1575907200,1255,370,0,1625,49,-0.3664514720035369,0.8453828689996643
144,1575921600,1547,496,0,2043,49,-0.3664514720035369,1.4320978297902283
144,1575936000,440,256,0,696,50,-0.4145565398086321,-0.4586681315721857
144,1575950400,46,52,6,98,50,0.5899458451122841,-1.2835219760922354
144,1575964800,418,278,0,696,50,-0.4145565398086321,-0.4586681315721857
144,1575979200,1322,602,0,1924,50,-0.4145565398086321,1.2351788936295216
144,1575993600,1211,439,0,1650,50,-0.4145565398086321,0.8572358277457529
144,1576008000,1838,417,0,2255,50,-0.4145565398086321,1.6917451520511544
144,1576022400,443,314,0,757,50,-0.4145565398086321,-0.3745275220141205
144,1576036800,43,23,0,66,50,-0.4145565398086321,-1.3276613122538434
144,1576051200,398,302,0,700,50,-0.4145565398086321,-0.4531507145519847
144,1576065600,1335,644,0,1979,50,-0.4145565398086321,1.3110433776572852
144,1576080000,1270,389,0,1659,50,-0.4145565398086321,0.8696500160412052
144,1576094400,1765,470,0,2235,50,-0.4145565398086321,1.6641580669501492
144,1576108800,460,294,0,754,50,-0.4145565398086321,-0.3786655847792712
144,1576123200,46,57,11,103,50,1.4270311658797143,-1.2766252048169842
144,1576137600,413,293,0,706,50,-0.4145565398086321,-0.4448745890216832
144,1576152000,1350,514,0,1864,50,-0.4145565398086321,1.1524176383265066
144,1576166400,1265,383,0,1648,50,-0.4145565398086321,0.8544771192356524
144,1576180800,1813,470,0,2283,50,-0.4145565398086321,1.7303670711925614
144,1576195200,468,341,0,809,50,-0.4145565398086321,-0.30280110075150746
144,1576209600,37,58,21,95,50,3.1012018074145753,-1.287660038857386
144,1576224000,383,332,0,715,50,-0.4145565398086321,-0.432460400726231
144,1576238400,1184,652,0,1836,50,-0.4145565398086321,1.1137957191850996
144,1576252800,1340,440,0,1780,50,-0.4145565398086321,1.0365518809022856
144,1576267200,1533,448,0,1981,50,-0.4145565398086321,1.3138020861673858
144,1576281600,459,288,0,747,50,-0.4145565398086321,-0.38832106456462295
144,1576296000,57,80,23,137,50,3.4360359357215473,-1.2297271601452755
144,1576310400,115,106,0,221,50,-0.4145565398086321,-1.1138614027210545
144,1576324800,557,187,0,744,50,-0.4145565398086321,-0.3924591273297737
144,1576339200,756,303,0,1059,50,-0.4145565398086321,0.04203746301105509
144,1576353600,701,235,0,936,50,-0.4145565398086321,-0.12762311036012566
144,1576368000,340,266,0,606,50,-0.4145565398086321,-0.5828100145267082
144,1576382400,66,83,17,149,50,2.431533550800631,-1.2131749090846726
144,1576396800,88,102,14,190,50,1.9292823583401726,-1.1566213846276123
144,1576411200,403,158,0,561,50,-0.4145565398086321,-0.6448809560039694
144,1576425600,636,216,0,852,50,-0.4145565398086321,-0.2434888677843467
144,1576440000,560,259,0,819,50,-0.4145565398086321,-0.28900755820100493
144,1576454400,217,158,0,375,50,-0.4145565398086321,-0.901440847443316
144,1576468800,26,38,12,64,50,1.5944482300332004,-1.3304200207639438
144,1576483200,399,295,0,694,50,-0.4145565398086321,-0.46142684008228624
144,1576497600,1281,688,0,1969,50,-0.4145565398086321,1.2972498351067827
144,1576512000,1180,410,0,1590,50,-0.4145565398086321,0.774474572442738
144,1576526400,1656,540,0,2196,50,-0.4145565398086321,1.6103632510031896
144,1576540800,440,280,0,720,51,-0.4530667088028833,-0.3324665363147316
144,1576555200,32,35,3,67,51,0.3289388433774358,-1.295117214626369
144,1576569600,397,320,0,717,51,-0.4530667088028833,-0.336889127486148
144,1576584000,1194,706,0,1900,51,-0.4530667088028833,1.407085991109054
144,1576598400,1242,453,0,1695,51,-0.4530667088028833,1.1048755943956
144,1576612800,1730,497,0,2227,51,-0.4530667088028833,1.8891484287934421
144,1576627200,437,241,0,678,51,-0.4530667088028833,-0.39438281271456127
144,1576641600,37,47,10,84,51,2.153618465131514,-1.2700558646550093
144,1576656000,396,320,0,716,51,-0.4530667088028833,-0.3383633245432868
144,1576670400,1223,633,0,1856,51,-0.4530667088028833,1.342221320594947
144,1576684800,1283,427,0,1710,51,-0.4530667088028833,1.126988550252682
144,1576699200,1683,443,0,2126,51,-0.4530667088028833,1.7402545260224231
144,1576713600,458,255,0,713,51,-0.4530667088028833,-0.34278591571470324
144,1576728000,39,47,8,86,51,1.6322814303446342,-1.2671074705407317
144,1576742400,392,284,0,676,51,-0.4530667088028833,-0.3973312068288389
144,1576756800,1260,643,0,1903,51,-0.4530667088028833,1.4115085822804705
144,1576771200,1271,391,0,1662,51,-0.4530667088028833,1.0562270915100194
144,1576785600,1621,450,0,2071,51,-0.4530667088028833,1.6591736878797891
144,1576800000,442,288,0,730,51,-0.4530667088028833,-0.31772456574334357
144,1576814400,42,49,7,91,51,1.3716129129511945,-1.2597364852550377
144,1576828800,340,279,0,619,51,-0.4530667088028833,-0.48136043908575055
144,1576843200,1100,587,0,1687,51,-0.4530667088028833,1.0930820179384895
144,1576857600,1177,401,0,1578,51,-0.4530667088028833,0.93239453871036
144,1576872000,1453,388,0,1841,51,-0.4530667088028833,1.3201083647378649
144,1576886400,430,270,0,700,51,-0.4530667088028833,-0.36195047745750764
144,1576900800,55,72,17,127,51,3.9782980868855917,-1.206665391198041
144,1576915200,126,123,0,249,51,-0.4530667088028833,-1.026813350227107
144,1576929600,463,197,0,660,51,-0.4530667088028833,-0.4209183597430597
144,1576944000,667,225,0,892,51,-0.4530667088028833,-0.07890464248685775
144,1576958400,637,262,0,899,51,-0.4530667088028833,-0.06858526308688613
144,1576972800,282,189,0,471,51,-0.4530667088028833,-0.6995416035422932
144,1576987200,46,50,4,96,51,0.5896073607708755,-1.2523654999693437
144,1577001600,90,94,4,184,51,0.5896073607708755,-1.1226361589411291
144,1577016000,356,127,0,483,51,-0.4530667088028833,-0.6818512388566276
144,1577030400,557,142,0,699,51,-0.4530667088028833,-0.36342467451464644
144,1577044800,468,261,0,729,51,-0.4530667088028833,-0.31919876280048237
144,1577059200,188,130,0,318,51,-0.4530667088028833,-0.9250937532845298
144,1577073600,27,36,9,63,51,1.892949947738074,-1.3010140028549242
144,1577088000,252,263,11,515,51,2.4142869825249536,-0.634676933028186
144,1577102400,891,563,0,1454,51,-0.4530667088028833,0.7495941036251487
144,1577116800,1038,297,0,1335,51,-0.4530667088028833,0.5741646538256313
144,1577131200,1296,389,0,1685,51,-0.4530667088028833,1.0901336238242119
144,1577145600,336,226,0,562,52,-0.43609982665241426,-0.18975317042416087
144,1577160000,36,56,20,92,52,0.8640735695783862,-1.2217761995391732
144,1577174400,205,238,33,443,52,1.7091862771284063,-0.4510526182213661
144,1577188800,724,431,0,1155,52,-0.43609982665241426,1.1123524812039292
144,1577203200,1013,337,0,1350,52,-0.43609982665241426,1.5405322486027109
144,1577217600,767,270,0,1037,52,-0.43609982665241426,0.8532488270856919
144,1577232000,263,139,0,402,52,-0.43609982665241426,-0.5410801590590587
144,1577246400,33,42,9,75,52,0.1489782016514459,-1.2591046920816311
144,1577260800,89,91,2,180,52,-0.3060824870293342,-1.0285463557899794
144,1577275200,216,113,0,329,52,-0.43609982665241426,-0.7013730976237308
144,1577289600,335,154,0,489,52,-0.43609982665241426,-0.350046108988833
144,1577304000,308,146,0,454,52,-0.43609982665241426,-0.4268988877527169
144,1577318400,188,104,0,292,52,-0.43609982665241426,-0.7826174637455509
144,1577332800,40,21,0,61,52,-0.43609982665241426,-1.2898458035871845
144,1577347200,191,224,33,415,52,1.7091862771284063,-0.5125348412324732
144,1577361600,645,497,0,1142,52,-0.43609982665241426,1.0838071633773436
144,1577376000,788,301,0,1089,52,-0.43609982665241426,0.9674300983920338
144,1577390400,986,392,0,1378,52,-0.43609982665241426,1.6020144716138178
144,1577404800,229,167,0,396,52,-0.43609982665241426,-0.5542549211328673
144,1577419200,39,34,0,73,52,-0.43609982665241426,-1.2634962794395672
144,1577433600,199,263,64,462,52,3.724455041286147,-0.409332538320972
144,1577448000,723,433,0,1156,52,-0.43609982665241426,1.1145482748828972
144,1577462400,895,359,0,1254,52,-0.43609982665241426,1.329736055421772
144,1577476800,1011,265,0,1276,52,-0.43609982665241426,1.3780435163590705
