remote_unit_id,time_stamp,entries,exits,num_people_exited,sum_exit_entry,week_num,z_score_num_people_exited,z_score_sum_exit_entry
192,1546300800,0,0,0,0,1,-0.5390395434037005,-1.4297282007329946
192,1546315200,109,141,32,250,1,0.8201896242033794,-0.786231003780856
192,1546329600,37,63,26,100,1,0.5653341552770519,-1.1723293219521391
192,1546344000,195,106,0,301,1,-0.5390395434037005,-0.6549575756026197
192,1546358400,452,225,0,677,1,-0.5390395434037005,0.3128622086133969
192,1546372800,348,262,0,610,1,-0.5390395434037005,0.14040495983022375
192,1546387200,139,161,22,300,1,0.3954305093261669,-0.6575315643904283
192,1546401600,20,26,6,46,1,-0.2841840744773731,-1.3113247164938011
192,1546416000,182,105,0,287,1,-0.5390395434037005,-0.6909934186319394
192,1546430400,624,361,0,985,1,-0.5390395434037005,1.1056507552584318
192,1546444800,562,343,0,905,1,-0.5390395434037005,0.8997316522337474
192,1546459200,618,580,0,1198,1,-0.5390395434037005,1.653910367061654
192,1546473600,188,249,61,437,1,2.0519910573472955,-0.3048951004606562
192,1546488000,28,46,18,74,1,0.22552686337528188,-1.2392530304351617
192,1546502400,214,134,0,348,1,-0.5390395434037005,-0.5339801025756176
192,1546516800,659,329,0,988,1,-0.5390395434037005,1.1133727216218574
192,1546531200,547,379,0,926,1,-0.5390395434037005,0.9537854167777271
192,1546545600,642,591,0,1233,1,-0.5390395434037005,1.7439999746349533
192,1546560000,186,307,121,493,1,4.60054574661057,-0.16075172834337714
192,1546574400,33,42,9,75,1,-0.15675634001420935,-1.236679041647353
192,1546588800,214,111,0,325,1,-0.5390395434037005,-0.5931818446952144
192,1546603200,701,381,0,1082,1,-0.5390395434037005,1.3553276676758617
192,1546617600,523,283,0,806,1,-0.5390395434037005,0.6449067622407005
192,1546632000,654,506,0,1160,1,-0.5390395434037005,1.5560987931249288
192,1546646400,239,251,12,490,1,-0.029328605551045595,-0.16847369470680282
192,1546660800,47,80,33,127,1,0.8626655356911006,-1.1028316246813081
192,1546675200,54,62,8,116,1,-0.19923225150193058,-1.1311455013472023
192,1546689600,334,163,0,497,1,-0.5390395434037005,-0.15045577319214293
192,1546704000,513,312,0,825,1,-0.5390395434037005,0.693812549209063
192,1546718400,458,357,0,815,1,-0.5390395434037005,0.6680726613309775
192,1546732800,181,240,59,421,1,1.967039234371853,-0.34607892106559307
192,1546747200,39,71,32,110,1,0.8201896242033794,-1.1465894340740537
192,1546761600,49,76,27,125,1,0.6078100667647731,-1.1079796022569253
192,1546776000,307,133,0,440,1,-0.5390395434037005,-0.29717313409723056
192,1546790400,520,293,0,813,1,-0.5390395434037005,0.6629246837553604
192,1546804800,383,397,14,780,1,0.0556232174243969,0.5779830537576781
192,1546819200,142,190,48,332,1,1.4998042080069194,-0.5751639231805544
192,1546833600,21,26,5,47,1,-0.3266599859650943,-1.3087507277059927
192,1546848000,252,160,0,412,1,-0.5390395434037005,-0.36924482015587007
192,1546862400,719,379,0,1098,1,-0.5390395434037005,1.3965114882807985
192,1546876800,556,349,0,905,1,-0.5390395434037005,0.8997316522337474
192,1546891200,689,681,0,1370,1,-0.5390395434037005,2.0966364385647256
192,1546905600,167,273,106,440,2,2.3062176596240462,-0.4986823635005519
192,1546920000,18,40,22,58,2,0.09405455381827273,-1.3802226720068163
192,1546934400,261,148,0,409,2,-0.485321497702287,-0.5702209749238351
192,1546948800,753,387,0,1140,2,-0.485321497702287,1.1167056363800372
192,1546963200,550,342,0,892,2,-0.485321497702287,0.5443967449937713
192,1546977600,708,644,0,1352,2,-0.485321497702287,1.605937430629587
192,1546992000,204,298,94,502,2,1.9901943587946498,-0.3556051406539854
192,1547006400,27,30,3,57,2,-0.40631567249493794,-1.3825303691495028
192,1547020800,266,144,0,410,2,-0.485321497702287,-0.5679132777811485
192,1547035200,741,391,0,1132,2,-0.485321497702287,1.0982440592385447
192,1547049600,583,391,0,974,2,-0.485321497702287,0.733627910694069
192,1547064000,771,651,0,1422,2,-0.485321497702287,1.767476230617646
192,1547078400,192,312,120,504,2,2.674911510591675,-0.3509897463686123
192,1547092800,25,43,18,68,2,-0.011286546458192681,-1.3571457005799505
192,1547107200,273,154,0,427,2,-0.485321497702287,-0.5286824263554771
192,1547121600,752,396,0,1148,2,-0.485321497702287,1.1351672135215296
192,1547136000,583,388,0,971,2,-0.485321497702287,0.7267048192660093
192,1547150400,734,636,0,1370,2,-0.485321497702287,1.647475979197945
192,1547164800,201,326,125,527,2,2.806587885937257,-0.2979127120868215
192,1547179200,30,41,11,71,2,-0.19563347194200714,-1.350222609151891
192,1547193600,249,140,0,389,2,-0.485321497702287,-0.6163749177775663
192,1547208000,751,420,0,1171,2,-0.485321497702287,1.1882442478033204
192,1547222400,610,369,0,979,2,-0.485321497702287,0.7451663964075017
192,1547236800,739,591,0,1330,2,-0.485321497702287,1.5551680934904828
192,1547251200,217,353,136,570,2,3.0962759116975365,-0.19868173495129962
192,1547265600,37,74,37,111,2,0.489083679855018,-1.2579147234444288
192,1547280000,60,53,0,113,2,-0.485321497702287,-1.2532993291590557
192,1547294400,358,188,0,546,2,-0.485321497702287,-0.25406646637577696
192,1547308800,523,311,0,834,2,-0.485321497702287,0.4105503107179511
192,1547323200,557,366,0,923,2,-0.485321497702287,0.6159353564170545
192,1547337600,211,237,26,448,2,0.1993956540947381,-0.4802207863590594
192,1547352000,44,58,14,102,2,-0.11662764673465809,-1.2786839977286077
192,1547366400,44,48,4,92,2,-0.37998039742582157,-1.3017609691554732
192,1547380800,320,156,0,476,2,-0.485321497702287,-0.4156052663638359
192,1547395200,452,279,0,731,2,-0.485321497702287,0.17285750502123587
192,1547409600,349,304,0,653,2,-0.485321497702287,-0.00714287210831548
192,1547424000,141,196,55,337,2,0.9631186310991122,-0.7363751691972671
192,1547438400,20,23,3,43,2,-0.40631567249493794,-1.4148381291471146
192,1547452800,264,147,0,411,2,-0.485321497702287,-0.565605580638462
192,1547467200,758,370,0,1128,2,-0.485321497702287,1.0890132706677986
192,1547481600,587,338,0,925,2,-0.485321497702287,0.6205507507024277
192,1547496000,707,663,0,1370,2,-0.485321497702287,1.647475979197945
192,1547510400,191,293,102,484,3,2.503055427604094,-0.36457720187498344
192,1547524800,21,30,9,51,3,-0.20974548810666935,-1.358610334303536
192,1547539200,397,148,0,545,3,-0.47227460898190454,-0.22454020169451755
192,1547553600,934,426,0,1360,3,-0.47227460898190454,1.6464459482576081
192,1547568000,532,404,0,936,3,-0.47227460898190454,0.6730740125769931
192,1547582400,767,679,0,1446,3,-0.47227460898190454,1.8438751616267897
192,1547596800,194,318,124,512,3,3.144793278632447,-0.300297923103622
192,1547611200,22,48,26,70,3,0.2861428513243304,-1.3149922522801123
192,1547625600,274,150,0,424,3,-0.47227460898190454,-0.5023185135279007
192,1547640000,777,404,0,1181,3,-0.47227460898190454,1.2355177018264052
192,1547654400,597,433,0,1030,3,-0.47227460898190454,0.8888687341665634
192,1547668800,775,687,0,1462,3,-0.47227460898190454,1.8806061780675676
192,1547683200,201,312,111,513,3,2.765584548479329,-0.29800223457607344
192,1547697600,26,46,20,72,3,0.11112343740750698,-1.3104008752250151
192,1547712000,267,156,0,423,3,-0.47227460898190454,-0.5046142020554493
192,1547726400,784,405,0,1189,3,-0.47227460898190454,1.253883210046794
192,1547740800,610,328,0,938,3,-0.47227460898190454,0.6776653896320903
192,1547755200,815,660,0,1475,3,-0.47227460898190454,1.9104501289256997
192,1547769600,241,365,124,606,3,3.144793278632447,-0.0845032015140517
192,1547784000,29,37,8,66,3,-0.23891539042613993,-1.3241750063903068
192,1547798400,260,149,0,409,3,-0.47227460898190454,-0.5367538414411299
192,1547812800,802,364,0,1166,3,-0.47227460898190454,1.2010823739131757
192,1547827200,628,389,0,1017,3,-0.47227460898190454,0.8590247833084314
192,1547841600,750,589,0,1339,3,-0.47227460898190454,1.5982364891790872
192,1547856000,259,302,43,561,3,0.7820311907553302,-0.18780918525373963
192,1547870400,40,71,31,111,3,0.4319923629216833,-1.220869022650619
192,1547884800,61,51,0,112,3,-0.47227460898190454,-1.2185733341230702
192,1547899200,437,160,0,597,3,-0.47227460898190454,-0.1051643982619893
192,1547913600,561,305,0,866,3,-0.47227460898190454,0.5123758156485897
192,1547928000,483,320,0,803,3,-0.47227460898190454,0.36774743841302654
192,1547942400,228,202,0,430,3,-0.47227460898190454,-0.48854438236260894
192,1547956800,34,56,22,90,3,0.1694632420464481,-1.2690784817291398
192,1547971200,42,41,0,83,3,-0.47227460898190454,-1.2851483014219802
192,1547985600,272,131,0,403,3,-0.47227460898190454,-0.5505279726064217
192,1548000000,514,246,0,760,3,-0.47227460898190454,0.26903283172843584
192,1548014400,406,297,0,703,3,-0.47227460898190454,0.1381785856581645
192,1548028800,156,203,47,359,3,0.8987108000332125,-0.651538267818561
192,1548043200,27,40,13,67,3,-0.09306587882878706,-1.3218793178627581
192,1548057600,81,64,0,145,3,-0.47227460898190454,-1.1428156127139657
192,1548072000,467,205,0,672,3,-0.47227460898190454,0.06701224130415726
192,1548086400,459,268,0,727,3,-0.47227460898190454,0.1932751103193314
192,1548100800,421,374,0,795,3,-0.47227460898190454,0.3493819301926376
192,1548115200,123,209,86,332,4,0.9647277326985622,-0.724133553598214
192,1548129600,25,25,0,50,4,-0.5298525586794365,-1.3164332818229656
192,1548144000,265,151,0,416,4,-0.5298525586794365,-0.5477038473185007
192,1548158400,822,385,0,1207,4,-0.5298525586794365,1.1136758868154655
192,1548172800,540,382,0,922,4,-0.5298525586794365,0.5150750976521526
192,1548187200,794,577,0,1371,4,-0.5298525586794365,1.4581338847901435
192,1548201600,168,335,167,503,4,2.372413821089468,-0.36497308010022633
192,1548216000,24,40,16,64,4,-0.2517911091207391,-1.2870283307763466
192,1548230400,242,143,0,385,4,-0.5298525586794365,-0.6128148103502997
192,1548244800,782,370,0,1152,4,-0.5298525586794365,0.998156436275177
192,1548259200,595,386,0,981,4,-0.5298525586794365,0.6389959627771894
192,1548273600,841,526,0,1367,4,-0.5298525586794365,1.4497324702053953
192,1548288000,184,400,216,584,4,3.2239770103629786,-0.19484443475907431
192,1548302400,27,37,10,64,4,-0.3560641527052506,-1.2870283307763466
192,1548316800,243,151,0,394,4,-0.5298525586794365,-0.5939116275346161
192,1548331200,766,417,0,1183,4,-0.5298525586794365,1.063267399306976
192,1548345600,549,436,0,985,4,-0.5298525586794365,0.6473973773619376
192,1548360000,842,654,0,1496,4,-0.5298525586794365,1.7206780905635264
192,1548374400,187,358,171,545,4,2.441929183479142,-0.2767582269603697
192,1548388800,33,56,23,89,4,-0.13013922493880895,-1.23451948962167
192,1548403200,224,154,0,378,4,-0.5298525586794365,-0.6275172858736091
192,1548417600,832,406,0,1238,4,-0.5298525586794365,1.1787868498472642
192,1548432000,722,406,0,1128,4,-0.5298525586794365,0.9477479487666874
192,1548446400,903,632,0,1535,4,-0.5298525586794365,1.8025918827648217
192,1548460800,201,357,156,558,4,2.1812465745178633,-0.24945362955993794
192,1548475200,54,88,34,142,4,0.061028021632795526,-1.1232007463737559
192,1548489600,60,53,0,113,4,-0.5298525586794365,-1.1841110021131807
192,1548504000,390,170,0,560,4,-0.5298525586794365,-0.24525292226756382
192,1548518400,635,348,0,983,4,-0.5298525586794365,0.6431966700695635
192,1548532800,537,325,0,862,4,-0.5298525586794365,0.38905387888092896
192,1548547200,150,297,147,447,4,2.024837009141096,-0.48259288428670183
192,1548561600,52,110,58,162,4,0.47812019597084165,-1.0811936734500145
192,1548576000,56,44,0,100,4,-0.5298525586794365,-1.2114155995136124
192,1548590400,71,135,64,206,4,0.5823932395553532,-0.9887781130177838
192,1548604800,1028,340,0,1368,4,-0.5298525586794365,1.4518328238515825
192,1548619200,513,331,0,844,4,-0.5298525586794365,0.3512475132495618
192,1548633600,101,218,117,319,4,1.5034717912185385,-0.7514381509986457
192,1548648000,21,22,1,43,4,-0.5124737180820179,-1.331135757346275
192,1548661371,62,107,45,169,4,0.2521952682044,-1.066491197926705
192,1548662400,234,103,0,337,4,-0.5298525586794365,-0.7136317853672787
192,1548676800,790,441,0,1231,4,-0.5298525586794365,1.1640843743239548
192,1548691200,559,384,0,943,4,-0.5298525586794365,0.559182524222081
192,1548705600,739,606,0,1345,4,-0.5298525586794365,1.40352468998928
192,1548720000,251,235,0,486,5,-0.3208828004216175,-0.45386296727812725
192,1548734400,25,62,37,87,5,0.2763050700636443,-1.3010266569246915
192,1548748800,192,115,0,307,5,-0.3208828004216175,-0.8339188581220747
192,1548763200,781,415,0,1196,5,-0.3208828004216175,1.0536212924939545
192,1548777600,557,380,0,937,5,-0.3208828004216175,0.5037080202672374
192,1548792000,769,647,0,1416,5,-0.3208828004216175,1.5207290912965714
192,1548806400,235,181,0,416,5,-0.3208828004216175,-0.6024881759880508
192,1548820800,17,50,33,67,5,0.21174421920037279,-1.3434910022703839
192,1548835200,256,131,0,387,5,-0.3208828004216175,-0.6640614767393048
192,1548849600,799,419,0,1218,5,-0.3208828004216175,1.1003320723742163
192,1548864000,629,434,0,1063,5,-0.3208828004216175,0.7712333959450999
192,1548878400,727,700,0,1427,5,-0.3208828004216175,1.5440844812367023
192,1548892800,204,209,5,413,5,-0.24018173684252805,-0.6088578277899047
192,1548907200,21,24,3,45,5,-0.2724621622741638,-1.3902017821506456
192,1548921600,230,148,0,378,5,-0.3208828004216175,-0.6831704321448664
192,1548936000,712,393,0,1105,5,-0.3208828004216175,0.8604085211710539
192,1548950400,564,351,0,915,5,-0.3208828004216175,0.45699724038697576
192,1548964800,275,628,353,903,5,5.376612288262097,0.43151863317956024
192,1548979200,1032,310,0,1342,5,-0.3208828004216175,1.3636110135175095
192,1548993600,30,36,6,66,5,-0.22404152412671016,-1.3456142195376686
192,1549008000,238,168,0,406,5,-0.3208828004216175,-0.623720348660897
192,1549022400,688,390,0,1078,5,-0.3208828004216175,0.8030816549543691
192,1549036800,658,384,0,1042,5,-0.3208828004216175,0.7266458333321227
192,1549051200,919,605,0,1524,5,-0.3208828004216175,1.7500365561633107
192,1549065600,304,348,44,652,5,0.38928655907436954,-0.10140890090887993
192,1549080000,49,72,23,121,5,0.050342092042193906,-1.2288372698370145
192,1549094400,60,79,19,139,5,-0.014218758821077641,-1.190619359025891
192,1549108800,545,196,0,741,5,-0.3208828004216175,0.08755743587945146
192,1549123200,675,260,0,935,5,-0.3208828004216175,0.4994615857326682
192,1549137600,616,384,0,1000,5,-0.3208828004216175,0.6374707081061687
192,1549152000,275,275,0,550,5,-0.3208828004216175,-0.3179770621719114
192,1549166400,41,87,46,128,5,0.4215669845060053,-1.213974748966022
192,1549180800,47,47,0,94,5,-0.3208828004216175,-1.2861641360536993
192,1549195200,388,164,0,552,5,-0.3208828004216175,-0.31373062763734216
192,1549209600,590,320,0,910,5,-0.3208828004216175,0.4463811540505526
192,1549224000,473,352,0,825,5,-0.3208828004216175,0.26590768633135975
192,1549238400,178,239,61,417,5,0.6636701752432737,-0.6003649587207661
192,1549252800,31,28,0,59,5,-0.3208828004216175,-1.360476740408661
192,1549267200,263,118,0,381,5,-0.3208828004216175,-0.6768007803430126
192,1549281600,177,382,205,559,5,2.9878608063210494,-0.2988681067663498
192,1549296000,1358,354,0,1712,5,-0.3208828004216175,2.1492014024128197
192,1549310400,808,583,0,1391,5,-0.3208828004216175,1.467648659614456
192,1549324800,154,319,165,473,6,1.7074325753009831,-0.2824216577306787
192,1549339200,29,37,8,66,6,-0.4102784002533632,-1.1678958200523828
192,1549353600,156,140,0,296,6,-0.518187239772056,-0.6675050157919603
192,1549356349,0,0,0,0,6,-0.518187239772056,-1.3114862247531998
192,1549356446,0,0,0,0,6,-0.518187239772056,-1.3114862247531998
192,1549357229,1,1,0,2,6,-0.518187239772056,-1.3071350003683266
192,1549357294,1,0,0,1,6,-0.518187239772056,-1.3093106125607632
192,1549368000,170,394,224,564,6,2.5032602667513424,-0.0844409482189463
192,1549382400,199,345,146,544,6,1.4511490814440877,-0.1279531920676787
192,1549396800,423,622,199,1045,6,2.1660451432554275,0.9620285163430677
192,1549411200,185,397,212,582,6,2.341397007473303,-0.04527992875508714
192,1549425600,29,45,16,74,6,-0.3023695607346704,-1.1504909225128899
192,1549440000,261,140,0,401,6,-0.518187239772056,-0.4390657355861153
192,1549454400,816,427,0,1243,6,-0.518187239772056,1.3927997304455184
192,1549468800,632,434,0,1066,6,-0.518187239772056,1.0077163723842368
192,1549483200,791,661,0,1452,6,-0.518187239772056,1.847502678664772
192,1549497600,201,379,178,580,6,1.8827844395188589,-0.04963115313996039
192,1549512000,37,30,0,67,6,-0.518187239772056,-1.1657202078599462
192,1549526400,278,154,0,432,6,-0.518187239772056,-0.3716217576205801
192,1549540800,863,429,0,1292,6,-0.518187239772056,1.4994047278749127
192,1549555200,600,372,0,972,6,-0.518187239772056,0.8032088262951945
192,1549569600,858,613,0,1471,6,-0.518187239772056,1.8888393103210677
192,1549584000,188,400,212,588,6,2.341397007473303,-0.03222625560046743
192,1549598400,33,59,26,92,6,-0.1674835113363044,-1.1113299030490307
192,1549612800,269,168,0,437,6,-0.518187239772056,-0.360743696658397
192,1549627200,828,414,0,1242,6,-0.518187239772056,1.3906241182530819
192,1549641600,703,395,0,1098,6,-0.518187239772056,1.0773359625422085
192,1549656000,935,570,0,1505,6,-0.518187239772056,1.9628101248639127
192,1549670400,356,391,35,747,6,-0.046086066877775014,0.3136960829969551
192,1549684800,42,89,47,131,6,0.11577719240026418,-1.0264810275440026
192,1549699200,71,61,0,132,6,-0.518187239772056,-1.024305415351566
192,1549713600,433,212,0,645,6,-0.518187239772056,0.09178363936841989
192,1549728000,659,343,0,1002,6,-0.518187239772056,0.8684771920682931
192,1549742400,655,404,0,1059,6,-0.518187239772056,0.9924870870371804
192,1549756800,310,347,37,657,6,-0.019108856998101817,0.11789098567765932
192,1549771200,52,87,35,139,6,-0.046086066877775014,-1.0090761300045097
192,1549785600,46,47,1,93,6,-0.5046986348322194,-1.1091542908565941
192,1549800000,374,158,0,532,6,-0.518187239772056,-0.15406053837691813
192,1549814400,514,330,0,844,6,-0.518187239772056,0.5247304656633072
192,1549828800,459,337,0,796,6,-0.518187239772056,0.42030108042634945
192,1549843200,166,213,47,379,6,0.11577719240026418,-0.48692920381972093
192,1549857600,19,16,0,35,6,-0.518187239772056,-1.2353397980179182
192,1549872000,267,134,0,401,6,-0.518187239772056,-0.4390657355861153
192,1549884238,747,145,0,892,6,-0.518187239772056,0.6291598509002649
192,1549884318,3,0,0,3,6,-0.518187239772056,-1.3049593881758899
192,1549886400,158,414,256,572,6,2.9348956248261135,-0.06703605067945334
192,1549900800,527,366,0,893,6,-0.518187239772056,0.6313354630927016
192,1549915200,754,644,0,1398,6,-0.518187239772056,1.7300196202731946
192,1549929600,224,300,76,524,7,1.9492577124431807,-0.36597375161475726
192,1549944000,25,33,8,58,7,-0.3147032581699645,-1.4696468281330977
192,1549958400,259,162,0,421,7,-0.5810516076538639,-0.6099186590855492
192,1549972800,731,374,0,1105,7,-0.5810516076538639,1.0100649982933023
192,1549987200,582,357,0,939,7,-0.5810516076538639,0.6169110697481425
192,1550001600,697,581,0,1278,7,-0.5810516076538639,1.4197977069578365
192,1550016000,224,307,83,531,7,2.182312518241593,-0.349394971495383
192,1550030400,20,33,13,53,7,-0.14823553974252734,-1.4814888139326505
192,1550044800,304,172,0,476,7,-0.5810516076538639,-0.4796568152904661
192,1550059200,830,421,0,1251,7,-0.5810516076538639,1.3558509836402501
192,1550073600,612,403,0,1015,7,-0.5810516076538639,0.7969092539013481
192,1550088000,791,593,0,1384,7,-0.5810516076538639,1.6708478059083602
192,1550102400,286,383,97,669,7,2.6484221298384165,-0.022556163427720002
192,1550116800,25,38,13,63,7,-0.14823553974252734,-1.4578048423335446
192,1550131200,262,154,0,416,7,-0.5810516076538639,-0.6217606448851022
192,1550145600,875,383,0,1258,7,-0.5810516076538639,1.3724297637596243
192,1550160000,637,365,0,1002,7,-0.5810516076538639,0.7661200908225103
192,1550174400,906,562,0,1468,7,-0.5810516076538639,1.8697931673408508
192,1550188800,318,382,64,700,7,1.5497351882173316,0.05086414852950865
192,1550203200,33,74,41,107,7,0.7839836834511206,-1.353595367297478
192,1550217600,278,145,0,423,7,-0.5810516076538639,-0.605181864765728
192,1550232000,812,380,0,1192,7,-0.5810516076538639,1.2161155512055246
192,1550246400,622,355,0,977,7,-0.5810516076538639,0.7069101618247453
192,1550260800,831,539,0,1370,7,-0.5810516076538639,1.6376902456696116
192,1550275200,339,420,81,759,7,2.1157254308706177,0.19059958096423416
192,1550289600,49,113,64,162,7,1.5497351882173316,-1.223333523502395
192,1550304000,64,48,0,112,7,-0.5810516076538639,-1.341753381497925
192,1550318400,412,193,0,605,7,-0.5810516076538639,-0.1741335816619985
192,1550332800,635,312,0,947,7,-0.5810516076538639,0.6358582470274272
192,1550347200,578,409,0,987,7,-0.5810516076538639,0.7305941334238513
192,1550361600,263,301,38,564,7,0.6841030523946583,-0.27123786521833315
192,1550376000,52,84,32,136,7,0.48434179028173374,-1.2849118496600707
192,1550390400,53,47,0,100,7,-0.5810516076538639,-1.3701741474168523
192,1550404800,388,174,0,562,7,-0.5810516076538639,-0.27597465953815437
192,1550419200,587,323,0,910,7,-0.5810516076538639,0.548227552110735
192,1550433600,457,355,0,812,7,-0.5810516076538639,0.316124630439496
192,1550448000,159,250,91,409,7,2.448660867725492,-0.6383394250044764
192,1550462400,23,55,32,78,7,0.48434179028173374,-1.4222788849348855
192,1550476800,92,89,0,181,7,-0.5810516076538639,-1.1783339774640935
192,1550491200,430,288,0,718,7,-0.5810516076538639,0.09349529740789948
192,1550505600,517,295,0,812,7,-0.5810516076538639,0.316124630439496
192,1550520000,566,398,0,964,7,-0.5810516076538639,0.6761209987459075
192,1550534400,185,284,99,469,8,2.120010147094087,-0.6208094262582303
192,1550548800,27,38,11,65,8,-0.22175838358724753,-1.5017355490446787
192,1550563200,208,161,0,369,8,-0.5144794499224143,-0.8388604467499254
192,1550577600,761,383,0,1144,8,-0.5144794499224143,0.8510349620607116
192,1550592000,557,368,0,925,8,-0.5144794499224143,0.37350322718389933
192,1550606400,743,574,0,1317,8,-0.5144794499224143,1.228263227511344
192,1550620800,243,330,87,573,8,1.8006780747284503,-0.39403636494686745
192,1550635200,26,41,15,67,8,-0.11531435946536871,-1.4973745286348445
192,1550649600,205,175,0,380,8,-0.5144794499224143,-0.814874834495839
192,1550664000,801,411,0,1212,8,-0.5144794499224143,0.9993096559950643
192,1550678400,590,373,0,963,8,-0.5144794499224143,0.45636261497074343
192,1550692800,700,604,0,1304,8,-0.5144794499224143,1.1999165948474237
192,1550707200,216,337,121,553,8,2.7054522797644203,-0.43764656904520643
192,1550721600,28,40,12,68,8,-0.19514737755677783,-1.4951940184299277
192,1550736000,228,171,0,399,8,-0.5144794499224143,-0.7734451406024169
192,1550750400,776,378,0,1154,8,-0.5144794499224143,0.8728400641098811
192,1550764800,545,316,0,861,8,-0.5144794499224143,0.23395057406921446
192,1550779200,812,614,0,1426,8,-0.5144794499224143,1.4659388398472917
192,1550793600,292,392,100,684,8,2.1466211531245567,-0.15199973220108587
192,1550808000,33,52,19,85,8,-0.008870335343489872,-1.4581253449463396
192,1550822400,211,144,0,355,8,-0.5144794499224143,-0.8693875896187627
192,1550836800,797,405,0,1202,8,-0.5144794499224143,0.9775045539458947
192,1550851200,691,384,0,1075,8,-0.5144794499224143,0.700579757921442
192,1550865600,836,603,0,1439,8,-0.5144794499224143,1.494285472511212
192,1551484800,4300,7324,3024,11624,9,4.121889495194767,4.084844838065708
192,1551499200,52,84,32,136,9,-0.20908601310103,-0.4023845912009202
192,1551513600,79,54,0,133,9,-0.2554066067726428,-0.4035563955435212
192,1551528000,430,179,0,609,9,-0.2554066067726428,-0.21763010651750142
192,1551542400,631,328,0,959,9,-0.2554066067726428,-0.08091959988072221
192,1551556800,637,372,0,1009,9,-0.2554066067726428,-0.06138952750403946
192,1551571200,280,300,20,580,9,-0.2264562357278848,-0.2289575484959774
192,1551585600,46,95,49,141,9,-0.1844781977129857,-0.4004315839632519
192,1551600000,54,53,0,107,9,-0.2554066067726428,-0.4137120331793962
192,1551614400,373,142,0,515,9,-0.2554066067726428,-0.254346642585665
192,1551628800,547,330,0,877,9,-0.2554066067726428,-0.11294891857848191
192,1551643200,432,376,0,808,9,-0.2554066067726428,-0.1399004184583041
192,1551657600,146,197,51,343,9,-0.18158316060850993,-0.3215300915614536
192,1551672000,22,21,0,43,9,-0.2554066067726428,-0.4387105258215501
192,1551686400,159,109,0,268,9,-0.2554066067726428,-0.3508252001264778
192,1551700800,601,312,0,913,9,-0.2554066067726428,-0.09888726646727033
192,1551715200,474,314,0,788,9,-0.2554066067726428,-0.14771244740897718
192,1551729600,608,530,0,1138,9,-0.2554066067726428,-0.011001940772197976
192,1551744000,214,335,121,549,10,1.8842683627315135,-0.2991470287402779
192,1551758400,18,28,10,46,10,-0.5237522258250424,-1.4020754980539094
192,1551772800,313,147,0,460,10,-0.7406910175868944,-0.4942973940860298
192,1551787200,804,426,0,1230,10,-0.7406910175868944,1.1940821712648575
192,1551801600,581,384,0,965,10,-0.7406910175868944,0.6130164766960458
192,1551816000,779,682,0,1461,10,-0.7406910175868944,1.7005960408701237
192,1551830400,293,375,82,668,10,1.038207074860291,-0.03821564136786799
192,1551844800,20,41,21,61,10,-0.2851195548870054,-1.3691849870405806
192,1551859200,276,161,0,437,10,-0.7406910175868944,-0.5447295109731342
192,1551873600,806,405,0,1211,10,-0.7406910175868944,1.1524208573146408
192,1551888000,584,374,0,958,10,-0.7406910175868944,0.5976675715564922
192,1551902400,855,670,0,1525,10,-0.7406910175868944,1.8409288878603274
192,1551916800,289,366,77,655,10,0.9297376789793651,-0.0667207509127531
192,1551931200,25,40,15,65,10,-0.4152828299441165,-1.3604141841036927
192,1551945600,285,147,0,432,10,-0.7406910175868944,-0.5556930146442438
192,1551960000,838,379,0,1217,10,-0.7406910175868944,1.1655770617199726
192,1551974400,594,395,0,989,10,-0.7406910175868944,0.6656412943173721
192,1551988800,863,639,0,1502,10,-0.7406910175868944,1.790496770973223
192,1552003200,285,399,114,684,10,1.7324112084982173,-0.0031324296203170806
192,1552017600,33,50,17,83,10,-0.3718950715917461,-1.320945570887698
192,1552032000,265,136,0,401,10,-0.7406910175868944,-0.6236667374051237
192,1552046400,866,385,0,1251,10,-0.7406910175868944,1.240128886683518
192,1552060800,700,419,0,1119,10,-0.7406910175868944,0.9506923897662232
192,1552075200,903,602,0,1505,10,-0.7406910175868944,1.7970748731758888
192,1552089600,398,369,0,767,10,-0.7406910175868944,0.17886173132010325
192,1552104000,49,89,40,138,10,0.12706414946051317,-1.2003470305054917
192,1552118400,31,77,46,108,10,0.2572274245176243,-1.2661280525321497
192,1552132800,121,288,167,409,10,2.882186804836032,-0.6061251315313483
192,1552147200,212,323,111,535,10,1.6673295709696616,-0.3298448390193849
192,1552161600,248,372,124,620,10,1.949350000260069,-0.14346527661052072
192,1552176000,264,326,62,590,10,0.6043294913365873,-0.20924629863717867
192,1552194000,55,107,52,162,10,0.38739069957473543,-1.1477222128841653
192,1552208400,31,85,54,116,10,0.4307784579271058,-1.2485864466583743
192,1552222800,180,219,39,399,10,0.105370270284328,-0.6280521388735676
192,1552237200,209,310,101,519,10,1.4503907792078097,-0.3649280507669358
192,1552251600,175,294,119,469,10,1.840880604379143,-0.4745630874780324
192,1552266000,121,164,43,285,10,0.19214578698906873,-0.8780200225748678
192,1552280400,16,15,0,31,10,-0.7406910175868944,-1.4349660090672385
192,1552294800,641,322,0,963,10,-0.7406910175868944,0.6086310752276018
192,1552309200,558,354,0,912,10,-0.7406910175868944,0.49680333778228336
192,1552323600,629,441,0,1070,10,-0.7406910175868944,0.8432500537893486
192,1552338000,601,620,19,1221,10,-0.32850731323937576,1.1743478646568601
192,1552352400,176,198,22,374,11,0.2261199239219156,-0.7639062659418694
192,1552366800,19,13,0,32,11,-0.444442609087903,-1.5698468317601584
192,1552381200,617,340,0,957,11,-0.444442609087903,0.609963178128489
192,1552395600,593,320,0,913,11,-0.444442609087903,0.5062749181986507
192,1552410000,699,432,0,1131,11,-0.444442609087903,1.020003115123759
192,1552424400,677,659,0,1336,11,-0.444442609087903,1.503096144342324
192,1552438800,177,235,58,412,11,1.3234040688470734,-0.6743573141842817
192,1552453200,16,22,6,38,11,-0.2615619182670434,-1.5557075235879076
192,1552467600,645,294,0,939,11,-0.444442609087903,0.5675452536117369
192,1552482000,599,317,0,916,11,-0.444442609087903,0.5133445722847759
192,1552496400,709,489,0,1198,11,-0.444442609087903,1.1778920563805582
192,1552510800,770,680,0,1450,11,-0.444442609087903,1.771742999615087
192,1552525200,259,94,0,353,11,-0.444442609087903,-0.8133938445447467
192,1552539600,162,272,110,434,11,2.90837005596119,-0.6225131842193625
192,1552552184,428,134,0,562,11,-0.444442609087903,-0.3208746098780145
192,1552554000,183,308,125,491,11,3.365571783013339,-0.48818975658298097
192,1552568400,594,359,0,953,11,-0.444442609087903,0.6005369726803218
192,1552582800,797,383,0,1180,11,-0.444442609087903,1.1354741318638062
192,1552597200,757,558,0,1315,11,-0.444442609087903,1.4536085657394466
192,1552611600,194,287,93,481,11,2.390208098635421,-0.5117552702033987
192,1552626000,22,26,4,48,11,-0.32252214854066324,-1.5321420099674898
192,1552640400,589,307,0,896,11,-0.444442609087903,0.46621354504394036
192,1552654800,619,319,0,938,11,-0.444442609087903,0.5651887022496952
192,1552669200,850,432,0,1282,11,-0.444442609087903,1.3758423707920677
192,1552683600,708,553,0,1261,11,-0.444442609087903,1.3263547921891905
192,1552698000,222,263,41,485,11,0.8052421115213044,-0.5023290647552316
192,1552712400,21,38,17,59,11,0.07371934823786591,-1.5062199449850304
192,1552726800,145,79,0,224,11,-0.444442609087903,-1.1173889702481365
192,1552741200,525,184,0,709,11,-0.444442609087903,0.025538440342127294
192,1552755600,635,289,0,924,11,-0.444442609087903,0.5321969831811102
192,1552770000,478,298,0,776,11,-0.444442609087903,0.18342738159892663
192,1552784400,226,233,7,459,11,-0.23108180313023347,-0.563599400168318
192,1552798800,31,43,12,74,11,-0.07868122744618376,-1.4708716745544037
192,1552813200,94,64,0,158,11,-0.444442609087903,-1.272921360142894
192,1552827600,412,155,0,567,11,-0.444442609087903,-0.3090918530678056
192,1552842000,452,245,0,697,11,-0.444442609087903,-0.0027401760023740766
192,1552856400,303,246,0,549,11,-0.444442609087903,-0.35150977758455765
192,1552870800,116,130,14,246,11,-0.017720997172563892,-1.0655448402832173
192,1552885200,16,21,5,37,11,-0.2920420334038533,-1.5580640749499495
192,1552899600,505,255,0,760,11,-0.444442609087903,0.14572255980625812
192,1552914000,577,282,0,859,11,-0.444442609087903,0.3790211446483944
192,1552928400,1055,374,0,1429,11,-0.444442609087903,1.7222554210122096
192,1552942800,503,616,113,1119,11,2.99981040137162,0.9917244987792575
192,1552957200,162,140,0,302,12,-0.4875130174696473,-0.868079386610817
192,1552971600,21,21,0,42,12,-0.4875130174696473,-1.5333490126751106
192,1552986000,592,232,0,824,12,-0.4875130174696473,0.4675773241798033
192,1553000400,571,316,0,887,12,-0.4875130174696473,0.6287772720338437
192,1553014800,608,406,0,1014,12,-0.4875130174696473,0.9537358970729409
192,1553029200,598,623,25,1221,12,0.9265440774008766,1.4833928685933593
192,1553043600,185,127,0,312,12,-0.4875130174696473,-0.8424920933006518
192,1553058000,18,26,8,44,12,-0.035014747111079624,-1.5282315540130775
192,1553072400,569,263,0,832,12,-0.4875130174696473,0.4880471588279354
192,1553086800,582,330,0,912,12,-0.4875130174696473,0.6927455053092565
192,1553101200,666,427,0,1093,12,-0.4875130174696473,1.1558755142232455
192,1553115600,568,638,70,1206,12,3.47184684816782,1.4450119286281116
192,1553130000,188,155,0,343,12,-0.4875130174696473,-0.7631714840391399
192,1553144400,12,27,15,39,12,0.36092123945266713,-1.5410252006681602
192,1553158800,509,253,0,762,12,-0.4875130174696473,0.3089361056567794
192,1553173200,533,304,0,837,12,-0.4875130174696473,0.500840805483018
192,1553187600,637,415,0,1052,12,-0.4875130174696473,1.0509676116515685
192,1553202000,592,615,23,1207,12,0.8134195098112349,1.447570657959128
192,1553216400,206,144,0,350,12,-0.4875130174696473,-0.7452603787220243
192,1553230800,16,39,23,55,12,0.8134195098112349,-1.500085531371896
192,1553245200,481,218,0,699,12,-0.4875130174696473,0.14773615780273905
192,1553259600,569,337,0,906,12,-0.4875130174696473,0.6773931293231574
192,1553274000,650,429,0,1079,12,-0.4875130174696473,1.1200533035890143
192,1553288400,627,600,0,1227,12,-0.4875130174696473,1.4987452445794585
192,1553302800,215,240,25,455,12,0.9265440774008766,-0.47659379896529036
192,1553317200,23,37,14,60,12,0.30435895565784615,-1.4872918847168133
192,1553331600,120,95,0,215,12,-0.4875130174696473,-1.0906888384092537
192,1553346000,420,197,0,617,12,-0.4875130174696473,-0.06207964734061508
192,1553360400,544,291,0,835,12,-0.4875130174696473,0.49572334682098496
192,1553374800,477,321,0,798,12,-0.4875130174696473,0.4010503615733739
192,1553389200,203,213,10,416,12,0.07810982047856231,-0.5763842428749344
192,1553403600,24,47,23,71,12,0.8134195098112349,-1.4591458620756317
192,1553418000,81,60,0,141,12,-0.4875130174696473,-1.2800348089044757
192,1553432400,434,151,0,585,12,-0.4875130174696473,-0.14395898593314352
192,1553446800,544,273,0,817,12,-0.4875130174696473,0.4496662188626877
192,1553461200,311,298,0,609,12,-0.4875130174696473,-0.08254948198874719
192,1553475600,108,163,55,271,12,2.6234125912455055,-0.9473999958723289
192,1553490000,14,15,1,29,12,-0.4309507336748264,-1.5666124939783252
192,1553504400,542,245,0,787,12,-0.4875130174696473,0.37290433893219227
192,1553518800,525,296,0,821,12,-0.4875130174696473,0.45990113618675377
192,1553533200,601,394,0,995,12,-0.4875130174696473,0.9051200397836272
192,1553547600,548,618,70,1166,12,3.47184684816782,1.342662755387451
192,1553562000,110,227,117,337,13,1.9543726227745868,-0.9002041846124049
192,1553576400,16,26,10,42,13,-0.2579574947944291,-1.6353917033882073
192,1553590800,574,231,0,805,13,-0.46471731886629974,0.2661272011064952
192,1553605200,568,341,0,909,13,-0.46471731886629974,0.525311953488473
192,1553619600,685,369,0,1054,13,-0.46471731886629974,0.8866753101748843
192,1553634000,634,578,0,1212,13,-0.46471731886629974,1.280436760909043
192,1553648400,140,277,137,417,13,2.367892270918328,-0.7008312981647297
192,1553662800,15,30,15,45,13,-0.15457758275849373,-1.6279152201464195
192,1553677200,566,281,0,847,13,-0.46471731886629974,0.3707979664915247
192,1553691600,548,344,0,892,13,-0.46471731886629974,0.482945215118342
192,1553706000,672,411,0,1083,13,-0.46471731886629974,0.9589479815121666
192,1553720400,671,642,0,1313,13,-0.46471731886629974,1.532145030049233
192,1553734800,152,311,159,463,13,2.8227638838764437,-0.5861918884573164
192,1553749200,16,32,16,48,13,-0.1339016003513067,-1.6204387369046318
192,1553763600,565,254,0,819,13,-0.46471731886629974,0.30101745623483833
192,1553778000,558,366,0,924,13,-0.46471731886629974,0.5626943696974122
192,1553792400,684,394,0,1078,13,-0.46471731886629974,0.946487176109187
192,1553806800,642,539,0,1181,13,-0.46471731886629974,1.2031797674105689
192,1553821200,156,338,182,494,13,3.2983114792417463,-0.5089348949588423
192,1553835600,20,23,3,43,13,-0.40268937164473856,-1.6328995423076114
192,1553850000,555,244,0,799,13,-0.46471731886629974,0.25117423462291955
192,1553864400,617,332,0,949,13,-0.46471731886629974,0.6249983967123106
192,1553878800,799,422,0,1221,13,-0.46471731886629974,1.3028662106344064
192,1553893200,767,528,0,1295,13,-0.46471731886629974,1.487286130598506
192,1553907600,208,349,141,557,13,2.4505962005470763,-0.35192874688129805
192,1553922000,21,55,34,76,13,0.2382660829780605,-1.5506582266479454
192,1553936400,132,84,0,216,13,-0.46471731886629974,-1.2017556753645138
192,1553950800,518,221,0,739,13,-0.46471731886629974,0.10164456978716312
192,1553965200,649,297,0,946,13,-0.46471731886629974,0.6175219134705228
192,1553979600,605,343,0,948,13,-0.46471731886629974,0.6225062356317147
192,1553994000,290,302,12,592,13,-0.21660552998005494,-0.26470310906044014
192,1554008400,29,80,51,109,13,0.5897577839002406,-1.4684169109882794
192,1554022800,114,64,0,178,13,-0.46471731886629974,-1.2964577964271595
192,1554037200,482,194,0,676,13,-0.46471731886629974,-0.055361578290381123
192,1554051600,516,338,0,854,13,-0.46471731886629974,0.3882430940556963
192,1554066000,381,339,0,720,13,-0.46471731886629974,0.054293509255840255
192,1554080400,111,176,65,287,13,0.8792215376008595,-1.024812238642202
192,1554094800,17,19,2,36,13,-0.4233653540519256,-1.650344669871783
192,1554109200,628,276,0,904,13,-0.46471731886629974,0.5128511480854933
192,1554123600,527,326,0,853,13,-0.46471731886629974,0.3857509329751003
192,1554138000,678,443,0,1121,13,-0.46471731886629974,1.0536501025748124
192,1554152400,629,614,0,1243,13,-0.46471731886629974,1.3576937544075172
192,1554166800,187,137,0,324,14,-0.39787804868059523,-0.9142537473637854
192,1554181200,15,24,9,39,14,0.14507466756945894,-1.5352739128356112
192,1554195600,669,310,0,979,14,-0.39787804868059523,0.5130031241591824
192,1554210000,505,277,0,782,14,-0.39787804868059523,0.08373655364006075
192,1554224400,729,442,0,1171,14,-0.39787804868059523,0.9313746040559913
192,1554238800,652,686,34,1338,14,1.6532766571529427,1.2952706308412365
192,1554253200,209,127,0,336,14,-0.39787804868059523,-0.8881055298702349
192,1554267600,18,24,6,42,14,-0.03590957118055912,-1.5287368584622234
192,1554282000,656,335,0,991,14,-0.39787804868059523,0.5391513416527329
192,1554296400,572,313,0,885,14,-0.39787804868059523,0.30817542045970303
192,1554310800,737,464,0,1201,14,-0.39787804868059523,0.9967451477898677
192,1554325200,704,662,0,1366,14,-0.39787804868059523,1.3562831383261877
192,1554339600,228,126,0,354,14,-0.39787804868059523,-0.8488832036299091
192,1554354000,21,21,0,42,14,-0.39787804868059523,-1.5287368584622234
192,1554368400,645,300,0,945,14,-0.39787804868059523,0.4389165079274558
192,1554382800,579,364,0,943,14,-0.39787804868059523,0.4345584716785307
192,1554397200,739,444,0,1183,14,-0.39787804868059523,0.9575228215495418
192,1554411600,858,710,0,1568,14,-0.39787804868059523,1.796444799467622
192,1554426000,402,145,0,547,14,-0.39787804868059523,-0.4283327056086376
192,1554440400,28,25,0,53,14,-0.39787804868059523,-1.5047676590931356
192,1554454800,982,312,0,1294,14,-0.39787804868059523,1.1993938333648844
192,1554469200,910,311,0,1221,14,-0.39787804868059523,1.0403255102791185
192,1554483600,849,493,0,1342,14,-0.39787804868059523,1.3039867033390866
192,1554498000,836,591,0,1427,14,-0.39787804868059523,1.489203243918403
192,1554512400,246,330,84,576,14,4.66968063631991,-0.3651411799992238
192,1554526800,20,42,22,62,14,0.9293397021528705,-1.4851564959729726
192,1554541200,148,98,0,246,14,-0.39787804868059523,-1.084217161071864
192,1554555600,557,239,0,796,14,-0.39787804868059523,0.1142428073825364
192,1554570000,643,310,0,953,14,-0.39787804868059523,0.45634865292315613
192,1554584400,604,338,0,942,14,-0.39787804868059523,0.43237945355406815
192,1554598800,233,274,41,507,14,2.0755732142363184,-0.5154934305871395
192,1554613200,30,58,28,88,14,1.2913081796529067,-1.4285020247369464
192,1554627600,105,57,0,162,14,-0.39787804868059523,-1.267254683526718
192,1554642000,429,185,0,614,14,-0.39787804868059523,-0.28233849126964705
192,1554656400,517,329,0,846,14,-0.39787804868059523,0.2231937136056637
192,1554670800,356,296,0,652,14,-0.39787804868059523,-0.19953580254007028
192,1554685200,129,174,45,303,14,2.3168855325696756,-0.9600131279774989
192,1554699600,14,22,8,36,14,0.08474658798611959,-1.5418109672089988
192,1554714000,609,305,0,914,14,-0.39787804868059523,0.37136694606911685
192,1554728400,553,294,0,847,14,-0.39787804868059523,0.22537273173012626
192,1554742800,687,386,0,1073,14,-0.39787804868059523,0.7178308278586617
192,1554757200,630,610,0,1240,14,-0.39787804868059523,1.081726854643907
192,1554771600,145,245,100,390,15,2.8622073498040925,-0.7806134714420012
192,1554786000,7,15,8,22,15,-0.19207853797359695,-1.6512413986037542
192,1554800400,655,313,0,968,15,-0.4576686151716569,0.5868401750240128
192,1554814800,539,310,0,849,15,-0.4576686151716569,0.30530560075159807
192,1554829200,740,390,0,1130,15,-0.4576686151716569,0.9701057299158713
192,1554843600,676,660,0,1336,15,-0.4576686151716569,1.4574681021857656
192,1554858000,174,267,93,441,15,2.62981603225579,-0.6599557967538235
192,1554872400,9,24,15,33,15,0.040312779574705505,-1.6252171942592453
192,1554886800,640,302,0,942,15,-0.4576686151716569,0.525328419300628
192,1554901200,573,311,0,884,15,-0.4576686151716569,0.3881098873023083
192,1554915600,708,389,0,1097,15,-0.4576686151716569,0.8920331168823445
192,1554930000,696,575,0,1271,15,-0.4576686151716569,1.3036887128773038
192,1554944400,188,290,102,478,15,2.9286048691036073,-0.5724198366859299
192,1554958800,16,26,10,42,15,-0.12568101867408196,-1.6039246634319198
192,1554973200,663,296,0,959,15,-0.4576686151716569,0.5655476441966872
192,1554987600,567,321,0,888,15,-0.4576686151716569,0.3975732343366752
192,1555002000,754,432,0,1186,15,-0.4576686151716569,1.1025925883970076
192,1555016400,733,590,0,1323,15,-0.4576686151716569,1.4267122243240733
192,1555030800,215,320,105,535,15,3.02820114805288,-0.4375671414462019
192,1555045200,19,30,11,49,15,-0.09248225902432447,-1.5873638061217776
192,1555059600,641,277,0,918,15,-0.4576686151716569,0.4685483370944267
192,1555074000,642,317,0,959,15,-0.4576686151716569,0.5655476441966872
192,1555088400,799,449,0,1248,15,-0.4576686151716569,1.2492744674296943
192,1555102800,775,607,0,1382,15,-0.4576686151716569,1.5662965930809847
192,1555117200,252,295,43,547,15,0.9698780497679154,-0.4091771003431013
192,1555131600,28,35,7,63,15,-0.22527729762335444,-1.5542420915014936
192,1555146000,167,86,0,253,15,-0.4576686151716569,-1.104733107369067
192,1555160400,522,194,0,716,15,-0.4576686151716569,-0.009350688141100632
192,1555174800,636,309,0,945,15,-0.4576686151716569,0.5324259295764032
192,1555189200,597,376,0,973,15,-0.4576686151716569,0.5986693588169714
192,1555203600,211,266,55,477,15,1.3682631655650053,-0.5747856734445217
192,1555218000,31,38,7,69,15,-0.22527729762335444,-1.5400470709499432
192,1555232400,94,72,0,166,15,-0.4576686151716569,-1.3105609053665466
192,1555246800,485,208,0,693,15,-0.4576686151716569,-0.06376493358871019
192,1555261200,542,320,0,862,15,-0.4576686151716569,0.33606147861329044
192,1555275600,357,333,0,690,15,-0.4576686151716569,-0.07086244386448534
192,1555290000,131,154,23,285,15,0.30590285677276546,-1.0290263310941319
192,1555304400,17,14,0,31,15,-0.4576686151716569,-1.6299488677764287
192,1555318800,633,289,0,922,15,-0.4576686151716569,0.47801168412879363
192,1555333200,566,333,0,899,15,-0.4576686151716569,0.4235974386811841
192,1555347600,728,410,0,1138,15,-0.4576686151716569,0.9890324239846051
192,1555362000,591,588,0,1179,15,-0.4576686151716569,1.0860317310868657
192,1555376400,158,214,56,372,16,1.7428652743838382,-0.7898828368933015
192,1555390800,19,19,0,38,16,-0.48255227466653494,-1.6055233548130095
192,1555405200,697,296,0,993,16,-0.48255227466653494,0.7266224374424429
192,1555419600,615,331,0,946,16,-0.48255227466653494,0.6118466759387715
192,1555434000,706,431,0,1137,16,-0.48255227466653494,1.078275834389862
192,1555448400,675,667,0,1342,16,-0.48255227466653494,1.5788935175441738
192,1555462800,208,269,61,477,16,1.9415632698347642,-0.5334689016191417
192,1555477200,15,23,8,38,16,-0.16463548194505306,-1.6055233548130095
192,1555491600,670,329,0,999,16,-0.48255227466653494,0.7412746623152521
192,1555506000,633,306,0,939,16,-0.48255227466653494,0.5947524135871608
192,1555520400,758,428,0,1186,16,-0.48255227466653494,1.1979356708511364
192,1555534800,747,612,0,1359,16,-0.48255227466653494,1.6204081546837996
192,1555549200,191,291,100,482,16,3.4914076343519884,-0.5212587142251341
192,1555563600,15,28,13,43,16,0.034062513505873075,-1.5933131674190018
192,1555578000,643,307,0,950,16,-0.48255227466653494,0.6216148258539775
192,1555592400,656,329,0,985,16,-0.48255227466653494,0.7070861376120308
192,1555606800,760,460,0,1220,16,-0.48255227466653494,1.2809649451303882
192,1555621200,723,588,0,1311,16,-0.48255227466653494,1.5031903557013266
192,1555635600,241,345,104,586,16,3.6503660307127292,-0.26728681642977603
192,1555650000,19,27,8,46,16,-0.16463548194505306,-1.5859870549825972
192,1555664400,345,191,0,536,16,-0.48255227466653494,-0.3893886903698521
192,1555678800,596,300,0,896,16,-0.48255227466653494,0.48974480199869547
192,1555693200,647,387,0,1034,16,-0.48255227466653494,0.8267459740733053
192,1555707600,641,471,0,1112,16,-0.48255227466653494,1.017224897419824
192,1555722000,244,276,32,520,16,0.7891148962193925,-0.4284612900306764
192,1555736400,29,47,18,76,16,0.23276050895679923,-1.5127259306185517
192,1555750800,112,74,0,186,16,-0.48255227466653494,-1.2441018079503843
192,1555765200,499,216,0,715,16,-0.48255227466653494,0.047736018335620176
192,1555779600,610,303,0,913,16,-0.48255227466653494,0.5312594391383213
192,1555794000,497,340,0,837,16,-0.48255227466653494,0.3456645907494057
192,1555808400,245,271,26,516,16,0.5506773016782811,-0.4382294399458825
192,1555822800,34,47,13,81,16,0.034062513505873075,-1.500515743224544
192,1555837200,106,71,0,177,16,-0.48255227466653494,-1.266080145259598
192,1555851600,435,213,0,648,16,-0.48255227466653494,-0.11588049274408171
192,1555866000,532,269,0,801,16,-0.48255227466653494,0.25775124151255097
192,1555880400,343,277,0,620,16,-0.48255227466653494,-0.1842575421505243
192,1555894800,121,168,47,289,16,1.3852088825721711,-0.9925719476338277
192,1555909200,17,21,4,38,16,-0.323593878305794,-1.6055233548130095
192,1555923600,491,261,0,752,16,-0.48255227466653494,0.13809140505127646
192,1555938000,546,312,0,858,16,-0.48255227466653494,0.39694737780423767
192,1555952400,615,394,0,1009,16,-0.48255227466653494,0.7656950371032673
192,1555966800,563,583,20,1146,16,0.3122397071371697,1.1002541716990757
192,1555981200,149,230,81,379,17,2.0164702220835102,-0.763314958250317
192,1555995600,16,20,4,36,17,-0.3228895905718865,-1.6227799799492197
192,1556010000,524,286,0,810,17,-0.4444147756448941,0.3166542089573421
192,1556024400,555,328,0,883,17,-0.4444147756448941,0.49957242057256046
192,1556038800,675,375,0,1050,17,-0.4444147756448941,0.9180291512539505
192,1556053200,699,681,0,1380,17,-0.4444147756448941,1.7449196969117868
192,1556067600,189,257,68,446,17,1.6215133705962355,-0.5954311201925139
192,1556082000,17,15,0,32,17,-0.4444147756448941,-1.6328028956541634
192,1556096400,559,320,0,879,17,-0.4444147756448941,0.489549504867617
192,1556110800,579,321,0,900,17,-0.4444147756448941,0.5421698123185702
192,1556125200,651,404,0,1055,17,-0.4444147756448941,0.9305577958851298
192,1556139600,653,562,0,1215,17,-0.4444147756448941,1.3314744240828686
192,1556154000,186,251,65,437,17,1.5303694817914797,-0.6179826805286367
192,1556168400,19,20,1,39,17,-0.41403347937664225,-1.6152627931705121
192,1556182800,545,308,0,853,17,-0.4444147756448941,0.42440055278548444
192,1556197200,672,349,0,1021,17,-0.4444147756448941,0.8453630123931103
192,1556211600,757,351,0,1108,17,-0.4444147756448941,1.0633614289756308
192,1556226000,702,538,0,1240,17,-0.4444147756448941,1.3941176472387653
192,1556240400,192,280,88,472,17,2.2291392959612737,-0.5302821681103813
192,1556254800,26,44,18,70,17,0.10244855718364017,-1.5375851964572003
192,1556269200,495,244,0,739,17,-0.4444147756448941,0.13874745519459547
192,1556283600,634,352,0,986,17,-0.4444147756448941,0.7576624999748549
192,1556298000,680,351,0,1031,17,-0.4444147756448941,0.8704203016554689
192,1556312400,705,535,0,1240,17,-0.4444147756448941,1.3941176472387653
192,1556326800,229,296,67,525,17,1.5911320743279835,-0.3974785350198803
192,1556341200,34,51,17,85,17,0.07206726091538826,-1.4999992625636622
192,1556355600,140,92,0,232,17,-0.4444147756448941,-1.1316571104069897
192,1556370000,527,216,0,743,17,-0.4444147756448941,0.14877037089953893
192,1556384400,628,344,0,972,17,-0.4444147756448941,0.7225822950075528
192,1556398800,519,338,0,857,17,-0.4444147756448941,0.4344234684904279
192,1556413200,256,264,8,520,17,-0.20136440549887888,-0.41000717965105965
192,1556427600,31,54,23,85,17,0.2543550385248997,-1.4999992625636622
192,1556442000,107,56,0,163,17,-0.4444147756448941,-1.3045524063172647
192,1556456400,445,233,0,678,17,-0.4444147756448941,-0.014102009305792487
192,1556470800,541,244,0,785,17,-0.4444147756448941,0.2540109858014454
192,1556485200,376,347,0,723,17,-0.4444147756448941,0.09865579237482158
192,1556499600,140,166,26,306,17,0.3454989273296554,-0.9462331698655354
192,1556514000,20,21,1,41,17,-0.41403347937664225,-1.6102513353180405
192,1556526933,491,142,0,633,17,-0.4444147756448941,-0.12685981098640656
192,1556528400,143,305,162,448,17,4.477355219811915,-0.5904196623400422
192,1556542800,533,303,0,836,17,-0.4444147756448941,0.3818031610394747
192,1556557200,711,446,0,1157,17,-0.4444147756448941,1.1861421463611883
192,1556571600,660,646,0,1306,17,-0.4444147756448941,1.5594957563703327
192,1556586000,183,229,46,412,18,1.6959469848192352,-0.7238934553027099
192,1556600400,17,22,5,39,18,-0.20536858019295431,-1.5792649193826809
192,1556614800,686,326,0,1012,18,-0.43723633202370915,0.6520391946918814
192,1556629200,558,379,0,937,18,-0.43723633202370915,0.48004761344255753
192,1556643600,703,444,0,1147,18,-0.43723633202370915,0.9616240409406644
192,1556658000,729,658,0,1387,18,-0.43723633202370915,1.5119971009385011
192,1556672400,184,259,75,443,18,3.040779945437613,-0.652803601719656
192,1556686800,13,22,9,35,18,-0.019874378728350427,-1.588437803715978
192,1556701200,619,368,0,987,18,-0.43723633202370915,0.5947086676087735
192,1556715600,599,323,0,922,18,-0.43723633202370915,0.44564929719269275
192,1556730000,742,532,0,1274,18,-0.43723633202370915,1.252863118522853
192,1556744400,731,614,0,1345,18,-0.43723633202370915,1.4156818154388797
192,1556758800,190,274,84,464,18,3.458141898732972,-0.6046459589698453
192,1556773200,17,17,0,34,18,-0.43723633202370915,-1.5907310247993025
192,1556787600,635,279,0,914,18,-0.43723633202370915,0.4273035285260982
192,1556802000,624,329,0,953,18,-0.43723633202370915,0.5167391507757466
192,1556816400,708,415,0,1123,18,-0.43723633202370915,0.9065867349408808
192,1556830800,793,645,0,1438,18,-0.43723633202370915,1.6289513761880412
192,1556845200,213,283,70,496,18,2.8089121936068584,-0.5312628843034671
192,1556859600,18,26,8,44,18,-0.06624792909450139,-1.5677988139660592
192,1556874000,613,326,0,939,18,-0.43723633202370915,0.48463405560920614
192,1556888400,664,323,0,987,18,-0.43723633202370915,0.5947086676087735
192,1556902800,787,420,0,1207,18,-0.43723633202370915,1.0992173059401236
192,1556917200,782,579,0,1361,18,-0.43723633202370915,1.4523733527720688
192,1556931600,262,263,1,525,18,-0.39086278165755817,-0.4647594728870619
192,1556946000,22,45,23,67,18,0.6293553263977631,-1.5150547290496
192,1556960400,137,88,0,225,18,-0.43723633202370915,-1.1527257978843575
192,1556974800,513,184,0,697,18,-0.43723633202370915,-0.07032544655527903
192,1556989200,576,271,0,847,18,-0.43723633202370915,0.2736577159433688
192,1557003600,581,329,0,910,18,-0.43723633202370915,0.4181306441928009
192,1557018000,230,275,45,505,18,1.6495734344530844,-0.5106238945535483
192,1557032400,24,53,29,77,18,0.9075966285946688,-1.4921225182163567
192,1557046800,96,70,0,166,18,-0.43723633202370915,-1.2880258418004924
192,1557061200,450,188,0,638,18,-0.43723633202370915,-0.20562549047141385
192,1557075600,533,281,0,814,18,-0.43723633202370915,0.1979814201936663
192,1557090000,338,313,0,651,18,-0.43723633202370915,-0.1758136163881977
192,1557104400,153,139,0,292,18,-0.43723633202370915,-0.9990799853016282
192,1557118800,17,18,1,35,18,-0.39086278165755817,-1.588437803715978
192,1557133200,643,320,0,963,18,-0.43723633202370915,0.5396713616089898
192,1557147600,536,335,0,871,18,-0.43723633202370915,0.3286950219431525
192,1557162000,711,406,0,1117,18,-0.43723633202370915,0.8928274084409349
192,1557176400,644,618,0,1262,18,-0.43723633202370915,1.2253444655229613
192,1557190800,184,257,73,441,19,1.7785144539164133,-0.6574584675244622
192,1557205200,133,41,0,174,19,-0.47569196018351356,-1.3007478187869455
192,1557219600,667,287,0,954,19,-0.47569196018351356,0.5785244433281739
192,1557234000,609,341,0,950,19,-0.47569196018351356,0.5688871496763015
192,1557248400,679,424,0,1103,19,-0.47569196018351356,0.937513631860421
192,1557262800,678,631,0,1309,19,-0.47569196018351356,1.43383425493185
192,1557277200,198,276,78,474,19,1.9329121535122986,-0.5779507948965149
192,1557291600,17,23,6,40,19,-0.2904147206684511,-1.623597156124671
192,1557306000,660,321,0,981,19,-0.47569196018351356,0.6435761754783126
192,1557320400,611,359,0,970,19,-0.47569196018351356,0.6170736179356635
192,1557334800,727,461,0,1188,19,-0.47569196018351356,1.1423061219627098
192,1557349200,676,668,0,1344,19,-0.47569196018351356,1.5181605743857336
192,1557363600,179,287,108,466,19,2.8592983510876113,-0.5972253822002598
192,1557378000,19,18,0,37,19,-0.47569196018351356,-1.6308251263635754
192,1557392400,616,309,0,925,19,-0.47569196018351356,0.5086540643520989
192,1557406800,629,316,0,945,19,-0.47569196018351356,0.5568405326114609
192,1557421200,739,430,0,1169,19,-0.47569196018351356,1.0965289771163158
192,1557435600,722,596,0,1318,19,-0.47569196018351356,1.455518165648563
192,1557450000,172,290,118,462,19,3.168093750279382,-0.6068626758521322
192,1557464400,19,25,6,44,19,-0.2904147206684511,-1.6139598624727987
192,1557478800,606,249,0,855,19,-0.47569196018351356,0.3400014254443318
192,1557493200,633,336,0,969,19,-0.47569196018351356,0.6146642945226953
192,1557507600,718,409,0,1127,19,-0.47569196018351356,0.9953373937716554
192,1557522000,749,553,0,1302,19,-0.47569196018351356,1.4169689910410732
192,1557536400,268,312,44,580,19,0.8830077962602779,-0.32256251312189615
192,1557550800,35,42,7,77,19,-0.259535180749274,-1.5344521898448513
192,1557565200,139,98,0,237,19,-0.47569196018351356,-1.148960443769955
192,1557579600,524,197,0,721,19,-0.47569196018351356,0.01715208810660618
192,1557594000,556,307,0,863,19,-0.47569196018351356,0.35927601274807663
192,1557608400,512,345,0,857,19,-0.47569196018351356,0.344820072270268
192,1557622800,176,276,100,452,19,2.6122620317341947,-0.6309559099818132
192,1557637200,23,38,15,61,19,-0.012498861395857399,-1.5730013644523408
192,1557651600,91,81,0,172,19,-0.47569196018351356,-1.3055664656128816
192,1557666000,387,209,0,596,19,-0.47569196018351356,-0.2840133385144065
192,1557680400,452,287,0,739,19,-0.47569196018351356,0.06051990954003201
192,1557694800,300,291,0,591,19,-0.47569196018351356,-0.296059955579247
192,1557709200,104,168,64,272,19,1.5005985946438194,-1.0646341243160715
192,1557723600,14,17,3,31,19,-0.3830533404259823,-1.645281066841384
192,1557738000,640,319,0,959,19,-0.47569196018351356,0.5905710603930143
192,1557752400,569,330,0,899,19,-0.47569196018351356,0.4460116556149283
192,1557766800,683,445,0,1128,19,-0.47569196018351356,0.9977467171846236
192,1557781200,588,613,25,1201,19,0.29629653779591336,1.173627326331295
192,1557795600,159,234,75,393,20,1.180921404134495,-0.7697817979084336
192,1557810000,11,21,10,32,20,-0.423814998696352,-1.6312692218741607
192,1557824400,635,293,0,928,20,-0.6706975222087901,0.5069377916252616
192,1557838800,277,367,90,644,20,1.5512451894031523,-0.1707974671178588
192,1557853200,504,503,0,1007,20,-0.6706975222087901,0.6954627403601438
192,1557867600,722,640,0,1362,20,-0.6706975222087901,1.5426318137890442
192,1557882000,190,299,109,489,20,2.0203219840767845,-0.5406881893192097
192,1557896400,14,16,2,30,20,-0.6213210175063024,-1.6360420053864362
192,1557910800,628,339,0,967,20,-0.6706975222087901,0.6000070701146338
192,1557925200,304,345,41,649,20,0.3415208241922059,-0.15886550833717006
192,1557939600,452,466,14,918,20,-0.3250619892913768,0.4830738740638842
192,1557954000,752,639,0,1391,20,-0.6706975222087901,1.611837174717039
192,1557968400,182,307,125,489,20,2.4153340216966854,-0.5406881893192097
192,1557982800,22,29,7,51,20,-0.4978797557500834,-1.5859277785075434
192,1557997200,652,321,0,973,20,-0.6706975222087901,0.6143254206514603
192,1558011600,280,315,35,595,20,0.1933913100847431,-0.28773066316860846
192,1558026000,459,511,52,970,20,0.6130916000558878,0.6071662453830471
192,1558040400,766,621,0,1387,20,-0.6706975222087901,1.602291607692488
192,1558054800,213,334,121,547,20,2.31658101229171,-0.40227746746322035
192,1558069200,29,45,16,74,20,-0.2756854845888892,-1.5310407681163751
192,1558083600,583,297,0,880,20,-0.6706975222087901,0.39239098733064975
192,1558098000,274,374,100,648,20,1.7981277129155904,-0.16125190009330778
192,1558112400,390,459,69,849,20,1.0327918900270323,0.3184128428903796
192,1558126800,832,549,0,1381,20,-0.6706975222087901,1.5879732571556615
192,1558141200,253,340,87,593,20,1.4771804323494209,-0.29250344668088396
192,1558155600,27,52,25,79,20,-0.05349121342769494,-1.5191088093356864
192,1558170000,189,112,0,301,20,-0.6706975222087901,-0.9893298394731064
192,1558184400,545,241,0,786,20,-0.6706975222087901,0.16807016225370144
192,1558198800,734,325,0,1059,20,-0.6706975222087901,0.8195551116793066
192,1558213200,645,304,0,949,20,-0.6706975222087901,0.5570520185041544
192,1558227600,250,367,117,617,20,2.2178280028867348,-0.235230044533578
192,1558242000,24,57,33,81,20,0.1440148053822555,-1.5143360258234109
192,1558256400,133,68,0,201,20,-0.6706975222087901,-1.2279690150868812
192,1558270800,630,207,0,837,20,-0.6706975222087901,0.28977614181672656
192,1558285200,677,316,0,993,20,-0.6706975222087901,0.6620532557742153
192,1558299600,420,354,0,774,20,-0.6706975222087901,0.13943346118004846
192,1558314000,194,200,6,394,20,-0.5225680081013272,-0.7673954061522958
192,1558328400,15,22,7,37,20,-0.4978797557500834,-1.619337263093472
192,1558342800,672,319,0,991,20,-0.6706975222087901,0.6572804722619398
192,1558357200,588,334,0,922,20,-0.6706975222087901,0.4926194410884352
192,1558371600,899,472,0,1371,20,-0.6706975222087901,1.564109339594284
192,1558386000,762,653,0,1415,20,-0.6706975222087901,1.669110576864345
192,1558400400,196,328,132,524,21,2.359590900581287,-0.3622283610489342
192,1558414800,19,27,8,46,21,-0.37024963240673286,-1.424468585474643
192,1558429200,672,347,0,1019,21,-0.5463683764704761,0.7377902814002831
192,1558443600,774,343,0,1117,21,-0.5463683764704761,0.9555717500063908
192,1558454839,220,329,109,549,21,1.8532495113980254,-0.3066718639555394
192,1558458000,909,173,0,1082,21,-0.5463683764704761,0.8777926540756381
192,1558472400,808,635,0,1443,21,-0.5463683764704761,1.6800284721042593
192,1558486800,214,334,120,548,21,2.0954127844856725,-0.30889412383927517
192,1558501200,18,20,2,38,21,-0.5023386904545403,-1.4422466645445295
192,1558515600,701,346,0,1047,21,-0.5463683764704761,0.8000135581448854
192,1558530000,776,352,0,1128,21,-0.5463683764704761,0.9800166087274845
192,1558544400,1084,447,0,1531,21,-0.5463683764704761,1.875587341873009
192,1558558800,811,598,0,1409,21,-0.5463683764704761,1.6044716360572424
192,1558573200,200,352,152,552,21,2.799887760740645,-0.30000508430433204
192,1558587600,20,35,15,55,21,-0.21614573135095755,-1.404468246521021
192,1558602000,667,338,0,1005,21,-0.5463683764704761,0.7066786430279821
192,1558616400,680,333,0,1013,21,-0.5463683764704761,0.7244567220978684
192,1558630800,1260,399,0,1659,21,-0.5463683764704761,2.1600366069911905
192,1558645200,716,607,0,1323,21,-0.5463683764704761,1.4133572860559642
192,1558659600,193,309,116,502,21,2.0073534124538006,-0.41111807849112164
192,1558674000,17,21,4,38,21,-0.45830900443860445,-1.4422466645445295
192,1558687303,110,245,135,355,21,2.4256354296051907,-0.7377902814002831
192,1558688400,521,155,0,676,21,-0.5463683764704761,-0.02444485872109372
192,1558702800,660,339,0,999,21,-0.5463683764704761,0.6933450837255674
192,1558717200,832,465,0,1297,21,-0.5463683764704761,1.3555785290788336
192,1558731600,656,468,0,1124,21,-0.5463683764704761,0.9711275691925414
192,1558746000,209,293,84,502,21,1.3028784361988277,-0.41111807849112164
192,1558760400,25,37,12,62,21,-0.2821902603748613,-1.3889124273348705
192,1558774800,124,74,0,198,21,-0.5463683764704761,-1.0866850831468027
192,1558789200,465,187,0,652,21,-0.5463683764704761,-0.07777909593075275
192,1558803600,508,264,0,772,21,-0.5463683764704761,0.18889209011754238
192,1558818000,424,271,0,695,21,-0.5463683764704761,0.017778079069886342
192,1558832400,161,243,82,404,21,1.258848750182892,-0.6288995470972293
192,1558846800,25,43,18,68,21,-0.15010120232705385,-1.3755788680324557
192,1558861200,118,67,0,185,21,-0.5463683764704761,-1.115574461635368
192,1558875600,444,144,0,588,21,-0.5463683764704761,-0.22000372848984348
192,1558890000,526,259,0,785,21,-0.5463683764704761,0.21778146860610767
192,1558904400,285,299,14,584,21,-0.23816057435892546,-0.22889276802478664
192,1558918800,126,189,63,315,21,0.8405667330315019,-0.8266806767497149
192,1558933200,17,43,26,60,21,0.026017541736689374,-1.393356947102342
192,1558947600,101,83,0,184,21,-0.5463683764704761,-1.1177967215191038
192,1558962000,391,168,0,559,21,-0.5463683764704761,-0.28444926511818147
192,1558976400,482,285,0,767,21,-0.5463683764704761,0.1777807906988634
192,1558990800,437,332,0,769,21,-0.5463683764704761,0.182225310466335
192,1559005200,183,177,0,360,22,-0.3645691600858974,-0.3859716230987322
192,1559019600,17,25,8,42,22,-0.0905305967998537,-1.0265876288284037
192,1559034000,645,313,0,958,22,-0.3645691600858974,0.8187087901916565
192,1559048400,605,335,0,940,22,-0.3645691600858974,0.7824475068484676
192,1559062800,731,490,0,1221,22,-0.3645691600858974,1.3485264301504731
192,1559077200,672,621,0,1293,22,-0.3645691600858974,1.493571563523229
192,1559091600,150,290,140,440,22,4.431105697419867,-0.22481036379567013
192,1559106000,18,26,8,44,22,-0.0905305967998537,-1.0225585973458273
192,1559120400,663,324,0,987,22,-0.3645691600858974,0.8771297466890166
192,1559134800,607,215,0,822,22,-0.3645691600858974,0.5447346493764511
192,1559149200,804,274,0,1078,22,-0.3645691600858974,1.0604506791462496
192,1559163600,639,677,38,1316,22,0.9371140155228102,1.5399054255728593
192,1559178000,161,234,73,395,22,2.1360327298992514,-0.3154635721536425
192,1559192400,20,20,0,40,22,-0.3645691600858974,-1.0306166603109803
192,1559206800,684,306,0,990,22,-0.3645691600858974,0.8831732939128814
192,1559221200,622,206,0,828,22,-0.3645691600858974,0.5568217438241808
192,1559235600,833,265,0,1098,22,-0.3645691600858974,1.1007409939720152
192,1559250000,690,620,0,1310,22,-0.3645691600858974,1.5278183311251297
192,1559264400,178,288,110,466,22,3.4034610850972036,-0.17243295452217497
192,1559278800,20,31,11,51,22,0.012233864432412683,-1.0084569871568092
192,1559293200,644,286,0,930,22,-0.3645691600858974,0.7623023494355848
192,1559307600,640,213,0,853,22,-0.3645691600858974,0.6071846373563876
192,1559322000,789,270,0,1059,22,-0.3645691600858974,1.0221748800617725
192,1559336400,734,401,0,1135,22,-0.3645691600858974,1.1752780763996813
192,1559350800,201,243,42,444,22,1.074133297165832,-0.21675230083051703
192,1559365200,5,6,1,11,22,-0.33031433967514195,-1.0890376168083402
192,1559379600,1,5,4,6,22,-0.22754987844287555,-1.0991101955147817
192,1559394000,9,12,3,21,22,-0.261804698853631,-1.0688924593954576
192,1559408400,1,0,0,1,22,-0.3645691600858974,-1.109182774221223
192,1559422800,1,0,0,1,22,-0.3645691600858974,-1.109182774221223
192,1559437200,0,1,1,1,22,-0.33031433967514195,-1.109182774221223
192,1559451600,0,6,6,6,22,-0.15904023762136463,-1.0991101955147817
192,1559466000,0,0,0,0,22,-0.3645691600858974,-1.1111972899625113
192,1559480400,1,2,1,3,22,-0.33031433967514195,-1.1051537427386464
192,1559494800,1,2,1,3,22,-0.33031433967514195,-1.1051537427386464
192,1559509200,5,3,0,8,22,-0.3645691600858974,-1.0950811640322051
192,1559523600,0,0,0,0,22,-0.3645691600858974,-1.1111972899625113
192,1559538000,3,2,0,5,22,-0.3645691600858974,-1.10112471125607
192,1559552400,710,321,0,1031,22,-0.3645691600858974,0.9657684393057007
192,1559566800,450,280,0,730,22,-0.3645691600858974,0.3593992011779298
192,1559581200,619,392,0,1011,22,-0.3645691600858974,0.9254781244799352
192,1559595600,622,607,0,1229,22,-0.3645691600858974,1.3646425560807793
192,1559610000,160,229,69,389,23,1.588983521803456,-0.7085071124698158
192,1559624400,10,17,7,27,23,-0.36461094976226616,-1.6255192975375847
192,1559638800,679,279,0,958,23,-0.5851780675196864,0.7328739187554895
192,1559653200,562,346,0,908,23,-0.5851780675196864,0.6062147771715435
192,1559667600,655,429,0,1084,23,-0.5851780675196864,1.0520549555470333
192,1559682000,664,591,0,1255,23,-0.5851780675196864,1.4852292197641286
192,1559696400,192,270,78,462,23,1.8725698160629962,-0.5235847657572547
192,1559710800,15,28,13,43,23,-0.17555342025590595,-1.584988372230722
192,1559725200,731,309,0,1040,23,-0.5851780675196864,0.9405949109531608
192,1559739600,288,341,53,629,23,1.0848301097864954,-0.10054323286687511
192,1559754000,446,441,0,887,23,-0.5851780675196864,0.5530179377062862
192,1559768400,674,610,0,1284,23,-0.5851780675196864,1.5586915218828172
192,1559782800,188,253,65,441,23,1.4629451687992159,-0.576781605222512
192,1559797200,18,16,0,34,23,-0.5851780675196864,-1.6077870177158322
192,1559811600,665,303,0,968,23,-0.5851780675196864,0.7582057470722786
192,1559826000,309,339,30,648,23,0.3601095800121146,-0.05241275906497563
192,1559840400,463,408,0,871,23,-0.5851780675196864,0.5124870123994234
192,1559854800,690,624,0,1314,23,-0.5851780675196864,1.634687006833185
192,1559869200,186,291,105,477,23,2.723328698841617,-0.4855870232820709
192,1559883600,19,28,9,47,23,-0.3015917732601461,-1.5748556409040062
192,1559898000,648,296,0,944,23,-0.5851780675196864,0.6974093591119845
192,1559912400,285,250,0,535,23,-0.5851780675196864,-0.3386624190446935
192,1559926800,448,430,0,878,23,-0.5851780675196864,0.5302192922211759
192,1559941200,689,544,0,1233,23,-0.5851780675196864,1.4294991974671922
192,1559955600,222,306,84,528,23,2.0616273455693563,-0.356394698866446
192,1559970000,24,64,40,88,23,0.675205462522715,-1.4709951448051706
192,1559984400,138,106,0,244,23,-0.5851780675196864,-1.0758186230632591
192,1559998800,516,198,0,714,23,-0.5851780675196864,0.11477730782583306
192,1560013200,572,292,0,864,23,-0.5851780675196864,0.494754732577671
192,1560027600,502,284,0,786,23,-0.5851780675196864,0.2971664717067153
192,1560042000,238,271,33,509,23,0.4546383447652947,-0.4045251726683455
192,1560056400,29,59,30,88,23,0.3601095800121146,-1.4709951448051706
192,1560070800,99,50,0,149,23,-0.5851780675196864,-1.3164709920727564
192,1560085200,447,165,0,612,23,-0.5851780675196864,-0.14360734100541675
192,1560099600,514,284,0,798,23,-0.5851780675196864,0.3275646656868623
192,1560114000,371,329,0,700,23,-0.5851780675196864,0.07931274818232818
192,1560128400,133,179,46,312,23,0.8642629920290751,-0.9035621905090926
192,1560142800,18,16,0,34,23,-0.5851780675196864,-1.6077870177158322
192,1560157200,743,314,0,1057,23,-0.5851780675196864,0.9836590190917025
192,1560171600,555,307,0,862,23,-0.5851780675196864,0.48968836691431317
192,1560186000,680,458,0,1138,23,-0.5851780675196864,1.188846828457695
192,1560200400,564,682,118,1246,23,3.1329533461053978,1.4624305742790182
192,1560214800,48,63,15,111,24,2.2970062306755668,-1.2836641063698926
192,1560229200,0,3,3,3,24,0.031465838776377604,-1.5040268697125485
192,1560243600,620,287,0,907,24,-0.5349192591984198,0.34049107530375655
192,1560258000,609,303,0,912,24,-0.5349192591984198,0.35069305508813875
192,1560272400,671,371,0,1042,24,-0.5349192591984198,0.6159445294820765
192,1560286800,636,636,0,1272,24,-0.5349192591984198,1.0852355995636584
192,1560301200,60,81,21,141,24,3.429776426625162,-1.2224522276635994
192,1560315600,3,4,1,7,24,-0.34612422654015396,-1.4958652858850428
192,1560330000,745,331,0,1076,24,-0.5349192591984198,0.6853179920158755
192,1560344400,664,344,0,1008,24,-0.5349192591984198,0.5465710669482774
192,1560358800,697,383,0,1080,24,-0.5349192591984198,0.6934795758433813
192,1560373200,682,660,0,1342,24,-0.5349192591984198,1.2280633165450094
192,1560387600,64,72,8,136,24,0.9754410020677063,-1.2326542074479816
192,1560402000,0,3,3,3,24,0.031465838776377604,-1.5040268697125485
192,1560416400,699,260,0,959,24,-0.5349192591984198,0.44659166506133163
192,1560430800,589,365,0,954,24,-0.5349192591984198,0.4363896852769494
192,1560445200,665,445,0,1110,24,-0.5349192591984198,0.7546914545496746
192,1560459600,647,649,2,1296,24,-0.15732919388188818,1.1342051025286932
192,1560474000,67,74,7,141,24,0.7866459694094406,-1.2224522276635994
192,1560488400,2,10,8,12,24,0.9754410020677063,-1.4856633061006606
192,1560502800,648,263,0,911,24,-0.5349192591984198,0.3486526591312623
192,1560517200,607,322,0,929,24,-0.5349192591984198,0.3853797863550383
192,1560531600,758,431,0,1189,24,-0.5349192591984198,0.9158827351429136
192,1560546000,690,532,0,1222,24,-0.5349192591984198,0.9832158017198362
192,1561165200,9878,7342,0,17220,25,-0.3163376245457789,4.102176483853276
192,1561179600,0,3,3,3,25,-0.07908440613644473,-0.2979505591966697
192,1561194000,0,1,1,1,25,-0.23725321840933417,-0.2984616966820678
192,1561208400,3,4,1,7,25,-0.23725321840933417,-0.29692828422587336
192,1561222800,3,4,1,7,25,-0.23725321840933417,-0.29692828422587336
192,1561237200,1,1,0,2,25,-0.3163376245457789,-0.29820612793936874
192,1561251600,0,1,1,1,25,-0.23725321840933417,-0.2984616966820678
192,1561266000,1,2,1,3,25,-0.23725321840933417,-0.2979505591966697
192,1561280400,1,0,0,1,25,-0.3163376245457789,-0.2984616966820678
192,1561294800,1,2,1,3,25,-0.23725321840933417,-0.2979505591966697
192,1561309200,0,1,1,1,25,-0.23725321840933417,-0.2984616966820678
192,1561323600,0,2,2,2,25,-0.15816881227288945,-0.29820612793936874
192,1561338000,0,1,1,1,25,-0.23725321840933417,-0.2984616966820678
192,1561352400,1,4,3,5,25,-0.07908440613644473,-0.2974394217112715
192,1561366800,623,281,0,904,25,-0.3163376245457789,-0.06768312202480457
192,1561381200,540,271,0,811,25,-0.3163376245457789,-0.09145101509581839
192,1561395600,578,319,0,897,25,-0.3163376245457789,-0.0694721032236981
192,1561410000,557,613,56,1170,25,4.112389119095125,0.0002981635331489383
192,1561424400,38,68,30,106,26,1.1301725684933328,-1.2539235048809796
192,1561438800,1,3,2,4,26,-0.6094647882450959,-1.5195915709002732
192,1561453200,614,238,0,852,26,-0.7337245994406979,0.6890998014954225
192,1561467600,555,311,0,866,26,-0.7337245994406979,0.7255640458510119
192,1561482000,615,350,0,965,26,-0.7337245994406979,0.9834183452226791
192,1561496400,556,601,45,1157,26,2.062121152460348,1.4834994106707613
192,1561510800,53,69,16,122,26,0.2603538901241185,-1.212250082760306
192,1561525200,0,6,6,6,26,-0.3609451658538917,-1.514382393135189
192,1561539600,664,276,0,940,26,-0.7337245994406979,0.9183036231591268
192,1561554000,306,337,31,643,26,1.1923024740911339,0.14474072504412488
192,1561568400,368,392,24,760,26,0.7573931349065267,0.4494776243015499
192,1561582800,605,646,41,1251,26,1.8136015300691442,1.728330765629718
192,1561597200,51,82,31,133,26,1.1923024740911339,-1.183599605052343
192,1561611600,1,4,3,5,26,-0.5473348826472948,-1.516986982017731
192,1561626000,595,215,0,810,26,-0.7337245994406979,0.5797070684286546
192,1561640400,300,335,35,635,26,1.440822096482338,0.12390401398378814
192,1561654800,372,386,14,758,26,0.1360940789285165,0.4442684465364657
192,1561669200,626,600,0,1226,26,-0.7337245994406979,1.6632160435661656
192,1561683600,52,78,26,130,26,0.8816529461021287,-1.1914133716999693
192,1561698000,2,6,4,8,26,-0.4852049770494938,-1.5091732153701047
192,1561712400,569,249,0,818,26,-0.7337245994406979,0.6005437794889913
192,1561726800,279,334,55,613,26,2.6834202084383585,0.06660305856786207
192,1561741200,403,364,0,767,26,-0.7337245994406979,0.46770974647934455
192,1561755600,653,486,0,1139,26,-0.7337245994406979,1.4366168107850035
192,1561770000,242,244,2,486,26,-0.6094647882450959,-0.26417972951498386
192,1561784400,25,51,26,76,26,0.8816529461021287,-1.3320611713572423
192,1561798800,133,98,0,231,26,-0.7337245994406979,-0.9283498945632178
192,1561813200,465,192,0,657,26,-0.7337245994406979,0.1812049693997142
192,1561827600,584,286,0,870,26,-0.7337245994406979,0.7359824013811802
192,1561842000,437,274,0,711,26,-0.7337245994406979,0.3218527690569873
192,1561856400,231,237,6,468,26,-0.3609451658538917,-0.3110623294007416
192,1561870800,22,46,24,68,26,0.7573931349065267,-1.3528978824175792
192,1561885200,98,61,0,159,26,-0.7337245994406979,-1.1158802941062487
192,1561899600,556,172,0,728,26,-0.7337245994406979,0.3661307800602029
192,1561914000,557,295,0,852,26,-0.7337245994406979,0.6890998014954225
192,1561928400,313,318,5,631,26,-0.42307507145169276,0.11348565845361977
192,1561942800,136,188,52,324,26,2.4970304916449555,-0.6861231284868031
192,1561957200,18,29,11,47,26,-0.05029563786488658,-1.4075942489509632
192,1561971600,568,244,0,812,26,-0.7337245994406979,0.5849162461937388
192,1561986000,550,301,0,851,26,-0.7337245994406979,0.6864952126128805
192,1562000400,582,330,0,912,26,-0.7337245994406979,0.8453751344479482
192,1562014800,534,541,7,1075,26,-0.2988152602560907,1.2699231223023095
192,1562029200,151,222,71,373,27,2.095029375584021,-0.13717548073097666
192,1562043600,15,24,9,39,27,-0.06064345934727963,-0.9748090922353501
192,1562058000,618,296,0,914,27,-0.3735637095792426,1.2195903391009575
192,1562072400,563,295,0,858,27,-0.3735637095792426,1.0791487754954339
192,1562086800,579,359,0,938,27,-0.3735637095792426,1.279779580646182
192,1562101200,627,560,0,1187,27,-0.3735637095792426,1.9042429616778853
192,1562115600,154,269,115,423,27,3.6248617100513956,-0.011781227511759076
192,1562130000,21,32,11,53,27,0.008894374037601032,-0.9396987013339692
192,1562144400,514,234,0,748,27,-0.3735637095792426,0.8032814184131551
192,1562158800,605,297,0,902,27,-0.3735637095792426,1.1894957183283454
192,1562173200,720,393,0,1113,27,-0.3735637095792426,1.7186594669134434
192,1562187600,591,471,0,1062,27,-0.3735637095792426,1.5907573286298415
192,1562202000,183,219,36,402,27,0.8781172913486093,-0.06444681386383046
192,1562216400,18,28,10,46,27,-0.0258745426548393,-0.9572538967846597
192,1562230800,124,77,0,201,27,-0.3735637095792426,-0.5685317118050851
192,1562245200,410,162,0,572,27,-0.3735637095792426,0.3618936470815093
192,1562259600,446,196,0,642,27,-0.3735637095792426,0.5374456015884139
192,1562274000,392,204,0,596,27,-0.3735637095792426,0.42208288862673377
192,1562288400,113,253,140,366,27,4.494084627362404,-0.1547306761816671
192,1562302800,16,42,26,58,27,0.5304281244242061,-0.9271592760120474
192,1562317200,266,177,0,443,27,-0.3735637095792426,0.038376473775927955
192,1562331600,439,209,0,648,27,-0.3735637095792426,0.5524929119747201
192,1562346000,542,315,0,857,27,-0.3735637095792426,1.0766408904310496
192,1562360400,474,340,0,814,27,-0.3735637095792426,0.9688018326625224
192,1562374800,151,161,10,312,27,-0.0258745426548393,-0.2901564696584221
192,1562389200,0,13,13,13,27,0.07843220742248169,-1.0400141039093431
192,1562403600,0,7,7,7,27,-0.1301812927321603,-1.0550614142956494
192,1562418000,0,1,1,1,27,-0.3387947928868023,-1.0701087246819554
192,1562432400,1,0,0,1,27,-0.3735637095792426,-1.0701087246819554
192,1562446800,5,2,0,7,27,-0.3735637095792426,-1.0550614142956494
192,1562461200,2,0,0,2,27,-0.3735637095792426,-1.0676008396175711
192,1562475600,1,4,3,5,27,-0.26925695950192163,-1.0600771844244181
192,1562490000,0,0,0,0,27,-0.3735637095792426,-1.0726166097463399
192,1562504400,1,1,0,2,27,-0.3735637095792426,-1.0676008396175711
192,1562518800,2,1,0,3,27,-0.3735637095792426,-1.0650929545531866
192,1562533200,0,1,1,1,27,-0.3387947928868023,-1.0701087246819554
192,1562547600,0,1,1,1,27,-0.3387947928868023,-1.0701087246819554
192,1562562000,3,3,0,6,27,-0.3735637095792426,-1.0575692993600336
192,1562572518,209,90,0,299,27,-0.3735637095792426,-0.32275897549541865
192,1562576400,390,251,0,641,27,-0.3735637095792426,0.5349377165240295
192,1562590800,545,272,0,817,27,-0.3735637095792426,0.9763254878556754
192,1562605200,564,324,0,888,27,-0.3735637095792426,1.1543853274269644
192,1562619600,561,569,8,1130,27,-0.09541237603971997,1.7612935130079774
192,1562634000,131,203,72,334,28,2.151839824961654,-0.35009828021026623
192,1562648400,12,16,4,28,28,-0.24506132171950193,-1.0256933398592665
192,1562662800,647,239,0,886,28,-0.3860555068183934,0.8686222195487147
192,1562677200,556,364,0,920,28,-0.3860555068183934,0.9436883372874926
192,1562691600,571,313,0,884,28,-0.3860555068183934,0.8642065655640807
192,1562706000,648,536,0,1184,28,-0.3860555068183934,1.526554663259179
192,1562720400,161,220,59,381,28,1.6936087233902564,-0.24633041157136748
192,1562734800,1,2,1,3,28,-0.35080696054367055,-1.0808890146671915
192,1562749200,689,241,0,930,28,-0.3860555068183934,0.9657666072106624
192,1562763600,604,159,0,763,28,-0.3860555068183934,0.5970594994937244
192,1562778000,660,152,0,812,28,-0.3860555068183934,0.7052430221172571
192,1562792400,636,617,0,1253,28,-0.3860555068183934,1.6788947257290516
192,1562806800,138,281,143,419,28,4.654486610466978,-0.1624329858633217
192,1562821200,1,2,1,3,28,-0.35080696054367055,-1.0808890146671915
192,1562835600,637,257,0,894,28,-0.3860555068183934,0.8862848354872507
192,1562850000,581,197,0,778,28,-0.3860555068183934,0.6301769043784793
192,1562864400,602,208,0,810,28,-0.3860555068183934,0.7008273681326231
192,1562878800,589,617,28,1206,28,0.6009037888738471,1.5751268570901529
192,1562893200,113,198,85,311,28,2.6100709265330515,-0.4008783010335571
192,1562907600,1,2,1,3,28,-0.35080696054367055,-1.0808890146671915
192,1562922000,550,239,0,789,28,-0.3860555068183934,0.6544630012939663
192,1562936400,624,203,0,827,28,-0.3860555068183934,0.738360427002012
192,1562950800,661,207,0,868,28,-0.3860555068183934,0.8288813336870088
192,1562965200,669,484,0,1153,28,-0.3860555068183934,1.4581120264973522
192,1562979600,204,231,27,435,28,0.5656552425991243,-0.1271077539862498
192,1562994000,0,1,1,1,28,-0.35080696054367055,-1.0853046686518253
192,1563008400,0,0,0,0,28,-0.3860555068183934,-1.0875124956441424
192,1563022800,0,1,1,1,28,-0.35080696054367055,-1.0853046686518253
192,1563037200,0,0,0,0,28,-0.3860555068183934,-1.0875124956441424
192,1563051600,0,0,0,0,28,-0.3860555068183934,-1.0875124956441424
192,1563066000,0,1,1,1,28,-0.35080696054367055,-1.0853046686518253
192,1563080400,0,1,1,1,28,-0.35080696054367055,-1.0853046686518253
192,1563094800,0,2,2,2,28,-0.31555841426894765,-1.0830968416595084
192,1563109200,0,0,0,0,28,-0.3860555068183934,-1.0875124956441424
192,1563123600,0,1,1,1,28,-0.35080696054367055,-1.0853046686518253
192,1563138000,1,0,0,1,28,-0.3860555068183934,-1.0853046686518253
192,1563152400,0,0,0,0,28,-0.3860555068183934,-1.0875124956441424
192,1563166800,3,4,1,7,28,-0.35080696054367055,-1.0720577066979233
192,1563181200,590,251,0,841,28,-0.3860555068183934,0.76927000489445
192,1563195600,522,276,0,798,28,-0.3860555068183934,0.6743334442248192
192,1563210000,617,376,0,993,28,-0.3860555068183934,1.1048597077266331
192,1563224400,568,599,31,1167,28,0.7066494276980158,1.4890216043897901
192,1563238800,116,203,87,319,29,1.5118895493587032,-0.3881093858808865
192,1563253200,0,2,2,2,29,-0.34682430967461675,-1.0845705547779854
192,1563267600,646,258,0,904,29,-0.39055875341657725,0.8971580709165989
192,1563279750,492,131,0,623,29,-0.39055875341657725,0.2797902839762683
192,1563282000,118,347,229,465,29,4.6170350550378965,-0.06734178127843717
192,1563296400,641,370,0,1011,29,-0.39055875341657725,1.1322411783992157
192,1563310800,669,629,0,1298,29,-0.39055875341657725,1.7627911956656745
192,1563325200,138,244,106,382,29,1.9273667649073276,-0.24969596745654193
192,1563339600,2,2,0,4,29,-0.39055875341657725,-1.0801764780026095
192,1563354000,642,297,0,939,29,-0.39055875341657725,0.9740544144856792
192,1563368400,597,323,0,920,29,-0.39055875341657725,0.932310685119607
192,1563382800,601,319,0,920,29,-0.39055875341657725,0.932310685119607
192,1563397200,626,614,0,1240,29,-0.39055875341657725,1.63536296917977
192,1563411600,123,228,105,351,29,1.9054995430363475,-0.31780415747487023
192,1563426000,2,1,0,3,29,-0.39055875341657725,-1.0823735163902974
192,1563440400,605,274,0,879,29,-0.39055875341657725,0.8422321112243987
192,1563454800,591,332,0,923,29,-0.39055875341657725,0.9389018002826711
192,1563469200,605,348,0,953,29,-0.39055875341657725,1.0048129519133113
192,1563483600,674,584,0,1258,29,-0.39055875341657725,1.6749096601581541
192,1563498000,162,254,92,416,29,1.6212256587136045,-0.17499666227514962
192,1563512400,1,2,1,3,29,-0.368691531545597,-1.0823735163902974
192,1563526800,584,262,0,846,29,-0.39055875341657725,0.7697298444306944
192,1563541200,558,300,0,858,29,-0.39055875341657725,0.7960943050829504
192,1563555600,659,348,0,1007,29,-0.39055875341657725,1.1234530248484638
192,1563570000,469,305,0,774,29,-0.39055875341657725,0.6115430805171577
192,1563584400,132,160,28,292,29,0.22172345897086937,-0.4474294223484628
192,1563598800,1,3,2,4,29,-0.34682430967461675,-1.0801764780026095
192,1563613200,1,3,2,4,29,-0.34682430967461675,-1.0801764780026095
192,1563627600,0,0,0,0,29,-0.39055875341657725,-1.0889646315533614
192,1563642000,10,3,0,13,29,-0.39055875341657725,-1.0604031325134173
192,1563656400,1,1,0,2,29,-0.39055875341657725,-1.0845705547779854
192,1563670800,4,2,0,6,29,-0.39055875341657725,-1.0757824012272335
192,1563685200,0,1,1,1,29,-0.368691531545597,-1.0867675931656735
192,1563699600,0,0,0,0,29,-0.39055875341657725,-1.0889646315533614
192,1563714000,0,3,3,3,29,-0.3249570878036365,-1.0823735163902974
192,1563728400,0,0,0,0,29,-0.39055875341657725,-1.0889646315533614
192,1563742800,2,2,0,4,29,-0.39055875341657725,-1.0801764780026095
192,1563757200,0,0,0,0,29,-0.39055875341657725,-1.0889646315533614
192,1563771600,4,3,0,7,29,-0.39055875341657725,-1.0735853628395455
192,1563786000,621,272,0,893,29,-0.39055875341657725,0.8729906486520308
192,1563800400,527,306,0,833,29,-0.39055875341657725,0.7411683453907503
192,1563814800,531,338,0,869,29,-0.39055875341657725,0.8202617273475186
192,1563829200,487,597,110,1084,29,2.0148356523912487,1.2926249807004404
192,1563843600,123,183,60,306,30,1.9836108805521653,-0.48970703397944626
192,1563858000,13,16,3,29,30,-0.2637930229224602,-1.04880925510966
192,1563872400,874,269,0,1143,30,-0.3820774388948089,1.1997101468363982
192,1563886800,674,320,0,994,30,-0.3820774388948089,0.8989656307771857
192,1563901200,604,328,0,932,30,-0.3820774388948089,0.7738236173834195
192,1563915600,878,566,0,1444,30,-0.3820774388948089,1.8072544376674247
192,1563930000,232,272,40,504,30,1.1950481074031738,-0.0900599589477411
192,1563944400,23,21,0,44,30,-0.3820774388948089,-1.018532961546652
192,1563958800,864,263,0,1127,30,-0.3820774388948089,1.167415433702523
192,1563973200,989,322,0,1311,30,-0.3820774388948089,1.5388046347420874
192,1563987600,628,372,0,1000,30,-0.3820774388948089,0.9110761482023889
192,1564002000,603,613,10,1216,30,0.012203947679686798,1.3470547755097035
192,1564016400,164,267,103,431,30,3.6790208428224966,-0.23740458762104652
192,1564030800,11,27,16,38,30,0.2487727796243842,-1.0306434789718553
192,1564045200,616,288,0,904,30,-0.3820774388948089,0.7173078693991379
192,1564059600,596,309,0,905,30,-0.3820774388948089,0.7193262889700052
192,1564074000,608,364,0,972,30,-0.3820774388948089,0.8545604002181074
192,1564088400,604,566,0,1170,30,-0.3820774388948089,1.2542074752498125
192,1564102800,171,289,118,460,30,4.27044292268424,-0.1788704200658978
192,1564117200,20,33,13,53,30,0.1304883636520355,-1.0003671854088472
192,1564131600,563,266,0,829,30,-0.3820774388948089,0.5659264015840981
192,1564146000,581,282,0,863,30,-0.3820774388948089,0.6345526669935828
192,1564160400,681,379,0,1060,30,-0.3820774388948089,1.0321813224544207
192,1564174800,623,500,0,1123,30,-0.3820774388948089,1.1593417554190542
192,1564189200,200,204,4,404,30,-0.2243648842650106,-0.29190191603446086
192,1564203600,1,2,1,3,30,-0.34264930023735934,-1.1012881639522072
192,1564218000,0,0,0,0,30,-0.3820774388948089,-1.1073434226648087
192,1564232400,2,0,0,2,30,-0.3820774388948089,-1.1033065835230744
192,1564246800,0,0,0,0,30,-0.3820774388948089,-1.1073434226648087
192,1564261200,1,7,6,8,30,-0.14550860695011147,-1.0911960660978712
192,1564275600,0,0,0,0,30,-0.3820774388948089,-1.1073434226648087
192,1564290000,0,3,3,3,30,-0.2637930229224602,-1.1012881639522072
192,1564304400,0,2,2,2,30,-0.30322116157990975,-1.1033065835230744
192,1564318800,2,3,1,5,30,-0.34264930023735934,-1.0972513248104727
192,1564333200,9,3,0,12,30,-0.3820774388948089,-1.0831223878144023
192,1564347600,2,2,0,4,30,-0.3820774388948089,-1.09926974438134
192,1564362000,0,1,1,1,30,-0.34264930023735934,-1.1053250030939414
192,1564376400,3,4,1,7,30,-0.34264930023735934,-1.0932144856687382
192,1564390800,585,248,0,833,30,-0.3820774388948089,0.574000079867567
192,1564405200,493,335,0,828,30,-0.3820774388948089,0.5639079820132309
192,1564419600,583,338,0,921,30,-0.3820774388948089,0.7516210021038803
192,1564434000,563,588,25,1151,30,0.6036260275414304,1.2158575034033359
192,1564448400,152,228,76,380,31,2.2919488411866054,-0.8273107053056878
192,1564462800,15,25,10,40,31,-0.12448284440949614,-1.601264149626439
192,1564477200,611,279,0,890,31,-0.4906088573786024,0.333619461175439
192,1564491600,553,276,0,829,31,-0.4906088573786024,0.19476310792965715
192,1564506000,572,328,0,900,31,-0.4906088573786024,0.35638279777310816
192,1564520400,597,603,6,1200,31,-0.27093324959713866,1.0392828957031828
192,1564534800,150,262,112,412,31,3.6100024878753874,-0.7544680281931465
192,1564549200,11,18,7,29,31,-0.234320648300228,-1.626303819883875
192,1564563600,629,277,0,906,31,-0.4906088573786024,0.3700407997317096
192,1564578000,733,308,0,1041,31,-0.4906088573786024,0.6773458438002432
192,1564584530,1,16,15,17,31,0.058580162075056987,-1.6536198238010782
192,1564592400,736,350,0,1086,31,-0.4906088573786024,0.7797808584897544
192,1564606800,785,631,0,1416,31,-0.4906088573786024,1.5309709662128363
192,1564621200,197,251,54,448,31,1.4864716126545714,-0.6725200164415376
192,1564635600,16,18,2,34,31,-0.4173836547847811,-1.6149221515850405
192,1564650000,782,267,0,1049,31,-0.4906088573786024,0.6955565130783785
192,1564664400,737,347,0,1084,31,-0.4906088573786024,0.7752281911702206
192,1564678800,827,318,0,1145,31,-0.4906088573786024,0.9140845444160024
192,1564693200,815,575,0,1390,31,-0.4906088573786024,1.4717862910588966
192,1564707600,238,271,33,509,31,0.7176069854194483,-0.5336636631957558
192,1564722000,15,35,20,50,31,0.2416431685596101,-1.5785008130287699
192,1564736400,551,246,0,797,31,-0.4906088573786024,0.12192043081711586
192,1564750800,560,306,0,866,31,-0.4906088573786024,0.27898745334103303
192,1564765200,641,365,0,1006,31,-0.4906088573786024,0.5976741657084012
192,1564779600,622,440,0,1062,31,-0.4906088573786024,0.7251488506553484
192,1565398800,4536,8802,4266,13338,32,4.122317368232827,4.103060421325812
192,1565413200,31,58,27,89,32,-0.22523491073303523,-0.3732409707272458
192,1565427600,125,84,0,209,32,-0.2529263265226267,-0.33269782278805293
192,1565442000,437,149,0,586,32,-0.2529263265226267,-0.2053247663457552
192,1565456400,492,203,0,695,32,-0.2529263265226267,-0.16849807363432162
192,1565470800,356,223,0,579,32,-0.2529263265226267,-0.20768978330887478
192,1565485200,152,210,58,362,32,-0.19344106297461539,-0.281005309165582
192,1565499600,22,34,12,56,32,-0.24061903061614162,-0.3843903364105239
192,1565514000,95,53,0,148,32,-0.2529263265226267,-0.3533072563238093
192,1565528400,362,139,0,501,32,-0.2529263265226267,-0.23404282946935018
192,1565542800,459,203,0,662,32,-0.2529263265226267,-0.1796474393175997
192,1565557200,311,256,0,567,32,-0.2529263265226267,-0.21174409810279407
192,1565571600,97,160,63,257,32,-0.1883130230135799,-0.31648056361237575
192,1565586000,18,22,4,40,32,-0.24882389455379833,-0.38979608946908295
192,1565600400,447,207,0,654,32,-0.2529263265226267,-0.18235031584687922
192,1565614800,509,265,0,774,32,-0.2529263265226267,-0.1418071679076863
192,1565629200,599,284,0,883,32,-0.2529263265226267,-0.10498047519625274
192,1565643600,539,548,9,1087,32,-0.24369585459276288,-0.03605712369962479
192,1565658000,130,207,77,337,33,2.398267311325524,-0.3019981804877626
192,1565672400,21,24,3,45,33,-0.2657122467873168,-1.0025288567695707
192,1565686800,467,212,0,679,33,-0.37371141806216174,0.5184863787190127
192,1565701200,558,285,0,843,33,-0.37371141806216174,0.911935114712905
192,1565715600,572,322,0,894,33,-0.37371141806216174,1.0342880752963715
192,1565730000,550,522,0,1072,33,-0.37371141806216174,1.4613238985092545
192,1565744400,146,219,73,365,33,2.2542684162923976,-0.234824006049781
192,1565758800,19,20,1,39,33,-0.3377116943038801,-1.0169233227205667
192,1565773200,478,246,0,724,33,-0.37371141806216174,0.6264448733514831
192,1565787600,582,297,0,879,33,-0.37371141806216174,0.9983019104188813
192,1565802000,630,344,0,974,33,-0.37371141806216174,1.226214287976319
192,1565816400,575,537,0,1112,33,-0.37371141806216174,1.5572870048492282
192,1565830800,162,247,85,409,33,2.6862651013917773,-0.1292645890758099
192,1565845200,18,16,0,34,33,-0.37371141806216174,-1.0289187110130635
192,1565859600,449,241,0,690,33,-0.37371141806216174,0.5448762329625055
192,1565874000,539,279,0,818,33,-0.37371141806216174,0.8519581732504214
192,1565888400,648,328,0,976,33,-0.37371141806216174,1.2310124432933176
192,1565902800,628,490,0,1118,33,-0.37371141806216174,1.5716814708002242
192,1565917200,163,258,95,421,33,3.0462623389745933,-0.10047565717381779
192,1565931600,20,21,1,41,33,-0.3377116943038801,-1.012125167403568
192,1565946000,424,174,0,598,33,-0.37371141806216174,0.32416108838056595
192,1565960400,572,282,0,854,33,-0.37371141806216174,0.9383249689563977
192,1565974800,668,321,0,989,33,-0.37371141806216174,1.262200452853809
192,1565989200,549,407,0,956,33,-0.37371141806216174,1.1830308901233306
192,1566003600,124,221,97,345,33,3.1182617864911566,-0.28280555921976785
192,1566018000,1,0,0,1,33,-0.37371141806216174,-1.1080882737435418
192,1566032400,0,2,2,2,33,-0.30171197054559845,-1.1056891960850426
192,1566046800,1,2,1,3,33,-0.3377116943038801,-1.1032901184265431
192,1566061200,0,0,0,0,33,-0.37371141806216174,-1.1104873514020412
192,1566075600,0,0,0,0,33,-0.37371141806216174,-1.1104873514020412
192,1566090000,0,0,0,0,33,-0.37371141806216174,-1.1104873514020412
192,1566104400,0,0,0,0,33,-0.37371141806216174,-1.1104873514020412
192,1566118800,0,0,0,0,33,-0.37371141806216174,-1.1104873514020412
192,1566133200,0,0,0,0,33,-0.37371141806216174,-1.1104873514020412
192,1566147600,0,0,0,0,33,-0.37371141806216174,-1.1104873514020412
192,1566162000,1,1,0,2,33,-0.37371141806216174,-1.1056891960850426
192,1566176400,0,1,1,1,33,-0.3377116943038801,-1.1080882737435418
192,1566190800,5,1,0,6,33,-0.37371141806216174,-1.0960928854510452
192,1566205200,421,219,0,640,33,-0.37371141806216174,0.4249223500375383
192,1566219600,492,278,0,770,33,-0.37371141806216174,0.7368024456424529
192,1566234000,515,285,0,800,33,-0.37371141806216174,0.8087747753974333
192,1566248400,532,472,0,1004,33,-0.37371141806216174,1.2981866177312993
192,1566262800,124,199,75,323,34,3.149111724317509,-0.30841192735390865
192,1566277200,14,16,2,30,34,-0.31898329966147176,-1.021415342348686
192,1566291600,454,211,0,665,34,-0.41399960168829314,0.5238309665990396
192,1566306000,530,282,0,812,34,-0.41399960168829314,0.8815494034735525
192,1566320400,574,315,0,889,34,-0.41399960168829314,1.0689257275506783
192,1566334800,563,533,0,1096,34,-0.41399960168829314,1.5726516896800946
192,1566349200,141,204,63,345,34,2.5790139121565803,-0.2548758347604441
192,1566363600,13,27,14,40,34,0.25111451249945654,-0.9970807548062022
192,1566378000,451,221,0,672,34,-0.41399960168829314,0.5408651778787784
192,1566392400,507,301,0,808,34,-0.41399960168829314,0.8718155684565589
192,1566406800,577,339,0,916,34,-0.41399960168829314,1.1346291139153848
192,1566421200,533,477,0,1010,34,-0.41399960168829314,1.3633742368147332
192,1566435600,152,196,44,348,34,1.6763590429017772,-0.247575458497699
192,1566450000,11,16,5,27,34,-0.17645884662123967,-1.028715718611431
192,1566464400,442,225,0,667,34,-0.41399960168829314,0.5286978841075364
192,1566478800,527,282,0,809,34,-0.41399960168829314,0.8742490272108073
192,1566493200,571,325,0,896,34,-0.41399960168829314,1.085959938830417
192,1566507600,580,534,0,1114,34,-0.41399960168829314,1.6164539472565655
192,1566522000,140,219,79,359,34,3.3391443283711517,-0.22080741220096672
192,1566536400,16,22,6,38,34,-0.12895069560782899,-1.001947672314699
192,1566550800,398,213,0,611,34,-0.41399960168829314,0.39242419386962674
192,1566565200,479,271,0,750,34,-0.41399960168829314,0.7306749607101526
192,1566579600,650,342,0,992,34,-0.41399960168829314,1.3195719792382623
192,1566594000,564,429,0,993,34,-0.41399960168829314,1.3220054379925106
192,1566608400,124,185,61,309,34,2.4839976101297587,-0.34248034991338605
192,1566622800,0,4,4,4,34,-0.22396699763465036,-1.084685269959144
192,1566637200,0,1,1,1,34,-0.3664914506748824,-1.0919856462218893
192,1566651600,0,0,0,0,34,-0.41399960168829314,-1.0944191049761376
192,1566666000,0,0,0,0,34,-0.41399960168829314,-1.0944191049761376
192,1566680400,0,0,0,0,34,-0.41399960168829314,-1.0944191049761376
192,1566694800,0,1,1,1,34,-0.3664914506748824,-1.0919856462218893
192,1566709200,0,1,1,1,34,-0.3664914506748824,-1.0919856462218893
192,1566723600,1,0,0,1,34,-0.41399960168829314,-1.0919856462218893
192,1566738000,0,1,1,1,34,-0.3664914506748824,-1.0919856462218893
192,1566752400,2,2,0,4,34,-0.41399960168829314,-1.084685269959144
192,1566766800,0,1,1,1,34,-0.3664914506748824,-1.0919856462218893
192,1566781200,0,4,4,4,34,-0.22396699763465036,-1.084685269959144
192,1566795600,3,5,2,8,34,-0.31898329966147176,-1.0749514349421505
192,1566810000,387,224,0,611,34,-0.41399960168829314,0.39242419386962674
192,1566824400,487,327,0,814,34,-0.41399960168829314,0.8864163209820493
192,1566838800,566,269,0,835,34,-0.41399960168829314,0.9375189548212655
192,1566853200,541,543,2,1084,34,-0.31898329966147176,1.543450184629114
192,1566867600,42,65,23,107,35,1.8206185740842027,-1.1685751255240144
192,1566882000,0,2,2,2,35,-0.2567237057893636,-1.4541304146890228
192,1566896400,409,222,0,631,35,-0.4545658276820842,0.256481746118503
192,1566910800,526,276,0,802,35,-0.4545658276820842,0.7215289313300879
192,1566925200,585,305,0,890,35,-0.4545658276820842,0.9608514593921901
192,1566939600,582,503,0,1085,35,-0.4545658276820842,1.4911684249843482
192,1566954000,58,54,0,112,35,-0.4545658276820842,-1.154977254611395
192,1566968400,0,5,5,5,35,0.0400394770497173,-1.4459716921414512
192,1566982800,478,252,0,730,35,-0.4545658276820842,0.525719590188368
192,1566997200,576,305,0,881,35,-0.4545658276820842,0.9363752917494751
192,1567011600,606,366,0,972,35,-0.4545658276820842,1.183856542359149
192,1567026000,627,491,0,1118,35,-0.4545658276820842,1.5809143730076367
192,1567040400,61,70,9,131,35,0.4357237208351585,-1.1033053451434411
192,1567054800,0,2,2,2,35,-0.2567237057893636,-1.4541304146890228
192,1567069200,427,218,0,645,35,-0.4545658276820842,0.2945557846738375
192,1567083600,565,334,0,899,35,-0.4545658276820842,0.9853276270349051
192,1567098000,594,336,0,930,35,-0.4545658276820842,1.0696344266931457
192,1567112400,675,481,0,1156,35,-0.4545658276820842,1.6842581919435444
192,1567126800,55,55,0,110,35,-0.4545658276820842,-1.1604164029764428
192,1567141200,0,5,5,5,35,0.0400394770497173,-1.4459716921414512
192,1567155600,349,213,0,562,35,-0.4545658276820842,0.06883112752435472
192,1567170000,587,262,0,849,35,-0.4545658276820842,0.8493489179087107
192,1567184400,740,372,0,1112,35,-0.4545658276820842,1.5645969279124934
192,1567198800,581,376,0,957,35,-0.4545658276820842,1.1430629296212906
192,1567213200,183,218,35,401,35,3.0076713054405264,-0.3690203158619913
192,1567227600,27,41,14,68,35,0.93032902556696,-1.274638518642446
192,1567242000,114,75,0,189,35,-0.4545658276820842,-0.9455700425570556
192,1567256400,454,165,0,619,35,-0.4545658276820842,0.22384685592821635
192,1567270800,520,246,0,766,35,-0.4545658276820842,0.6236242607592279
192,1567285200,411,250,0,661,35,-0.4545658276820842,0.33806897159421967
192,1567299600,168,209,41,377,35,3.601197671118688,-0.4342900962425646
192,1567314000,23,45,22,68,35,1.7216975131378423,-1.274638518642446
192,1567328400,101,64,0,165,35,-0.4545658276820842,-1.010839822937629
192,1567342800,468,158,0,626,35,-0.4545658276820842,0.24288387520588356
192,1567357200,528,239,0,767,35,-0.4545658276820842,0.6263438349417518
192,1567371600,398,267,0,665,35,-0.4545658276820842,0.3489472683243152
192,1567386000,156,186,30,342,35,2.513066000708725,-0.5294751926309007
192,1567400400,25,30,5,55,35,0.0400394770497173,-1.3099929830152566
192,1567414800,82,78,0,160,35,-0.4545658276820842,-1.0244376938502484
192,1567429200,391,168,0,559,35,-0.4545658276820842,0.060672404976783056
192,1567443600,481,257,0,738,35,-0.4545658276820842,0.5474761836485591
192,1567458000,341,281,0,622,35,-0.4545658276820842,0.232005578475788
192,1567472400,113,148,35,261,36,0.373643698948789,-1.056516668096773
192,1567486800,16,11,0,27,36,-0.24073687985962247,-1.632255277137809
192,1567501200,441,270,0,711,36,-0.24073687985962247,0.05067296467445011
192,1567515600,530,298,0,828,36,-0.24073687985962247,0.3385422691949681
192,1567530000,620,381,0,1001,36,-0.24073687985962247,0.7641951724603494
192,1567544400,670,560,0,1230,36,-0.24073687985962247,1.327631674470594
192,1567558800,197,203,6,400,36,-0.13541449492103763,-0.7145180926407729
192,1567573200,14,27,13,41,36,-0.012538379159355325,-1.5978093774515931
192,1567587600,497,286,0,783,36,-0.24073687985962247,0.2278233059178458
192,1567602000,610,330,0,940,36,-0.24073687985962247,0.6141094666846948
192,1567616400,628,355,0,983,36,-0.24073687985962247,0.7199075871495005
192,1567630800,628,568,0,1196,36,-0.24073687985962247,1.2439773466612127
192,1567645200,187,190,3,377,36,-0.18807568739033004,-0.7711077849824133
192,1567659600,21,19,0,40,36,-0.24073687985962247,-1.6002697988577514
192,1567674000,647,322,0,969,36,-0.24073687985962247,0.6854616874632847
192,1567688400,579,304,0,883,36,-0.24073687985962247,0.4738654465336732
192,1567702800,727,440,0,1167,36,-0.24073687985962247,1.1726251258826228
192,1567717200,723,564,0,1287,36,-0.24073687985962247,1.4678756946216156
192,1567731600,204,253,49,457,36,0.6193959304721537,-0.5742740724897514
192,1567746000,27,25,0,52,36,-0.24073687985962247,-1.5707447419838523
192,1567760400,603,316,0,919,36,-0.24073687985962247,0.562440617155371
192,1567774800,640,319,0,959,36,-0.24073687985962247,0.660857473401702
192,1567789200,818,429,0,1247,36,-0.24073687985962247,1.3694588383752848
192,1567803600,715,174,0,889,36,-0.24073687985962247,0.4886279749706228
192,1567818000,399,769,370,1168,36,6.254143524686442,1.1750855472887811
192,1567832400,23,47,24,70,36,0.18055265989471686,-1.5264571566730032
192,1567846800,122,86,0,208,36,-0.24073687985962247,-1.1869190026231615
192,1567861200,523,192,0,715,36,-0.24073687985962247,0.0605146502990832
192,1567875600,650,319,0,969,36,-0.24073687985962247,0.6854616874632847
192,1567890000,572,285,0,857,36,-0.24073687985962247,0.40989448997355804
192,1567904400,274,246,0,520,36,-0.24073687985962247,-0.4192675239017801
192,1567918800,25,63,38,88,36,0.4263048914180815,-1.4821695713621543
192,1567933200,95,54,0,149,36,-0.24073687985962247,-1.3320838655864997
192,1567947600,504,173,0,677,36,-0.24073687985962247,-0.0329813631349312
192,1567962000,515,277,0,792,36,-0.24073687985962247,0.24996709857327026
192,1567976400,361,304,0,665,36,-0.24073687985962247,-0.06250642000883048
192,1567990800,118,156,38,274,36,0.4263048914180815,-1.0245311898167155
192,1568005200,18,15,0,33,36,-0.24073687985962247,-1.6174927487008595
192,1568019600,639,326,0,965,36,-0.24073687985962247,0.6756200018386516
192,1568034000,525,316,0,841,36,-0.24073687985962247,0.37052774747502565
192,1568048400,713,424,0,1137,36,-0.24073687985962247,1.0988124836978745
192,1568062800,634,588,0,1222,36,-0.24073687985962247,1.307948303221328
192,1568077200,189,210,21,399,37,1.1071766224844777,-0.7469242457105308
192,1568091600,12,15,3,27,37,-0.3019572606775848,-1.5954006463926114
192,1568106000,651,324,0,975,37,-0.5368129078712619,0.566845665023013
192,1568120400,558,327,0,885,37,-0.5368129078712619,0.3615691164708968
192,1568134800,729,405,0,1134,37,-0.5368129078712619,0.9295009007984184
192,1568149200,696,629,0,1325,37,-0.5368129078712619,1.3651433538367983
192,1568163600,195,234,39,429,37,2.516310505646541,-0.6784987295264922
192,1568178000,15,17,2,32,37,-0.38024247640881054,-1.5839963936952715
192,1568192400,692,328,0,1020,37,-0.5368129078712619,0.6694839392990711
192,1568206800,544,274,0,818,37,-0.5368129078712619,0.20875213032654358
192,1568221200,703,435,0,1138,37,-0.5368129078712619,0.9386243029562902
192,1568235600,744,634,0,1378,37,-0.5368129078712619,1.4860284324286002
192,1568250000,191,218,27,409,37,1.576887916871832,-0.7241157403158514
192,1568264400,20,29,9,49,37,0.1677540337097694,-1.5452219345243163
192,1568278800,681,316,0,997,37,-0.5368129078712619,0.6170243768913081
192,1568293200,582,335,0,917,37,-0.5368129078712619,0.4345563337338714
192,1568307600,719,433,0,1152,37,-0.5368129078712619,0.9705562105088417
192,1568322000,808,645,0,1453,37,-0.5368129078712619,1.657092222888697
192,1568336400,188,231,43,419,37,2.8294513685714437,-0.7013072349211718
192,1568350800,20,26,6,46,37,-0.06710161348390772,-1.5520644861427202
192,1568365200,660,355,0,1015,37,-0.5368129078712619,0.6580796866017313
192,1568379600,606,322,0,928,37,-0.5368129078712619,0.459645689668019
192,1568394000,856,417,0,1273,37,-0.5368129078712619,1.2465391257844645
192,1568408400,848,527,0,1375,37,-0.5368129078712619,1.4791858808101963
192,1568422800,261,297,36,558,37,2.2814548584528636,-0.3842690099351255
192,1568437200,24,46,22,70,37,1.1854618382157034,-1.497324073195489
192,1568451600,122,92,0,214,37,-0.5368129078712619,-1.1688815955121032
192,1568466000,534,241,0,775,37,-0.5368129078712619,0.11067555712942138
192,1568480400,619,300,0,919,37,-0.5368129078712619,0.43911803481280737
192,1568494800,572,304,0,876,37,-0.5368129078712619,0.34104146161568516
192,1568509200,220,248,28,468,37,1.6551731326030577,-0.5895455584872418
192,1568523600,31,46,15,77,37,0.6374653280971235,-1.4813581194192134
192,1568538000,102,42,0,144,37,-0.5368129078712619,-1.3285411332748602
192,1568552400,479,251,0,730,37,-0.5368129078712619,0.008037282853363269
192,1568566800,557,303,0,860,37,-0.5368129078712619,0.30454785298419784
192,1568581200,390,306,0,696,37,-0.5368129078712619,-0.06951163548854732
192,1568595600,132,169,37,301,37,2.359740074184089,-0.9704475985783908
192,1568610000,14,12,0,26,37,-0.5368129078712619,-1.5976814969320794
192,1568624400,665,334,0,999,37,-0.5368129078712619,0.621586077970244
192,1568638800,487,328,0,815,37,-0.5368129078712619,0.20190957870813972
192,1568653200,723,431,0,1154,37,-0.5368129078712619,0.9751179115877775
192,1568667600,638,599,0,1237,37,-0.5368129078712619,1.1644285063636182
192,1568682000,192,194,2,386,38,-0.29746852057211365,-0.804550749045281
192,1568696400,15,22,7,37,38,-0.11898740822884547,-1.6177000891477238
192,1568710800,691,333,0,1024,38,-0.36886096550942093,0.6819514830044567
192,1568725200,553,344,0,897,38,-0.36886096550942093,0.3860490010760607
192,1568739600,671,451,0,1122,38,-0.36886096550942093,0.9102856816578647
192,1568754000,722,647,0,1369,38,-0.36886096550942093,1.4857810598965564
192,1568768400,199,228,29,427,38,0.6663294860815344,-0.7090231761392634
192,1568782800,11,15,4,26,38,-0.22607607563480636,-1.6433294379761676
192,1568797200,713,332,0,1045,38,-0.36886096550942093,0.7308802398587585
192,1568811600,559,308,0,867,38,-0.36886096550942093,0.3161507769984868
192,1568826000,721,404,0,1125,38,-0.36886096550942093,0.9172755040656222
192,1568840400,721,588,0,1309,38,-0.36886096550942093,1.3459846117414085
192,1568854800,179,249,70,428,38,2.1298746072963333,-0.7066932353366776
192,1568869200,15,13,0,28,38,-0.36886096550942093,-1.6386695563709959
192,1568883600,669,329,0,998,38,-0.36886096550942093,0.6213730221372261
192,1568898000,573,292,0,865,38,-0.36886096550942093,0.3114908953933152
192,1568912400,705,417,0,1122,38,-0.36886096550942093,0.9102856816578647
192,1568926800,761,616,0,1377,38,-0.36886096550942093,1.5044205863172426
192,1568941200,255,287,32,542,38,0.7734181534874953,-0.44107998384189684
192,1568955600,18,33,15,51,38,0.1665823715203836,-1.5850809179115226
192,1568970000,664,314,0,978,38,-0.36886096550942093,0.5747742060855101
192,1568984400,724,313,0,1037,38,-0.36886096550942093,0.7122407134380722
192,1568998800,820,425,0,1245,38,-0.36886096550942093,1.1968684003759176
192,1569013200,836,602,0,1438,38,-0.36886096550942093,1.6465469752749762
192,1569027600,251,304,53,555,38,1.5230388253292217,-0.4107907534082815
192,1569042000,29,48,19,77,38,0.30936726139499815,-1.524502457044292
192,1569056400,142,95,0,237,38,-0.36886096550942093,-1.1517119286305646
192,1569070800,546,202,0,748,38,-0.36886096550942093,0.03888782149077711
192,1569085200,616,289,0,905,38,-0.36886096550942093,0.40468852749674705
192,1569099600,542,335,0,877,38,-0.36886096550942093,0.33945018502434476
192,1569114000,221,105,0,326,38,-0.36886096550942093,-0.9443471972004287
192,1569128400,152,311,159,463,38,5.306838407006507,-0.6251453072461747
192,1569142800,90,59,0,149,38,-0.36886096550942093,-1.3567467192581146
192,1569157200,426,185,0,611,38,-0.36886096550942093,-0.2803140684634769
192,1569171600,544,318,0,862,38,-0.36886096550942093,0.30450107298555784
192,1569186000,323,290,0,613,38,-0.36886096550942093,-0.27565418685830534
192,1569200400,120,164,44,284,38,1.201772823111339,-1.0422047109090322
192,1569214800,21,15,0,36,38,-0.36886096550942093,-1.6200300299503096
192,1569229200,672,302,0,974,38,-0.36886096550942093,0.565454442875167
192,1569243600,516,314,0,830,38,-0.36886096550942093,0.22994296730281238
192,1569258000,730,397,0,1127,38,-0.36886096550942093,0.9219353856707937
192,1569272400,653,645,0,1298,38,-0.36886096550942093,1.320355262912965
192,1569286800,193,218,25,411,39,0.9597161212108701,-0.7070533734303294
192,1569301200,13,14,1,27,39,-0.4302175715772867,-1.5963426822258022
192,1569315600,655,327,0,982,39,-0.4881314754434599,0.6153013018879391
192,1569330000,564,308,0,872,39,-0.4881314754434599,0.36055696863923586
192,1569344400,779,453,0,1232,39,-0.4881314754434599,1.1942656956349917
192,1569358800,730,658,0,1388,39,-0.4881314754434599,1.5555394773331526
192,1569373200,198,239,41,437,39,1.8863385830696415,-0.6468410764806358
192,1569387600,13,13,0,26,39,-0.4881314754434599,-1.5986585398007904
192,1569402000,720,322,0,1042,39,-0.4881314754434599,0.7542527563872317
192,1569416400,586,354,0,940,39,-0.4881314754434599,0.5180352837384342
192,1569430800,741,468,0,1209,39,-0.4881314754434599,1.141000971410263
192,1569445200,719,618,0,1337,39,-0.4881314754434599,1.437430741008754
192,1569459600,203,240,37,443,39,1.6546829676049486,-0.6329459310307066
192,1569474000,19,16,0,35,39,-0.4881314754434599,-1.5778158216258966
192,1569488400,686,343,0,1029,39,-0.4881314754434599,0.7241466079123849
192,1569502800,589,334,0,923,39,-0.4881314754434599,0.47866570496363464
192,1569517200,759,460,0,1219,39,-0.4881314754434599,1.1641595471601451
192,1569531600,733,492,0,1225,39,-0.4881314754434599,1.1780546926100743
192,1569546000,204,271,67,475,39,3.3921000835901447,-0.5588384886310839
192,1569560400,20,27,7,47,39,-0.08273414838024745,-1.550025530726038
192,1569574800,648,328,0,976,39,-0.4881314754434599,0.6014061564380098
192,1569589200,656,327,0,983,39,-0.4881314754434599,0.6176171594629273
192,1569603600,855,435,0,1290,39,-0.4881314754434599,1.328585434984308
192,1569618000,868,600,0,1468,39,-0.4881314754434599,1.7408080833322095
192,1569632400,282,303,21,585,39,0.7280605057461774,-0.30409415538238066
192,1569646800,28,45,17,73,39,0.4964048902814846,-1.4898132337763446
192,1569661200,139,94,0,233,39,-0.4881314754434599,-1.119276021778231
192,1569675600,535,195,0,730,39,-0.4881314754434599,0.03170519299090993
192,1569690000,640,294,0,934,39,-0.4881314754434599,0.5041401382885049
192,1569704400,611,317,0,928,39,-0.4881314754434599,0.4902449928385757
192,1569718800,197,261,64,458,39,3.2183583719916253,-0.5982080674058834
192,1569733200,29,58,29,87,39,1.191371736675563,-1.4573912277265095
192,1569747600,110,54,0,164,39,-0.4881314754434599,-1.2790701944524174
192,1569762000,468,178,0,646,39,-0.4881314754434599,-0.1628268433080998
192,1569776400,464,330,0,794,39,-0.4881314754434599,0.17992007779015542
192,1569790800,353,305,0,658,39,-0.4881314754434599,-0.13503655240824125
192,1569805200,131,171,40,302,39,1.8284246792034684,-0.9594818491040443
192,1569819600,18,15,0,33,39,-0.4881314754434599,-1.582447536775873
192,1569834000,421,222,0,643,39,-0.4881314754434599,-0.16977441603306442
192,1569848400,486,293,0,779,39,-0.4881314754434599,0.14518221416533225
192,1569862800,575,332,0,907,39,-0.4881314754434599,0.44161198376382327
192,1569877200,555,560,5,1115,39,-0.19856195611259386,0.9233103593613711
192,1569891600,183,192,9,375,40,-0.4816043532249276,-0.6656407691183849
192,1569906000,11,27,16,38,40,-0.3414145711970774,-1.4321132264972998
192,1569920400,514,300,0,814,40,-0.6618483586893065,0.3328203845591926
192,1569934800,547,270,0,817,40,-0.6618483586893065,0.33964358150915325
192,1569949200,707,391,0,1098,40,-0.6618483586893065,0.9787496958221357
192,1569963600,670,585,0,1255,40,-0.6618483586893065,1.3358303362034105
192,1569978000,170,207,37,377,40,0.07915477488647317,-0.6610919711517445
192,1569992400,13,19,6,32,40,-0.5416856883797205,-1.4457596203972212
192,1570006800,667,298,0,965,40,-0.6618483586893065,0.6762546310405461
192,1570021200,638,305,0,943,40,-0.6618483586893065,0.6262178534075012
192,1570035600,693,476,0,1169,40,-0.6618483586893065,1.1402320236378714
192,1570050000,695,627,0,1322,40,-0.6618483586893065,1.4882150680858655
192,1570064400,182,235,53,417,40,0.3995885623787022,-0.5701160118189356
192,1570078800,19,15,0,34,40,-0.6618483586893065,-1.4412108224305806
192,1570093200,643,302,0,945,40,-0.6618483586893065,0.6307666513741417
192,1570107600,579,314,0,893,40,-0.6618483586893065,0.5124979042414901
192,1570122000,734,411,0,1145,40,-0.6618483586893065,1.085646448038186
192,1570136400,772,674,0,1446,40,-0.6618483586893065,1.7702405420175729
192,1570150800,229,289,60,518,40,0.5397783444065524,-0.34040171450359313
192,1570165200,20,15,0,35,40,-0.6618483586893065,-1.4389364234472604
192,1570179600,636,297,0,933,40,-0.6618483586893065,0.603473863574299
192,1570194000,639,364,0,1003,40,-0.6618483586893065,0.7626817924067145
192,1570208400,879,426,0,1305,40,-0.6618483586893065,1.4495502853694215
192,1570222800,852,552,0,1404,40,-0.6618483586893065,1.6747157847181235
192,1570237200,232,303,71,535,40,0.7600765733074598,-0.3017369317871494
192,1570251600,39,54,15,93,40,-0.36144168291534173,-1.3070212824146876
192,1570266000,60,136,76,196,40,0.8602121318987814,-1.0727581871327045
192,1570280400,146,246,100,392,40,1.340862813137125,-0.6269759864019411
192,1570294800,268,303,35,571,40,0.039100551449944544,-0.21985856838762138
192,1570309200,212,334,122,546,40,1.7814592709389399,-0.2767185429706269
192,1570323600,109,273,164,382,40,2.6225979631060414,-0.6497199762351433
192,1570338000,22,58,36,80,40,0.05912766316820886,-1.3365884691978505
192,1570352400,31,84,53,115,40,0.3995885623787022,-1.2569845047816426
192,1570366800,96,238,142,334,40,2.182001505304226,-0.758891127434514
192,1570381200,180,345,165,525,40,2.6426250748243056,-0.3244809216203516
192,1570395600,193,332,139,525,40,2.121920170149433,-0.3244809216203516
192,1570410000,86,173,87,259,40,1.0805103607996889,-0.9294710511835307
192,1570424400,18,20,2,38,40,-0.6217941352527778,-1.4321132264972998
192,1570438800,644,307,0,951,40,-0.6618483586893065,0.644413045274063
192,1570453200,564,306,0,870,40,-0.6618483586893065,0.460186727625125
192,1570467600,741,438,0,1179,40,-0.6618483586893065,1.1629760134710736
192,1570482000,634,534,0,1168,40,-0.6618483586893065,1.137957624654551
192,1570496400,166,240,74,406,41,2.9702965488410644,-0.6781225410091498
192,1570510800,15,20,5,35,41,-0.22967348779142802,-1.5914690216042375
192,1570525200,676,314,0,990,41,-0.4615553745039275,0.7595980645637109
192,1570539600,545,322,0,867,41,-0.4615553745039275,0.45679047126668715
192,1570554000,732,467,0,1199,41,-0.4615553745039275,1.2741247881334503
192,1570568400,667,540,0,1207,41,-0.4615553745039275,1.293819590949517
192,1570582800,185,236,51,421,41,1.903639869963567,-0.6411947857290249
192,1570597200,18,22,4,40,41,-0.27604986513392793,-1.579159769844196
192,1570611600,442,219,0,661,41,-0.4615553745039275,-0.050350701247027396
192,1570626000,522,336,0,858,41,-0.4615553745039275,0.43463381809861223
192,1570640400,586,362,0,948,41,-0.4615553745039275,0.6562003497793614
192,1570654800,683,504,0,1187,41,-0.4615553745039275,1.2445825839093505
192,1570669200,201,241,40,442,41,1.393499719196068,-0.5894959283368502
192,1570683600,16,18,2,34,41,-0.3688026198189277,-1.593930871956246
192,1570698000,651,358,0,1009,41,-0.4615553745039275,0.806373221251869
192,1570712400,567,390,0,957,41,-0.4615553745039275,0.6783570029474363
192,1570726800,778,423,0,1201,41,-0.4615553745039275,1.2790484888374671
192,1570741200,785,628,0,1413,41,-0.4615553745039275,1.8009607634632316
192,1570755600,227,305,78,532,41,3.155802058211064,-0.3679293966561011
192,1570770000,25,25,0,50,41,-0.4615553745039275,-1.5545412663241127
192,1570784400,632,311,0,943,41,-0.4615553745039275,0.6438910980193197
192,1570798800,651,303,0,954,41,-0.4615553745039275,0.6709714518914113
192,1570813200,825,435,0,1260,41,-0.4615553745039275,1.4242976596059582
192,1570827600,780,537,0,1317,41,-0.4615553745039275,1.5646231296704325
192,1570842000,279,297,18,576,41,0.37321941766107053,-0.25960798116773487
192,1570856400,29,41,12,70,41,0.09496115360607119,-1.5053042592839463
192,1570870800,133,83,0,216,41,-0.4615553745039275,-1.145874107890731
192,1570885200,510,195,0,705,41,-0.4615553745039275,0.05797071424133882
192,1570899600,629,306,0,935,41,-0.4615553745039275,0.6241962952032531
192,1570914000,534,338,0,872,41,-0.4615553745039275,0.46909972302672875
192,1570928400,220,277,57,497,41,2.1818981340185664,-0.4540941589763924
192,1570942800,42,56,14,98,41,0.18771390829107096,-1.4363724494277132
192,1570957200,87,60,0,147,41,-0.4615553745039275,-1.3157417821793054
192,1570971600,438,178,0,616,41,-0.4615553745039275,-0.16113396708740194
192,1570986000,500,288,0,788,41,-0.4615553745039275,0.26230429345802964
192,1571000400,360,267,0,627,41,-0.4615553745039275,-0.13405361321531037
192,1571014800,118,181,63,299,41,2.4601563980735657,-0.9415405286740404
192,1571029200,19,18,0,37,41,-0.4615553745039275,-1.586545320900221
192,1571043600,315,185,0,500,41,-0.4615553745039275,-0.44670860792036743
192,1571058000,486,296,0,782,41,-0.4615553745039275,0.2475331913459797
192,1571072400,565,315,0,880,41,-0.4615553745039275,0.48879452584279537
192,1571086800,566,479,0,1045,41,-0.4615553745039275,0.8949998339241687
192,1571101200,161,157,0,318,42,-0.4680297584785968,-0.9244691963257913
192,1571115600,19,15,0,34,42,-0.4680297584785968,-1.5752256775163511
192,1571130000,584,294,0,878,42,-0.4680297584785968,0.3587125975710875
192,1571144400,516,294,0,810,42,-0.4680297584785968,0.2028976654550379
192,1571158800,680,382,0,1062,42,-0.4680297584785968,0.7803294727086333
192,1571173200,679,596,0,1275,42,-0.4680297584785968,1.2683968336015532
192,1571187600,198,243,45,441,42,1.8971473632447935,-0.642627480880584
192,1571202000,18,18,0,36,42,-0.4680297584785968,-1.570642885395291
192,1571216400,620,328,0,948,42,-0.4680297584785968,0.5191103218081973
192,1571230800,555,329,0,884,42,-0.4680297584785968,0.3724609739342683
192,1571245200,691,406,0,1097,42,-0.4680297584785968,0.8605283348271883
192,1571259600,689,693,4,1382,42,-0.25779179210318437,1.5135762120782783
192,1571274000,162,219,57,381,42,2.527861262371031,-0.7801112445123924
192,1571288400,13,20,7,33,42,-0.100113317321625,-1.5775170735768813
192,1571302800,657,334,0,991,42,-0.4680297584785968,0.6176403524109934
192,1571317200,563,363,0,926,42,-0.4680297584785968,0.4686996084765342
192,1571331600,757,449,0,1206,42,-0.4680297584785968,1.1102905054249737
192,1571346000,844,635,0,1479,42,-0.4680297584785968,1.735841629949702
192,1571360400,225,304,79,529,42,3.6841700774358,-0.4409846275539316
192,1571374800,21,21,0,42,42,-0.4680297584785968,-1.55689450903211
192,1571389200,578,308,0,886,42,-0.4680297584785968,0.3770437660553286
192,1571403600,657,328,0,985,42,-0.4680297584785968,0.6038919760478125
192,1571418000,901,459,0,1360,42,-0.4680297584785968,1.4631654987466152
192,1571432400,849,525,0,1374,42,-0.4680297584785968,1.4952450435940372
192,1571446800,277,296,19,573,42,0.5306005818046123,-0.3401632008906054
192,1571461200,32,58,26,90,42,0.8985170229615842,-1.4469074981266632
192,1571475600,133,81,0,214,42,-0.4680297584785968,-1.162774386620926
192,1571490000,522,217,0,739,42,-0.4680297584785968,0.04020854515739792
192,1571504400,632,290,0,922,42,-0.4680297584785968,0.45953402423441364
192,1571518800,611,311,0,922,42,-0.4680297584785968,0.45953402423441364
192,1571533200,233,281,48,514,42,2.054825838026353,-0.4753555684618837
192,1571547600,37,61,24,98,42,0.793398039773878,-1.428576329642422
192,1571562000,98,68,0,166,42,-0.4680297584785968,-1.2727613975263725
192,1571576400,463,197,0,660,42,-0.4680297584785968,-0.14081174362448318
192,1571590800,519,331,0,850,42,-0.4680297584785968,0.2945535078762435
192,1571605200,358,276,0,634,42,-0.4680297584785968,-0.20038804119826684
192,1571619600,118,172,54,290,42,2.3701827875894717,-0.9886282860206351
192,1571634000,18,29,11,47,42,0.11012464905378747,-1.5454375287294593
192,1571648400,611,323,0,934,42,-0.4680297584785968,0.48703077696077535
192,1571662800,543,292,0,835,42,-0.4680297584785968,0.2601825669682914
192,1571677200,743,375,0,1118,42,-0.4680297584785968,0.9086476520983212
192,1571691600,696,642,0,1338,42,-0.4680297584785968,1.412754785414952
192,1571706000,177,206,29,383,43,1.3065040486942208,-0.7958204065061051
192,1571720400,20,17,0,37,43,-0.42507585479822857,-1.5903286606519365
192,1571734800,622,335,0,957,43,-0.42507585479822857,0.5222366393890022
192,1571749200,569,335,0,904,43,-0.42507585479822857,0.40053450797360035
192,1571763600,731,478,0,1209,43,-0.42507585479822857,1.100895830269781
192,1571778000,677,575,0,1252,43,-0.42507585479822857,1.1996352953803902
192,1571792400,164,241,77,405,43,4.172567337233447,-0.7453025406355609
192,1571806800,17,26,9,43,43,0.11231101180287648,-1.5765510608690607
192,1571821200,650,322,0,972,43,-0.42507585479822857,0.5566806388461915
192,1571835600,563,342,0,905,43,-0.42507585479822857,0.4028307746040796
192,1571850000,748,475,0,1223,43,-0.42507585479822857,1.133043563096491
192,1571864400,728,635,0,1363,43,-0.42507585479822857,1.4545208913635903
192,1571878800,208,255,47,463,43,2.381277781896431,-0.6121190760677626
192,1571893200,19,22,3,41,43,-0.24594689926452687,-1.5811435941300191
192,1571907600,651,332,0,983,43,-0.42507585479822857,0.5819395717814636
192,1571922000,587,329,0,916,43,-0.42507585479822857,0.4280897075393517
192,1571936400,695,391,0,1086,43,-0.42507585479822857,0.8184550347208295
192,1571950800,742,606,0,1348,43,-0.42507585479822857,1.420076891906401
192,1571965200,267,264,0,531,43,-0.42507585479822857,-0.4559729451951715
192,1571979600,22,31,9,53,43,0.11231101180287648,-1.553588394564268
192,1571994000,535,267,0,802,43,-0.42507585479822857,0.1663153116647137
192,1572008400,674,365,0,1039,43,-0.42507585479822857,0.7105305030883033
192,1572022800,819,439,0,1258,43,-0.42507585479822857,1.213412895163266
192,1572037200,877,624,0,1501,43,-0.42507585479822857,1.7714056863697312
192,1572051600,351,329,0,680,43,-0.42507585479822857,-0.11382921725375861
192,1572066000,37,56,19,93,43,0.7094075302485487,-1.4617377293450966
192,1572080400,135,90,0,225,43,-0.42507585479822857,-1.1586305341218315
192,1572094800,540,196,0,736,43,-0.42507585479822857,0.01476171405308113
192,1572109200,654,335,0,989,43,-0.42507585479822857,0.5957171715643392
192,1572123600,621,386,0,1007,43,-0.42507585479822857,0.6370499709129663
192,1572138000,249,303,54,552,43,2.7992453448084014,-0.4077513459551066
192,1572152400,38,54,16,92,43,0.5302785747148471,-1.464033995975576
192,1572166800,81,61,0,142,43,-0.42507585479822857,-1.3492206644516118
192,1572181200,397,213,0,610,43,-0.42507585479822857,-0.2745678813873083
192,1572195600,406,312,0,718,43,-0.42507585479822857,-0.02657108529554593
192,1572210000,353,290,0,643,43,-0.42507585479822857,-0.198791082581492
192,1572224400,113,148,35,261,43,1.664761959761624,-1.0759649354245775
192,1572238800,13,14,1,27,43,-0.36536620295366135,-1.613291326956729
192,1572253200,625,295,0,920,43,-0.42507585479822857,0.43727477406126886
192,1572267600,549,316,0,865,43,-0.42507585479822857,0.3109801093849084
192,1572282000,695,426,0,1121,43,-0.42507585479822857,0.8988243667876044
192,1572296400,696,591,0,1287,43,-0.42507585479822857,1.280004627447165
192,1572310800,161,235,74,396,44,3.117467232837781,-0.7816488436909347
192,1572325200,19,27,8,46,44,-0.15711373321994118,-1.5589616567241331
192,1572339600,659,319,0,978,44,-0.5540326381966348,0.5109113196956981
192,1572354000,567,304,0,871,44,-0.5540326381966348,0.2732756882826918
192,1572368400,739,490,0,1229,44,-0.5540326381966348,1.0683556513280776
192,1572382800,697,615,0,1312,44,-0.5540326381966348,1.2526898327045217
192,1572397200,209,264,55,473,44,2.174784833518134,-0.610640024823631
192,1572411600,15,20,5,35,44,-0.3059583225862013,-1.5833914879908908
192,1572426000,653,336,0,989,44,-0.5540326381966348,0.5353411509624558
192,1572440400,624,381,0,1005,44,-0.5540326381966348,0.5708754509868306
192,1572454800,758,464,0,1222,44,-0.5540326381966348,1.0528093950674136
192,1572469200,767,655,0,1422,44,-0.5540326381966348,1.4969881453720983
192,1572483600,226,269,43,495,44,1.5794064760530935,-0.5617803622901156
192,1572498000,17,29,12,46,44,0.04134571926840561,-1.5589616567241331
192,1572512400,587,309,0,896,44,-0.5540326381966348,0.3287980320707774
192,1572526800,553,321,0,874,44,-0.5540326381966348,0.27993836953726203
192,1572541200,745,488,0,1233,44,-0.5540326381966348,1.0772392263341712
192,1572555600,775,616,0,1391,44,-0.5540326381966348,1.4281404390748722
192,1572570000,275,311,36,586,44,1.2321024341984865,-0.35967903090148406
192,1572584400,29,46,17,75,44,0.2894200348788391,-1.4945557379299539
192,1572598800,648,326,0,974,44,-0.5540326381966348,0.5020277446896044
192,1572613200,661,306,0,967,44,-0.5540326381966348,0.4864814884289405
192,1572627600,899,472,0,1371,44,-0.5540326381966348,1.3837225640444037
192,1572642000,759,558,0,1317,44,-0.5540326381966348,1.263794301462139
192,1572656400,254,304,50,558,44,1.9267105179077004,-0.42186405594413995
192,1572670800,31,48,17,79,44,0.2894200348788391,-1.48567216292386
192,1572685200,148,107,0,255,44,-0.5540326381966348,-1.0947948626557376
192,1572699600,540,238,0,778,44,-0.5540326381966348,0.06673256939101334
192,1572714000,641,357,0,998,44,-0.5540326381966348,0.5553291947261666
192,1572728400,547,358,0,905,44,-0.5540326381966348,0.3487860758344882
192,1572742800,183,234,51,417,44,1.9763253810297872,-0.7350100749089428
192,1572753600,20,44,24,64,44,0.636724076733446,-1.5189855691967116
192,1572768000,64,53,0,117,44,-0.5540326381966348,-1.40127820036597
192,1572782400,424,186,0,610,44,-0.5540326381966348,-0.3063775808649219
192,1572796800,589,331,0,920,44,-0.5540326381966348,0.38209948210733957
192,1572811200,476,436,0,912,44,-0.5540326381966348,0.36433233209515214
192,1572825600,171,234,63,405,44,2.5717037384948274,-0.7616607999272238
192,1572840000,23,37,14,60,44,0.14057544551257903,-1.5278691442028052
192,1572854400,282,143,0,425,44,-0.5540326381966348,-0.7172429248967553
192,1572868800,841,401,0,1242,44,-0.5540326381966348,1.097227270097882
192,1572883200,624,403,0,1027,44,-0.5540326381966348,0.6197351135203459
192,1572897600,759,680,0,1439,44,-0.5540326381966348,1.5347433391479968
192,1572912000,245,359,114,604,45,4.031391810382315,-0.2988928710153381
192,1572926400,29,35,6,64,45,-0.2743282866024227,-1.4640510550352537
192,1572940800,253,147,0,400,45,-0.5135349586571304,-0.739063740533973
192,1572955200,839,345,0,1184,45,-0.5135349586571304,0.9525733266356824
192,1572969600,624,365,0,989,45,-0.5135349586571304,0.5318217601840461
192,1572984000,747,727,0,1474,45,-0.5135349586571304,1.5783064254611927
192,1572998400,322,372,50,694,45,1.4798539751321003,-0.1046998403453522
192,1573012800,33,41,8,74,45,-0.1945927292508535,-1.4424740516274777
192,1573027200,277,170,0,447,45,-0.5135349586571304,-0.6376518245174247
192,1573041600,839,438,0,1277,45,-0.5135349586571304,1.1532394583280012
192,1573056000,590,389,0,979,45,-0.5135349586571304,0.5102447567762699
192,1573070400,889,660,0,1549,45,-0.5135349586571304,1.7401339510195142
192,1573084800,320,395,75,715,45,2.476548442026716,-0.05938813318902214
192,1573099200,50,46,0,96,45,-0.5135349586571304,-1.3950046441303698
192,1573113600,290,165,0,455,45,-0.5135349586571304,-0.6203902217912037
192,1573128000,831,433,0,1264,45,-0.5135349586571304,1.125189353897892
192,1573142400,657,379,0,1036,45,-0.5135349586571304,0.6332336762005943
192,1573156800,916,643,0,1559,45,-0.5135349586571304,1.7617109544272904
192,1573171200,342,395,53,737,45,1.599457311159454,-0.01191872569191447
192,1573185600,54,75,21,129,45,0.3236883935343465,-1.3238005328847084
192,1573200000,261,172,0,433,45,-0.5135349586571304,-0.6678596292883114
192,1573214400,871,380,0,1251,45,-0.5135349586571304,1.097139249467783
192,1573228800,709,430,0,1139,45,-0.5135349586571304,0.8554768113006894
192,1573243200,969,555,0,1524,45,-0.5135349586571304,1.6861914425000737
192,1573257600,355,389,34,744,45,0.8419695163195465,0.0031851766935288815
192,1573272000,40,102,62,142,45,1.9582673192415156,-1.2957504284545993
192,1573286400,74,70,0,144,45,-0.5135349586571304,-1.291435027773044
192,1573300800,450,186,0,636,45,-0.5135349586571304,-0.22984646011045423
192,1573315200,699,343,0,1042,45,-0.5135349586571304,0.6461798782452601
192,1573329600,666,392,0,1058,45,-0.5135349586571304,0.680703083697702
192,1573344000,313,339,26,652,45,0.5230272869132696,-0.1953232546580123
192,1573358400,56,93,37,149,45,0.9615728523469004,-1.280646526069156
192,1573372800,44,42,0,86,45,-0.5135349586571304,-1.416581647538146
192,1573387200,410,153,0,563,45,-0.5135349586571304,-0.38735858498722064
192,1573401600,589,308,0,897,45,-0.5135349586571304,0.333313328832505
192,1573416000,451,314,0,765,45,-0.5135349586571304,0.04849688384985893
192,1573430400,182,223,41,405,45,1.1210439670500387,-0.7282752388300848
192,1573444800,30,44,14,74,45,0.044613942803854195,-1.4424740516274777
192,1573459200,206,147,0,353,45,-0.5135349586571304,-0.8404756565505211
192,1573473600,688,346,0,1034,45,-0.5135349586571304,0.6289182755190391
192,1573488000,549,386,0,935,45,-0.5135349586571304,0.4153059417820546
192,1573502400,794,640,0,1434,45,-0.5135349586571304,1.4919984118300877
192,1573516800,290,306,16,596,46,-0.1337527937906089,-0.2568278390495833
192,1573531200,33,52,19,85,46,-0.08795700026447652,-1.3940341690851012
192,1573545600,291,167,0,458,46,-0.3779970259299817,-0.5639403117401929
192,1573560000,809,395,0,1204,46,-0.3779970259299817,1.096247402949624
192,1573574400,538,357,0,895,46,-0.3779970259299817,0.4085825184467374
192,1573588800,759,591,0,1350,46,-0.3779970259299817,1.4211634972454863
192,1573603200,287,340,53,627,46,0.4310619930316906,-0.18783880532922897
192,1573617600,32,61,29,93,46,0.06469564482263146,-1.3762305474798486
192,1573632000,290,156,0,446,46,-0.3779970259299817,-0.5906457441480719
192,1573646400,696,420,0,1116,46,-0.3779970259299817,0.900407565291844
192,1573660800,276,411,135,687,46,1.682813682745976,-0.05431164328983352
192,1573675200,333,718,385,1051,46,5.499129809923676,0.7557531397491656
192,1573689600,1131,397,0,1528,46,-0.3779970259299817,1.8172940779623594
192,1573704000,40,65,25,105,46,0.003634586787788272,-1.3495251150719694
192,1573718400,281,180,0,461,46,-0.3779970259299817,-0.5572639536382231
192,1573732800,703,404,0,1107,46,-0.3779970259299817,0.8803784909859347
192,1573747200,258,420,162,678,46,2.0949758244811676,-0.07434071759574283
192,1573761600,896,628,0,1524,46,-0.3779970259299817,1.808392267159733
192,1573776000,316,371,55,687,46,0.4615925220491122,-0.05431164328983352
192,1573790400,45,64,19,109,46,-0.08795700026447652,-1.3406233042693432
192,1573804800,255,145,0,400,46,-0.3779970259299817,-0.6930165683782751
192,1573819200,813,417,0,1230,46,-0.3779970259299817,1.1541091731666955
192,1573833600,619,374,0,993,46,-0.3779970259299817,0.6266768831110833
192,1573848000,974,660,0,1634,46,-0.3779970259299817,2.053192064231958
192,1573862400,354,399,45,753,46,0.3089398769620042,0.09256823495350149
192,1573876800,47,84,37,131,46,0.18681776089231783,-1.2916633448548982
192,1573891200,71,74,3,145,46,-0.33220123240384924,-1.2605070070457058
192,1573905600,485,164,0,649,46,-0.3779970259299817,-0.13887884591478397
192,1573920000,594,189,0,783,46,-0.3779970259299817,0.1593318159731992
192,1573934400,703,283,0,986,46,-0.3779970259299817,0.6110987142064872
192,1573948800,329,290,0,619,46,-0.3779970259299817,-0.2056424269344817
192,1573963200,57,95,38,152,46,0.20208302540102863,-1.2449288381411097
192,1573977600,44,47,3,91,46,-0.33220123240384924,-1.3806814528811617
192,1573992000,354,152,0,506,46,-0.3779970259299817,-0.4571185821086765
192,1574006400,541,299,0,840,46,-0.3779970259299817,0.2861826199106249
192,1574020800,425,368,0,793,46,-0.3779970259299817,0.18158634297976511
192,1574035200,165,169,4,334,46,-0.31693596789513845,-0.8398964466216101
192,1574049600,22,34,12,56,46,-0.1948138518254521,-1.4585722974041424
192,1574064000,279,155,0,434,46,-0.3779970259299817,-0.6173511765559511
192,1574078400,785,425,0,1210,46,-0.3779970259299817,1.1096001191535636
192,1574092800,488,375,0,863,46,-0.3779970259299817,0.3373680320257265
192,1574107200,842,628,0,1470,46,-0.3779970259299817,1.6882178213242771
192,1574121600,269,353,84,622,47,1.3548551911617122,-0.2327673454437847
192,1574136000,35,42,7,77,47,-0.3155991314524614,-1.399918394120287
192,1574150400,307,170,0,477,47,-0.46745861532647714,-0.5432937712384505
192,1574164800,866,433,0,1299,47,-0.46745861532647714,1.2170698287837238
192,1574179200,578,403,0,981,47,-0.46745861532647714,0.5360532535926636
192,1574193600,836,682,0,1518,47,-0.46745861532647714,1.6860718098115293
192,1574208000,282,385,103,667,47,1.767045218819755,-0.13639707536957807
192,1574222400,37,50,13,87,47,-0.18543385956044783,-1.378502778548241
192,1574236800,287,156,0,443,47,-0.46745861532647714,-0.6161068641834065
192,1574251200,720,449,0,1169,47,-0.46745861532647714,0.938666826347127
192,1574265600,248,427,179,675,47,3.415805329451927,-0.11926458291194132
192,1574280000,864,726,0,1590,47,-0.46745861532647714,1.84026424193026
192,1574294400,339,396,57,735,47,0.7691114676476513,0.009229110520334165
192,1574308800,36,49,13,85,47,-0.18543385956044783,-1.3827859016626503
192,1574323200,335,169,0,504,47,-0.46745861532647714,-0.48547160919392646
192,1574337600,709,441,0,1150,47,-0.46745861532647714,0.8979771567602397
192,1574352000,264,473,209,737,47,4.066631688911994,0.013512233634743348
192,1574366400,1078,565,0,1643,47,-0.46745861532647714,1.9537670044621034
192,1574380800,372,424,52,796,47,0.6606404077376401,0.13986436550981424
192,1574395200,62,76,14,138,47,-0.16373964757844559,-1.269283139130807
192,1574409600,285,189,0,474,47,-0.46745861532647714,-0.5497184559100642
192,1574424000,854,376,0,1230,47,-0.46745861532647714,1.069302081336607
192,1574438400,634,383,0,1017,47,-0.46745861532647714,0.613149469652029
192,1574452800,916,608,0,1524,47,-0.46745861532647714,1.698921179154757
192,1574467200,395,371,0,766,47,-0.46745861532647714,0.07561751879367651
192,1574481600,47,99,52,146,47,0.6606404077376401,-1.2521506466731702
192,1574496000,67,60,0,127,47,-0.46745861532647714,-1.2928403162600575
192,1574510400,427,171,0,598,47,-0.46745861532647714,-0.28416482281669486
192,1574524800,718,288,0,1006,47,-0.46745861532647714,0.5895922925227784
192,1574539200,630,388,0,1018,47,-0.46745861532647714,0.6152910312092336
192,1574553600,299,304,5,603,47,-0.3589875554164659,-0.27345701503067193
192,1574568000,55,97,42,152,47,0.44369828791761756,-1.2393012773299428
192,1574582400,47,45,0,92,47,-0.46745861532647714,-1.3677949707622181
192,1574596800,347,148,0,495,47,-0.46745861532647714,-0.5047456632087678
192,1574611200,487,291,0,778,47,-0.46745861532647714,0.10131625748013161
192,1574625600,391,326,0,717,47,-0.46745861532647714,-0.029318997509348483
192,1574640000,143,208,65,351,47,0.9426651635036694,-0.8131305274462289
192,1574654400,24,34,10,58,47,-0.2505164955064546,-1.4406080637071743
192,1574668800,267,152,0,419,47,-0.46745861532647714,-0.6675043415563168
192,1574683200,813,407,0,1220,47,-0.46745861532647714,1.047886465764561
192,1574697600,625,330,0,955,47,-0.46745861532647714,0.4803726531053443
192,1574712000,890,660,0,1550,47,-0.46745861532647714,1.7546017796420763
192,1574726400,207,286,79,493,48,2.752078773714196,-0.21717428737907093
192,1574740800,29,30,1,59,48,-0.5062551846116826,-1.3272844697530766
192,1574755200,281,181,0,462,48,-0.5480286968979118,-0.2964678718343571
192,1574769600,827,406,0,1233,48,-0.5480286968979118,1.6756403092955008
192,1574784000,689,383,0,1072,48,-0.5480286968979118,1.2638252416406277
192,1574798400,932,639,0,1571,48,-0.5480286968979118,2.540196165614427
192,1574812800,299,379,80,678,48,2.793852286000425,0.25602936178957203
192,1574827200,27,59,32,86,48,0.7887236962614229,-1.2582223155500853
192,1574841600,239,128,0,367,48,-0.5480286968979118,-0.5394643403263629
192,1574856000,710,281,0,991,48,-0.5480286968979118,1.0566387790316545
192,1574870400,813,307,0,1120,48,-0.5480286968979118,1.3866024046681675
192,1574884800,656,446,0,1102,48,-0.5480286968979118,1.3405609685328401
192,1574899200,236,310,74,546,48,2.5432112122830497,-0.08160783653616242
192,1574913600,35,59,24,94,48,0.4545355979715893,-1.2377594550454956
192,1574928000,96,60,0,156,48,-0.5480286968979118,-1.0791722861349233
192,1574942400,416,161,0,577,48,-0.5480286968979118,-0.0023142520808763015
192,1574956800,468,222,0,690,48,-0.5480286968979118,0.28672365254645693
192,1574971200,337,191,0,528,48,-0.5480286968979118,-0.12764927267148984
192,1574985600,206,180,0,386,48,-0.5480286968979118,-0.4908650466279617
192,1575000000,26,47,21,73,48,0.32921506111290166,-1.2914744638700442
192,1575014400,75,85,10,160,48,-0.13029357403561967,-1.0689408558826283
192,1575028800,434,186,0,620,48,-0.5480286968979118,0.10767362313129476
192,1575043200,579,266,0,845,48,-0.5480286968979118,0.6831915748228875
192,1575057600,504,411,0,915,48,-0.5480286968979118,0.8622416042380497
192,1575072000,206,287,81,493,48,2.8356257982866544,-0.21717428737907093
192,1575086400,27,61,34,88,48,0.8722707208338814,-1.253106600423938
192,1575100800,38,52,14,90,48,0.03680047510929718,-1.2479908852977903
192,1575115200,348,139,0,487,48,-0.5480286968979118,-0.2325214327575134
192,1575129600,542,256,0,798,48,-0.5480286968979118,0.5629722693584215
192,1575144000,447,328,0,775,48,-0.5480286968979118,0.5041415454077254
192,1575158400,213,252,39,465,48,1.0811382822650275,-0.2887942991451358
192,1575172800,42,78,36,120,48,0.9558177454063398,-1.1712551584055781
192,1575187200,47,51,4,98,48,-0.38093464775299496,-1.2275280247932006
192,1575201600,381,162,0,543,48,-0.5480286968979118,-0.08928140922538365
192,1575216000,492,262,0,754,48,-0.5480286968979118,0.45042653658317666
192,1575230400,302,308,6,610,48,-0.2973876231805365,0.08209504750055731
192,1575244800,165,157,0,322,48,-0.5480286968979118,-0.6545679306646814
192,1575259200,25,41,16,66,48,0.12034749968175561,-1.3093794668115604
192,1575273600,266,160,0,426,48,-0.5480286968979118,-0.3885507441050119
192,1575288000,743,350,0,1093,48,-0.5480286968979118,1.3175402504651765
192,1575302400,547,335,0,882,48,-0.5480286968979118,0.7778323046566161
192,1575316800,679,659,0,1338,48,-0.5480286968979118,1.9442153534182443
192,1575331200,204,301,97,505,49,2.6689401239666966,-0.5012748710762408
192,1575345600,24,42,18,66,49,0.0968973324123837,-1.4659451636243808
192,1575360000,312,130,0,442,49,-0.4891377340177129,-0.6397127490501197
192,1575374400,783,437,0,1220,49,-0.4891377340177129,1.069885172595559
192,1575388800,586,375,0,961,49,-0.4891377340177129,0.5007516742585014
192,1575403200,829,654,0,1483,49,-0.4891377340177129,1.6478083774706405
192,1575417600,281,373,92,654,49,2.506152605513892,-0.17385830253484477
192,1575432000,29,55,26,84,49,0.35735736193687107,-1.4263914842032726
192,1575446400,262,159,0,421,49,-0.4891377340177129,-0.6858587083747459
192,1575460800,873,329,0,1202,49,-0.4891377340177129,1.0303314931744507
192,1575475200,632,316,0,948,49,-0.4891377340177129,0.47218512800992324
192,1575489600,805,673,0,1478,49,-0.4891377340177129,1.6368212442981105
192,1575504000,282,389,107,671,49,2.994515160872306,-0.13650204974824254
192,1575518400,32,45,13,77,49,-0.0658901860404209,-1.4417734706448146
192,1575532800,302,172,0,474,49,-0.4891377340177129,-0.5693950967459273
192,1575547200,852,328,0,1180,49,-0.4891377340177129,0.9819881072153184
192,1575561600,698,244,0,942,49,-0.4891377340177129,0.45900056820288715
192,1575576000,860,672,0,1532,49,-0.4891377340177129,1.7554822825614351
192,1575590400,253,367,114,620,49,3.2224176867062324,-0.24857080810804924
192,1575604800,37,65,28,102,49,0.4224723693179929,-1.3868378047821643
192,1575619200,270,175,0,445,49,-0.4891377340177129,-0.6331204691466016
192,1575633600,863,319,0,1182,49,-0.4891377340177129,0.9863829604843304
192,1575648000,745,229,0,974,49,-0.4891377340177129,0.5293182205070796
192,1575662400,911,641,0,1552,49,-0.4891377340177129,1.7994308152515555
192,1575676800,373,353,0,726,49,-0.4891377340177129,-0.0156435848504118
192,1575691200,53,104,51,157,49,1.1712949542008941,-1.2659793398843335
192,1575705600,91,72,0,163,49,-0.4891377340177129,-1.2527947800772974
192,1575720000,460,208,0,668,49,-0.4891377340177129,-0.14309432965176058
192,1575734400,702,319,0,1021,49,-0.4891377340177129,0.6325972723288622
192,1575748800,699,424,0,1123,49,-0.4891377340177129,0.8567347890484757
192,1575763200,353,343,0,696,49,-0.4891377340177129,-0.0815663838855922
192,1575777600,61,99,38,160,49,0.7480474062236021,-1.2593870599808155
192,1575792000,47,58,11,105,49,-0.13100519342154276,-1.3802455248786463
192,1575806400,368,182,0,550,49,-0.4891377340177129,-0.4023906725234702
192,1575820800,624,337,0,961,49,-0.4891377340177129,0.5007516742585014
192,1575835200,418,391,0,809,49,-0.4891377340177129,0.16674282581358735
192,1575849600,179,200,21,379,49,0.19456984348406647,-0.7781506270239985
192,1575864000,26,41,15,67,49,-0.0007751786592990668,-1.4637477369898748
192,1575878400,265,136,0,401,49,-0.4891377340177129,-0.7298072410648663
192,1575892800,787,424,0,1211,49,-0.4891377340177129,1.050108332885005
192,1575907200,598,397,0,995,49,-0.4891377340177129,0.5754641798317058
192,1575921600,715,669,0,1384,49,-0.4891377340177129,1.4302631406545452
192,1575936000,254,322,68,576,50,1.833131639219981,-0.48147510292049167
192,1575950400,31,51,20,82,50,0.30476382091250304,-1.485964337248733
192,1575964800,254,173,0,427,50,-0.3320561033822795,-0.7844485764324511
192,1575979200,814,410,0,1224,50,-0.3320561033822795,0.8361545000040029
192,1575993600,614,387,0,1001,50,-0.3320561033822795,0.3827109792444932
192,1576008000,817,562,0,1379,50,-0.3320561033822795,1.1513282476171152
192,1576022400,221,399,178,620,50,5.335641222841286,-0.392006426178705
192,1576036800,283,61,0,344,50,-0.3320561033822795,-0.9532190348317305
192,1576051200,300,169,0,469,50,-0.3320561033822795,-0.699046657724382
192,1576065600,881,411,0,1292,50,-0.3320561033822795,0.9744242731504005
192,1576080000,524,331,0,855,50,-0.3320561033822795,0.08583764278311017
192,1576094400,868,605,0,1473,50,-0.3320561033822795,1.3424658752018412
192,1576108800,271,341,70,612,50,1.8968136316494593,-0.4082734583135753
192,1576123200,36,43,7,79,50,-0.10916912987910558,-1.4920644742993092
192,1576137600,272,178,0,450,50,-0.3320561033822795,-0.7376808590446989
192,1576152000,878,461,0,1339,50,-0.3320561033822795,1.0699930869427636
192,1576166400,591,414,0,1005,50,-0.3320561033822795,0.3908444953119284
192,1576180800,874,599,0,1473,50,-0.3320561033822795,1.3424658752018412
192,1576195200,329,318,0,647,50,-0.3320561033822795,-0.33710519272351774
192,1576209600,337,281,0,618,50,-0.3320561033822795,-0.3960731842124226
192,1576224000,407,140,0,547,50,-0.3320561033822795,-0.5404430944093965
192,1576238400,1282,424,0,1706,50,-0.3320561033822795,1.8162431861299388
192,1576252800,1166,430,0,1596,50,-0.3320561033822795,1.592571494275472
192,1576267200,1316,652,0,1968,50,-0.3320561033822795,2.3489884885469414
192,1576281600,691,387,0,1078,50,-0.3320561033822795,0.5392811635426199
192,1576296000,120,79,0,199,50,-0.3320561033822795,-1.2480589922762548
192,1576310400,117,57,0,174,50,-0.3320561033822795,-1.2988934676977244
192,1576324800,533,200,0,733,50,-0.3320561033822795,-0.16223459727366196
192,1576339200,676,377,0,1053,50,-0.3320561033822795,0.4884466881211502
192,1576353600,685,500,0,1185,50,-0.3320561033822795,0.7568527183465102
192,1576368000,416,357,0,773,50,-0.3320561033822795,-0.08089943659931045
192,1576382400,54,109,55,163,50,1.4191986884283725,-1.3212606368831712
192,1576396800,46,46,0,92,50,-0.3320561033822795,-1.4656305470801452
192,1576411200,366,173,0,539,50,-0.3320561033822795,-0.5567101265442669
192,1576425600,597,359,0,956,50,-0.3320561033822795,0.29120892348584776
192,1576440000,469,385,0,854,50,-0.3320561033822795,0.08380426376625137
192,1576454400,207,243,36,450,50,0.814219760348329,-0.7376808590446989
192,1576468800,26,30,4,56,50,-0.20469211852332295,-1.5388321916870615
192,1576483200,268,162,0,430,50,-0.3320561033822795,-0.7783484393818747
192,1576497600,814,418,0,1232,50,-0.3320561033822795,0.8524215321388733
192,1576512000,625,352,0,977,50,-0.3320561033822795,0.3339098828398823
192,1576526400,830,581,0,1411,50,-0.3320561033822795,1.2163963761565963
192,1576540800,233,332,99,565,51,2.95227916782718,-0.3771420376787119
192,1576555200,23,57,34,80,51,0.6819349063713488,-1.3751133688706265
192,1576569600,282,142,0,424,51,-0.5056297842363171,-0.6672739092211036
192,1576584000,787,442,0,1229,51,-0.5056297842363171,0.9891527332726929
192,1576598400,653,430,0,1083,51,-0.5056297842363171,0.6887324974912094
192,1576612800,792,698,0,1490,51,-0.5056297842363171,1.5262053465532903
192,1576627200,256,363,107,619,51,3.2317061538525134,-0.2660277038965193
192,1576641600,33,49,16,82,51,0.053224187814349164,-1.3709980231749899
192,1576656000,257,157,0,414,51,-0.5056297842363171,-0.6878506376992874
192,1576670400,828,429,0,1257,51,-0.5056297842363171,1.0467675730116077
192,1576684800,732,413,0,1145,51,-0.5056297842363171,0.816308214055949
192,1576699200,910,651,0,1561,51,-0.5056297842363171,1.6723001187483955
192,1576713600,267,374,107,641,51,3.2317061538525134,-0.22075890124451494
192,1576728000,25,52,27,77,51,0.43743629359918224,-1.3812863874140817
192,1576742400,254,185,0,439,51,-0.5056297842363171,-0.6364088165038279
192,1576756800,837,411,0,1248,51,-0.5056297842363171,1.0282485173812421
192,1576771200,722,420,0,1142,51,-0.5056297842363171,0.8101351955124938
192,1576785600,915,718,0,1633,51,-0.5056297842363171,1.820452563791319
192,1576800000,379,402,23,781,51,0.2977228005865157,0.06731529745005836
192,1576814400,45,73,28,118,51,0.47236466685234885,-1.2969218006535281
192,1576828800,245,150,0,395,51,-0.5056297842363171,-0.7269464218078366
192,1576843200,825,427,0,1252,51,-0.5056297842363171,1.0364792087725156
192,1576857600,837,408,0,1245,51,-0.5056297842363171,1.0220754988377871
192,1576872000,819,605,0,1424,51,-0.5056297842363171,1.3903989385972773
192,1576886400,405,340,0,745,51,-0.5056297842363171,-0.006760925071403351
192,1576900800,40,83,43,123,51,0.9962902656498486,-1.2866334364144363
192,1576915200,64,62,0,126,51,-0.5056297842363171,-1.280460417870981
192,1576929600,420,168,0,588,51,-0.5056297842363171,-0.32981556217888913
192,1576944000,745,349,0,1094,51,-0.5056297842363171,0.7113668988172116
192,1576958400,695,402,0,1097,51,-0.5056297842363171,0.7175399173606667
192,1576972800,346,291,0,637,51,-0.5056297842363171,-0.22898959263578847
192,1576987200,45,72,27,117,51,0.43743629359918224,-1.2989794735013465
192,1577001600,40,50,10,90,51,-0.15634605170465068,-1.3545366403924428
192,1577016000,369,154,0,523,51,-0.5056297842363171,-0.46356429728708387
192,1577030400,578,281,0,859,51,-0.5056297842363171,0.22781377957989207
192,1577044800,492,328,0,820,51,-0.5056297842363171,0.1475645385149752
192,1577059200,178,239,61,417,51,1.625000984206848,-0.6816776191558322
192,1577073600,23,49,26,72,51,0.40250792034601557,-1.3915747516531736
192,1577088000,124,120,0,244,51,-0.5056297842363171,-1.0376550218284122
192,1577102400,600,306,0,906,51,-0.5056297842363171,0.32452440342735595
192,1577116800,757,306,0,1063,51,-0.5056297842363171,0.6475790405348417
192,1577131200,1117,446,0,1563,51,-0.5056297842363171,1.676415464444032
192,1577145600,202,273,71,475,52,1.054988525524907,0.03568287127180492
192,1577160000,28,63,35,91,52,0.22934533163584933,-1.2744898045885724
192,1577174400,94,96,2,190,52,-0.5274942627624535,-0.9367109115933189
192,1577188800,480,210,0,690,52,-0.5733633290896233,0.7692430934332141
192,1577203200,600,324,0,924,52,-0.5733633290896233,1.5676295677856316
192,1577217600,525,311,0,836,52,-0.5733633290896233,1.2673816629009618
192,1577232000,189,237,48,426,52,0.5274942627624535,-0.1315006212207953
192,1577246400,94,41,0,135,52,-0.5733633290896233,-1.1243658521462374
192,1577260800,28,41,13,69,52,-0.2752143979630192,-1.34955178080974
192,1577275200,177,118,0,295,52,-0.5733633290896233,-0.5784605705377469
192,1577289600,408,179,0,587,52,-0.5733633290896233,0.4178165683977483
192,1577304000,329,205,0,534,52,-0.5733633290896233,0.2369854438649358
192,1577318400,139,188,49,327,52,0.5504287959260384,-0.46927951421604885
192,1577332800,16,31,15,47,52,-0.22934533163584933,-1.4246137570309074
192,1577347200,80,101,21,181,52,-0.09173813265433974,-0.9674180836837964
192,1577361600,422,229,0,651,52,-0.5733633290896233,0.6361786810411445
192,1577376000,559,259,0,818,52,-0.5733633290896233,1.2059673187200066
192,1577390400,545,381,0,926,52,-0.5733633290896233,1.5744533838057377
192,1577404800,151,270,119,421,52,2.1558461173769836,-0.14856016127106064
192,1577419200,21,53,32,74,52,0.16054173214509454,-1.3324922407594746
192,1577433600,98,110,12,208,52,-0.2981489311266041,-0.8752965674123637
192,1577448000,472,251,0,723,52,-0.5733633290896233,0.8818360577649653
192,1577462400,561,307,0,868,52,-0.5733633290896233,1.37656271922266
192,1577476800,235,418,183,653,52,3.6236562398464196,0.6430024970612507
