remote_unit_id,time_stamp,entries,exits,num_people_exited,sum_exit_entry,week_num,z_score_num_people_exited,z_score_sum_exit_entry
10,1546304400,486,1067,581,1553,1,3.6774870395757735,0.8570438660130583
10,1546318800,603,220,0,823,1,-0.5858381905737182,-0.5455946613148823
10,1546333200,146,160,14,306,1,-0.4831074621363811,-1.5389701662854922
10,1546347600,418,339,0,757,1,-0.5858381905737182,-0.6724085555664495
10,1546362000,751,611,0,1362,1,-0.5858381905737182,0.4900521417395834
10,1546376400,990,648,0,1638,1,-0.5858381905737182,1.0203647904279554
10,1546390800,771,177,0,948,1,-0.5858381905737182,-0.30541683129297464
10,1546405200,210,68,0,278,1,-0.5858381905737182,-1.5927700002103995
10,1546419600,354,663,309,1017,1,1.6815757442217945,-0.17283866912088164
10,1546434000,575,919,344,1494,1,1.9384025653151373,0.7436799302427178
10,1546448400,802,869,67,1671,1,-0.09419827590931906,1.083771737553739
10,1546462800,1132,928,0,2060,1,-0.5858381905737182,1.8312051445819155
10,1546477200,743,197,0,940,1,-0.5858381905737182,-0.3207882124143767
10,1546491600,187,85,0,272,1,-0.5858381905737182,-1.604298536051451
10,1546506000,409,617,208,1026,1,0.940446917638148,-0.1555458653593043
10,1546520400,563,872,309,1435,1,1.6815757442217945,0.6303159944723775
10,1546534800,794,770,0,1564,1,-0.5858381905737182,0.8781795150549861
10,1546549200,1011,1082,71,2093,1,-0.06484663921293703,1.8946120917076992
10,1546563600,733,256,0,989,1,-0.5858381905737182,-0.22663850304578895
10,1546578000,181,140,0,321,1,-0.5858381905737182,-1.5101488266828633
10,1546592400,377,616,239,993,1,1.1679221020351087,-0.2189528124850879
10,1546601602,412,342,0,754,1,-0.5858381905737182,-0.6781728234869753
10,1546606800,432,850,418,1282,1,2.481407844198205,0.3363383305255625
10,1546621200,797,819,22,1616,1,-0.424404188743617,0.9780934923440997
10,1546635600,1071,1066,0,2137,1,-0.5858381905737182,1.9791546878754107
10,1546650000,929,290,0,1219,1,-0.5858381905737182,0.2152887041945211
10,1546664400,302,114,0,416,1,-0.5858381905737182,-1.3276136758662136
10,1546678800,145,266,121,411,1,0.3020488194918385,-1.3372207890670897
10,1546693200,546,603,57,1149,1,-0.16757736765027417,0.08078911938225282
10,1546707600,734,799,65,1533,1,-0.10887409425751009,0.818615413209553
10,1546722000,864,701,0,1565,1,-0.5858381905737182,0.8801009376951614
10,1546736400,932,234,0,1166,1,-0.5858381905737182,0.11345330426523226
10,1546750800,268,88,0,356,1,-0.5858381905737182,-1.4428990342767292
10,1546765200,129,182,53,311,1,-0.19692900434665622,-1.5293630530846158
10,1546779600,511,468,0,979,1,-0.5858381905737182,-0.24585272944754155
10,1546794000,612,711,99,1323,1,0.14061481766173725,0.4151166587727482
10,1546808400,803,484,0,1287,1,-0.5858381905737182,0.3459454437264388
10,1546822800,614,200,0,814,1,-0.5858381905737182,-0.5628874650764596
10,1546837200,164,73,0,237,1,-0.5858381905737182,-1.6715483284575852
10,1546851600,424,622,198,1046,1,0.8670678258971928,-0.11711741255579906
10,1546866000,551,809,258,1360,1,1.3073423763429235,0.4862092964592329
10,1546880400,739,645,0,1384,1,-0.5858381905737182,0.5323234398234391
10,1546894800,967,747,0,1714,1,-0.5858381905737182,1.1663929110812752
10,1546909200,518,201,0,719,2,-0.6388734465911772,-0.7311655851707853
10,1546923600,145,81,0,226,2,-0.6388734465911772,-1.6855572265088856
10,1546938000,447,628,181,1075,2,0.8364351624568571,-0.04199028229783674
10,1546952400,516,822,306,1338,2,1.8552946990922399,0.4671476521279652
10,1546966800,751,653,0,1404,2,-0.6388734465911772,0.5949161071549726
10,1546981200,1029,916,0,1945,2,-0.6388734465911772,1.6422302612399873
10,1546995600,794,239,0,1033,2,-0.6388734465911772,-0.12329748095138686
10,1547010000,181,85,0,266,2,-0.6388734465911772,-1.6081217992197903
10,1547024400,428,698,270,1126,2,1.5618631525412496,0.05673988749575983
10,1547038800,565,1030,465,1595,2,3.1512840296924467,0.9646702724604028
10,1547053200,782,796,14,1578,2,-0.5247611784880143,0.9317602158625373
10,1547067600,949,918,0,1867,2,-0.6388734465911772,1.4912311780262513
10,1547082000,661,233,0,894,2,-0.6388734465911772,-0.3923855907809932
10,1547096400,189,97,0,286,2,-0.6388734465911772,-1.5694040855752425
10,1547110800,491,630,139,1121,2,0.49409835814736847,0.04706045908462291
10,1547125200,567,856,289,1423,2,1.7167298021098278,0.6316979351172928
10,1547139600,763,779,16,1542,2,-0.5084594259018481,0.8620683313023515
10,1547154000,945,950,5,1895,2,-0.5981190651257619,1.545435977128618
10,1547168400,643,261,0,904,2,-0.6388734465911772,-0.3730267339587194
10,1547182800,189,109,0,298,2,-0.6388734465911772,-1.546173457388514
10,1547197200,469,603,134,1072,2,0.4533439766819532,-0.04779793934451889
10,1547211600,517,879,362,1396,2,2.311743771504891,0.5794290216971535
10,1547226000,737,734,0,1471,2,-0.6388734465911772,0.7246204478642072
10,1547240400,1028,1191,163,2219,2,0.689719389181362,2.17266293817029
10,1547254800,914,275,0,1189,2,-0.6388734465911772,0.178700685476085
10,1547269200,254,111,0,365,2,-0.6388734465911772,-1.4164691166792793
10,1547283600,143,239,96,382,2,0.1436106775447968,-1.3835590600814138
10,1547298000,457,640,183,1097,2,0.8527369150430232,0.0005992027111657027
10,1547312400,833,721,0,1554,2,-0.6388734465911772,0.8852989594890801
10,1547326800,868,685,0,1553,2,-0.6388734465911772,0.8833630738068527
10,1547341200,827,246,0,1073,2,-0.6388734465911772,-0.045862053662291506
10,1547355600,266,117,0,383,2,-0.6388734465911772,-1.3816231743991862
10,1547370000,110,197,87,307,2,0.07025279090704926,-1.5287504862484675
10,1547384400,410,455,45,865,2,-0.2720840134024394,-0.44852627556558733
10,1547398800,630,662,32,1292,2,-0.37804540521251917,0.37809691074550555
10,1547413200,747,391,0,1138,2,-0.6388734465911772,0.07997051568248843
10,1547427600,548,166,0,714,2,-0.6388734465911772,-0.7408450135819223
10,1547442000,170,81,0,251,2,-0.6388734465911772,-1.637160084453201
10,1547456400,441,607,166,1048,2,0.7141720180606111,-0.0942591957179761
10,1547470800,483,822,339,1305,2,2.124273616763981,0.4032634246144615
10,1547485200,675,617,0,1292,2,-0.6388734465911772,0.37809691074550555
10,1547499600,850,710,0,1560,2,-0.6388734465911772,0.8969142735824445
10,1547514000,558,240,0,798,3,-0.6180272468853478,-0.597360991690135
10,1547528400,139,93,0,232,3,-0.6180272468853478,-1.642127434778561
10,1547542800,512,702,190,1214,3,0.8219311268796378,0.17052388520877879
10,1547557200,489,826,337,1315,3,1.9360041844767584,0.356957473109717
10,1547571600,877,747,0,1624,3,-0.6180272468853478,0.9273334994601121
10,1547586000,1178,1068,0,2246,3,-0.6180272468853478,2.0754690605926225
10,1547600400,794,198,0,992,3,-0.6180272468853478,-0.23926083275169927
10,1547614800,186,102,0,288,3,-0.6180272468853478,-1.5387583167344765
10,1547629200,498,705,207,1203,3,0.9507695076901891,0.15021923702154788
10,1547643600,559,1096,537,1655,3,3.45174984107148,0.9845556898059445
10,1547658000,770,883,113,1653,3,0.2383690490906699,0.9808639355900844
10,1547672400,962,936,0,1898,3,-0.6180272468853478,1.4331038270329544
10,1547686800,773,266,0,1039,3,-0.6180272468853478,-0.15250460867898544
10,1547701200,201,119,0,320,3,-0.6180272468853478,-1.4796902492807138
10,1547715600,509,655,146,1164,3,0.488467082428799,0.07823002981227471
10,1547730000,552,984,432,1536,3,2.6559833713592513,0.7648963139622649
10,1547744400,750,847,97,1597,3,0.11710939656309216,0.8774948175459999
10,1547758800,1015,1072,57,2087,3,-0.18603973475585217,1.7819746004317396
10,1547773200,790,274,0,1064,3,-0.6180272468853478,-0.10635768098073341
10,1547787600,202,101,0,303,3,-0.6180272468853478,-1.5110701601155252
10,1547802000,423,707,284,1130,3,1.534331585479157,0.01547020814265195
10,1547816400,573,943,370,1516,3,2.1861022178148874,0.7279787718036633
10,1547830800,780,865,85,1645,3,0.026164657167408862,0.9660969187266438
10,1547845200,1008,980,0,1988,3,-0.6180272468853478,1.5992327667466617
10,1547859600,1038,258,0,1296,3,-0.6180272468853478,0.32188580805904543
10,1547874000,322,118,0,440,3,-0.6180272468853478,-1.258184996329104
10,1547888400,169,264,95,433,3,0.10195193999714494,-1.2711061360846148
10,1547902800,542,606,64,1148,3,-0.13298863677503692,0.04869599608539341
10,1547917200,877,742,0,1619,3,-0.6180272468853478,0.9181041139204617
10,1547931600,895,677,0,1572,3,-0.6180272468853478,0.8313478898477479
10,1547946000,769,208,0,977,3,-0.6180272468853478,-0.2669489893706505
10,1547960400,260,84,0,344,3,-0.6180272468853478,-1.435389198690392
10,1547974800,127,168,41,295,3,-0.3072993872834299,-1.5258371769789658
10,1547989200,486,499,13,985,3,-0.519503779206691,-0.2521819725072098
10,1548003600,645,781,136,1426,3,0.41267979959906287,0.561849832089956
10,1548018000,727,576,0,1303,3,-0.6180272468853478,0.334806947814556
10,1548032400,597,177,0,774,3,-0.6180272468853478,-0.641662042280457
10,1548046800,136,83,0,219,3,-0.6180272468853478,-1.666123837181652
10,1548061200,196,389,193,585,3,0.8446673117285586,-0.9905328156792423
10,1548075600,438,466,28,904,3,-0.4058228549620868,-0.40169801824954643
10,1548090000,664,494,0,1158,3,-0.6180272468853478,0.06715476716469422
10,1548104400,690,433,0,1123,3,-0.6180272468853478,0.002549068387141381
10,1548118800,458,160,0,618,4,-0.7218396206741069,-0.9654790339090713
10,1548133200,146,87,0,233,4,-0.7218396206741069,-1.626100055333821
10,1548147600,472,762,290,1234,4,0.8746751023712213,0.09151460037052794
10,1548162000,562,1051,489,1613,4,1.9702145157712914,0.741840229253593
10,1548176400,662,869,207,1531,4,0.4177415781892825,0.6011365311839062
10,1548190800,1018,1282,264,2300,4,0.7315392996154332,1.920662675276458
10,1548205200,672,272,0,944,4,-0.7218396206741069,-0.4060960391442185
10,1548219600,163,108,0,271,4,-0.7218396206741069,-1.5608959025698197
10,1548234000,499,820,321,1319,4,1.045337021041584,0.23736599471105707
10,1548248400,505,1448,943,1953,4,4.469585840814667,1.3252458066157096
10,1548262800,782,941,159,1723,4,0.1534908654093661,0.9305890925178073
10,1548277200,937,1013,76,1950,4,-0.30344265877257265,1.3200981103448675
10,1548291600,661,249,0,910,4,-0.7218396206741069,-0.4644365968804301
10,1548306000,172,78,0,250,4,-0.7218396206741069,-1.596929776465715
10,1548320400,466,629,163,1095,4,0.1755117581410258,-0.14699532684516084
10,1548334800,586,1024,438,1610,4,1.6894481334426301,0.7366925329827508
10,1548349200,654,770,116,1424,4,-0.08323373145597565,0.4175353641905342
10,1548363600,921,1179,258,2100,4,0.6985079605179436,1.5774829238869776
10,1548378000,673,267,0,940,4,-0.7218396206741069,-0.4129596341720081
10,1548392400,165,100,0,265,4,-0.7218396206741069,-1.5711912951115041
10,1548406800,463,670,207,1133,4,0.4177415781892825,-0.0817911740811596
10,1548421200,603,954,351,1557,4,1.2104937165290317,0.6457498988645386
10,1548435600,802,900,98,1702,4,-0.1823277487484443,0.8945552186219118
10,1548450000,1067,1223,156,2290,4,0.13697519586062132,1.903503687706984
10,1548464400,871,289,0,1160,4,-0.7218396206741069,-0.03546190764357976
10,1548478800,283,110,0,393,4,-0.7218396206741069,-1.3515562542222366
10,1548493200,168,291,123,459,4,-0.04469716917557118,-1.2383069362637082
10,1548507600,543,671,128,1214,4,-0.017171053260996556,0.057196625231579916
10,1548522000,881,860,0,1741,4,-0.7218396206741069,0.9614752701428605
10,1548536400,923,788,0,1711,4,-0.7218396206741069,0.9099983074344384
10,1548550800,899,248,0,1147,4,-0.7218396206741069,-0.05776859148389598
10,1548565200,318,114,0,432,4,-0.7218396206741069,-1.284636202701288
10,1548579600,117,216,99,333,4,-0.17682252556552938,-1.4545101796390807
10,1548594000,406,507,101,913,4,-0.1658120791996995,-0.45928890060958794
10,1548608400,667,779,112,1446,4,-0.10525462418763536,0.45528513684337707
10,1548622800,743,424,0,1167,4,-0.7218396206741069,-0.02345061634494795
10,1548637200,594,191,0,785,4,-0.7218396206741069,-0.6789239414988553
10,1548651600,132,109,0,241,4,-0.7218396206741069,-1.6123728652782416
10,1548666000,453,618,165,1071,4,0.18652220450685564,-0.1881768970118985
10,1548680400,633,876,243,1509,4,0.6159296127742198,0.5633867585310633
10,1548694800,670,613,0,1283,4,-0.7218396206741069,0.1755936394609506
10,1548709200,868,750,0,1618,4,-0.7218396206741069,0.7504197230383302
10,1548723600,508,239,0,747,5,-0.8628222381348786,-0.7605447026245983
10,1548738000,151,97,0,248,5,-0.8628222381348786,-1.6715812754187414
10,1548752400,469,680,211,1149,5,0.36353392455177636,-0.026603415523905875
10,1548766800,541,918,377,1459,5,1.328344934058813,0.5393712088572251
10,1548781200,715,720,5,1435,5,-0.8337616655593654,0.4955538185825569
10,1548795600,877,968,91,1845,5,-0.33391981726053926,1.2441009024414722
10,1548810000,700,258,0,958,5,-0.8628222381348786,-0.3753168131264737
10,1548824400,155,95,0,250,5,-0.8628222381348786,-1.6679298262291857
10,1548838800,469,764,295,1233,5,0.8517515438203972,0.12675745043743283
10,1548853200,449,1111,662,1560,5,2.9847975708630625,0.7237693929297871
10,1548867600,840,765,0,1605,5,-0.8628222381348786,0.8059269996947901
10,1548882000,938,1016,78,1954,5,-0.4094773059568734,1.4431048832722568
10,1548896400,583,226,0,809,5,-0.8628222381348786,-0.6473497777483721
10,1548910800,108,98,0,206,5,-0.8628222381348786,-1.7482617083994108
10,1548925200,372,725,353,1097,5,1.1888541856963497,-0.12154109445235366
10,1548939600,503,1014,511,1517,5,2.107168279082565,0.6452632353543399
10,1548954000,608,862,254,1470,5,0.6134548487011894,0.5594541793997814
10,1548968400,810,1198,388,2008,5,1.3922781937249418,1.5416940113902604
10,1548982800,612,281,0,893,5,-0.8628222381348786,-0.4939889117870334
10,1548997200,137,106,0,243,5,-0.8628222381348786,-1.6807098983926307
10,1549011600,402,723,321,1125,5,1.0028665212130656,-0.07042080579857408
10,1549026000,579,1015,436,1594,5,1.671259690449868,0.7858440291522338
10,1549040400,672,921,249,1593,5,0.5843942761256763,0.7840183045574559
10,1549054800,936,1231,295,2167,5,0.8517515438203972,1.8319842219599372
10,1549069200,851,308,0,1159,5,-0.8628222381348786,-0.008346169576127455
10,1549083600,234,97,0,331,5,-0.8628222381348786,-1.5200461340521805
10,1549098000,163,361,198,524,5,0.28797643585544214,-1.167681287260057
10,1549112400,528,881,353,1409,5,1.1888541856963497,0.448084979118333
10,1549126800,827,1070,243,1897,5,0.5495215890350605,1.33903858136992
10,1549141200,919,944,25,1863,5,-0.7175193752573128,1.2769639451474732
10,1549155600,825,354,0,1179,5,-0.8628222381348786,0.028168322319429385
10,1549170000,296,105,0,401,5,-0.8628222381348786,-1.3922454124177317
10,1549184400,150,259,109,409,5,-0.2293017559886919,-1.377639615659509
10,1549198800,493,631,138,1124,5,-0.060750435050715645,-0.07224653039335192
10,1549213200,628,774,146,1402,5,-0.014253518929894607,0.43530490695488816
10,1549227600,752,500,0,1252,5,-0.8628222381348786,0.16144621773821186
10,1549242000,643,218,0,861,5,-0.8628222381348786,-0.5524120988199244
10,1549256400,121,87,0,208,5,-0.8628222381348786,-1.7446102592098551
10,1549270800,459,693,234,1152,5,0.4972125583991368,-0.02112624173957235
10,1549285200,639,902,263,1541,5,0.6657638793371131,0.6890806256290082
10,1549299600,697,640,0,1337,5,-0.8628222381348786,0.3166328082943284
10,1549314000,855,801,0,1656,5,-0.8628222381348786,0.89903895402846
10,1549328400,544,219,0,763,6,-0.703618068760316,-0.7991964046553005
10,1549342800,169,93,0,262,6,-0.703618068760316,-1.6756134750512162
10,1549357200,448,671,223,1119,6,0.9191563296659631,-0.17643297738794317
10,1549371600,566,976,410,1542,6,2.279958179467372,0.5635359263595067
10,1549386000,769,668,0,1437,6,-0.703618068760316,0.37985570202503327
10,1549400400,1067,1043,0,2110,6,-0.703618068760316,1.5571584732355148
10,1549414800,801,246,0,1047,6,-0.703618068760316,-0.3023851312172963
10,1549429200,166,79,0,245,6,-0.703618068760316,-1.7053521780387024
10,1549443600,468,750,282,1218,6,1.3485002288011667,-0.003248765872582579
10,1549458000,615,1154,539,1769,6,3.2186931453731566,0.9606350780159395
10,1549472400,804,782,0,1586,6,-0.703618068760316,0.6405066870330002
10,1549486800,1077,1085,8,2162,6,-0.6454019468436781,1.6481239176678255
10,1549501200,723,205,0,928,6,-0.703618068760316,-0.5105560521296995
10,1549515600,128,91,0,219,6,-0.703618068760316,-1.7508349002548576
10,1549530000,503,773,270,1276,6,1.26117604592621,0.0982126913788408
10,1549544400,609,948,339,1557,6,1.7632900974572112,0.5897759584072886
10,1549558800,712,791,79,1503,6,-0.12873386483351754,0.49531184303527365
10,1549573200,954,1057,103,2011,6,0.0459145009163959,1.3839742617201543
10,1549587600,835,235,0,1070,6,-0.703618068760316,-0.2621504154106974
10,1549602000,171,108,0,279,6,-0.703618068760316,-1.6458747720637301
10,1549616400,457,685,228,1142,6,0.9555414058638616,-0.13619826158134424
10,1549630800,704,1009,305,1713,6,1.5158715793115005,0.8626722917042203
10,1549645200,801,820,19,1621,6,-0.5653547792083011,0.7017334284778247
10,1549659600,1074,1214,140,2288,6,0.3151640647808458,1.8685401868691935
10,1549674000,953,308,0,1261,6,-0.703618068760316,0.0719726593310589
10,1549688400,310,129,0,439,6,-0.703618068760316,-1.3659810968873896
10,1549702800,182,333,151,515,6,0.39521123241622275,-1.233031601178628
10,1549717200,634,771,137,1405,6,0.29333301906210657,0.3238769669897652
10,1549731600,910,1026,116,1936,6,0.14051569903093233,1.2527741014812448
10,1549746000,930,846,0,1776,6,-0.703618068760316,0.9728804263049043
10,1549760400,937,301,0,1238,6,-0.703618068760316,0.031737943524459966
10,1549774800,324,92,0,416,6,-0.703618068760316,-1.4062158126939885
10,1549789200,138,257,119,395,6,0.1623467447496715,-1.4429518575608833
10,1549803600,539,583,44,1122,6,-0.38342939821880795,-0.17118497097838678
10,1549818000,798,780,0,1578,6,-0.703618068760316,0.6265120032741832
10,1549832400,796,447,0,1243,6,-0.703618068760316,0.0404846208737206
10,1549846800,650,160,0,810,6,-0.703618068760316,-0.7169776375722505
10,1549861200,184,84,0,268,6,-0.703618068760316,-1.6651174622321034
10,1549875600,482,700,218,1182,6,0.8827712534680644,-0.06622484278725915
10,1549890000,617,948,331,1565,6,1.7050739755405735,0.6037706421661055
10,1549904400,767,691,0,1458,6,-0.703618068760316,0.41659174689192796
10,1549918800,899,861,0,1760,6,-0.703618068760316,0.9448910587872703
10,1549933200,638,251,0,889,7,-0.4386892590529604,-0.5892692039709244
10,1549947600,151,70,0,221,7,-0.4386892590529604,-1.7843347516511514
10,1549962000,410,665,255,1075,7,0.5727987849636608,-0.2565114317126576
10,1549976400,549,977,428,1526,7,1.2590240069827805,0.5503367149995915
10,1549990800,766,720,0,1486,7,-0.4386892590529604,0.47877590376125445
10,1550005200,867,1049,182,1916,7,0.28323554099027515,1.2480546245733766
10,1550019600,650,201,0,851,7,-0.4386892590529604,-0.6572519746473445
10,1550034000,167,78,0,245,7,-0.4386892590529604,-1.7413982649081492
10,1550048400,517,774,257,1291,7,0.5807320245245755,0.12991694897436187
10,1550062800,550,1123,573,1673,7,1.8341838751490944,0.8133226963004797
10,1550077200,804,894,90,1698,7,-0.08169347881179996,0.8580482033244403
10,1550091600,1010,938,0,1948,7,-0.4386892590529604,1.3053032735640462
10,1550106000,750,218,0,968,7,-0.4386892590529604,-0.44793660177520894
10,1550120400,169,95,0,264,7,-0.4386892590529604,-1.707406879569939
10,1550134800,515,726,211,1241,7,0.39826751462353793,0.04046593492644069
10,1550149200,620,918,298,1538,7,0.7433634355233263,0.5718049583710925
10,1550163600,825,769,0,1594,7,-0.4386892590529604,0.6719900941047642
10,1550178000,1014,1145,131,2159,7,0.08093793218695089,1.6827865528462735
10,1550192400,949,250,0,1199,7,-0.4386892590529604,-0.0346729168738131
10,1550206800,256,113,0,369,7,-0.4386892590529604,-1.5195597500693048
10,1550221200,474,682,208,1156,7,0.38636765528216593,-0.11160078895502532
10,1550235600,646,869,223,1515,7,0.445866951989026,0.5306574919090488
10,1550250000,1147,818,0,1965,7,-0.4386892590529604,1.3357166183403393
10,1550264400,1191,1175,0,2366,7,-0.4386892590529604,2.053113751004667
10,1550278800,946,292,0,1238,7,-0.4386892590529604,0.03509887408356542
10,1550293200,325,124,0,449,7,-0.4386892590529604,-1.3764381275926307
10,1550307600,163,1657,1494,1820,7,5.487440692950303,1.076308677601368
10,1550322000,614,655,41,1269,7,-0.2760578480542095,0.09055850279327655
10,1550336400,845,762,0,1607,7,-0.4386892590529604,0.6952473577572237
10,1550350800,1076,779,0,1855,7,-0.4386892590529604,1.1389243874349129
10,1550365200,1040,325,0,1365,7,-0.4386892590529604,0.2623044497652852
10,1550379600,347,115,0,462,7,-0.4386892590529604,-1.3531808639401712
10,1550394000,132,237,105,369,7,-0.022194182104939893,-1.5195597500693048
10,1550408400,532,549,17,1081,7,-0.3712567227851856,-0.2457773100269071
10,1550422800,755,789,34,1544,7,-0.3038241865174109,0.5825390800568431
10,1550437200,847,508,0,1355,7,-0.4386892590529604,0.244414246955701
10,1550451600,777,231,0,1008,7,-0.4386892590529604,-0.37637579053687203
10,1550466000,183,64,0,247,7,-0.4386892590529604,-1.7378202243462324
10,1550480400,231,329,98,560,7,-0.04996052056814126,-1.1778568764062458
10,1550494800,516,493,0,1009,7,-0.4386892590529604,-0.3745867702559136
10,1550509200,734,620,0,1354,7,-0.4386892590529604,0.24262522667474257
10,1550523600,844,583,0,1427,7,-0.4386892590529604,0.3732237071847075
10,1550538000,536,158,0,694,8,-0.6568247381274704,-0.9430841883035903
10,1550552400,152,71,0,223,8,-0.6568247381274704,-1.7355777702678918
10,1550566800,457,718,261,1175,8,1.0454301893158375,-0.1337648402678598
10,1550581200,662,926,264,1588,8,1.0649963379071399,0.561139298482154
10,1550595600,792,742,0,1534,8,-0.6568247381274704,0.470280161696438
10,1550610000,1084,1052,0,2136,8,-0.6568247381274704,1.4831912791964583
10,1550624400,732,207,0,939,8,-0.6568247381274704,-0.530852919553582
10,1550638800,222,86,0,308,8,-0.6568247381274704,-1.5925587586607461
10,1550653200,448,664,216,1112,8,0.7519379604463016,-0.23976716651786195
10,1550667600,554,1177,623,1731,8,3.406412119332992,0.8017477533035875
10,1550682000,744,806,62,1550,8,-0.2524576672405544,0.4972013874107242
10,1550696400,925,918,0,1843,8,-0.6568247381274704,0.9901963333035912
10,1550710800,643,220,0,863,8,-0.6568247381274704,-0.6587287416964418
10,1550725200,145,78,0,223,8,-0.6568247381274704,-1.7355777702678918
10,1550739600,448,623,175,1071,8,0.48453392969850223,-0.3087528074107205
10,1550754000,715,1043,328,1758,8,1.4824075078549241,0.8471773216964456
10,1550768400,779,778,0,1557,8,-0.6568247381274704,0.5089794236607245
10,1550782800,1065,1021,0,2086,8,-0.6568247381274704,1.3990624488393137
10,1550797200,736,285,0,1021,8,-0.6568247381274704,-0.392881637767865
10,1550811600,207,77,0,284,8,-0.6568247381274704,-1.6329405972321756
10,1550826000,423,618,195,1041,8,0.6149749203071848,-0.3592301056250072
10,1550840400,684,910,226,1594,8,0.8171584557506428,0.5712347581250115
10,1550854800,783,788,5,1571,8,-0.6242144904752998,0.5325354961607249
10,1550869200,1072,1134,62,2206,8,-0.2524576672405544,1.6009716416964606
10,1551488400,9352,6359,0,15711,9,-0.5312307740180047,4.082674587259134
10,1551502800,257,110,0,367,9,-0.5312307740180047,-0.4335867258197151
10,1551517200,161,297,136,458,9,0.7589011057400066,-0.4068023293461635
10,1551531600,594,647,53,1241,9,-0.02845879146525025,-0.1763387860627473
10,1551546000,792,774,0,1566,9,-0.5312307740180047,-0.08068022722863456
10,1551560400,847,737,0,1584,9,-0.5312307740180047,-0.07538221473936063
10,1551574800,890,296,0,1186,9,-0.5312307740180047,-0.192527157557751
10,1551589200,311,86,0,397,9,-0.5312307740180047,-0.4247567050042585
10,1551603600,177,218,41,395,9,-0.14229395732625125,-0.4253453730586223
10,1551618000,523,538,15,1061,9,-0.3889368166917534,-0.22931891095548665
10,1551632400,657,791,134,1448,9,0.7399285780965065,-0.11541164243609703
10,1551646800,823,453,0,1276,9,-0.5312307740180047,-0.16603709511138132
10,1551661200,523,151,0,674,9,-0.5312307740180047,-0.34322617947487627
10,1551675600,155,93,0,248,9,-0.5312307740180047,-0.46861247505435943
10,1551690000,351,572,221,923,9,1.5652335305887637,-0.2699370067065868
10,1551704400,555,963,408,1518,9,3.3391648652560293,-0.09480826053336505
10,1551718800,696,628,0,1324,9,-0.5312307740180047,-0.1519090618066508
10,1551733200,902,843,0,1745,9,-0.5312307740180047,-0.027994436363077087
10,1551747600,503,204,0,707,10,-0.7180756408672723,-0.8467633672500404
10,1551762000,134,96,0,230,10,-0.7180756408672723,-1.6308740909140091
10,1551776400,474,793,319,1267,10,1.9273074812358861,0.07378591000744911
10,1551779673,143,394,251,537,10,1.3634013611637394,-1.1262158264174926
10,1551779766,155,203,48,358,10,-0.32002426199281586,-1.4204628275408686
10,1551790800,489,626,137,1115,10,0.4180293363369055,-0.17607746524815518
10,1551805200,790,771,0,1561,10,-0.7180756408672723,0.5570742805676311
10,1551819600,1048,1197,149,2245,10,0.5175421810555195,1.6814594692178504
10,1551834000,684,207,0,891,10,-0.7180756408672723,-0.544297176151151
10,1551848400,181,102,0,283,10,-0.7180756408672723,-1.5437506771735683
10,1551862800,519,805,286,1324,10,1.6536471582596972,0.16748467572830072
10,1551877200,689,1080,391,1769,10,2.5243845495475705,0.8989925835489844
10,1551891600,814,877,63,1691,10,-0.1956332060945482,0.7707732199309769
10,1551906000,974,1044,70,2018,10,-0.13758404667535665,1.3083082443295466
10,1551920400,674,221,0,895,10,-0.7180756408672723,-0.5377218241707403
10,1551934800,150,100,0,250,10,-0.7180756408672723,-1.597997331011956
10,1551949200,539,702,163,1241,10,0.6336404998939027,0.03104612213477995
10,1551963600,698,1041,343,1739,10,2.126333170673114,0.8496774436959046
10,1551978000,796,914,118,1710,10,0.2604673321990998,0.8020061418379274
10,1551992400,956,1171,215,2127,10,1.0648628270078973,1.4874865857957367
10,1552006800,872,263,0,1135,10,-0.7180756408672723,-0.143200705346102
10,1552021200,298,90,0,388,10,-0.7180756408672723,-1.3711476876877888
10,1552035600,487,697,210,1184,10,1.0233991417084747,-0.06265264358607166
10,1552050000,702,987,285,1689,10,1.6453544211998128,0.7674855439407716
10,1552064400,948,874,0,1822,10,-0.7180756408672723,0.9861159972894253
10,1552078800,1162,1242,80,2404,10,-0.054656676076511555,1.9428297104391734
10,1552093200,1122,375,0,1497,10,-0.7180756408672723,0.4518686488810609
10,1552107600,387,98,0,485,10,-0.7180756408672723,-1.211695402162831
10,1552122000,201,299,98,500,10,0.0946125910014096,-1.1870378322362911
10,1552136400,707,672,0,1379,10,-0.7180756408672723,0.257895765458947
10,1552150800,917,894,0,1811,10,-0.7180756408672723,0.968033779343296
10,1552165200,1054,919,0,1973,10,-0.7180756408672723,1.234335534549927
10,1552179600,1041,322,0,1363,10,-0.7180756408672723,0.23159435753730445
10,1552197600,347,108,0,455,10,-0.7180756408672723,-1.2610105420159108
10,1552212000,170,289,119,459,10,0.26876006925898427,-1.2544351900355
10,1552226400,520,581,61,1101,10,-0.21221868021431722,-0.19909119717959242
10,1552240800,868,770,0,1638,10,-0.7180756408672723,0.683649806190536
10,1552255200,777,434,0,1211,10,-0.7180756408672723,-0.018269017718299845
10,1552269600,526,113,0,639,10,-0.7180756408672723,-0.9585443509170213
10,1552284000,172,92,0,264,10,-0.7180756408672723,-1.5749835990805188
10,1552298400,646,1039,393,1685,10,2.5409700236673394,0.7609101919603609
10,1552312800,640,651,11,1291,10,-0.6268555332085427,0.11323802188991294
10,1552327200,917,847,0,1764,10,-0.7180756408672723,0.8907733935734711
10,1552341600,842,836,0,1678,10,-0.7180756408672723,0.7494033259946423
10,1552356000,507,155,0,662,11,-0.5729924850194357,-1.0269354693236823
10,1552370400,176,104,0,280,11,-0.5729924850194357,-1.6546701692828836
10,1552384800,623,1173,550,1796,11,2.421606248905669,0.8365492158955179
10,1552399200,641,685,44,1326,11,-0.33342458630542726,0.0642054751080187
10,1552413600,921,744,0,1665,11,-0.5729924850194357,0.6212789392079383
10,1552428000,1062,820,0,1882,11,-0.5729924850194357,0.9778716876140815
10,1552442400,701,194,0,895,11,-0.5729924850194357,-0.6440501680396666
10,1552456800,168,112,0,280,11,-0.5729924850194357,-1.6546701692828836
10,1552471200,605,1089,484,1694,11,2.0622544008346564,0.6689341912990818
10,1552485600,639,831,192,1470,11,0.47239470936896455,0.3008384510088695
10,1552500000,1027,934,0,1961,11,-0.5729924850194357,1.107691167448576
10,1552514400,894,765,0,1659,11,-0.5729924850194357,0.6114192318787361
10,1552528800,610,165,0,775,11,-0.5729924850194357,-0.841244314623709
10,1552543200,170,90,0,260,11,-0.5729924850194357,-1.687535860380224
10,1552557600,629,1134,505,1763,11,2.176593625220888,0.7823208255849062
10,1552572000,639,812,173,1451,11,0.36894493492427916,0.26961604446639614
10,1552586400,936,969,33,1905,11,-0.39331656098392936,1.015667232376023
10,1552600800,936,946,10,1882,11,-0.5185452353117065,0.9778716876140815
10,1552615200,762,184,0,946,11,-0.5729924850194357,-0.5602426557414487
10,1552629600,198,115,0,313,11,-0.5729924850194357,-1.600441778972272
10,1552644000,579,1077,498,1656,11,2.1384805504254776,0.6064893782141352
10,1552658400,568,821,253,1389,11,0.8045229325861125,0.16773240206464093
10,1552672800,893,1046,153,1939,11,0.2600504355088208,1.0715389072415016
10,1552687200,1037,948,0,1985,11,-0.5729924850194357,1.1471299967653845
10,1552701600,949,234,0,1183,11,-0.5729924850194357,-0.17078421623796508
10,1552716000,208,78,0,286,11,-0.5729924850194357,-1.6448104619536816
10,1552730400,301,449,148,750,11,0.2328268106549562,-0.8823264284953845
10,1552744800,746,973,227,1719,11,0.6629600833460166,0.7100163051707573
10,1552759200,1035,985,0,2020,11,-0.5729924850194357,1.2046449561857302
10,1552773600,1124,848,0,1972,11,-0.5729924850194357,1.1257672975521134
10,1552788000,846,251,0,1097,11,-0.5729924850194357,-0.31210668795652874
10,1552802400,188,71,0,259,11,-0.5729924850194357,-1.689179144935091
10,1552816800,308,344,36,652,11,-0.3769823860716106,-1.0433683148723525
10,1552831200,684,507,0,1191,11,-0.5729924850194357,-0.15763793979902893
10,1552845600,837,1441,604,2278,11,2.7156213973274066,1.6286123713414213
10,1552860000,941,539,0,1480,11,-0.5729924850194357,0.3172712965575397
10,1552874400,520,132,0,652,11,-0.5729924850194357,-1.0433683148723525
10,1552888800,160,84,0,244,11,-0.5729924850194357,-1.7138284132580963
10,1552903200,601,1096,495,1697,11,2.1221463755131587,0.6738640449636829
10,1552917600,711,675,0,1386,11,-0.5729924850194357,0.16280254840003988
10,1552932000,927,825,0,1752,11,-0.5729924850194357,0.764244695481369
10,1552946400,792,807,15,1599,11,-0.4913216104578419,0.512822158586715
10,1552960800,403,78,0,481,12,-0.6366893297755298,-1.2019424946028887
10,1552975200,152,77,0,229,12,-0.6366893297755298,-1.5963176492321776
10,1552989600,639,1040,401,1679,12,1.7179706816604547,0.6729044706585721
10,1553004000,630,662,32,1292,12,-0.44878628646891766,0.06725691176359266
10,1553018400,973,1094,121,2067,12,0.07381905272759766,1.2801170103258899
10,1553032800,1008,898,0,1906,12,-0.6366893297755298,1.0281551059793999
10,1553047200,459,97,0,556,12,-0.6366893297755298,-1.084568936677505
10,1553061600,129,61,0,190,12,-0.6366893297755298,-1.6573518993533771
10,1553076000,650,1106,456,1756,12,2.0409290373436946,0.7934079901286326
10,1553090400,655,1013,358,1668,12,1.4654759672171944,0.6556896821628492
10,1553104800,1062,995,0,2057,12,-0.6366893297755298,1.2644672026025054
10,1553119200,936,896,0,1832,12,-0.6366893297755298,0.9123465288263546
10,1553133600,445,85,0,530,12,-0.6366893297755298,-1.1252584367583047
10,1553148000,154,50,0,204,12,-0.6366893297755298,-1.6354421685406388
10,1553162400,623,1098,475,1721,12,2.1524964693069957,0.7386336630967869
10,1553176800,532,774,242,1306,12,0.7843274352307251,0.08916664257633093
10,1553191200,1023,1160,137,2183,12,0.1677705743809038,1.46165477991715
10,1553205600,966,960,0,1926,12,-0.6366893297755298,1.0594547214261687
10,1553220000,468,94,0,562,12,-0.6366893297755298,-1.0751790520434745
10,1553234400,149,58,0,207,12,-0.6366893297755298,-1.6307472262236236
10,1553248800,561,1082,521,1643,12,2.4226070940602504,0.6165651628543879
10,1553263200,617,824,207,1441,12,0.578808481614118,0.30043904684202144
10,1553277600,939,1091,152,2030,12,0.25585012593087825,1.2222127217493672
10,1553292000,998,891,0,1889,12,-0.6366893297755298,1.001550432849646
10,1553306400,962,216,0,1178,12,-0.6366893297755298,-0.11115089628299042
10,1553320800,222,67,0,289,12,-0.6366893297755298,-1.5024188028918708
10,1553335200,240,739,499,979,12,2.2934237517869547,-0.4225820699783416
10,1553349600,716,976,260,1692,12,0.8900228970906945,0.6932492206989719
10,1553364000,888,913,25,1801,12,-0.4898900771922391,0.8638321248838627
10,1553378400,1039,779,0,1818,12,-0.6366893297755298,0.8904367980136163
10,1553392800,897,244,0,1141,12,-0.6366893297755298,-0.169055184859513
10,1553407200,229,63,0,292,12,-0.6366893297755298,-1.4977238605748555
10,1553421600,224,320,96,544,12,-0.07298019985569316,-1.1033487059455664
10,1553436000,568,656,88,1224,12,-0.11995596068234622,-0.03916178075542181
10,1553450400,791,801,10,1592,12,-0.5779696287422136,0.5367511434651271
10,1553464800,847,500,0,1347,12,-0.6366893297755298,0.1533308542422073
10,1553479200,531,136,0,667,12,-0.6366893297755298,-0.9108560709479374
10,1553493600,156,90,0,246,12,-0.6366893297755298,-1.569712976102424
10,1553508000,609,1083,474,1692,12,2.146624499203664,0.6932492206989719
10,1553522400,686,623,0,1309,12,-0.6366893297755298,0.09386158489334627
10,1553536800,907,865,0,1772,12,-0.6366893297755298,0.8184476824860477
10,1553551200,808,713,0,1521,12,-0.6366893297755298,0.42563750862909727
10,1553565600,424,63,0,487,13,-0.6031685147275918,-1.1898284683673266
10,1553580000,157,58,0,215,13,-0.6031685147275918,-1.6127864427466507
10,1553594400,670,1078,408,1748,13,1.9233276154048975,0.7710171407956428
10,1553608800,691,657,0,1348,13,-0.6031685147275918,0.1490201196495779
10,1553623200,983,1007,24,1990,13,-0.45455109530803367,1.1473253385890119
10,1553637600,1037,873,0,1910,13,-0.6031685147275918,1.022925934359799
10,1553652000,574,74,0,648,13,-0.6031685147275918,-0.9394746673560355
10,1553666400,134,50,0,184,13,-0.6031685147275918,-1.6609912118854706
10,1553680800,647,1099,452,1746,13,2.1957928843407544,0.7679071556899124
10,1553695200,656,1057,401,1713,13,1.8799808680741932,0.7165924014453621
10,1553709600,1003,919,0,1922,13,-0.6031685147275918,1.0415858449941808
10,1553724000,940,902,0,1842,13,-0.6031685147275918,0.9171864407649679
10,1553738400,501,75,0,576,13,-0.6031685147275918,-1.0514341311623272
10,1553752800,139,54,0,193,13,-0.6031685147275918,-1.6469962789096841
10,1553767200,604,1207,603,1811,13,3.130844148188808,0.8689816716261479
10,1553781600,659,741,82,1400,13,-0.09539233171076798,0.22987973239856632
10,1553796000,1015,1177,162,2192,13,0.39999906635442606,1.4614338342677746
10,1553810400,981,938,0,1919,13,-0.6031685147275918,1.0369208673355854
10,1553824800,522,85,0,607,13,-0.6031685147275918,-1.003229362023507
10,1553839200,149,64,0,213,13,-0.6031685147275918,-1.615896427852381
10,1553853600,544,986,442,1530,13,2.133868959582605,0.43202876427103737
10,1553868000,737,792,55,1529,13,-0.26258692855777094,0.43047377171817225
10,1553882400,976,1080,104,2056,13,0.040840302757160385,1.2499548470781126
10,1553896800,1016,1074,58,2090,13,-0.2440097511303262,1.302824593875528
10,1553911200,870,232,0,1102,13,-0.6031685147275918,-0.23350804835525193
10,1553925600,214,70,0,284,13,-0.6031685147275918,-1.5054919565989544
10,1553940000,280,442,162,722,13,0.39999906635442606,-0.8244052184440135
10,1553954400,717,896,179,1613,13,0.5052697384432798,0.5610931461588459
10,1553968800,895,907,12,1802,13,-0.5288598050178127,0.8549867386503615
10,1553983200,1101,886,0,1987,13,-0.6031685147275918,1.1426603609304165
10,1553997600,905,233,0,1138,13,-0.6031685147275918,-0.17752831645210612
10,1554012000,211,70,0,281,13,-0.6031685147275918,-1.51015693425755
10,1554026400,264,343,79,607,13,-0.11396950913821276,-1.003229362023507
10,1554040800,558,751,193,1309,13,0.5919632331046888,0.08837541008783659
10,1554055200,730,859,129,1589,13,0.1956501146525335,0.523773324890082
10,1554069600,796,417,0,1213,13,-0.6031685147275918,-0.06090387498721896
10,1554084000,509,131,0,640,13,-0.6031685147275918,-0.9519146077789568
10,1554098400,160,95,0,255,13,-0.6031685147275918,-1.5505867406320442
10,1554112800,569,1048,479,1617,13,2.362987481187757,0.5673131163703065
10,1554127200,635,702,67,1337,13,-0.18827821884799187,0.13191520156806114
10,1554141600,888,772,0,1660,13,-0.6031685147275918,0.6341777961435084
10,1554156000,823,743,0,1566,13,-0.6031685147275918,0.48800849617418324
10,1554170400,536,178,0,714,14,-0.6053921980729163,-0.9885078632085758
10,1554184800,148,98,0,246,14,-0.6053921980729163,-1.7451910378805815
10,1554199200,634,1184,550,1818,14,2.774153421908806,0.7964883437100022
10,1554213600,644,680,36,1324,14,-0.3841855756741127,-0.002232785110448392
10,1554228000,971,1047,76,2018,14,-0.13840043967544194,1.119857221774962
10,1554242400,872,903,31,1775,14,-0.41490871767394655,0.7269640349260359
10,1554256800,607,192,0,799,14,-0.6053921980729163,-0.8510760900309678
10,1554271200,163,96,0,259,14,-0.6053921980729163,-1.724172060806359
10,1554285600,622,1168,546,1790,14,2.749574908308939,0.7512167007809079
10,1554300000,640,955,315,1595,14,1.3301657479166158,0.4359320446675721
10,1554314400,1001,951,0,1952,14,-0.6053921980729163,1.0131454920135252
10,1554328800,1002,915,0,1917,14,-0.6053921980729163,0.9565559383521574
10,1554343200,685,215,0,900,14,-0.6053921980729163,-0.6877748066081631
10,1554357600,166,102,0,268,14,-0.6053921980729163,-1.709620461293436
10,1554372000,622,1066,444,1688,14,2.122822811512329,0.5862985729677784
10,1554386400,604,806,202,1410,14,0.6358227387203709,0.1368158324574843
10,1554400800,967,1105,138,2072,14,0.2425665211224977,1.207166818852501
10,1554415200,1049,1026,0,2075,14,-0.6053921980729163,1.2120173520234756
10,1554429600,846,253,0,1099,14,-0.6053921980729163,-0.36602277293352814
10,1554444000,195,136,0,331,14,-0.6053921980729163,-1.6077592647029737
10,1554458400,581,997,416,1578,14,1.9507732163132594,0.4084456900320505
10,1554472800,720,740,20,1460,14,-0.482499630073581,0.21765805197372426
10,1554487200,1306,1135,0,2441,14,-0.6053921980729163,1.803782398882352
10,1554501600,1035,1020,0,2055,14,-0.6053921980729163,1.1796804642169796
10,1554516000,873,280,0,1153,14,-0.6053921980729163,-0.278713175855989
10,1554530400,220,69,0,289,14,-0.6053921980729163,-1.6756667290966152
10,1554544800,388,500,112,888,14,0.08280618272336172,-0.7071769392920607
10,1554559200,807,995,188,1802,14,0.5497979411208361,0.7706188334648054
10,1554573600,940,1031,91,1971,14,-0.046231013675940416,1.0438655354296964
10,1554588000,1039,884,0,1923,14,-0.6053921980729163,0.9662570046941061
10,1554602400,931,284,0,1215,14,-0.6053921980729163,-0.17846882365585146
10,1554616800,231,73,0,304,14,-0.6053921980729163,-1.6514140632417433
10,1554631200,238,321,83,559,14,-0.09538804087567457,-1.2391187437089195
10,1554645600,652,769,117,1421,14,0.11352932472319557,0.1546011207510571
10,1554660000,762,859,97,1621,14,-0.009363243276139804,0.47796999881601687
10,1554674400,893,493,0,1386,14,-0.6053921980729163,0.09801156708968914
10,1554688800,610,136,0,746,14,-0.6053921980729163,-0.9367688427181822
10,1554703200,289,75,0,364,14,-0.6053921980729163,-1.5544033998222553
10,1554717600,589,1115,526,1704,14,2.626682340309604,0.6121680832129752
10,1554732000,648,785,137,1433,14,0.23642189272253095,0.17400325343495468
10,1554746400,885,898,13,1783,14,-0.5255120288733484,0.7398987900486342
10,1554760800,854,666,0,1520,14,-0.6053921980729163,0.3146687153932122
10,1554775200,601,172,0,773,15,-0.5426247601271237,-0.8665898943156336
10,1554789600,178,91,0,269,15,-0.5426247601271237,-1.7078636793591249
10,1554804000,570,1184,614,1754,15,2.8455610302259675,0.7708894372868764
10,1554818400,641,718,77,1359,15,-0.11772198185808784,0.11155780019921946
10,1554832800,939,1034,95,1973,15,-0.0183940596653262,1.1364429272164887
10,1554847200,1166,623,0,1789,15,-0.5426247601271237,0.8293112279148966
10,1554861600,697,161,0,858,15,-0.5426247601271237,-0.7247084027904416
10,1554876000,172,97,0,269,15,-0.5426247601271237,-1.7078636793591249
10,1554890400,596,1192,596,1788,15,2.746233108033206,0.8276420338969532
10,1554904800,628,1004,376,1632,15,1.532225170121675,0.5672477670977772
10,1554919200,1013,994,0,2007,15,-0.5426247601271237,1.1931955238265655
10,1554933600,984,992,8,1976,15,-0.49847901693034075,1.141450509270319
10,1554948000,670,233,0,903,15,-0.5426247601271237,-0.649594671982987
10,1554962400,186,118,0,304,15,-0.5426247601271237,-1.6494418887311046
10,1554976800,600,1088,488,1688,15,2.150265574876636,0.6607226321026096
10,1554991200,673,817,144,1490,15,0.2519986174149694,0.3302222165498095
10,1555005600,941,1040,99,1981,15,0.003678811933065272,1.1497964793600361
10,1555020000,853,931,78,1784,15,-0.11220376395848997,0.8209652578251795
10,1555034400,582,187,0,769,15,-0.5426247601271237,-0.8732666703874074
10,1555048800,199,108,0,307,15,-0.5426247601271237,-1.6444343066772744
10,1555063200,575,1083,508,1658,15,2.2606299328685937,0.6106468115643066
10,1555077600,712,853,141,1565,15,0.23544396371617576,0.45541176789556714
10,1555092000,949,950,1,1899,15,-0.5371065422275259,1.0129225698886746
10,1555106400,1016,994,0,2010,15,-0.5426247601271237,1.198203105880396
10,1555120800,959,253,0,1212,15,-0.5426247601271237,-0.1338137204384655
10,1555135200,203,83,0,286,15,-0.5426247601271237,-1.6794873810540867
10,1555149600,326,358,32,684,15,-0.36604178733999193,-1.0151481619125993
10,1555164000,720,952,232,1672,15,0.7376017925795819,0.6340155278155147
10,1555178400,977,841,0,1818,15,-0.5426247601271237,0.8777178544352563
10,1555192800,1030,994,0,2024,15,-0.5426247601271237,1.2215718221316039
10,1555207200,968,295,0,1263,15,-0.5426247601271237,-0.04868482552335032
10,1555221600,253,88,0,341,15,-0.5426247601271237,-1.5876817100671976
10,1555236000,283,349,66,632,15,-0.1784223787536644,-1.101946250845658
10,1555250400,658,651,0,1309,15,-0.5426247601271237,0.0280980993020477
10,1555264800,815,794,0,1609,15,-0.5426247601271237,0.5288563046850783
10,1555279200,752,511,0,1263,15,-0.5426247601271237,-0.04868482552335032
10,1555293600,464,137,0,601,15,-0.5426247601271237,-1.1536912654019045
10,1555308000,139,91,0,230,15,-0.5426247601271237,-1.772962246058919
10,1555322400,550,1082,532,1632,15,2.3930671624589426,0.5672477670977772
10,1555336800,737,780,43,1517,15,-0.3053413904444154,0.3752904550342822
10,1555351200,927,820,0,1747,15,-0.5426247601271237,0.7592050791612723
10,1555365600,852,774,0,1626,15,-0.5426247601271237,0.5572326029901167
10,1555380000,460,221,0,681,16,-0.6360593822240951,-0.9887284749162967
10,1555394400,155,124,0,279,16,-0.6360593822240951,-1.6577606795686994
10,1555408800,598,1193,595,1791,16,2.9032690439126534,0.8585992543478005
10,1555423200,552,797,245,1349,16,0.8213111461851541,0.12299668107326811
10,1555437600,927,1003,76,1930,16,-0.1839770958604096,1.089931285309701
10,1555452000,1108,888,0,1996,16,-0.6360593822240951,1.1997723935362148
10,1555466400,573,211,0,784,16,-0.6360593822240951,-0.8173097757143128
10,1555480800,157,132,0,289,16,-0.6360593822240951,-1.641118087413167
10,1555495200,640,1171,531,1811,16,2.522568171185339,0.8918844386588654
10,1555509600,697,1018,321,1715,16,1.2733934325488396,0.7321155539657542
10,1555524000,1033,997,0,2030,16,-0.6360593822240951,1.256357206865025
10,1555538400,976,973,0,1949,16,-0.6360593822240951,1.1215522104052125
10,1555552800,608,277,0,885,16,-0.6360593822240951,-0.6492195949434356
10,1555567200,182,134,0,316,16,-0.6360593822240951,-1.5961830885932295
10,1555581600,658,1115,457,1773,16,2.082382787094382,0.8286425884678422
10,1555596000,709,709,0,1418,16,-0.6360593822240951,0.23783056694644172
10,1555610400,1006,1197,191,2203,16,0.500094784821483,1.5442740511557356
10,1555624800,1054,953,0,2007,16,-0.6360593822240951,1.2180792449073006
10,1555639200,671,273,0,944,16,-0.6360593822240951,-0.5510283012257944
10,1555653600,168,120,0,288,16,-0.6360593822240951,-1.6427823466287204
10,1555668000,459,823,364,1282,16,1.5291768314125038,0.011491313631200983
10,1555682400,675,829,154,1504,16,0.28000209277600446,0.3809568594840204
10,1555696800,1061,971,0,2032,16,-0.6360593822240951,1.2596857252961315
10,1555711200,1009,1068,59,2077,16,-0.28510076517860244,1.3345773899960274
10,1555725600,849,266,0,1115,16,-0.6360593822240951,-0.26643997536619024
10,1555740000,193,125,0,318,16,-0.6360593822240951,-1.592854570162123
10,1555754400,216,435,219,651,16,0.6666514166396829,-1.0386562513828939
10,1555768800,434,941,507,1375,16,2.3798053439125963,0.16626742067765238
10,1555783200,651,720,69,1371,16,-0.22561625381495962,0.1596103838154394
10,1555797600,935,838,0,1773,16,-0.6360593822240951,0.8286425884678422
10,1555812000,822,263,0,1085,16,-0.6360593822240951,-0.3163677518327874
10,1555826400,211,118,0,329,16,-0.6360593822240951,-1.5745477187910375
10,1555840800,283,344,61,627,16,-0.2732038629058739,-1.0785984725561717
10,1555855200,625,698,73,1323,16,-0.20182244926950246,0.07972594146888386
10,1555869600,795,853,58,1648,16,-0.2910492163149667,0.620610186523687
10,1555884000,932,543,0,1475,16,-0.6360593822240951,0.3326933422329764
10,1555898400,611,167,0,778,16,-0.6360593822240951,-0.8272953310076323
10,1555912800,142,128,0,270,16,-0.6360593822240951,-1.6727390125086785
10,1555927200,615,950,335,1565,16,1.3566717484579396,0.4824766716327681
10,1555941600,533,682,149,1215,16,0.25025983709418304,-0.10001405381086614
10,1555956000,875,902,27,1777,16,-0.4754512015422595,0.8352996253300551
10,1555970400,850,676,0,1526,16,-0.6360593822240951,0.4175705622261917
10,1555984800,471,203,0,674,17,-0.5235695427701321,-1.164310504110181
10,1555999200,150,120,0,270,17,-0.5235695427701321,-1.8470593510047606
10,1556013600,482,983,501,1465,17,2.763110146659796,0.17245765899281987
10,1556028000,1215,1319,104,2534,17,0.15869530293987297,1.97903814743417
10,1556042400,1014,1025,11,2039,17,-0.45140691485849693,1.1425018127489799
10,1556056800,1042,824,0,1866,17,-0.5235695427701321,0.8501365887074891
10,1556071200,670,240,0,910,17,-0.5235695427701321,-0.7654770192905752
10,1556085600,148,118,0,266,17,-0.5235695427701321,-1.8538192405779743
10,1556100000,610,1073,463,1683,17,2.513821068419602,0.5408716407329642
10,1556114400,705,1062,357,1767,17,1.8184357449074815,0.6828293217704511
10,1556128800,992,904,0,1896,17,-0.5235695427701321,0.9008357605065915
10,1556143200,1020,907,0,1927,17,-0.5235695427701321,0.9532249046989973
10,1556157600,631,234,0,865,17,-0.5235695427701321,-0.8415257769892289
10,1556172000,159,125,0,284,17,-0.5235695427701321,-1.8233997374985127
10,1556186400,593,1011,418,1604,17,2.218610317872004,0.4073638216619945
10,1556200800,702,797,95,1499,17,0.0996531528303533,0.22991672036513597
10,1556215200,1000,1107,107,2107,17,0.1783760196430462,1.257419935493612
10,1556229600,1042,876,0,1918,17,-0.5235695427701321,0.9380151531592666
10,1556244000,894,311,0,1205,17,-0.5235695427701321,-0.2669351632660679
10,1556258400,465,146,0,611,17,-0.5235695427701321,-1.2707787648882962
10,1556272800,627,1005,378,1632,17,1.9562007618296942,0.4546830486744901
10,1556287200,882,875,0,1757,17,-0.5235695427701321,0.6659295978374169
10,1556301600,965,1102,137,2067,17,0.3751831866747784,1.1898210397614755
10,1556316000,1043,983,0,2026,17,-0.5235695427701321,1.1205321716360355
10,1556330400,909,288,0,1197,17,-0.5235695427701321,-0.28045494241249525
10,1556344800,441,125,0,566,17,-0.5235695427701321,-1.34682752258695
10,1556359200,361,479,118,840,17,0.25053864755468136,-0.8837750868218143
10,1556373600,776,822,46,1598,17,-0.221798553321476,0.397223987302174
10,1556388000,1106,803,0,1909,17,-0.5235695427701321,0.922805401619536
10,1556402400,1026,778,0,1804,17,-0.5235695427701321,0.7453583003226774
10,1556416800,1021,315,0,1336,17,-0.5235695427701321,-0.04554877974332062
10,1556431200,406,85,0,491,17,-0.5235695427701321,-1.473575452084706
10,1556445600,316,332,16,648,17,-0.41860572035320825,-1.20824978633607
10,1556460000,708,709,1,1417,17,-0.5170093038690744,0.09133898411425596
10,1556474400,835,797,0,1632,17,-0.5235695427701321,0.4546830486744901
10,1556488800,928,431,0,1359,17,-0.5235695427701321,-0.006679414697342086
10,1556503200,628,146,0,774,17,-0.5235695427701321,-0.9953132647798396
10,1556517600,247,115,0,362,17,-0.5235695427701321,-1.6915818908208464
10,1556532000,587,1095,508,1682,17,2.8090318189672003,0.5391816683396609
10,1556546400,606,698,92,1304,17,0.07997243612718008,-0.09962789632902988
10,1556560800,921,891,0,1812,17,-0.5235695427701321,0.7588780794691047
10,1556575200,899,742,0,1641,17,-0.5235695427701321,0.4698928002142208
10,1556589600,601,219,0,820,18,-0.6007715096798595,-0.8580349690603698
10,1556604000,212,122,0,334,18,-0.6007715096798595,-1.6674166312656598
10,1556618400,649,1149,500,1798,18,2.3895583559937714,0.7707207215502752
10,1556632800,668,680,12,1348,18,-0.5290035929036923,0.021293256545377153
10,1556647200,1287,1028,0,2315,18,-0.6007715096798595,1.631729609122569
10,1556661600,1136,846,0,1982,18,-0.6007715096798595,1.0771532850189445
10,1556676000,781,269,0,1050,18,-0.6007715096798595,-0.4749942647245331
10,1556690400,252,140,0,392,18,-0.6007715096798595,-1.5708237579983617
10,1556704800,638,1137,499,1775,18,2.383577696262424,0.7324166511166915
10,1556719200,601,978,377,1579,18,1.6539372090380582,0.40599935524789144
10,1556733600,979,947,0,1926,18,-0.6007715096798595,0.9838912004850017
10,1556748000,949,898,0,1847,18,-0.6007715096798595,0.8523250455174751
10,1556762400,602,257,0,859,18,-0.6007715096798595,-0.7930845887599454
10,1556776800,188,114,0,302,18,-0.6007715096798595,-1.7207092509993414
10,1556791200,666,1151,485,1817,18,2.2998484600235622,0.8023632145171486
10,1556805600,650,787,137,1437,18,0.21857887351471542,0.1695133551796792
10,1556820000,913,1097,184,2010,18,0.4996698808880367,1.123784327285916
10,1556834400,1007,1025,18,2032,18,-0.49311963451560875,1.160423003352822
10,1556848800,757,243,0,1000,18,-0.6007715096798595,-0.5582639830584106
10,1556863200,199,126,0,325,18,-0.6007715096798595,-1.6824051805657576
10,1556877600,622,1131,509,1753,18,2.443384293575897,0.6957779750497853
10,1556892000,671,754,83,1425,18,-0.10437675197803671,0.1495286227795486
10,1556906400,968,1131,163,2099,18,0.37407602652974425,1.2720044259202181
10,1556920800,1097,1048,0,2145,18,-0.6007715096798595,1.3486125667873854
10,1556935200,1013,345,0,1358,18,-0.6007715096798595,0.037947200212152664
10,1556949600,279,118,0,397,18,-0.6007715096798595,-1.562496786164974
10,1556964000,306,437,131,743,18,0.18269491512663186,-0.9862703352945412
10,1556978400,672,949,277,1621,18,1.055871235903332,0.4759459186483486
10,1556992800,972,883,0,1855,18,-0.6007715096798595,0.8656482004508955
10,1557007200,979,866,0,1845,18,-0.6007715096798595,0.8489942567841201
10,1557021600,916,254,0,1170,18,-0.6007715096798595,-0.27514694072322693
10,1557036000,307,120,0,427,18,-0.6007715096798595,-1.5125349551646474
10,1557050400,238,351,113,589,18,0.07504303996238114,-1.242741067762884
10,1557064800,622,793,171,1415,18,0.42192130438052233,0.13287467911277306
10,1557079200,801,850,49,1651,18,-0.30771918284384364,0.5259077496486751
10,1557093600,906,459,0,1365,18,-0.6007715096798595,0.04960496077889552
10,1557108000,447,190,0,637,18,-0.6007715096798595,-1.1628021381623617
10,1557122400,145,111,0,256,18,-0.6007715096798595,-1.7973173918665086
10,1557136800,576,1063,487,1639,18,2.311809779486257,0.5059230172485445
10,1557151200,651,675,24,1326,18,-0.45723567612752514,-0.015345419521528972
10,1557165600,962,877,0,1839,18,-0.6007715096798595,0.8390018905840547
10,1557180000,860,716,0,1576,18,-0.6007715096798595,0.4010031721478588
10,1557194400,501,232,0,733,19,-0.6569590339793182,-0.9249167318350222
10,1557208800,173,115,0,288,19,-0.6569590339793182,-1.6791683884516533
10,1557223200,691,1113,422,1804,19,2.1768063391648624,0.8903720866737684
10,1557237600,630,685,55,1315,19,-0.2876294237354085,0.06154273816695365
10,1557252000,864,1049,185,1913,19,0.5853314732047419,1.075121368856269
10,1557266400,1019,915,0,1934,19,-0.6569590339793182,1.1107152672584022
10,1557280800,676,238,0,914,19,-0.6569590339793182,-0.6181312265594937
10,1557295200,181,127,0,308,19,-0.6569590339793182,-1.6452694375924788
10,1557309600,666,1205,539,1871,19,2.9624711464109974,1.0039335720520028
10,1557324000,657,938,281,1595,19,1.2299795201759298,0.5361280501953957
10,1557338400,914,902,0,1816,19,-0.6569590339793182,0.9107114571892732
10,1557352800,984,903,0,1887,19,-0.6569590339793182,1.0310527327393424
10,1557367200,597,193,0,790,19,-0.6569590339793182,-0.8283047218863752
10,1557381600,165,119,0,284,19,-0.6569590339793182,-1.6859481786234882
10,1557396000,648,1084,436,1732,19,2.270817512681494,0.7683358635807405
10,1557410400,664,806,142,1470,19,0.2965828688322306,0.3242596073255555
10,1557424800,994,1008,14,2002,19,-0.5629478604626866,1.2259717001795953
10,1557439200,974,876,0,1850,19,-0.6569590339793182,0.9683396736498696
10,1557453600,738,234,0,972,19,-0.6569590339793182,-0.5198242690678878
10,1557468000,190,138,0,328,19,-0.6569590339793182,-1.6113704867333045
10,1557482400,591,1034,443,1625,19,2.3178230994398095,0.5869764764841573
10,1557496800,655,761,106,1416,19,0.05483985121803512,0.23273244000578452
10,1557511200,996,1153,157,2149,19,0.39730912617147873,1.4751289889945274
10,1557525600,966,1063,97,2029,19,-0.005595903185513752,1.2717352838394809
10,1557540000,907,293,0,1200,19,-0.6569590339793182,-0.1333762292732993
10,1557554400,240,126,0,366,19,-0.6569590339793182,-1.546962480100873
10,1557568800,336,444,108,780,19,0.0682700188632682,-0.8452541973159623
10,1557583200,705,854,149,1559,19,0.3435884555905464,0.4751099386488817
10,1557597600,949,790,0,1739,19,-0.6569590339793182,0.7802004963814516
10,1557612000,1017,738,0,1755,19,-0.6569590339793182,0.807319657068791
10,1557626400,914,307,0,1221,19,-0.6569590339793182,-0.09778233087116617
10,1557640800,229,109,0,338,19,-0.6569590339793182,-1.5944210113037172
10,1557655200,162,345,183,507,19,0.5719013055595088,-1.3079748765436934
10,1557669600,589,805,216,1394,19,0.7934990717058547,0.19544359406069264
10,1557684000,695,783,88,1478,19,-0.06603165758906263,0.33781918766922525
10,1557698400,713,395,0,1108,19,-0.6569590339793182,-0.2893114032255017
10,1557712800,429,162,0,591,19,-0.6569590339793182,-1.1655992829351607
10,1557727200,153,99,0,252,19,-0.6569590339793182,-1.7401864999981673
10,1557741600,632,1043,411,1675,19,2.10294041711608,0.6717238536320934
10,1557756000,608,685,77,1293,19,-0.13989757963784458,0.024253892221861778
10,1557770400,943,908,0,1851,19,-0.6569590339793182,0.9700346211928284
10,1557784800,818,755,0,1573,19,-0.6569590339793182,0.4988392042503038
10,1557799200,482,225,0,707,20,-0.5403661084419698,-1.0491344233294502
10,1557813600,155,109,0,264,20,-0.5403661084419698,-1.7729088052526147
10,1557828000,666,1184,518,1850,20,2.4919282055284957,0.8183015101653065
10,1557842400,649,749,100,1398,20,0.045018894255031264,0.07982290829336422
10,1557856800,935,1032,97,1967,20,0.027457344174121233,1.0094563694994154
10,1557871200,1108,966,0,2074,20,-0.5403661084419698,1.1842732066682158
10,1557885600,641,240,0,881,20,-0.5403661084419698,-0.764852837653083
10,1557900000,177,101,0,278,20,-0.5403661084419698,-1.7500355742211828
10,1557914400,637,1140,503,1777,20,2.4041204551239455,0.6990339483585547
10,1557928800,533,973,440,1506,20,2.0353279034248346,0.25627354767869553
10,1557943200,971,933,0,1904,20,-0.5403661084419698,0.9065268298579722
10,1557957600,1032,878,0,1910,20,-0.5403661084419698,0.9163296431571571
10,1557972000,661,252,0,913,20,-0.5403661084419698,-0.7125711667240959
10,1557986400,171,129,0,300,20,-0.5403661084419698,-1.7140919254575042
10,1558000800,639,1119,480,1758,20,2.269481904503635,0.6679917062444687
10,1558015200,711,712,1,1423,20,-0.5345122584149997,0.12066796370663536
10,1558029600,964,1108,144,2072,20,0.30258829544171173,1.1810056022351543
10,1558044000,1075,995,0,2070,20,-0.5403661084419698,1.1777379978020925
10,1558058400,833,304,0,1137,20,-0.5403661084419698,-0.3465994702211865
10,1558072800,186,114,0,300,20,-0.5403661084419698,-1.7140919254575042
10,1558087200,594,1105,511,1699,20,2.4509512553397057,0.5715973754691488
10,1558101600,761,845,84,1606,20,-0.048642706176488894,0.4196537693317801
10,1558116000,1078,1099,21,2177,20,-0.41743525787559954,1.352554834970893
10,1558130400,995,996,1,1991,20,-0.5345122584149997,1.0486676226961558
10,1558144800,942,340,0,1282,20,-0.5403661084419698,-0.10969814882421387
10,1558159200,251,110,0,361,20,-0.5403661084419698,-1.6144299902491228
10,1558173600,357,488,131,845,20,0.22648824509110158,-0.8236697174481934
10,1558188000,838,905,67,1743,20,-0.14815815663497905,0.643484672996506
10,1558202400,1095,988,0,2083,20,-0.5403661084419698,1.1989774266169935
10,1558216800,1113,820,0,1933,20,-0.5403661084419698,0.9539070941373666
10,1558231200,1133,330,0,1463,20,-0.5403661084419698,0.1860200523678692
10,1558245600,265,103,0,368,20,-0.5403661084419698,-1.6029933747334069
10,1558260000,256,339,83,595,20,-0.054496556203458904,-1.2321202715809048
10,1558274400,680,740,60,1420,20,-0.18913510682376913,0.11576655705704283
10,1558288800,913,854,0,1767,20,-0.5403661084419698,0.6826959261932463
10,1558303200,948,497,0,1445,20,-0.5403661084419698,0.15661161247031397
10,1558317600,614,183,0,797,20,-0.5403661084419698,-0.902092223841674
10,1558332000,131,103,0,234,20,-0.5403661084419698,-1.82192287174854
10,1558346400,515,1051,536,1566,20,2.597297506013956,0.3543016806705463
10,1558360800,649,749,100,1398,20,0.045018894255031264,0.07982290829336422
10,1558375200,868,866,0,1734,20,-0.5403661084419698,0.6287804530477283
10,1558389600,963,705,0,1668,20,-0.5403661084419698,0.5209495067566926
10,1558404000,556,229,0,785,21,-0.4932834180219985,-0.8468580044620808
10,1558418400,208,121,0,329,21,-0.4932834180219985,-1.5555456083010117
10,1558432800,673,1087,414,1760,21,2.667074751678263,0.6684279905882647
10,1558447200,623,742,119,1365,21,0.41512871288218295,0.05454289515761192
10,1558461600,1017,1057,40,2074,21,-0.18793480259202153,1.1564277879685811
10,1558476000,1040,890,0,1930,21,-0.4932834180219985,0.9326317025457609
10,1558490400,649,250,0,899,21,-0.4932834180219985,-0.6696861035023481
10,1558504800,221,119,0,340,21,-0.4932834180219985,-1.5384500739978797
10,1558519200,647,1164,517,1811,21,3.4533474364104535,0.7476891041755136
10,1558533600,561,956,395,1517,21,2.522034159349024,0.29077209643725554
10,1558548000,1346,933,0,2279,21,-0.4932834180219985,1.4750263817996794
10,1558562400,1238,965,0,2203,21,-0.4932834180219985,1.3569117811598577
10,1558576800,703,258,0,961,21,-0.4932834180219985,-0.5733294556119671
10,1558591200,173,120,0,293,21,-0.4932834180219985,-1.6114946296567167
10,1558605600,808,1128,320,1936,21,1.949505505417817,0.9419565394383784
10,1558620000,694,776,82,1470,21,0.13268124360945424,0.21772754077841835
10,1558634400,1233,1151,0,2384,21,-0.4932834180219985,1.638211027420486
10,1558648800,984,912,0,1896,21,-0.4932834180219985,0.8797909601542616
10,1558663200,675,246,0,921,21,-0.4932834180219985,-0.6354950348960839
10,1558677600,214,122,0,336,21,-0.4932834180219985,-1.5446666319262912
10,1558692000,581,932,351,1513,21,2.1861506823760495,0.28455553850884385
10,1558706400,768,687,0,1455,21,-0.4932834180219985,0.1944154485468746
10,1558720800,1181,1165,0,2346,21,-0.4932834180219985,1.579153727100575
10,1558735200,978,977,0,1955,21,-0.4932834180219985,0.9714851895983339
10,1558749600,878,323,0,1201,21,-0.4932834180219985,-0.20033597990726673
10,1558764000,279,104,0,383,21,-0.4932834180219985,-1.4716220762674541
10,1558778400,258,431,173,689,21,0.8273493437126518,-0.996055394743961
10,1558792800,782,899,117,1681,21,0.39986128211068406,0.5456509715021342
10,1558807200,985,932,0,1917,21,-0.4932834180219985,0.912427889278423
10,1558821600,1066,1039,0,2105,21,-0.4932834180219985,1.2046061119137716
10,1558836000,852,319,0,1171,21,-0.4932834180219985,-0.24696016437035428
10,1558850400,204,130,0,334,21,-0.4932834180219985,-1.547774910890497
10,1558864800,290,343,53,633,21,-0.08869650257727903,-1.0830872057417245
10,1558879200,670,731,61,1401,21,-0.02762677949128364,0.11049191651331698
10,1558893600,866,885,19,1751,21,-0.34824282569275944,0.6544407352493384
10,1558908000,935,779,0,1714,21,-0.4932834180219985,0.5969375744115305
10,1558922400,640,298,0,938,21,-0.4932834180219985,-0.6090746637003343
10,1558936800,165,62,0,227,21,-0.4932834180219985,-1.7140678354755094
10,1558951200,274,327,53,601,21,-0.08869650257727903,-1.1328196691690178
10,1558965600,678,561,0,1239,21,-0.4932834180219985,-0.14127867958735582
10,1558980000,798,753,0,1551,21,-0.4932834180219985,0.34361283882875476
10,1558994400,885,677,0,1562,21,-0.4932834180219985,0.36070837313188686
10,1559008800,511,239,0,750,22,-0.5589169295363186,-0.920109710775312
10,1559023200,151,122,0,273,22,-0.5589169295363186,-1.6553313901655722
10,1559037600,736,1097,361,1833,22,2.012168776055205,0.7491671839409388
10,1559052000,674,722,48,1396,22,-0.2170551182665315,0.0755993141431534
10,1559066400,1450,985,0,2435,22,-0.5589169295363186,1.6770570183076823
10,1559080800,1015,869,0,1884,22,-0.5589169295363186,0.827775791171344
10,1559095200,600,225,0,825,22,-0.5589169295363186,-0.8045088177894221
10,1559109600,192,141,0,333,22,-0.5589169295363186,-1.56285067577686
10,1559124000,753,1081,328,1834,22,1.7771387808072265,0.7507085291807507
10,1559138400,737,1034,297,1771,22,1.5563530276954889,0.6536037790726031
10,1559152800,1517,1053,0,2570,22,-0.5589169295363186,1.8851386256822842
10,1559167200,977,1069,92,2046,22,0.0963182087307733,1.0774737200208664
10,1559181600,567,232,0,799,22,-0.5589169295363186,-0.8445837940245305
10,1559196000,151,107,0,258,22,-0.5589169295363186,-1.6784515687627501
10,1559210400,609,1121,512,1730,22,3.0876090573414103,0.5904086242403167
10,1559224800,687,855,168,1542,22,0.6375994099079362,0.3006357191556858
10,1559239200,1026,1071,45,2097,22,-0.2384214814708932,1.1560823272512715
10,1559253600,998,1059,61,2057,22,-0.12446754438096419,1.094428517658797
10,1559268000,668,240,0,908,22,-0.5589169295363186,-0.6765771628850372
10,1559282400,212,138,0,350,22,-0.5589169295363186,-1.5366478067000584
10,1559296800,546,1028,482,1574,22,2.8739454252977934,0.34995876682966554
10,1559311200,752,733,0,1485,22,-0.5589169295363186,0.21277904048640947
10,1559325600,999,1118,119,2117,22,0.28861547757002853,1.1869092320475088
10,1559340000,1025,1014,0,2039,22,-0.5589169295363186,1.0666843033421833
10,1559354400,990,375,0,1365,22,-0.5589169295363186,0.027817611708985564
10,1559368800,243,125,0,368,22,-0.5589169295363186,-1.5089035923834448
10,1559383200,336,427,91,763,22,0.08919608766265275,-0.9000722226577578
10,1559397600,718,836,118,1554,22,0.281493356501908,0.31913186203342825
10,1559412000,938,813,0,1751,22,-0.5589169295363186,0.6227768742763659
10,1559426400,993,744,0,1737,22,-0.5589169295363186,0.6011980409189998
10,1559440800,995,314,0,1309,22,-0.5589169295363186,-0.05849772172047893
10,1559455200,170,96,0,266,22,-0.5589169295363186,-1.6661208068442552
10,1559469600,263,361,98,624,22,0.13905093513949668,-1.1143192109916071
10,1559484000,655,669,14,1324,22,-0.4592072345826307,-0.03537754312330094
10,1559498400,769,670,0,1439,22,-0.5589169295363186,0.14187715945506366
10,1559512800,883,398,0,1281,22,-0.5589169295363186,-0.10165538843521117
10,1559527200,540,189,0,729,22,-0.5589169295363186,-0.9524779608113612
10,1559541600,167,130,0,297,22,-0.5589169295363186,-1.6183391044100872
10,1559556000,678,1094,416,1772,22,2.403885434801836,0.655145124312415
10,1559570400,633,679,46,1312,22,-0.23129936040277266,-0.053873686001043336
10,1559584800,1143,938,0,2081,22,-0.5589169295363186,1.1314208034142816
10,1559599200,1020,674,0,1694,22,-0.5589169295363186,0.5349201956070895
10,1559613600,542,255,0,797,23,-0.24075379050581117,-0.6149424029759553
10,1559628000,154,115,0,269,23,-0.24075379050581117,-1.0936506814326121
10,1559642400,749,1061,312,1810,23,0.1585927501002837,0.3034884418660776
10,1559656800,669,748,79,1417,23,-0.13963719849337047,-0.05282283357609309
10,1559671200,1252,869,0,2121,23,-0.24075379050581117,0.5854548710327827
10,1559685600,1112,861,0,1973,23,-0.24075379050581117,0.4512714899502349
10,1559700000,643,217,0,860,23,-0.24075379050581117,-0.5578238015691951
10,1559714400,187,137,0,324,23,-0.24075379050581117,-1.0437852357600437
10,1559728800,832,921,89,1753,23,-0.12683762988420078,0.25180970725996127
10,1559743200,664,1054,390,1718,23,0.2584293852518074,0.22007715092287228
10,1559757600,1651,1092,0,2743,23,-0.24075379050581117,1.1493877293661927
10,1559772000,1111,862,0,1973,23,-0.24075379050581117,0.4512714899502349
10,1559786400,671,257,0,928,23,-0.24075379050581117,-0.49617197782856504
10,1559800800,183,112,0,295,23,-0.24075379050581117,-1.070077925296489
10,1559815200,800,1122,322,1922,23,0.1713923187094534,0.4050326221447624
10,1559829600,789,787,0,1576,23,-0.24075379050581117,0.09133363664096834
10,1559844000,997,1275,278,2272,23,0.11507421682910669,0.7223581855156523
10,1559858400,1092,6208,5116,7300,23,6.30750550994541,5.28096656445518
10,1559872800,837,285,0,1122,23,-0.24075379050581117,-0.32028295127441464
10,1559887200,220,128,0,348,23,-0.24075379050581117,-1.0220257685574683
10,1559901600,616,1095,479,1711,23,0.37234554587341784,0.21373063965545447
10,1559916000,723,744,21,1467,23,-0.21387469642655477,-0.007490610237394526
10,1559930400,1055,1109,54,2164,23,-0.17163612001629475,0.6244405831040635
10,1559944800,1012,1026,14,2038,23,-0.22283439445297357,0.510203380290543
10,1559959200,1017,318,0,1335,23,-0.24075379050581117,-0.12716767985155875
10,1559973600,255,135,0,390,23,-0.24075379050581117,-0.9839467009529616
10,1559988000,326,382,56,708,23,-0.1690762062944608,-0.6956337605188387
10,1560002400,683,839,156,1522,23,-0.04108052020276373,0.042374835435173897
10,1560016800,971,710,0,1681,23,-0.24075379050581117,0.18653130565223533
10,1560031200,977,558,0,1535,23,-0.24075379050581117,0.05416121350323552
10,1560045600,944,351,0,1295,23,-0.24075379050581117,-0.1634334585225176
10,1560060000,267,111,0,378,23,-0.24075379050581117,-0.9948264345542492
10,1560074400,269,295,26,564,23,-0.20747491212196992,-0.8261905637342906
10,1560088800,661,676,15,1337,23,-0.2215544375920566,-0.1253543909180108
10,1560103200,794,742,0,1536,23,-0.24075379050581117,0.055067857970009494
10,1560117600,921,487,0,1408,23,-0.24075379050581117,-0.06098263377705883
10,1560132000,556,196,0,752,23,-0.24075379050581117,-0.655741403980784
10,1560146400,177,128,0,305,23,-0.24075379050581117,-1.0610114806287492
10,1560160800,581,1074,493,1655,23,0.39026494192625544,0.16295854951611208
10,1560175200,730,677,0,1407,23,-0.24075379050581117,-0.0618892782438328
10,1560189600,949,894,0,1843,23,-0.24075379050581117,0.33340770926961866
10,1560204000,778,631,0,1409,23,-0.24075379050581117,-0.06007598931028486
10,1560218400,477,197,0,674,24,-0.5497384378180351,-1.1599369653712046
10,1560232800,153,129,0,282,24,-0.5497384378180351,-1.7890915903474105
10,1560247200,635,1199,564,1834,24,2.6020021357969263,0.7018471289461399
10,1560261600,688,627,0,1315,24,-0.5497384378180351,-0.13114075463205133
10,1560276000,990,927,0,1917,24,-0.5497384378180351,0.8350609908671223
10,1560290400,1183,859,0,2042,24,-0.5497384378180351,1.0356842768926982
10,1560304800,724,243,0,967,24,-0.5497384378180351,-0.6896759829272546
10,1560319200,184,139,0,323,24,-0.5497384378180351,-1.7232871525310216
10,1560333600,674,1024,350,1698,24,1.406128939425292,0.48356899375031326
10,1560348000,716,798,82,1514,24,-0.09150665229245566,0.1882515167206655
10,1560362400,965,849,0,1814,24,-0.5497384378180351,0.6697474031820477
10,1560376800,1088,790,0,1878,24,-0.5497384378180351,0.7724665256271426
10,1560391200,663,230,0,893,24,-0.5497384378180351,-0.8084449682543956
10,1560405600,187,126,0,313,24,-0.5497384378180351,-1.7393370154130678
10,1560420000,628,1176,548,1804,24,2.512591055694374,0.6536975403000016
10,1560434400,719,812,93,1531,24,-0.030036534721951096,0.21553628362014382
10,1560448800,890,1187,297,2077,24,1.1099547365855882,1.0918587969798594
10,1560463200,1040,897,0,1937,24,-0.5497384378180351,0.8671607166312144
10,1560477600,687,269,0,956,24,-0.5497384378180351,-0.7073308320975054
10,1560492000,172,160,0,332,24,-0.5497384378180351,-1.7088422759371802
10,1560506400,601,995,394,1596,24,1.6520094097073101,0.3198603923534433
10,1560520800,818,767,0,1585,24,-0.5497384378180351,0.30220554318319265
10,1560535200,1067,1100,33,2167,24,-0.3653280851065215,1.236307562918274
10,1560549600,1068,1004,0,2072,24,-0.5497384378180351,1.0838338655388364
10,1561168800,5369,3669,0,9038,25,-0.43821485809523597,3.9739880739158084
10,1561183200,260,140,0,400,25,-0.43821485809523597,-0.665952164615412
10,1561197600,314,467,153,781,25,1.0933127043340531,-0.4612963147797562
10,1561212000,705,895,190,1600,25,1.463682114856169,-0.0213668108023228
10,1561226400,1015,758,0,1773,25,-0.43821485809523597,0.07156091103906423
10,1561240800,1025,766,0,1791,25,-0.43821485809523597,0.08122969134626057
10,1561255200,969,345,0,1314,25,-0.43821485809523597,-0.1749929867944424
10,1561269600,260,106,0,366,25,-0.43821485809523597,-0.6842154163067828
10,1561284000,302,318,16,620,25,-0.27805511300459135,-0.5477781830830123
10,1561298400,625,624,0,1249,25,-0.43821485809523597,-0.2099080267926514
10,1561312800,771,786,15,1557,25,-0.2880650970727566,-0.044464452647291826
10,1561327200,867,525,0,1392,25,-0.43821485809523597,-0.1330949387965916
10,1561341600,680,206,0,886,25,-0.43821485809523597,-0.40489509632111087
10,1561356000,194,143,0,337,25,-0.43821485809523597,-0.6997928956905992
10,1561370400,606,998,392,1604,25,3.485698896625557,-0.01921819295627917
10,1561384800,705,696,0,1401,25,-0.43821485809523597,-0.1282605486429934
10,1561399200,880,902,22,1782,25,-0.21799520859559962,0.0763953011926624
10,1561413600,926,699,0,1625,25,-0.43821485809523597,-0.007937949264550107
10,1561428000,526,245,0,771,26,-0.6512344846898527,-0.970820927601609
10,1561442400,191,142,0,333,26,-0.6512344846898527,-1.6844993565808715
10,1561456800,587,1056,469,1643,26,2.6272093127989784,0.4500183191333609
10,1561471200,584,753,169,1337,26,0.5301237280513252,-0.04857893946858956
10,1561485600,958,1135,177,2093,26,0.5860460103112627,1.183249581783288
10,1561500000,1156,823,0,1979,26,-0.6512344846898527,0.9974976619119732
10,1561514400,699,280,0,979,26,-0.6512344846898527,-0.6319051439767538
10,1561528800,206,138,0,344,26,-0.6512344846898527,-1.6665759257160955
10,1561543200,620,1104,484,1724,26,2.732063592036361,0.5819999464103478
10,1561557600,699,1072,373,1771,26,1.9561419256797292,0.658581878287118
10,1561572000,1063,921,0,1984,26,-0.6512344846898527,1.0056446759414168
10,1561586400,1141,963,0,2104,26,-0.6512344846898527,1.201173012648064
10,1561600800,704,243,0,947,26,-0.6512344846898527,-0.6840460337651931
10,1561615200,184,141,0,325,26,-0.6512344846898527,-1.6975345790279812
10,1561629600,595,1045,450,1640,26,2.494393892431627,0.4451301107156947
10,1561644000,751,852,101,1603,26,0.05478432884185726,0.38484220689781184
10,1561658400,945,1221,276,2166,26,1.2780842532779881,1.3021959866131652
10,1561672800,1052,991,0,2043,26,-0.6512344846898527,1.1017794414888518
10,1561687200,884,289,0,1173,26,-0.6512344846898527,-0.3158009996343408
10,1561701600,177,152,0,329,26,-0.6512344846898527,-1.6910169678044265
10,1561709010,111,331,220,442,26,0.8866282774584263,-1.5068944507390003
10,1561716000,544,692,148,1236,26,0.3833277371189896,-0.21314862286335098
10,1561730400,774,750,0,1524,26,-0.6512344846898527,0.2561193852326024
10,1561744800,1041,1214,173,2255,26,0.558084869181294,1.4472128363372618
10,1561759200,1081,1125,44,2206,26,-0.3436619322601968,1.3673720988487141
10,1561773600,1092,360,0,1452,26,-0.6512344846898527,0.13880238320861404
10,1561788000,260,133,0,393,26,-0.6512344846898527,-1.5867351882275478
10,1561802400,299,449,150,748,26,0.3973083076839739,-1.0082971921370498
10,1561816800,693,972,279,1665,26,1.2990551091254647,0.4858651808629129
10,1561831200,1002,908,0,1910,26,-0.6512344846898527,0.885068868305651
10,1561845600,974,811,0,1785,26,-0.6512344846898527,0.6813935175695601
10,1561860000,954,358,0,1312,26,-0.6512344846898527,-0.08931400961580774
10,1561874400,320,140,0,460,26,-0.6512344846898527,-1.477565200233003
10,1561888800,280,317,37,597,26,-0.3925939292376421,-1.2543370158262475
10,1561903200,805,757,0,1562,26,-0.6512344846898527,0.318036691856374
10,1561917600,958,1053,95,2011,26,0.012842617146904193,1.0496385517004125
10,1561932000,1012,821,0,1833,26,-0.6512344846898527,0.7596048522522191
10,1561946400,752,315,0,1067,26,-0.6512344846898527,-0.48851769705854586
10,1561960800,278,163,0,441,26,-0.6512344846898527,-1.5085238535448888
10,1561975200,608,917,309,1525,26,1.50876366760023,0.2577487880384911
10,1561989600,764,639,0,1403,26,-0.6512344846898527,0.05896164572006642
10,1562004000,905,957,52,1862,26,-0.2877396500002594,0.8068575336229921
10,1562018400,985,811,0,1796,26,-0.6512344846898527,0.6993169484343361
10,1562032800,586,260,0,846,27,-0.4654390764422101,-0.7121947747841331
10,1562047200,241,122,0,363,27,-0.4654390764422101,-1.5745311243884619
10,1562061600,594,1050,456,1644,27,3.198387143048627,0.7125348463012796
10,1562076000,794,717,0,1511,27,-0.4654390764422101,0.4750799094537108
10,1562090400,999,1075,76,2074,27,0.1451986268062628,1.4802462962595846
10,1562104800,1104,853,0,1957,27,-0.4654390764422101,1.2713573668523248
10,1562119200,813,248,0,1061,27,-0.4654390764422101,-0.3283390498049806
10,1562133600,186,138,0,324,27,-0.4654390764422101,-1.6441607675242151
10,1562148000,549,966,417,1515,27,2.8850335848027004,0.48222141131378804
10,1562162400,710,1009,299,1719,27,1.9369382034432292,0.8464380061777281
10,1562176800,1315,964,0,2279,27,-0.4654390764422101,1.846248266588544
10,1562191200,1048,872,0,1920,27,-0.4654390764422101,1.2052984746466102
10,1562205600,939,256,0,1195,27,-0.4654390764422101,-0.08909873749239249
10,1562220000,176,75,0,251,27,-0.4654390764422101,-1.774493176470625
10,1562234400,302,326,24,628,27,-0.2726061175216397,-1.1014066261583435
10,1562248800,754,383,0,1137,27,-0.4654390764422101,-0.1926505144635127
10,1562263200,891,578,0,1469,27,-0.4654390764422101,0.4000941399228996
10,1562277600,970,403,0,1373,27,-0.4654390764422101,0.22869809528104545
10,1562292000,604,788,184,1392,27,1.0129469419488295,0.2626202291164124
10,1562306400,163,116,0,279,27,-0.4654390764422101,-1.7245026634500842
10,1562320800,362,546,184,908,27,1.0129469419488295,-0.6015014959529357
10,1562335200,740,753,13,1493,27,-0.3609878903602345,0.44294315108336313
10,1562349600,1013,935,0,1948,27,-0.4654390764422101,1.2552889876671511
10,1562364000,1017,846,0,1863,27,-0.4654390764422101,1.1035320731405094
10,1562378400,996,307,0,1303,27,-0.4654390764422101,0.10372181272969346
10,1562392800,235,96,0,331,27,-0.4654390764422101,-1.63166313926908
10,1562407200,288,429,141,717,27,0.667454557216141,-0.9425082097716246
10,1562421600,861,807,0,1668,27,-0.4654390764422101,0.7553838574617431
10,1562436000,989,691,0,1680,27,-0.4654390764422101,0.7768083630419749
10,1562450400,938,762,0,1700,27,-0.4654390764422101,0.8125158723423612
10,1562464800,887,233,0,1120,27,-0.4654390764422101,-0.22300189736884105
10,1562479200,224,87,0,311,27,-0.4654390764422101,-1.6673706485694662
10,1562493600,273,337,64,610,27,0.04878214734597761,-1.1335433845286913
10,1562508000,602,721,119,1323,27,0.49069101153895145,0.13942932203007974
10,1562522400,785,700,0,1485,27,-0.4654390764422101,0.4286601473632086
10,1562536800,962,502,0,1464,27,-0.4654390764422101,0.39116726259780304
10,1562551200,632,194,0,826,27,-0.4654390764422101,-0.7479022840845194
10,1562565600,197,123,0,320,27,-0.4654390764422101,-1.6513022693842925
10,1562580000,582,1038,456,1620,27,3.198387143048627,0.669685835140816
10,1562594400,710,618,0,1328,27,-0.4654390764422101,0.1483561993551763
10,1562608800,943,839,0,1782,27,-0.4654390764422101,0.958916660473945
10,1562623200,889,660,0,1549,27,-0.4654390764422101,0.5429241771244447
10,1562637600,577,205,0,782,28,-0.521106000350685,-0.8533304067146656
10,1562652000,185,96,0,281,28,-0.521106000350685,-1.6855796960815252
10,1562666400,602,1067,465,1669,28,2.405900093077235,0.6201329059967206
10,1562680800,696,690,0,1386,28,-0.521106000350685,0.15002003395915312
10,1562695200,926,965,39,1891,28,-0.27561516670834335,0.9889140282311373
10,1562709600,1119,879,0,1998,28,-0.521106000350685,1.166659884443221
10,1562724000,787,221,0,1008,28,-0.521106000350685,-0.47790457957512417
10,1562738400,187,119,0,306,28,-0.521106000350685,-1.6440502904244962
10,1562752800,613,1051,438,1664,28,2.235944900555614,0.6118270248653147
10,1562767200,686,1063,377,1749,28,1.8519720581919512,0.7530270040992131
10,1562781600,1039,1359,320,2398,28,1.4931777628685288,1.8311303749556838
10,1562796000,1041,853,0,1894,28,-0.521106000350685,0.9938975569099808
10,1562810400,688,246,0,934,28,-0.521106000350685,-0.6008316203199298
10,1562824800,188,124,0,312,28,-0.521106000350685,-1.6340832330668094
10,1562839200,620,1010,390,1630,28,1.9338023360727319,0.5553470331717554
10,1562853600,743,793,50,1536,28,-0.20637416234768288,0.3991964679013266
10,1562868000,969,1165,196,2134,28,0.7126428046210834,1.3925798512174585
10,1562882400,1064,910,0,1974,28,-0.521106000350685,1.1267916550124732
10,1562896800,636,230,0,866,28,-0.521106000350685,-0.7137916037070484
10,1562911200,214,133,0,347,28,-0.521106000350685,-1.5759420651469689
10,1562925600,541,996,455,1537,28,2.342953725476635,0.4008576441276078
10,1562940000,826,729,0,1555,28,-0.521106000350685,0.43075881620066864
10,1562954400,1102,1013,0,2115,28,-0.521106000350685,1.3610175029181164
10,1562968800,1070,1011,0,2081,28,-0.521106000350685,1.3045375112245572
10,1562983200,968,300,0,1268,28,-0.521106000350685,-0.04599876074202339
10,1562997600,208,104,0,312,28,-0.521106000350685,-1.6340832330668094
10,1563012000,329,396,67,725,28,-0.09936533742666215,-0.9480174516126916
10,1563026400,780,790,10,1570,28,-0.4581596327500846,0.45567645959488595
10,1563040800,920,728,0,1648,28,-0.521106000350685,0.5852482052448162
10,1563055200,878,838,0,1716,28,-0.521106000350685,0.6982081886319349
10,1563069600,645,256,0,901,28,-0.521106000350685,-0.6556504357872079
10,1563084000,185,106,0,291,28,-0.521106000350685,-1.6689679338187136
10,1563098400,247,358,111,605,28,0.17759868001597975,-1.1473585987664303
10,1563112800,632,619,0,1251,28,-0.521106000350685,-0.07423875658880305
10,1563127200,647,681,34,1328,28,-0.3070883505086436,0.05367181283484602
10,1563141600,840,469,0,1309,28,-0.521106000350685,0.02210946453550404
10,1563156000,587,231,0,818,28,-0.521106000350685,-0.793528062568544
10,1563170400,185,107,0,292,28,-0.521106000350685,-1.6673067575924325
10,1563184800,551,1076,525,1627,28,2.7835782986808377,0.5503635044929119
10,1563199200,669,639,0,1308,28,-0.521106000350685,0.020448288309222882
10,1563213600,979,856,0,1835,28,-0.521106000350685,0.8958881595593925
10,1563228000,888,680,0,1568,28,-0.521106000350685,0.45235410714232366
10,1563242400,617,233,0,850,29,-0.5296062315820844,-0.7644734340394377
10,1563256800,158,122,0,280,29,-0.5296062315820844,-1.7213142355715199
10,1563271200,627,1045,418,1672,29,1.9281698724768834,0.6153917218541968
10,1563285600,645,731,86,1376,29,-0.023939377636937986,0.11850597228665927
10,1563300000,1015,1066,51,2081,29,-0.2297340274983348,1.3019669636552873
10,1563314400,1066,856,0,1922,29,-0.5296062315820844,1.0350587400700222
10,1563328800,696,245,0,941,29,-0.5296062315820844,-0.6117146394088772
10,1563343200,211,107,0,318,29,-0.5296062315820844,-1.6575248488027143
10,1563357600,594,1165,571,1759,29,2.8277864847281324,0.761435844193304
10,1563372000,654,959,305,1613,29,1.2637471457815166,0.5163503055552618
10,1563386400,898,904,6,1802,29,-0.49432714874870215,0.833618571326426
10,1563400800,1055,942,0,1997,29,-0.5296062315820844,1.16095884553477
10,1563415200,595,203,0,798,29,-0.5296062315820844,-0.8517641738283294
10,1563429600,123,108,0,231,29,-0.5296062315820844,-1.8035689711418217
10,1563444000,588,1182,594,1770,29,2.9630229689227647,0.7799011929948003
10,1563458400,708,906,198,1614,29,0.6346035019195319,0.5180289736281252
10,1563472800,1031,1019,0,2050,29,-0.5296062315820844,1.249928253396525
10,1563487200,1056,888,0,1944,29,-0.5296062315820844,1.071989437673015
10,1563501600,724,271,0,995,29,-0.5296062315820844,-0.5210665634742588
10,1563516000,214,117,0,331,29,-0.5296062315820844,-1.6357021638554916
10,1563530400,551,980,429,1531,29,1.9928481910047509,0.3786995235804711
10,1563544800,752,734,0,1486,29,-0.5296062315820844,0.3031594603016225
10,1563559200,884,1076,192,1960,29,0.5993244190861495,1.0988481268388277
10,1563573600,1217,1210,0,2427,29,-0.5296062315820844,1.8827861168659898
10,1563588000,1100,331,0,1431,29,-0.5296062315820844,0.21083271629414088
10,1563602400,224,101,0,325,29,-0.5296062315820844,-1.6457741722926713
10,1563616800,321,450,129,771,29,0.22889404933563526,-0.8970882117956386
10,1563631200,742,799,57,1541,29,-0.1944549446649525,0.39548620430910414
10,1563645600,886,690,0,1576,29,-0.5296062315820844,0.4542395868593197
10,1563660000,986,700,0,1686,29,-0.5296062315820844,0.6388930748742829
10,1563674400,930,252,0,1182,29,-0.5296062315820844,-0.20715563384882135
10,1563688800,268,100,0,368,29,-0.5296062315820844,-1.5735914451595494
10,1563703200,210,358,148,568,29,0.34061114497467926,-1.2378578305868888
10,1563717600,621,524,0,1145,29,-0.5296062315820844,-0.26926635254476355
10,1563732000,774,690,0,1464,29,-0.5296062315820844,0.2662287626986299
10,1563746400,934,470,0,1404,29,-0.5296062315820844,0.16550867832683172
10,1563760800,637,184,0,821,29,-0.5296062315820844,-0.8131548081524734
10,1563775200,172,114,0,286,29,-0.5296062315820844,-1.7112422271343402
10,1563789600,591,1133,542,1724,29,2.6572709177001177,0.7026824616430885
10,1563804000,609,666,57,1275,29,-0.1944549446649525,-0.05103950307253425
10,1563818400,875,872,0,1747,29,-0.5296062315820844,0.7412918273189444
10,1563832800,899,866,0,1765,29,-0.5296062315820844,0.7715078526304838
10,1563847200,505,239,0,744,30,-0.5171869561891463,-0.8240597810022822
10,1563861600,150,109,0,259,30,-0.5171869561891463,-1.514722753023445
10,1563876000,574,1215,641,1789,30,3.1701446717056907,0.6640697154144499
10,1563890400,697,774,77,1471,30,-0.07424696344670884,0.2112226533469659
10,1563904800,707,1104,397,1811,30,1.7665426167816027,0.6953987574442759
10,1563919200,2055,1586,0,3641,30,-0.5171869561891463,3.3014054353797975
10,1563933600,799,268,0,1067,30,-0.5171869561891463,-0.36409248210983775
10,1563948000,148,137,0,285,30,-0.5171869561891463,-1.4776975215336507
10,1563962400,633,1104,471,1737,30,2.1922252072094,0.5900192524348614
10,1563976800,715,1016,301,1731,30,1.2143057427131092,0.5814749682449089
10,1563991200,1012,1007,0,2019,30,-0.5171869561891463,0.9916006093626303
10,1564005600,1157,997,0,2154,30,-0.5171869561891463,1.1838470036365623
10,1564020000,687,251,0,938,30,-0.5171869561891463,-0.5477945921938171
10,1564034400,160,128,0,288,30,-0.5171869561891463,-1.4734253794386745
10,1564048800,627,1120,493,1747,30,2.3187794908500963,0.6042597260847823
10,1564063200,769,814,45,1583,30,-0.25832592146954003,0.3707159582260798
10,1564077600,999,1096,97,2095,30,0.04080238531756065,1.099828209102029
10,1564092000,1065,899,0,1964,30,-0.5171869561891463,0.9132780042880654
10,1564106400,829,275,0,1104,30,-0.5171869561891463,-0.3114027296051305
10,1564120800,241,148,0,389,30,-0.5171869561891463,-1.3295965955744735
10,1564135200,578,918,340,1496,30,1.4386519728034348,0.24682383747176811
10,1564149600,703,709,6,1412,30,-0.4826721515598655,0.1272038588124327
10,1564164000,1086,1149,63,2235,30,-0.15478150758169748,1.2991948402009212
10,1564178400,1045,947,0,1992,30,-0.5171869561891463,0.9531513305078438
10,1564192800,1007,330,0,1337,30,-0.5171869561891463,0.020400306438026088
10,1564207200,232,101,0,333,30,-0.5171869561891463,-1.4093432480140304
10,1564221600,270,419,149,689,30,0.3399306921046613,-0.9023823860768471
10,1564236000,650,805,155,1455,30,0.3744454967339422,0.1884378955070925
10,1564250400,912,773,0,1685,30,-0.5171869561891463,0.5159687894552728
10,1564264800,997,790,0,1787,30,-0.5171869561891463,0.6612216206844658
10,1564279200,833,284,0,1117,30,-0.5171869561891463,-0.29289011386023334
10,1564293600,224,95,0,319,30,-0.5171869561891463,-1.4292799111239196
10,1564308000,264,291,27,555,30,-0.36187033535738256,-1.0932047329857868
10,1564322400,652,617,0,1269,30,-0.5171869561891463,-0.0764349143814359
10,1564336800,763,711,0,1474,30,-0.5171869561891463,0.21549479544194217
10,1564351200,835,513,0,1348,30,-0.5171869561891463,0.03606482745293906
10,1564365600,568,186,0,754,30,-0.5171869561891463,-0.8098193073523613
10,1564380000,171,101,0,272,30,-0.5171869561891463,-1.496210137278548
10,1564394400,558,1140,582,1698,30,2.8307490928510957,0.53448140520017
10,1564408800,692,712,20,1404,30,-0.40213760742487686,0.115811479892496
10,1564423200,873,796,0,1669,30,-0.5171869561891463,0.49318403161539937
10,1564424250,82,84,2,166,30,-0.5056820213127194,-1.6471591579677092
10,1564437600,906,687,0,1593,30,-0.5171869561891463,0.38495643187600065
10,1564452000,669,220,0,889,31,-0.5987129406623889,-0.8560954748041446
10,1564466400,183,129,0,312,31,-0.5987129406623889,-1.8187597163865883
10,1564480800,600,1208,608,1808,31,2.4818298062154596,0.6771600503505621
10,1564495200,648,699,51,1347,31,-0.3403121510394114,-0.09197030557579239
10,1564509600,923,955,32,1878,31,-0.43657911187934423,0.793947739970616
10,1564524000,1023,880,0,1903,31,-0.5987129406623889,0.8356576291206351
10,1564538400,714,254,0,968,31,-0.5987129406623889,-0.7242922250900838
10,1564552800,159,133,0,292,31,-0.5987129406623889,-1.8521276277066037
10,1564567200,631,1167,536,1798,31,2.117028691453609,0.6604760946905545
10,1564581600,672,1019,347,1691,31,1.1594257652037514,0.48195776912847216
10,1564596000,938,1021,83,1959,31,-0.1781783222563668,0.9290877808166782
10,1564610400,976,853,0,1829,31,-0.5987129406623889,0.7121963572365783
10,1564624800,631,242,0,873,31,-0.5987129406623889,-0.8827898038601569
10,1564639200,166,137,0,303,31,-0.5987129406623889,-1.8337752764805952
10,1564653600,547,1072,525,1619,31,2.061295187809437,0.36183328837641676
10,1564668000,732,861,129,1593,31,0.054889056619259885,0.31845500366039675
10,1564682400,1014,1100,86,2114,31,-0.16297827580795637,1.1876890935467974
10,1564696800,1004,809,0,1813,31,-0.5987129406623889,0.6855020281805659
10,1564711200,793,259,0,1052,31,-0.5987129406623889,-0.5841469975460193
10,1564725600,244,129,0,373,31,-0.5987129406623889,-1.7169875868605413
10,1564740000,552,979,427,1531,31,1.5647603371613632,0.2150144785683491
10,1564754400,810,755,0,1565,31,-0.5987129406623889,0.27173992781237527
10,1564768800,1058,1070,12,2128,31,-0.5379127548687471,1.2110466314708082
10,1564783200,1121,892,0,2013,31,-0.5987129406623889,1.0191811413807197
10,1565402400,5806,4080,0,9886,32,-0.36304498322758577,3.9983301815391696
10,1565416800,171,89,0,260,32,-0.36304498322758577,-0.6702998155289062
10,1565431200,293,444,151,737,32,1.0036534439366498,-0.43895382460832943
10,1565445600,747,817,70,1564,32,0.27052382406709297,-0.037857106597182714
10,1565460000,910,708,0,1618,32,-0.36304498322758577,-0.011666994417494778
10,1565474400,964,715,0,1679,32,-0.36304498322758577,0.017918132304004557
10,1565488800,923,307,0,1230,32,-0.36304498322758577,-0.19984780044932662
10,1565503200,217,90,0,307,32,-0.36304498322758577,-0.6475047178910297
10,1565517600,307,339,32,646,32,-0.07341352846430407,-0.4830890136518776
10,1565532000,727,552,0,1279,32,-0.36304498322758577,-0.17608269865664683
10,1565546400,784,702,0,1486,32,-0.36304498322758577,-0.07568726863450974
10,1565560800,840,510,0,1350,32,-0.36304498322758577,-0.1416475511611312
10,1565575200,603,209,0,812,32,-0.36304498322758577,-0.4025786688032073
10,1565589600,185,103,0,288,32,-0.36304498322758577,-0.6567197573616607
10,1565604000,546,1015,469,1561,32,3.8818660256467616,-0.0393121128293876
10,1565618400,683,675,0,1358,32,-0.36304498322758577,-0.13776753454191817
10,1565632800,936,857,0,1793,32,-0.36304498322758577,0.0732083691277902
10,1565647200,940,763,0,1703,32,-0.36304498322758577,0.02955818216164364
10,1565661600,541,198,0,739,33,-0.5564038384093478,-0.9704487547593645
10,1565676000,186,85,0,271,33,-0.5564038384093478,-1.7631324616888056
10,1565690400,577,1163,586,1740,33,3.0905232643685134,0.7250136183952732
10,1565704800,620,736,116,1356,33,0.16551347203814692,0.07460647424803955
10,1565719200,869,1014,145,1883,33,0.3459927996500206,0.9672225288459357
10,1565733600,1091,811,0,1902,33,-0.5564038384093478,0.9994041323323875
10,1565748000,649,185,0,834,33,-0.5564038384093478,-0.8095407373271062
10,1565762400,122,106,0,228,33,-0.5564038384093478,-1.8359645116844594
10,1565776800,589,1099,510,1688,33,2.6175429575236033,0.6369376509586687
10,1565791200,680,945,265,1625,33,1.0928038104577737,0.5302302288720132
10,1565805600,1005,977,0,1982,33,-0.5564038384093478,1.1349056206963946
10,1565820000,1083,869,0,1952,33,-0.5564038384093478,1.0840925625598918
10,1565834400,621,190,0,811,33,-0.5564038384093478,-0.8484974152317583
10,1565848800,156,100,0,256,33,-0.5564038384093478,-1.788538990757057
10,1565863200,574,1072,498,1646,33,2.542861856442828,0.565799369567565
10,1565877600,741,871,130,1612,33,0.2526414232990515,0.508211237012862
10,1565892000,951,1049,98,2000,33,0.05349182041698396,1.165393455578296
10,1565906400,1049,899,0,1948,33,-0.5564038384093478,1.0773174881416916
10,1565920800,790,256,0,1046,33,-0.5564038384093478,-0.45046179316248763
10,1565935200,186,115,0,301,33,-0.5564038384093478,-1.712319403552303
10,1565949600,513,826,313,1339,33,1.3915282147808752,0.04581240797068807
10,1565964000,770,784,14,1554,33,-0.4692758871484433,0.40997265794895693
10,1565978400,1048,1079,31,2127,33,-0.36347766061734493,1.3805020683561573
10,1565992800,930,900,0,1830,33,-0.5564038384093478,0.8774527928047812
10,1566007200,938,361,0,1299,33,-0.5564038384093478,-0.02193833621131544
10,1566021600,248,96,0,344,33,-0.5564038384093478,-1.6394873535566492
10,1566036000,264,461,197,725,33,0.6696109043333803,-0.9941615152230658
10,1566050400,738,896,158,1634,33,0.42689732582086054,0.545474146312964
10,1566064800,921,920,0,1841,33,-0.5564038384093478,0.8960842474548321
10,1566079200,1044,960,0,2004,33,-0.5564038384093478,1.1721685299964963
10,1566093600,990,335,0,1325,33,-0.5564038384093478,0.02209964750698684
10,1566108000,239,99,0,338,33,-0.5564038384093478,-1.6496499651839498
10,1566122400,316,390,74,706,33,-0.09587038174456669,-1.0263431187095176
10,1566136800,758,698,0,1456,33,-0.5564038384093478,0.24398333470304834
10,1566151200,828,942,114,1770,33,0.15306662185801773,0.7758266765317758
10,1566165600,911,673,0,1584,33,-0.5564038384093478,0.46078571608545954
10,1566180000,640,223,0,863,33,-0.5564038384093478,-0.7604214477951536
10,1566194400,166,128,0,294,33,-0.5564038384093478,-1.7241757837841536
10,1566208800,560,1066,506,1626,33,2.5926492571633446,0.5319239974765633
10,1566223200,666,653,0,1319,33,-0.5564038384093478,0.011937035879686314
10,1566237600,885,815,0,1700,33,-0.5564038384093478,0.6572628742132698
10,1566252000,905,699,0,1604,33,-0.5564038384093478,0.4946610881764613
10,1566266400,464,199,0,663,34,-0.5160243486251687,-1.0580744825951234
10,1566280800,155,89,0,244,34,-0.5160243486251687,-1.7955876423649566
10,1566295200,523,1044,521,1567,34,2.6719047300354584,0.5331233609178342
10,1566309600,666,744,78,1410,34,-0.03875281669517074,0.2567759478298537
10,1566324000,943,994,51,1937,34,-0.2039621931324777,1.184387965010527
10,1566338400,1048,849,0,1897,34,-0.5160243486251687,1.1139809807842898
10,1566352800,654,253,0,907,34,-0.5160243486251687,-0.6285918788150773
10,1566367200,157,111,0,268,34,-0.5160243486251687,-1.7533434518292144
10,1566381600,541,1033,492,1574,34,2.4944576220102026,0.5454445831574256
10,1566396000,589,945,356,1534,34,1.6622918740296937,0.4750375989311886
10,1566410400,903,956,53,1859,34,-0.19172446154452905,1.0470943457693647
10,1566424800,982,712,0,1694,34,-0.5160243486251687,0.7566655358361368
10,1566439200,610,191,0,801,34,-0.5160243486251687,-0.8151703870146055
10,1566453600,147,109,0,256,34,-0.5160243486251687,-1.7744655470970854
10,1566468000,566,1082,516,1648,34,2.641310401065587,0.6756975039759642
10,1566482400,679,801,122,1480,34,0.23047727823969985,0.37998817022576853
10,1566496800,906,937,31,1843,34,-0.32633950901196435,1.0189315520788698
10,1566511200,981,857,0,1838,34,-0.5160243486251687,1.0101306790505902
10,1566525600,651,236,0,887,34,-0.5160243486251687,-0.6637953709281958
10,1566540000,199,117,0,316,34,-0.5160243486251687,-1.6688550707577299
10,1566554400,519,970,451,1489,34,2.243584124457255,0.3958297416766719
10,1566568800,819,690,0,1509,34,-0.5160243486251687,0.4310332337897904
10,1566583200,977,927,0,1904,34,-0.5160243486251687,1.1263022030238814
10,1566597600,1002,964,0,1966,34,-0.5160243486251687,1.2354330285745487
10,1566612000,844,335,0,1179,34,-0.5160243486251687,-0.14982438607666532
10,1566626400,218,115,0,333,34,-0.5160243486251687,-1.638932102461579
10,1566640800,342,439,97,781,34,0.07750563339034157,-0.850373879127724
10,1566655200,811,889,78,1700,34,-0.03875281669517074,0.7672265834700723
10,1566669600,1001,826,0,1827,34,-0.5160243486251687,0.990768758388375
10,1566684000,1019,961,0,1980,34,-0.5160243486251687,1.2600754730537318
10,1566698400,871,311,0,1182,34,-0.5160243486251687,-0.14454386225969754
10,1566712800,197,105,0,302,34,-0.5160243486251687,-1.6934975152369127
10,1566727200,281,317,36,598,34,-0.29574518004209266,-1.1724858319627587
10,1566741600,676,650,0,1326,34,-0.5160243486251687,0.10892128095475587
10,1566756000,899,861,0,1760,34,-0.5160243486251687,0.8728370598094279
10,1566770400,895,708,0,1603,34,-0.5160243486251687,0.5964896467214474
10,1566784800,595,207,0,802,34,-0.5160243486251687,-0.8134102124089496
10,1566799200,203,121,0,324,34,-0.5160243486251687,-1.6547736739124823
10,1566813600,577,1068,491,1645,34,2.4883387562162285,0.6704169801589964
10,1566828000,717,706,0,1423,34,-0.5160243486251687,0.27965821770338073
10,1566842400,770,780,10,1550,34,-0.4548356906854253,0.5032003926216834
10,1566856800,564,723,159,1287,34,0.45687531261675013,0.040274471334174736
10,1566871200,1396,909,0,2305,35,-0.5177163798458944,1.9331600303016618
10,1566885600,127,99,0,226,35,-0.5177163798458944,-1.730659580647853
10,1566900000,553,1038,485,1591,35,2.731448561979603,0.6748785477533437
10,1566914400,645,772,127,1417,35,0.33309588327129774,0.3682385225945098
10,1566928800,906,974,68,1880,35,-0.06216335707448442,1.1841829573562344
10,1566943200,1001,795,0,1796,35,-0.5177163798458944,1.0361498417623145
10,1566957600,576,230,0,806,35,-0.5177163798458944,-0.7085261634517401
10,1566972000,161,123,0,284,35,-0.5177163798458944,-1.6284462389282417
10,1566986400,578,1124,546,1702,35,3.1401064206421916,0.8704937362167376
10,1567000800,619,935,316,1554,35,1.5992653142094813,0.6096734849322123
10,1567015200,906,976,70,1882,35,-0.04876473875767825,1.187707555346566
10,1567029600,885,788,0,1673,35,-0.5177163798458944,0.8193870653569321
10,1567044000,552,227,0,779,35,-0.5177163798458944,-0.7561082363212144
10,1567058400,147,107,0,254,35,-0.5177163798458944,-1.681315208783213
10,1567072800,549,1037,488,1586,35,2.7515464894548125,0.6660670527775151
10,1567087200,734,711,0,1445,35,-0.5177163798458944,0.41758289445914976
10,1567101600,911,1059,148,1970,35,0.4737813755977626,1.3427898669211484
10,1567116000,968,788,0,1756,35,-0.5177163798458944,0.9656578819556861
10,1567130400,694,273,0,967,35,-0.5177163798458944,-0.42479602523006055
10,1567144800,188,110,0,298,35,-0.5177163798458944,-1.6037740529959217
10,1567153784,230,310,80,540,35,0.018228352826352632,-1.1772976961658195
10,1567159200,340,818,478,1158,35,2.6845533978707814,-0.08819691715340956
10,1567173600,771,688,0,1459,35,-0.5177163798458944,0.4422550803914697
10,1567188000,1035,903,0,1938,35,-0.5177163798458944,1.2863962990758457
10,1567202400,989,858,0,1847,35,-0.5177163798458944,1.1260270905157659
10,1567216800,851,288,0,1139,35,-0.5177163798458944,-0.12168059806155808
10,1567231200,215,117,0,332,35,-0.5177163798458944,-1.5438558871602874
10,1567245600,326,445,119,771,35,0.2795014100040731,-0.77020662828254
10,1567260000,682,870,188,1552,35,0.7417537419338861,0.606148886941881
10,1567274400,853,762,0,1615,35,-0.5177163798458944,0.7171737236373208
10,1567288800,897,766,0,1663,35,-0.5177163798458944,0.801764075405275
10,1567303200,815,311,0,1126,35,-0.5177163798458944,-0.14459048499871233
10,1567317600,219,86,0,305,35,-0.5177163798458944,-1.5914379600297617
10,1567332000,314,372,58,686,35,-0.1291564486585153,-0.9200020428716256
10,1567346400,650,713,63,1363,35,-0.09565990286649986,0.27307437685556135
10,1567360800,749,781,32,1530,35,-0.3033384867769956,0.5673783090482353
10,1567375200,883,643,0,1526,35,-0.5177163798458944,0.5603291130675724
10,1567389600,651,308,0,959,35,-0.5177163798458944,-0.4388944171913862
10,1567404000,156,69,0,225,35,-0.5177163798458944,-1.7324218796430186
10,1567418400,315,372,57,687,35,-0.1358557578169184,-0.9182397438764598
10,1567432800,616,373,0,989,35,-0.5177163798458944,-0.38602544733641486
10,1567447200,653,547,0,1200,35,-0.5177163798458944,-0.014180359356449663
10,1567461600,670,495,0,1165,35,-0.5177163798458944,-0.07586082418724957
10,1567476000,395,192,0,587,36,-0.5489370373105005,-1.147937035799865
10,1567490400,187,112,0,299,36,-0.5489370373105005,-1.644484253116242
10,1567504800,531,1100,569,1631,36,2.5909617941031757,0.6520466269720017
10,1567519200,603,592,0,1195,36,-0.5489370373105005,-0.09967068813195804
10,1567533600,842,949,107,1791,36,0.04151845471280948,0.9279061921477666
10,1567548000,874,824,0,1698,36,-0.5489370373105005,0.7675628198893533
10,1567562400,453,245,0,698,36,-0.5489370373105005,-0.9565594624591781
10,1567576800,159,100,0,259,36,-0.5489370373105005,-1.7134491444101834
10,1567591200,643,996,353,1639,36,1.3990142588037837,0.6658396052307899
10,1567605600,661,946,285,1607,36,1.0237715162095307,0.6106676921956369
10,1567620000,884,1017,133,1901,36,0.18499362099884742,1.117559643206105
10,1567634400,951,786,0,1737,36,-0.5489370373105005,0.834803588900946
10,1567648800,523,252,0,775,36,-0.5489370373105005,-0.8238020467183412
10,1567663200,168,92,0,260,36,-0.5489370373105005,-1.7117250221278348
10,1567677600,571,1180,609,1751,36,2.8116928191586186,0.8589413008538254
10,1567692000,664,786,122,1450,36,0.1242925891086006,0.3399804938669175
10,1567706400,933,989,56,1922,36,-0.2399136022328803,1.1537662111354243
10,1567720800,891,871,0,1762,36,-0.5489370373105005,0.8779066459596593
10,1567735200,676,246,0,922,36,-0.5489370373105005,-0.570356071213107
10,1567749600,179,121,0,300,36,-0.5489370373105005,-1.6427601308338935
10,1567764000,559,1124,565,1683,36,2.5688886915976314,0.7417009856541252
10,1567778400,660,749,89,1409,36,-0.05781050656213985,0.26929148029062766
10,1567792800,1002,1139,137,2141,36,0.2070667235043917,1.5313489909697526
10,1567807200,968,929,0,1897,36,-0.5489370373105005,1.110663154076711
10,1567821600,874,316,0,1190,36,-0.5489370373105005,-0.10829129954370069
10,1567836000,210,73,0,283,36,-0.5489370373105005,-1.6720702096338187
10,1567850400,306,515,209,821,36,0.604382568604189,-0.7444924217303087
10,1567864800,715,936,221,1651,36,0.6706018761208219,0.6865290726189722
10,1567879200,919,827,0,1746,36,-0.5489370373105005,0.8503206894420827
10,1567893600,1001,798,0,1799,36,-0.5489370373105005,0.9416991704065549
10,1567908000,836,304,0,1140,36,-0.5489370373105005,-0.19449741366112724
10,1567922400,228,104,0,332,36,-0.5489370373105005,-1.5875882177987406
10,1567936800,262,352,90,614,36,-0.05229223093575378,-1.1013857341764548
10,1567951200,585,520,0,1105,36,-0.5489370373105005,-0.25484169354332586
10,1567965600,858,810,0,1668,36,-0.5489370373105005,0.7158391514188973
10,1567980000,882,507,0,1389,36,-0.5489370373105005,0.23480903464365704
10,1567994400,485,209,0,694,36,-0.5489370373105005,-0.9634559515885722
10,1568008800,178,120,0,298,36,-0.5489370373105005,-1.6462083753985906
10,1568023200,597,1230,633,1827,36,2.9441314341918843,0.9899745943123138
10,1568037600,694,656,0,1350,36,-0.5489370373105005,0.16756826563206434
10,1568052000,892,859,0,1751,36,-0.5489370373105005,0.8589413008538254
10,1568066400,922,724,0,1646,36,-0.5489370373105005,0.6779084612072296
10,1568080800,570,206,0,776,37,-0.5510480854004699,-0.8785646080330546
10,1568095200,164,100,0,264,37,-0.5510480854004699,-1.7191346975126243
10,1568109600,603,1267,664,1870,37,2.775998679191066,0.9174972628471195
10,1568124000,642,780,138,1422,37,0.1404164530236746,0.18199843455249615
10,1568138400,953,954,1,1907,37,-0.5460374728031935,0.9782415857196666
10,1568152800,991,965,0,1956,37,-0.5510480854004699,1.058686770064391
10,1568167200,604,212,0,816,37,-0.5510480854004699,-0.8128950697924632
10,1568181600,185,94,0,279,37,-0.5510480854004699,-1.6945086206724025
10,1568196000,610,1269,659,1879,37,2.750945616204684,0.9322729089512526
10,1568210400,617,939,322,1556,37,1.062369170922534,0.40199138765847725
10,1568224800,991,1138,147,2129,37,0.1855119663991623,1.3427075229549488
10,1568239200,951,972,21,1923,37,-0.4458252208576653,1.0045094010159032
10,1568253600,623,252,0,875,37,-0.5510480854004699,-0.716032500887591
10,1568268000,163,116,0,279,37,-0.5510480854004699,-1.6945086206724025
10,1568282400,609,1157,548,1766,37,2.1947676179070026,0.746756463421582
10,1568296800,670,829,159,1499,37,0.2456393175664792,0.30841229566563455
10,1568311200,950,1097,147,2047,37,0.1855119663991623,1.2080849695617364
10,1568325600,969,973,4,1942,37,-0.5310056350113643,1.035702431680184
10,1568340000,606,235,0,841,37,-0.5510480854004699,-0.7718516083920935
10,1568354400,175,136,0,311,37,-0.5510480854004699,-1.6419729900799294
10,1568368800,565,1160,595,1725,37,2.430266409978994,0.6794451867249758
10,1568383200,699,674,0,1373,37,-0.5510480854004699,0.10155325020777171
10,1568397600,948,1148,200,2096,37,0.45107443405481196,1.2885301539064609
10,1568412000,1036,1065,29,2101,37,-0.40574032007945404,1.2967388461865348
10,1568426400,930,317,0,1247,37,-0.5510480854004699,-0.10530579525009112
10,1568440800,199,98,0,297,37,-0.5510480854004699,-1.6649573284641364
10,1568455200,311,439,128,750,37,0.0903103270509105,-0.921249807889439
10,1568469600,799,860,61,1659,37,-0.24540071696660895,0.5710904486280001
10,1568484000,984,738,0,1722,37,-0.5510480854004699,0.6745199713569314
10,1568498400,931,744,0,1675,37,-0.5510480854004699,0.5973582639242366
10,1568512800,954,313,0,1267,37,-0.5510480854004699,-0.07247102612979543
10,1568527200,211,90,0,301,37,-0.5510480854004699,-1.6583903746400772
10,1568541600,246,357,111,603,37,0.005129912897211535,-1.1625853609236123
10,1568556000,599,666,67,1265,37,-0.21533704138295048,-0.075754503041825
10,1568570400,816,738,0,1554,37,-0.5510480854004699,0.3987079107464477
10,1568584800,875,563,0,1438,37,-0.5510480854004699,0.2082662498487327
10,1568599200,544,226,0,770,37,-0.5510480854004699,-0.8884150387691433
10,1568613600,175,113,0,288,37,-0.5510480854004699,-1.6797329745682694
10,1568628000,595,1213,618,1808,37,2.545510499716351,0.815709478574203
10,1568642400,705,655,0,1360,37,-0.5510480854004699,0.08021065027957952
10,1568656800,889,887,0,1776,37,-0.5510480854004699,0.7631738479817298
10,1568671200,856,800,0,1656,37,-0.5510480854004699,0.5661652332599557
10,1568685600,480,191,0,671,38,-0.5838960805814486,-1.0672106100255334
10,1568700000,150,118,0,268,38,-0.5838960805814486,-1.699180899543505
10,1568714400,644,1237,593,1881,38,2.6010613839305003,0.8302684230185001
10,1568728800,676,782,106,1458,38,-0.014578220145923125,0.16693484369814787
10,1568743200,962,1058,96,2020,38,-0.06828745226248213,1.0482432871450462
10,1568757600,1119,975,0,2094,38,-0.5838960805814486,1.1642874594138548
10,1568772000,598,174,0,772,38,-0.5838960805814486,-0.9088259965235108
10,1568786400,145,62,0,207,38,-0.5838960805814486,-1.7948389334407662
10,1568800800,638,1234,596,1872,38,2.617174153565468,0.8161549426074288
10,1568815200,635,923,288,1558,38,0.9629298043754506,0.3237512927100515
10,1568829600,999,965,0,1964,38,-0.5838960805814486,0.9604260756983801
10,1568844000,982,954,0,1936,38,-0.5838960805814486,0.9165174699750471
10,1568858400,655,177,0,832,38,-0.5838960805814486,-0.8147361271163687
10,1568872800,158,68,0,226,38,-0.5838960805814486,-1.7650438081285045
10,1568887200,665,1208,543,1873,38,2.332515223347705,0.8177231070975478
10,1568901600,714,767,53,1481,38,-0.2992371503636858,0.2030026269708857
10,1568916000,1010,1110,100,2120,38,-0.04680375941585853,1.2050597361569497
10,1568930400,1048,978,0,2026,38,-0.5838960805814486,1.0576522740857603
10,1568944800,650,204,0,854,38,-0.5838960805814486,-0.7802365083337499
10,1568959200,146,61,0,207,38,-0.5838960805814486,-1.7948389334407662
10,1568973600,520,1089,569,1609,38,2.4721592268507586,0.40372768170612233
10,1568988000,763,788,25,1551,38,-0.44962300029005103,0.3127741412792182
10,1569002400,995,1101,106,2096,38,-0.014578220145923125,1.1674237883940928
10,1569016800,1113,1090,0,2203,38,-0.5838960805814486,1.3352173888368297
10,1569031200,924,318,0,1242,38,-0.5838960805814486,-0.1717886861675639
10,1569045600,209,112,0,321,38,-0.5838960805814486,-1.616068181567196
10,1569060000,311,500,189,811,38,0.4312084064215166,-0.8476675814088684
10,1569074400,751,1042,291,1793,38,0.9790425740104183,0.692269947888025
10,1569088800,981,960,0,1941,38,-0.5838960805814486,0.9243582924256423
10,1569103200,996,965,0,1961,38,-0.5838960805814486,0.955721582228023
10,1569117600,999,337,0,1336,38,-0.5838960805814486,-0.02438122409637452
10,1569132000,344,93,0,437,38,-0.5838960805814486,-1.4341611007133879
10,1569146400,282,487,205,769,38,0.517143177808011,-0.913530489993868
10,1569160800,632,904,272,1536,38,0.8769950329889562,0.2892516739274327
10,1569175200,776,790,14,1566,38,-0.508703155618266,0.33629660863100375
10,1569189600,946,557,0,1503,38,-0.5838960805814486,0.2375022457535045
10,1569204000,558,178,0,736,38,-0.5838960805814486,-0.9652799181677961
10,1569218400,164,108,0,272,38,-0.5838960805814486,-1.6929082415830288
10,1569232800,636,1148,512,1784,38,2.1660166037863724,0.6781564674769536
10,1569247200,765,654,0,1419,38,-0.5838960805814486,0.10577642858350547
10,1569261600,899,907,8,1806,38,-0.5409286948882014,0.7126560862595724
10,1569276000,992,761,0,1753,38,-0.5838960805814486,0.6295433682832635
10,1569290400,525,188,0,713,39,-0.5634760584804238,-0.9628760788746792
10,1569304800,130,94,0,224,39,-0.5634760584804238,-1.7341232575310561
10,1569319200,647,1284,637,1931,39,2.9197121274219002,0.9581445010915112
10,1569333600,683,725,42,1408,39,-0.3338152989703805,0.13327277422589745
10,1569348000,999,1077,78,2076,39,-0.13696321939034334,1.1868374272779625
10,1569362400,1075,853,0,1928,39,-0.5634760584804238,0.9534129233083433
10,1569376800,597,227,0,824,39,-0.5634760584804238,-0.7878077008974648
10,1569391200,130,98,0,228,39,-0.5634760584804238,-1.7278144871534988
10,1569405600,688,1287,599,1975,39,2.711923821198528,1.0275409752446412
10,1569420000,668,869,201,1537,39,0.5356147191747836,0.3367306189021196
10,1569434400,986,927,0,1913,39,-0.5634760584804238,0.9297550343925035
10,1569448800,1103,916,0,2019,39,-0.5634760584804238,1.0969374493977713
10,1569463200,581,256,0,837,39,-0.5634760584804238,-0.7673041971704037
10,1569477600,157,111,0,268,39,-0.5634760584804238,-1.664726783377926
10,1569492000,683,1219,536,1902,39,2.3674326819334626,0.9124059158542209
10,1569506400,650,818,168,1468,39,0.3551669795597496,0.22790432988925657
10,1569520800,966,1238,272,2204,39,0.9238507650131903,1.3887180793597953
10,1569535200,1005,1002,0,2007,39,-0.5634760584804238,1.0780111382650994
10,1569549600,660,220,0,880,39,-0.5634760584804238,-0.6994849156116629
10,1569564000,177,105,0,282,39,-0.5634760584804238,-1.6426460870564756
10,1569578400,580,1116,536,1696,39,2.3674326819334626,0.5875042414100212
10,1569592800,756,743,0,1499,39,-0.5634760584804238,0.27679730031532546
10,1569607200,1061,1123,62,2184,39,-0.2244530325370265,1.3571742274720089
10,1569621600,1093,1078,0,2171,39,-0.5634760584804238,1.3366707237449478
10,1569636000,901,338,0,1239,39,-0.5634760584804238,-0.13327277422589745
10,1569650400,202,89,0,291,39,-0.5634760584804238,-1.6284513537069718
10,1569664800,336,458,122,794,39,0.10363376676303541,-0.8351234787291443
10,1569679200,737,903,166,1640,39,0.34423075291641414,0.49918145612421944
10,1569693600,1023,942,0,1965,39,-0.5634760584804238,1.011769049300748
10,1569708000,971,833,0,1804,39,-0.5634760584804238,0.7578410416040677
10,1569722400,883,324,0,1207,39,-0.5634760584804238,-0.18374293724635565
10,1569736800,232,93,0,325,39,-0.5634760584804238,-1.5748268054977348
10,1569751200,311,362,51,673,39,-0.28460227907537117,-1.025963782650252
10,1569765600,683,732,49,1415,39,-0.2955385057187066,0.14431312238662267
10,1569780000,711,906,195,1617,39,0.5028060392447774,0.46290602645326506
10,1569794400,794,546,0,1340,39,-0.5634760584804238,0.026023677807423762
10,1569808800,543,177,0,720,39,-0.5634760584804238,-0.9518357307139539
10,1569823200,147,110,0,257,39,-0.5634760584804238,-1.6820759019162086
10,1569837600,546,1057,511,1603,39,2.2307298488917704,0.44082533013181463
10,1569852000,651,631,0,1282,39,-0.5634760584804238,-0.06545349266715673
10,1569866400,740,843,103,1583,39,-0.0002603863486508613,0.4092814782440282
10,1569880800,922,736,0,1658,39,-0.5634760584804238,0.5275709228232272
10,1569895200,491,212,0,703,40,-0.5712909821734345,-0.98728324256483
10,1569909600,159,90,0,249,40,-0.5712909821734345,-1.694477715488428
10,1569924000,574,1163,589,1737,40,2.446560035765157,0.6233755349748182
10,1569938400,588,694,106,1282,40,-0.02818027266326359,-0.085376635025704
10,1569952800,945,965,20,1910,40,-0.4688172633979306,0.8928571292827091
10,1569967200,980,886,0,1866,40,-0.5712909821734345,0.8243184578980431
10,1569981600,656,218,0,874,40,-0.5712909821734345,-0.7209170424107876
10,1569996000,183,111,0,294,40,-0.5712909821734345,-1.624381347026838
10,1570010400,641,1290,649,1931,40,2.753981192091669,0.9255687678981178
10,1570024800,697,967,270,1664,40,0.8121042212958689,0.5096636483593499
10,1570039200,980,1065,85,2045,40,-0.13577767737754273,1.1031462346674794
10,1570053600,1021,1005,0,2026,40,-0.5712909821734345,1.0735499902059191
10,1570068000,614,212,0,826,40,-0.5712909821734345,-0.7956865021031504
10,1570082400,167,104,0,271,40,-0.5712909821734345,-1.6602083797960951
10,1570096800,625,1228,603,1853,40,2.5182916389080097,0.8040683958980283
10,1570111200,673,897,224,1570,40,0.5764146681122098,0.3632401231284727
10,1570125600,1008,1224,216,2232,40,0.5354251806020082,1.3944355880523094
10,1570140000,1156,1073,0,2229,40,-0.5712909821734345,1.3897624968215367
10,1570154400,744,212,0,956,40,-0.5712909821734345,-0.5931858821030013
10,1570168800,182,124,0,306,40,-0.5712909821734345,-1.6056889821037472
10,1570183200,593,1194,601,1787,40,2.5080442670304595,0.7012603888210295
10,1570197600,798,795,0,1593,40,-0.5712909821734345,0.39906715589772984
10,1570212000,1012,1163,151,2175,40,0.2023855945816203,1.3056468546676285
10,1570226400,1200,988,0,2188,40,-0.5712909821734345,1.3258969166676435
10,1570240800,832,325,0,1157,40,-0.5712909821734345,-0.2800887696412321
10,1570255200,115,116,1,231,40,-0.5661672962346593,-1.7225162628730641
10,1570269600,264,452,188,716,40,0.39196197431630264,-0.9670331805648151
10,1570284000,721,879,158,1600,40,0.2382513961530467,0.40997103543619945
10,1570298400,990,930,0,1920,40,-0.5712909821734345,0.9084341000519512
10,1570312800,1008,798,0,1806,40,-0.5712909821734345,0.7308566332825897
10,1570327200,922,299,0,1221,40,-0.5712909821734345,-0.1803961567180817
10,1570341600,203,102,0,305,40,-0.5712909821734345,-1.6072466791806714
10,1570356000,241,318,77,559,40,-0.17676716488774433,-1.2115916216419185
10,1570370400,593,618,25,1211,40,-0.4431988337040546,-0.19597312748732396
10,1570384800,874,758,0,1632,40,-0.5712909821734345,0.4598173418977746
10,1570399200,955,574,0,1529,40,-0.5712909821734345,0.2993745429745795
10,1570413600,559,184,0,743,40,-0.5712909821734345,-0.924975359487861
10,1570428000,191,125,0,316,40,-0.5712909821734345,-1.5901120113345049
10,1570442400,593,1174,581,1767,40,2.4055705482549556,0.670106447282545
10,1570456800,650,762,112,1412,40,0.0025618429693875988,0.1171239849744452
10,1570471200,891,918,27,1809,40,-0.43295146182650424,0.7355297245133624
10,1570485600,922,723,0,1645,40,-0.5712909821734345,0.4800674038977895
10,1570500000,542,206,0,748,41,-0.5673588633398252,-1.0076232128434588
10,1570514400,160,115,0,275,41,-0.5673588633398252,-1.748982523474478
10,1570528800,643,1266,623,1909,41,2.726519995801481,0.8120769132508615
10,1570543200,736,755,19,1491,41,-0.4669034888234772,0.15692217362344907
10,1570557600,959,1066,107,2025,41,-0.0016364910635495327,0.9938901902766506
10,1570572000,1025,984,0,2009,41,-0.5673588633398252,0.9688124968937831
10,1570586400,781,237,0,1018,41,-0.5673588633398252,-0.5844371370075703
10,1570600800,151,131,0,282,41,-0.5673588633398252,-1.7380110326194735
10,1570615200,557,1115,558,1672,41,2.38285687245608,0.44061358001713724
10,1570629600,655,1041,386,1696,41,1.4734713768344032,0.4782301200914384
10,1570644000,829,892,63,1721,41,-0.2342699899435134,0.5174140160021689
10,1570658400,764,837,73,1601,41,-0.18139874019806704,0.32933131563066287
10,1570672800,1551,855,0,2406,41,-0.5673588633398252,1.591052763956182
10,1570687200,175,125,0,300,41,-0.5673588633398252,-1.7097986275637476
10,1570701600,628,1266,638,1894,41,2.8058268704196503,0.7885665757044232
10,1570716000,730,818,88,1548,41,-0.10209186557989756,0.2462614562999144
10,1570730400,1044,1374,330,2418,41,1.1773923782599036,1.6098610339933326
10,1570744800,1096,1062,0,2158,41,-0.5673588633398252,1.2023485165217365
10,1570759200,707,273,0,980,41,-0.5673588633398252,-0.6439966587918805
10,1570773600,214,133,0,347,41,-0.5673588633398252,-1.6361329032515743
10,1570788000,614,1169,555,1783,41,2.366995497532446,0.6145900778607802
10,1570802400,794,801,7,1595,41,-0.5303489885180128,0.3199271806120876
10,1570816800,1036,1172,136,2208,41,0.15169013319824481,1.2807163083431972
10,1570831200,1073,1161,88,2234,41,-0.10209186557989756,1.3214675600903567
10,1570845600,938,287,0,1225,41,-0.5673588633398252,-0.2599944788667225
10,1570860000,246,97,0,343,41,-0.5673588633398252,-1.6424023265972914
10,1570874400,316,474,158,790,41,0.26800688263822675,-0.9417942677134316
10,1570888800,823,893,70,1716,41,-0.19726011512170094,0.5095772368200228
10,1570903200,985,891,0,1876,41,-0.5673588633398252,0.7603541706486974
10,1570917600,1106,924,0,2030,41,-0.5673588633398252,1.0017269694587967
10,1570932000,963,292,0,1255,41,-0.5673588633398252,-0.212973803773846
10,1570946400,223,123,0,346,41,-0.5673588633398252,-1.6377002590880037
10,1570960800,322,351,29,673,41,-0.4140322390780309,-1.12517490057565
10,1570975200,664,780,116,1444,41,0.045947633707352165,0.08325644931127589
10,1570989600,910,859,0,1769,41,-0.5673588633398252,0.5926470961507712
10,1571004000,934,610,0,1544,41,-0.5673588633398252,0.23999203295419752
10,1571018400,654,179,0,833,41,-0.5673588633398252,-0.8743979667469753
10,1571032800,181,103,0,284,41,-0.5673588633398252,-1.7348763209466151
10,1571047200,455,918,463,1373,41,1.8805799998743398,-0.02802581507519847
10,1571061600,652,651,0,1303,41,-0.5673588633398252,-0.13774072362524362
10,1571076000,885,776,0,1661,41,-0.5673588633398252,0.42337266581641586
10,1571090400,914,720,0,1634,41,-0.5673588633398252,0.381054058232827
10,1571104800,490,205,0,695,42,-0.6688785415434658,-0.9856224060719724
10,1571119200,177,99,0,276,42,-0.6688785415434658,-1.60900448995835
10,1571133600,631,1242,611,1873,42,2.539488025388949,0.7669887987446217
10,1571148000,773,819,46,1592,42,-0.4273321224290778,0.3489211004819197
10,1571162400,986,1195,209,2181,42,0.428582362693645,1.2252267028902168
10,1571176800,1127,827,0,1954,42,-0.6688785415434658,0.8874994163933009
10,1571191200,582,228,0,810,42,-0.6688785415434658,-0.8145270847189093
10,1571205600,167,123,0,290,42,-0.6688785415434658,-1.5881754943153685
10,1571220000,665,1325,660,1990,42,2.796787471836884,0.941059690903825
10,1571234400,731,926,195,1657,42,0.3550682351370921,0.4456271516814771
10,1571248800,1116,1222,106,2338,42,-0.11227157575813687,1.4588090111722247
10,1571263200,925,1085,160,2010,42,0.17128291624570996,0.9708153989652273
10,1571277600,541,235,0,776,42,-0.6688785415434658,-0.8651117884232932
10,1571292000,148,129,0,277,42,-0.6688785415434658,-1.60751670455528
10,1571306400,637,1243,606,1880,42,2.5132329798330373,0.7774032965661125
10,1571320800,703,900,197,1603,42,0.36557025335945686,0.365286739915691
10,1571335200,1015,1250,235,2265,42,0.5651085995843861,1.3502006767481063
10,1571349600,839,1046,207,1885,42,0.41808034447128034,0.784842223581463
10,1571364000,712,257,0,969,42,-0.6688785415434658,-0.5779692056307612
10,1571378400,138,123,0,261,42,-0.6688785415434658,-1.6313212710044018
10,1571392800,615,1242,627,1857,42,2.6235041711678666,0.7431842322954999
10,1571407200,725,850,125,1575,42,-0.012502402645672251,0.3236287486297278
10,1571421600,1003,1193,190,2196,42,0.3288131895811804,1.2475434839362685
10,1571436000,1067,1124,57,2191,42,-0.36957102220607196,1.240104556920918
10,1571450400,870,280,0,1150,42,-0.6688785415434658,-0.3086800476750706
10,1571464800,186,102,0,288,42,-0.6688785415434658,-1.5911510651215088
10,1571479200,326,479,153,805,42,0.1345258524674335,-0.8219660117342599
10,1571493600,779,852,73,1631,42,-0.2855548764271544,0.40694473120165414
10,1571508000,925,881,0,1806,42,-0.6688785415434658,0.667307176738924
10,1571522400,1011,834,0,1845,42,-0.6688785415434658,0.7253308074586585
10,1571536800,847,259,0,1106,42,-0.6688785415434658,-0.3741426054101556
10,1571551200,193,116,0,309,42,-0.6688785415434658,-1.5599075716570363
10,1571565600,177,332,155,509,42,0.1450278706897982,-1.2623504910430137
10,1571580000,613,686,73,1299,42,-0.2855548764271544,-0.08700002261762364
10,1571594400,867,994,127,1861,42,-0.0020003844233075544,0.7491353739077803
10,1571608800,818,531,0,1349,42,-0.6688785415434658,-0.012610752464117947
10,1571623200,433,151,0,584,42,-0.6688785415434658,-1.150766585812755
10,1571637600,152,79,0,231,42,-0.6688785415434658,-1.6759548330965053
10,1571652000,695,1192,497,1887,42,1.9408729867141612,0.7878177943876034
10,1571666400,649,690,41,1339,42,-0.45358716798498955,-0.027488606494819084
10,1571680800,963,911,0,1874,42,-0.6688785415434658,0.7684765841476918
10,1571695200,984,756,0,1740,42,-0.6688785415434658,0.5691133401362966
10,1571709600,511,252,0,763,43,-0.6960142816004046,-0.972482295091315
10,1571724000,155,109,0,264,43,-0.6960142816004046,-1.723450752737733
10,1571738400,678,1233,555,1911,43,2.090672922814819,0.7551966415381193
10,1571752800,629,741,112,1370,43,-0.1336557826913865,-0.05897958208254616
10,1571767200,957,1258,301,2215,43,0.8153241842175813,1.2127004714469591
10,1571781600,1024,840,0,1864,43,-0.6960142816004046,0.6844641415193184
10,1571796000,541,260,0,801,43,-0.6960142816004046,-0.9152943163527101
10,1571810400,154,125,0,279,43,-0.6960142816004046,-1.700876550604073
10,1571824800,688,1251,563,1939,43,2.1308413870226057,0.7973351521876177
10,1571839200,717,962,245,1679,43,0.5341449347630723,0.40604898187084687
10,1571853600,1022,1083,61,2105,43,-0.38972974201602867,1.0471563224667868
10,1571868000,1186,1011,0,2197,43,-0.6960142816004046,1.1856114288865673
10,1571882400,596,302,0,898,43,-0.6960142816004046,-0.7693144758883763
10,1571896800,151,145,0,296,43,-0.6960142816004046,-1.6752924548525918
10,1571911200,615,1284,669,1899,43,2.6630735377757837,0.7371372798311914
10,1571925600,700,885,185,1585,43,0.23288145320466988,0.2645839818332451
10,1571940000,949,1190,241,2139,43,0.5140607026591789,1.098324513969749
10,1571954400,1114,975,0,2089,43,-0.6960142816004046,1.0230771735242163
10,1571968800,695,262,0,957,43,-0.6960142816004046,-0.6805226141626475
10,1571983200,172,130,0,302,43,-0.6960142816004046,-1.6662627739991278
10,1571997600,610,1186,576,1796,43,2.1961151413602598,0.5821277585133937
10,1572012000,762,798,36,1560,43,-0.515256192665363,0.2269603116104787
10,1572026400,1031,1127,96,2158,43,-0.21399271110696053,1.1269185033390516
10,1572040800,1110,1053,0,2163,43,-0.6960142816004046,1.1344432373836049
10,1572055200,985,368,0,1353,43,-0.6960142816004046,-0.08456367783402734
10,1572069600,238,111,0,349,43,-0.6960142816004046,-1.595530273980327
10,1572084000,363,560,197,923,43,0.29313414951635036,-0.7316908056656098
10,1572098400,761,1129,368,1890,43,1.1517350719577975,0.7235927585509955
10,1572112800,1119,1270,151,2389,43,0.062165480321575116,1.4745612161974133
10,1572127200,996,1016,20,2012,43,-0.595593121080937,0.9071962692380957
10,1572141600,886,391,0,1277,43,-0.6960142816004046,-0.19893963531123726
10,1572156000,313,111,0,424,43,-0.6960142816004046,-1.4826592633120277
10,1572170400,255,392,137,647,43,-0.008129332042052137,-1.1470561249249511
10,1572184800,572,965,393,1537,43,1.277261522607132,0.19234653500553356
10,1572199200,795,935,140,1730,43,0.006933842035867987,0.48280126912529037
10,1572213600,871,552,0,1423,43,-0.6960142816004046,0.02078259878971866
10,1572228000,522,175,0,697,43,-0.6960142816004046,-1.0718087844794184
10,1572242400,146,107,0,253,43,-0.6960142816004046,-1.7400051676357502
10,1572256800,627,1258,631,1885,43,2.472273332788795,0.7160680245064422
10,1572271200,679,754,75,1433,43,-0.3194349296524014,0.03583206687882523
10,1572285600,923,993,70,1916,43,-0.3445402197822683,0.7627213755826726
10,1572300000,978,841,0,1819,43,-0.6960142816004046,0.6167415351183388
10,1572314400,494,273,0,767,44,-0.6115649372899256,-0.9073745472050482
10,1572328800,155,100,0,255,44,-0.6115649372899256,-1.6761154763318844
10,1572343200,664,1279,615,1943,44,2.508467124767901,0.8583272743831539
10,1572357600,689,802,113,1491,44,-0.03829075352970698,0.17967317288836876
10,1572372000,991,1357,366,2348,44,1.2452346313493665,1.466413360899499
10,1572386400,1060,1017,0,2077,44,-0.6115649372899256,1.059521189428068
10,1572400800,516,217,0,733,44,-0.6115649372899256,-0.9584237495298772
10,1572415200,126,102,0,228,44,-0.6115649372899256,-1.7166545487663074
10,1572429600,707,1353,646,2060,44,2.6657370335870763,1.0339965882656537
10,1572444000,657,1075,418,1732,44,1.5090422203363696,0.5415219305437741
10,1572458400,1083,1107,24,2190,44,-0.48980758852669326,1.2291847148017645
10,1572472800,1028,987,0,2015,44,-0.6115649372899256,0.9664314675416152
10,1572487200,603,261,0,864,44,-0.6115649372899256,-0.7617341758665656
10,1572501600,152,107,0,259,44,-0.6115649372899256,-1.670109687823081
10,1572516000,593,1187,594,1780,44,2.4019294446000727,0.613591392649415
10,1572530400,651,807,156,1458,44,0.17985782967108413,0.13012541769074062
10,1572544800,1032,1017,0,2049,44,-0.6115649372899256,1.0174806698664443
10,1572559200,994,1014,20,2008,44,-0.510100479987232,0.9559213376512093
10,1572573600,675,348,0,1023,44,-0.6115649372899256,-0.52300408264163
10,1572588000,271,162,0,433,44,-0.6115649372899256,-1.4088578876901328
10,1572602400,575,1174,599,1749,44,2.427295558925746,0.5670465317061886
10,1572616800,796,761,0,1557,44,-0.6115649372899256,0.278768683283625
10,1572631200,1096,1107,11,2203,44,-0.555759485773444,1.2487035274553755
10,1572645600,1030,1164,134,2194,44,0.06824692663812124,1.235190503310568
10,1572660000,852,313,0,1165,44,-0.6115649372899256,-0.309798590579109
10,1572674400,175,111,0,286,44,-0.6115649372899256,-1.629570615388658
10,1572688800,297,458,161,755,44,0.20522394399675753,-0.9253919127314584
10,1572703200,650,1006,356,1656,44,1.1945024026980198,0.42741194887650935
10,1572717600,1012,947,0,1959,44,-0.6115649372899256,0.8823504284183675
10,1572732000,1026,929,0,1955,44,-0.6115649372899256,0.8763446399095641
10,1572742800,896,295,0,1191,44,-0.6115649372899256,-0.27076096527188687
10,1572757200,190,110,0,300,44,-0.6115649372899256,-1.6085503556078462
10,1572771600,207,297,90,504,44,-0.15497487942780458,-1.3022551416588724
10,1572786000,701,604,0,1305,44,-0.6115649372899256,-0.09959599277098974
10,1572800400,741,879,138,1620,44,0.08853981809865995,0.3733598522972787
10,1572814800,924,605,0,1529,44,-0.6115649372899256,0.23672816372200114
10,1572829200,668,210,0,878,44,-0.6115649372899256,-0.7407139160857537
10,1572843600,161,73,0,234,44,-0.6115649372899256,-1.7076458660031024
10,1572858000,494,803,309,1297,44,0.9560609280366898,-0.11160756978859657
10,1572872400,740,1048,308,1788,44,0.9509877051715552,0.6256029696670219
10,1572886800,848,787,0,1635,44,-0.6115649372899256,0.39588155920529144
10,1572901200,1059,1064,5,2123,44,-0.5861988229642522,1.1285877572793073
10,1572915600,649,263,0,912,45,-0.9288125043265926,-0.6305163001980083
10,1572930000,129,96,0,225,45,-0.9288125043265926,-1.7235122344673581
10,1572944400,453,819,366,1272,45,1.354889641628043,-0.0577673390088293
10,1572958800,602,1070,468,1672,45,1.9913312232875313,0.578620395645814
10,1572973200,775,832,57,1607,45,-0.5731539733992314,0.47520738876443447
10,1572987600,1072,1147,75,2219,45,-0.4608407531063804,1.4488806227860387
10,1573002000,786,269,0,1055,45,-0.9288125043265926,-0.40300768505897333
10,1573016400,149,97,0,246,45,-0.9288125043265926,-1.6901018783979895
10,1573030800,502,810,308,1312,45,0.9929914873510788,0.005871434456635034
10,1573045200,652,1177,525,1829,45,2.3469897542148925,0.8284025814977616
10,1573059600,831,1024,193,1855,45,0.2754348021467534,0.8697677842503133
10,1573074000,1005,1218,213,2223,45,0.40022726913881,1.455244500132585
10,1573088400,792,304,0,1096,45,-0.9288125043265926,-0.33777794225687235
10,1573102800,146,97,0,243,45,-0.9288125043265926,-1.6948747864078992
10,1573117200,518,878,360,1396,45,1.317451901530426,0.13951285873411012
10,1573131600,664,951,287,1615,45,0.8619593970094194,0.48793514345752736
10,1573146000,806,959,153,1765,45,0.025849868162640267,0.7265805439530186
10,1573160400,1039,1425,386,2464,45,1.4796821086200995,1.8386681102620077
10,1573174800,846,302,0,1148,45,-0.9288125043265926,-0.2550475367517687
10,1573189200,179,114,0,293,45,-0.9288125043265926,-1.6153263195760688
10,1573203600,478,783,305,1261,45,0.9742726173022703,-0.075268001711832
10,1573218000,693,1121,428,1814,45,1.7417462893034181,0.8045380414482124
10,1573232400,843,971,128,1814,45,-0.13014071557743045,0.8045380414482124
10,1573246800,1072,1510,438,2582,45,1.8041425227994465,2.026402491985128
10,1573261200,974,356,0,1330,45,-0.9288125043265926,0.034508882516093985
10,1573275600,289,124,0,413,45,-0.9288125043265926,-1.424409999179676
10,1573290000,200,348,148,548,45,-0.005348248585373879,-1.2096291387337337
10,1573304400,631,845,214,1476,45,0.40646689248841283,0.2667904056650388
10,1573318800,875,979,104,1854,45,-0.2798916759678984,0.8681768149136767
10,1573333200,954,1098,144,2052,45,-0.030306741983785197,1.183188743567725
10,1573347600,913,371,0,1284,45,-0.9288125043265926,-0.038675706969189996
10,1573362000,309,113,0,422,45,-0.9288125043265926,-1.4100912751499464
10,1573376400,171,255,84,426,45,-0.404684142959955,-1.4037273978034
10,1573390800,612,681,69,1293,45,-0.49827849320399736,-0.024356982939460526
10,1573405200,697,929,232,1626,45,0.5187801127812638,0.5054358061605301
10,1573419600,855,727,0,1582,45,-0.9288125043265926,0.4354331553485193
10,1573434000,663,227,0,890,45,-0.9288125043265926,-0.6655176256040137
10,1573448400,152,91,0,243,45,-0.9288125043265926,-1.6948747864078992
10,1573462800,347,634,287,981,45,0.8619593970094194,-0.5207394159700823
10,1573477200,602,882,280,1484,45,0.8182820335621995,0.27951816035813165
10,1573491600,801,677,0,1478,45,-0.9288125043265926,0.269972344338312
10,1573506000,904,745,0,1649,45,-0.9288125043265926,0.542028100903172
10,1573520400,591,255,0,846,46,-0.8718777072783055,-0.7132395603556431
10,1573534800,146,69,0,215,46,-0.8718777072783055,-1.7240563961067263
10,1573549200,491,814,323,1305,46,0.9306052212400566,0.022045586410992694
10,1573563600,594,1133,539,1727,46,2.1359808019210664,0.6980593814774857
10,1573578000,846,994,148,1840,46,-0.04597221681168757,0.8790772934265704
10,1573592400,1005,1142,137,2147,46,-0.10735708434636863,1.3708693196953223
10,1573606800,721,268,0,989,46,-0.8718777072783055,-0.48416379567671297
10,1573621200,125,87,0,212,46,-0.8718777072783055,-1.728862181379711
10,1573635600,503,783,280,1286,46,0.6906461936044852,-0.008391053651242774
10,1573650000,592,1308,716,1900,46,3.1237191249791167,0.9751929988862613
10,1573664400,755,978,223,1733,46,0.37256097092477425,0.7076709520234549
10,1573678800,963,1236,273,2199,46,0.6515830960824155,1.454169597760388
10,1573693200,701,253,0,954,46,-0.8718777072783055,-0.5402312905281994
10,1573707600,122,85,0,207,46,-0.8718777072783055,-1.7368718235013518
10,1573722000,433,837,404,1270,46,1.3826210639954355,-0.034021908440493694
10,1573736400,607,1133,526,1740,46,2.06343504938008,0.7188844509937521
10,1573750800,844,872,28,1716,46,-0.7156253171900264,0.6804381688098757
10,1573765200,1040,1293,253,2333,46,0.539974246019359,1.6688280066203645
10,1573779600,774,324,0,1098,46,-0.8718777072783055,-0.3095535974249411
10,1573794000,179,125,0,304,46,-0.8718777072783055,-1.5814847663415181
10,1573808400,443,785,342,1228,46,1.0366336287999602,-0.10130290226227737
10,1573822800,719,1054,335,1773,46,0.9975705312778905,0.7717480889965821
10,1573837200,847,994,147,1841,46,-0.05155265931484039,0.8806792218508985
10,1573851600,1091,1246,155,2337,46,-0.006909119289617798,1.675235720317677
10,1573866000,952,361,0,1313,46,-0.8718777072783055,0.03486101380561815
10,1573880400,293,133,0,426,46,-0.8718777072783055,-1.3860494985734797
10,1573894800,179,313,134,492,46,-0.12409841185582711,-1.2803222225678197
10,1573909200,681,807,126,1488,46,-0.1687419518810497,0.3151984880630501
10,1573923600,795,1067,272,1862,46,0.6460026535792626,0.9143197187617904
10,1573938000,932,1000,68,1932,46,-0.4924076170639135,1.026454708464763
10,1573952400,932,382,0,1314,46,-0.8718777072783055,0.03646294222994634
10,1573966800,276,96,0,372,46,-0.8718777072783055,-1.4725536334872016
10,1573981200,130,239,109,369,46,-0.2636094744346477,-1.4773594187601862
10,1573995600,544,644,100,1188,46,-0.3138334569630231,-0.16538003923540467
10,1574010000,693,851,158,1544,46,0.009832208219840675,0.4049064798254283
10,1574024400,793,631,0,1424,46,-0.8718777072783055,0.21267506890604643
10,1574038800,622,233,0,855,46,-0.8718777072783055,-0.6988222045366894
10,1574053200,137,91,0,228,46,-0.8718777072783055,-1.70323132659046
10,1574067600,497,760,263,1257,46,0.5957786710508872,-0.054846977956760065
10,1574082000,528,990,462,1518,46,1.7062867291782993,0.3632563407928956
10,1574096400,806,779,0,1585,46,-0.8718777072783055,0.4705855452228838
10,1574110800,912,953,41,1865,46,-0.6430795646490397,0.9191255040347749
10,1574125200,506,256,0,762,47,-0.8259816532228291,-0.8568000316177654
10,1574139600,134,87,0,221,47,-0.8259816532228291,-1.6841079662777547
10,1574154000,443,797,354,1240,47,1.2732824869681152,-0.1258329470198451
10,1574168400,641,1074,433,1715,47,1.7417623374627045,0.60054647805131
10,1574182800,808,818,10,1626,47,-0.7666804063247799,0.4644459120906093
10,1574197200,1058,1089,31,2147,47,-0.6421477878388764,1.2611694499054973
10,1574211600,740,289,0,1029,47,-0.8259816532228291,-0.44849833373566345
10,1574226000,129,103,0,232,47,-0.8259816532228291,-1.6672865480129488
10,1574240400,485,821,336,1306,47,1.1665402425516265,-0.024904437431010933
10,1574254800,581,1314,733,1895,47,3.520799744404183,0.8758060496572213
10,1574269200,856,1007,151,1863,47,0.06946717493771491,0.8268710147050593
10,1574283600,1075,1172,97,2247,47,-0.2507595583117512,1.4140914341310036
10,1574298000,713,322,0,1035,47,-0.8259816532228291,-0.4393230146821331
10,1574312400,139,165,26,304,47,-0.671798411287901,-1.5571827193705843
10,1574326800,453,782,329,1235,47,1.125029369722992,-0.13347904623112042
10,1574341200,711,1108,397,1819,47,1.528277848629727,0.7595853416458366
10,1574355600,825,887,62,1712,47,-0.45831392245492364,0.5959588185245448
10,1574370000,1138,1319,181,2457,47,0.24737091563186273,1.7352276010045669
10,1574384400,702,285,0,987,47,-0.8259816532228291,-0.5127255671103761
10,1574398800,178,87,0,265,47,-0.8259816532228291,-1.6168222932185319
10,1574413200,439,741,302,1180,47,0.964916003098259,-0.2175861375551489
10,1574427600,677,1074,397,1751,47,1.528277848629727,0.6555983923724923
10,1574442000,832,842,10,1674,47,-0.7666804063247799,0.5378484645188524
10,1574456400,980,1172,192,2152,47,0.31260228721971695,1.2688155491167725
10,1574470800,960,354,0,1314,47,-0.8259816532228291,-0.012670678692970425
10,1574485200,331,115,0,446,47,-0.8259816532228291,-1.3400335017703653
10,1574499600,232,390,158,622,47,0.1109780477663494,-1.0708908095334742
10,1574514000,670,917,247,1587,47,0.6387591451589879,0.4048063382426619
10,1574528400,858,1120,262,1978,47,0.7277110155060619,1.0027312965643915
10,1574542800,1046,1125,79,2171,47,-0.35750180272823984,1.2978707261196187
10,1574557200,988,330,0,1318,47,-0.8259816532228291,-0.006553799323950172
10,1574571600,298,119,0,417,47,-0.8259816532228291,-1.3843808771957622
10,1574586000,134,254,120,388,47,-0.11436669044623783,-1.428728252621159
10,1574600400,531,633,102,1164,47,-0.22110893486272654,-0.24205365503122991
10,1574614800,717,971,254,1688,47,0.6802700179876224,0.5592575423104232
10,1574629200,884,622,0,1506,47,-0.8259816532228291,0.28093953102000174
10,1574643600,622,211,0,833,47,-0.8259816532228291,-0.7482254228176559
10,1574658000,142,70,0,212,47,-0.8259816532228291,-1.6978709448580502
10,1574672400,459,780,321,1239,47,1.0775883722045525,-0.12736216686210017
10,1574686800,681,947,266,1628,47,0.7514315142652815,0.46750435177511945
10,1574701200,799,744,0,1543,47,-0.8259816532228291,0.3375206651834391
10,1574715600,1749,879,0,2628,47,-0.8259816532228291,1.9967241940301828
10,1574730000,667,304,0,971,48,-0.7319716065925229,-0.39762772408344127
10,1574744400,116,93,0,209,48,-0.7319716065925229,-1.7374548120563258
10,1574758800,502,792,290,1294,48,1.8233205024063104,0.17030423052973678
10,1574773200,754,1022,268,1776,48,1.629470756206399,1.0178064042868633
10,1574787600,854,937,83,1791,48,-0.0006293822928568376,1.0441809532627073
10,1574802000,1038,1148,110,2186,48,0.23727712440703452,1.7387107429599375
10,1574816400,950,266,0,1216,48,-0.7319716065925229,0.03315657585534703
10,1574830800,223,81,0,304,48,-0.7319716065925229,-1.5704160018759794
10,1574845200,394,759,365,1153,48,2.4841719099060087,-0.07761652984319854
10,1574859600,722,1014,292,1736,48,1.8409432066063023,0.947474273684612
10,1574874000,956,1143,187,2099,48,0.9157512361067247,1.5857383589000413
10,1574888400,992,1021,29,2013,48,-0.4764423956926396,1.4345242781052012
10,1574902800,822,245,0,1067,48,-0.7319716065925229,-0.22883061063803853
10,1574917200,246,104,0,350,48,-0.7319716065925229,-1.4895340516833904
10,1574931600,254,311,57,565,48,-0.2297245368927522,-1.1114988496962905
10,1574946000,677,351,0,1028,48,-0.7319716065925229,-0.2974044379752334
10,1574960400,848,453,0,1301,48,-0.7319716065925229,0.18261235338513074
10,1574974800,686,376,0,1062,48,-0.7319716065925229,-0.2376221269633199
10,1574989200,535,594,59,1129,48,-0.21210183269276028,-0.11981580820454923
10,1575003600,176,79,0,255,48,-0.7319716065925229,-1.656572861863737
10,1575018000,241,384,143,625,48,0.5280517437069018,-1.0060006537929138
10,1575032400,675,683,8,1358,48,-0.6614807897925551,0.2828356394933386
10,1575046800,831,897,66,1728,48,-0.15042236799278844,0.9334078475641618
10,1575061200,951,927,0,1878,48,-0.7319716065925229,1.1971533373226035
10,1575075600,1271,266,0,1537,48,-0.7319716065925229,0.5975719239384125
10,1575090000,352,313,0,665,48,-0.7319716065925229,-0.9356685231906626
10,1575104400,252,315,63,567,48,-0.17685642429277637,-1.1079822431661779
10,1575118800,677,836,159,1513,48,0.6690333773068374,0.5553726455770619
10,1575133200,837,1027,190,1864,48,0.9421852924067127,1.1725370916118156
10,1575147600,1057,1071,14,2128,48,-0.6086126771925792,1.6367291535866733
10,1575162000,1109,334,0,1443,48,-0.7319716065925229,0.43229141702312235
10,1575176400,322,98,0,420,48,-0.7319716065925229,-1.366452823129451
10,1575190800,155,265,110,420,48,0.23727712440703452,-1.366452823129451
10,1575205200,497,569,72,1066,48,-0.09755425539281258,-0.2305889139030948
10,1575219600,649,928,279,1577,48,1.7263956293063547,0.6679040545406637
10,1575234000,803,438,0,1241,48,-0.7319716065925229,0.077114157481754
10,1575248400,512,211,0,723,48,-0.7319716065925229,-0.8336869338173984
10,1575262800,149,88,0,237,48,-0.7319716065925229,-1.68822232063475
10,1575277200,443,740,297,1183,48,1.8849999671062823,-0.024867431891510174
10,1575291600,611,959,348,1570,48,2.334378924206077,0.6555959316852698
10,1575306000,791,688,0,1479,48,-0.7319716065925229,0.4955903345651484
10,1575320400,795,758,0,1553,48,-0.7319716065925229,0.625704776179313
10,1575334800,610,263,0,873,49,-0.8707171431660924,-0.7421127266824481
10,1575349200,301,57,0,358,49,-0.8707171431660924,-1.5458730931208513
10,1575363600,441,838,397,1279,49,1.3570468042255641,-0.10846863197566801
10,1575378000,589,1043,454,1632,49,1.676902081306986,0.4424583764762861
10,1575392400,734,893,159,1627,49,0.02151073500839976,0.4346548777730006
10,1575406800,1035,1224,189,2259,49,0.18985561768283224,1.4210171138682839
10,1575421200,688,292,0,980,49,-0.8707171431660924,-0.575117854432139
10,1575435600,127,83,0,210,49,-0.8707171431660924,-1.7768566547381013
10,1575450000,488,842,354,1330,49,1.115752472392211,-0.028872945202156233
10,1575464400,626,1367,741,1993,49,3.28740145889239,1.0058709828534969
10,1575478800,817,969,152,1786,49,-0.017769737615634485,0.6828061365374786
10,1575493200,1020,1151,131,2171,49,-0.13561115548773722,1.2836755366904595
10,1575507600,914,298,0,1212,49,-0.8707171431660924,-0.2130355145996933
10,1575522000,153,83,0,236,49,-0.8707171431660924,-1.7362784614810167
10,1575536400,507,814,307,1321,49,0.8520121562022667,-0.04291924286807008
10,1575550800,647,1079,432,1726,49,1.5534491673457356,0.589164152098053
10,1575565200,840,998,158,1838,49,0.01589923891925201,0.7639625230516474
10,1575579600,1008,1350,342,2358,49,1.048414519322438,1.5755263881933361
10,1575594000,847,307,0,1154,49,-0.8707171431660924,-0.3035560995578047
10,1575608400,168,102,0,270,49,-0.8707171431660924,-1.6832146702986757
10,1575622800,444,750,306,1194,49,0.8464006601131189,-0.24112810993152098
10,1575637200,703,1151,448,1854,49,1.6432331047720996,0.7889337189021609
10,1575651600,886,921,35,1807,49,-0.6743147800459212,0.7155808310912775
10,1575666000,1107,1323,216,2430,49,0.3413660120898215,1.6878967695206468
10,1575680400,1086,378,0,1464,49,-0.8707171431660924,0.18026082004589433
10,1575694800,269,121,0,390,49,-0.8707171431660924,-1.4959307014198244
10,1575709200,234,362,128,596,49,-0.15244564375518047,-1.174426554844463
10,1575723600,699,843,144,1542,49,-0.06266170632881649,0.3019953998171476
10,1575738000,919,1005,86,1924,49,-0.38812847949938595,0.8981827007481574
10,1575752400,1096,1089,0,2185,49,-0.8707171431660924,1.305525333059659
10,1575766800,1100,324,0,1424,49,-0.8707171431660924,0.11783283041961058
10,1575781200,256,144,0,400,49,-0.8707171431660924,-1.4803237040132535
10,1575795600,165,283,118,448,49,-0.20856060464665796,-1.405410116461713
10,1575810000,598,672,74,1270,49,-0.4554664325691589,-0.12251492964158187
10,1575824400,800,945,145,1745,49,-0.05705021023966873,0.6188174471705377
10,1575838800,878,639,0,1517,49,-0.8707171431660924,0.2629779063007203
10,1575853200,650,221,0,871,49,-0.8707171431660924,-0.7452341261637623
10,1575867600,131,79,0,210,49,-0.8707171431660924,-1.7768566547381013
10,1575882000,443,804,361,1247,49,1.155032945016245,-0.15841102367669502
10,1575896400,683,1133,450,1816,49,1.654456096950395,0.7296271287571914
10,1575910800,794,840,46,1634,49,-0.6125883230652959,0.4455797759576003
10,1575925200,956,1100,144,2056,49,-0.06266170632881649,1.1041950665148939
10,1575939600,723,280,0,1003,50,-0.8895897962076702,-0.505800582854697
10,1575954000,205,161,0,366,50,-0.8895897962076702,-1.5104920071396895
10,1575968400,499,802,303,1301,50,0.7323184769354258,-0.035787954225297
10,1575982800,637,1090,453,1727,50,1.5352433646300279,0.6361092934127043
10,1575997200,824,919,95,1743,50,-0.3810707006677556,0.6613448707887793
10,1576011600,1005,1223,218,2228,50,0.27732770724181804,1.4262983100010578
10,1576026000,794,303,0,1097,50,-0.8895897962076702,-0.35754156577025537
10,1576040400,148,115,0,263,50,-0.8895897962076702,-1.6729460364981732
10,1576054800,477,858,381,1335,50,1.149839418536619,0.017837647698862723
10,1576069200,603,1232,629,1835,50,2.4773418995250274,0.8064494407012116
10,1576083600,800,1002,202,1802,50,0.19168238588772712,0.7544010623630566
10,1576098000,1071,1266,195,2337,50,0.15421255779531237,1.5982156808755699
10,1576112400,877,325,0,1202,50,-0.8895897962076702,-0.19193308923976207
10,1576126800,157,137,0,294,50,-0.8895897962076702,-1.6240521053320276
10,1576141200,466,805,339,1271,50,0.9250204499821303,-0.08310466180543793
10,1576155600,647,1239,592,1886,50,2.2792870938936924,0.8868878435874512
10,1576170000,880,1022,142,1902,50,-0.12948756919011367,0.9121234209635264
10,1576184400,1052,1425,373,2477,50,1.1070167578595733,1.8190269829162276
10,1576198800,865,361,0,1226,50,-0.8895897962076702,-0.15407972317564933
10,1576213200,196,137,0,333,50,-0.8895897962076702,-1.5625403854778444
10,1576227600,433,703,270,1136,50,0.5556750016426134,-0.2960298459160721
10,1576242000,712,1129,417,1841,50,1.3425413915833233,0.8159127822172397
10,1576256400,918,1021,103,1939,50,-0.3382480399907102,0.9704806936457001
10,1576270800,1066,1458,392,2524,50,1.2087205769675564,1.8931564914584482
10,1576285200,980,403,0,1383,50,-0.8895897962076702,0.09354437982708821
10,1576299600,269,167,0,436,50,-0.8895897962076702,-1.4000863561193606
10,1576314000,182,287,105,469,50,-0.3275423748214488,-1.3480379777812055
10,1576328400,640,711,71,1351,50,-0.5095386826988919,0.04307322507493788
10,1576342800,816,987,171,1803,50,0.025744575764176054,0.7559782859490612
10,1576357200,781,1001,220,1782,50,0.2880333724110794,0.7228565906429626
10,1576371600,938,327,0,1265,50,-0.8895897962076702,-0.09256800332146611
10,1576386000,273,144,0,417,50,-0.8895897962076702,-1.4300536042534497
10,1576400400,145,202,57,347,50,-0.5844783388837215,-1.5404592552737786
10,1576414800,459,607,148,1066,50,-0.09737057368232958,-0.40643549693640096
10,1576429200,716,847,131,1563,50,-0.18836872762105114,0.3774446253079338
10,1576443600,758,592,0,1350,50,-0.8895897962076702,0.04149600148893319
10,1576458000,550,250,0,800,50,-0.8895897962076702,-0.8259769708136505
10,1576472400,151,72,0,223,50,-0.8895897962076702,-1.7360349799383612
10,1576486800,446,751,305,1197,50,0.7430241421046871,-0.19981920716978557
10,1576501200,501,1122,621,1623,50,2.434519238847982,0.47207804046821567
10,1576515600,753,800,47,1553,50,-0.6380066647300283,0.3616723894478868
10,1576530000,963,936,0,1899,50,-0.8895897962076702,0.9073917502055122
10,1576544400,630,266,0,896,51,-0.6196979188397743,0.13069388104192092
10,1576558800,141,91,0,232,51,-0.6196979188397743,-0.7638230074366386
10,1576573200,488,783,295,1271,51,1.4461261954526134,0.6358803767941194
10,1576587600,622,1138,516,1760,51,2.993743582769962,1.2946435672549863
10,1576602000,790,909,119,1699,51,0.2136345204849516,1.212466563945962
10,1576616400,1118,1310,192,2428,51,0.7248384538522205,2.194549111688236
10,1576630800,758,286,0,1044,51,-0.6196979188397743,0.33007415136545526
10,1576645200,151,97,0,248,51,-0.6196979188397743,-0.7422683836178781
10,1576659600,402,770,368,1172,51,1.9573301288198826,0.502511141915539
10,1576674000,697,1280,583,1977,51,3.4629307544906056,1.5869781527969251
10,1576688400,866,974,108,1840,51,0.1366037907994727,1.4024166863487886
10,1576702800,1060,1250,190,2310,51,0.7108328666366788,2.0355837610248773
10,1576717200,693,325,0,1018,51,-0.6196979188397743,0.2950478876599695
10,1576731600,160,104,0,264,51,-0.6196979188397743,-0.7207137597991176
10,1576746000,398,764,366,1162,51,1.943324541604341,0.4890395020288137
10,1576760400,577,864,287,1441,51,1.390103846590447,0.8648982548684494
10,1576768998,334,319,0,653,51,-0.6196979188397743,-0.1966669682055037
10,1576769078,8,4,0,12,51,-0.6196979188397743,-1.060199084944595
10,1576769158,7,5,0,12,51,-0.6196979188397743,-1.060199084944595
10,1576769238,8,6,0,14,51,-0.6196979188397743,-1.05750475696725
10,1576769319,5,12,7,17,51,-0.5706783635853787,-1.0534632650012323
10,1576769399,7,8,1,15,51,-0.6126951252320035,-1.0561575929785774
10,1576769482,9,4,0,13,51,-0.6196979188397743,-1.0588519209559224
10,1576769560,6,8,2,14,51,-0.6056923316242327,-1.05750475696725
10,1576774800,881,877,0,1758,51,-0.6196979188397743,1.291949239277641
10,1576775282,33,30,0,63,51,-0.6196979188397743,-0.991493721522296
10,1576775363,10,6,0,16,51,-0.6196979188397743,-1.0548104289899047
10,1576775443,5,3,0,8,51,-0.6196979188397743,-1.065587740899285
10,1576775604,473,405,0,878,51,-0.6196979188397743,0.1064449292458154
10,1576775689,8,18,10,26,51,-0.5496699827620662,-1.0413387891031796
10,1576775770,8,8,0,16,51,-0.6196979188397743,-1.0548104289899047
10,1576789200,934,1172,238,2106,51,1.0469669598096776,1.7607623073356813
10,1576803600,817,321,0,1138,51,-0.6196979188397743,0.456707566300673
10,1576818000,293,121,0,414,51,-0.6196979188397743,-0.5186391614982382
10,1576832400,390,703,313,1093,51,1.572176480392488,0.3960851868104092
10,1576846800,499,1023,524,1522,51,3.049765931632128,0.9740185379509243
10,1576861200,818,1010,192,1828,51,0.7248384538522205,1.3862507184847181
10,1576869591,649,569,0,1218,51,-0.6196979188397743,0.5644806853944754
10,1576869669,539,900,361,1439,51,1.9083105735654868,0.8622039268911044
10,1576869749,6,11,5,17,51,-0.5846839508009203,-1.0534632650012323
10,1576869830,5,20,15,25,51,-0.5146560147232122,-1.042685953091852
10,1576869910,5,21,16,26,51,-0.5076532211154414,-1.0413387891031796
10,1576869992,7,16,9,23,51,-0.556672776369837,-1.0453802810691972
10,1576870071,35,37,2,72,51,-0.6056923316242327,-0.9793692456242432
10,1576870153,7,12,5,19,51,-0.5846839508009203,-1.0507689370238873
10,1576870232,14,8,0,22,51,-0.6196979188397743,-1.0467274450578696
10,1576870313,8,7,0,15,51,-0.6196979188397743,-1.0561575929785774
10,1576870393,7,7,0,14,51,-0.6196979188397743,-1.05750475696725
10,1576870473,11,21,10,32,51,-0.5496699827620662,-1.0332558051711445
10,1576870553,4,11,7,15,51,-0.5706783635853787,-1.0561575929785774
10,1576870634,11,16,5,27,51,-0.5846839508009203,-1.039991625114507
10,1576870714,3,1,0,4,51,-0.6196979188397743,-1.0709763968539752
10,1576875600,273,262,0,535,51,-0.6196979188397743,-0.35563231886886215
10,1576890000,948,345,0,1293,51,-0.6196979188397743,0.6655179845449151
10,1576904400,315,122,0,437,51,-0.6196979188397743,-0.48765438975877
10,1576918800,188,333,145,521,51,0.39570715428699255,-0.37449261471027756
10,1576933200,507,745,238,1252,51,1.0469669598096776,0.6102842610093413
10,1576947600,828,931,103,1759,51,0.10158982276061869,1.2932964032663137
10,1576962000,754,889,135,1643,51,0.32567921820928447,1.1370253805803003
10,1576976400,849,328,0,1177,51,-0.6196979188397743,0.5092469618589016
10,1576990800,273,123,0,396,51,-0.6196979188397743,-0.5428881132943437
10,1577005200,154,269,115,423,51,0.18562334605386838,-0.5065146856001854
10,1577019600,481,635,154,1116,51,0.4587322967569298,0.4270699585498774
10,1577034000,706,977,271,1683,51,1.2780591488661142,1.1909119401272015
10,1577048400,938,778,0,1716,51,-0.6196979188397743,1.2353683517533949
10,1577062800,727,211,0,938,51,-0.6196979188397743,0.18727476856616715
10,1577077200,175,102,0,277,51,-0.6196979188397743,-0.7032006279463747
10,1577091600,364,547,183,911,51,0.6618133113822832,0.15090134087200888
10,1577106000,734,799,65,1533,51,-0.16451633433467194,0.9888373418263221
10,1577120400,863,929,66,1792,51,-0.15751354072690113,1.337752814892507
10,1577134800,959,1021,62,1980,51,-0.18552471515798435,1.5910196447629426
10,1577149200,782,257,0,1039,52,-0.6024164796178587,-0.10303037379205789
10,1577163600,154,77,0,231,52,-0.6024164796178587,-1.446651764898708
10,1577178000,218,408,190,626,52,2.0137922318654136,-0.7898071491968185
10,1577192400,632,572,0,1204,52,-0.6024164796178587,0.17134775681759223
10,1577206800,809,669,0,1478,52,-0.6024164796178587,0.6269817434057384
10,1577221200,855,453,0,1308,52,-0.6024164796178587,0.3442891239897353
10,1577235600,704,212,0,916,52,-0.6024164796178587,-0.3075667984283425
10,1577250000,179,73,0,252,52,-0.6024164796178587,-1.4117309119120254
10,1577264400,103,176,73,279,52,0.40275844637308267,-1.366832672357719
10,1577278800,548,259,0,807,52,-0.6024164796178587,-0.48882265440683864
10,1577293200,763,522,0,1285,52,-0.6024164796178587,0.3060424754805114
10,1577307600,897,519,0,1416,52,-0.6024164796178587,0.5238820822069609
10,1577322000,797,169,0,966,52,-0.6024164796178587,-0.22442191036481218
10,1577336400,199,74,0,273,52,-0.6024164796178587,-1.3768100589253427
10,1577350800,292,475,183,767,52,1.917405595126556,-0.5553385648576629
10,1577365200,682,849,167,1531,52,1.6970932825805962,0.7151153247530806
10,1577379600,903,948,45,1851,52,0.017211899417653106,1.2472426083596748
10,1577394000,1035,1032,0,2067,52,-0.6024164796178587,1.606428524794126
10,1577408400,852,258,0,1110,52,-0.6024164796178587,0.015035367258155196
10,1577422800,211,97,0,308,52,-0.6024164796178587,-1.3186086372808714
10,1577437200,290,504,214,794,52,2.344260700684353,-0.5104403253033565
10,1577451600,775,772,0,1547,52,-0.6024164796178587,0.7417216889334103
10,1577466000,973,1007,34,1980,52,-0.1342528154576942,1.461756419563583
10,1577480400,1122,1266,144,2388,52,1.380394333295779,2.1402187061619906
