remote_unit_id,time_stamp,entries,exits,num_people_exited,sum_exit_entry,week_num,z_score_num_people_exited,z_score_sum_exit_entry
176,1546300800,0,0,0,0,1,-0.5458972351443542,-1.2746854538268217
176,1546315200,214,137,0,351,1,-0.5458972351443542,-0.7543783057396858
176,1546329600,60,98,38,158,1,-0.06347642269120397,-1.0404731193602477
176,1546344000,179,191,12,370,1,-0.39355382068546463,-0.7262135313418066
176,1546358400,512,291,0,803,1,-0.5458972351443542,-0.08435314637961307
176,1546372800,400,292,0,692,1,-0.5458972351443542,-0.24889472312511762
176,1546387200,262,130,0,392,1,-0.5458972351443542,-0.693601687302157
176,1546401600,69,30,0,99,1,-0.5458972351443542,-1.1279321556483988
176,1546416000,238,422,184,660,1,1.790035119891952,-0.29633013263733515
176,1546430400,1245,935,0,2180,1,-0.5458972351443542,1.9568518191929978
176,1546444800,817,601,0,1418,1,-0.5458972351443542,0.8272961301833177
176,1546459200,1464,631,0,2095,1,-0.5458972351443542,1.83085151267617
176,1546473600,536,181,0,717,1,-0.5458972351443542,-0.21183580944369768
176,1546488000,87,36,0,123,1,-0.5458972351443542,-1.0923555985142357
176,1546502400,248,409,161,657,1,1.4980435755124137,-0.30077720227910554
176,1546516800,744,1003,259,1747,1,2.7421814602600114,1.3149914342308042
176,1546531200,814,537,0,1351,1,-0.5458972351443542,0.7279782415171122
176,1546545600,1477,539,0,2016,1,-0.5458972351443542,1.7137453454428828
176,1546560000,495,213,0,708,1,-0.5458972351443542,-0.22517701836900886
176,1546574400,97,35,0,132,1,-0.5458972351443542,-1.0790143895889246
176,1546588800,201,396,195,597,1,1.9296832498126006,-0.38971859511451346
176,1546603200,758,1035,277,1793,1,2.9706965819483457,1.383179835404617
176,1546617600,916,617,0,1533,1,-0.5458972351443542,0.9977671331178495
176,1546632000,1484,592,0,2076,1,-0.5458972351443542,1.8026867382782907
176,1546646400,534,252,0,786,1,-0.5458972351443542,-0.10955320768297863
176,1546660800,161,41,0,202,1,-0.5458972351443542,-0.9752494312809487
176,1546675200,78,165,87,243,1,0.5585925196825949,-0.91447281284342
176,1546689600,270,342,72,612,1,0.368163251608983,-0.3674832469056615
176,1546704000,447,408,0,855,1,-0.5458972351443542,-0.007270605922259565
176,1546718400,480,468,0,948,1,-0.5458972351443542,0.13058855297262265
176,1546732800,331,235,0,566,1,-0.5458972351443542,-0.43567164807947417
176,1546747200,120,44,0,164,1,-0.5458972351443542,-1.031578980076707
176,1546761600,80,107,27,187,1,-0.2031245526118527,-0.9974847794898006
176,1546776000,207,276,69,483,1,0.3300773979942606,-0.5587072415017884
176,1546790400,380,418,38,798,1,-0.06347642269120397,-0.09176492911589705
176,1546804800,410,365,0,775,1,-0.5458972351443542,-0.1258591297028034
176,1546819200,306,135,0,441,1,-0.5458972351443542,-0.6209662164865739
176,1546833600,53,25,0,78,1,-0.5458972351443542,-1.1590616431407916
176,1546848000,238,416,178,654,1,1.7138634126625072,-0.305224271920876
176,1546862400,768,977,209,1745,1,2.107417233347972,1.3120267211362906
176,1546876800,806,669,0,1475,1,-0.5458972351443542,0.9117904533769552
176,1546891200,1801,635,0,2436,1,-0.5458972351443542,2.336335095290738
176,1546905600,472,162,0,634,2,-0.6287158662687047,-0.5275828758455303
176,1546920000,87,32,0,119,2,-0.6287158662687047,-1.250248799760344
176,1546934400,273,430,157,703,2,1.3644343367004486,-0.43075967438898255
176,1546948800,726,931,205,1657,2,1.9738050993916545,0.9079263283580703
176,1546963200,834,661,0,1495,2,-0.6287158662687047,0.6806022901557406
176,1546977600,1548,622,0,2170,2,-0.6287158662687047,1.6277857826654478
176,1546992000,2091,521,0,2612,2,-0.6287158662687047,2.248015565908841
176,1547006400,93,20,0,113,2,-0.6287158662687047,-1.2586682085826524
176,1547020800,256,437,181,693,2,1.6691197180460515,-0.4447920224261634
176,1547035200,781,898,117,1679,2,0.8566253677911101,0.9387974940398681
176,1547049600,896,671,0,1567,2,-0.6287158662687047,0.7816351960234427
176,1547064000,1515,607,0,2122,2,-0.6287158662687047,1.5604305120869797
176,1547078400,554,197,0,751,2,-0.6287158662687047,-0.3634044038105145
176,1547092800,76,28,0,104,2,-0.6287158662687047,-1.2712973218161152
176,1547107200,236,452,216,688,2,2.1134525658417225,-0.4518081964447538
176,1547121600,778,951,173,1729,2,1.5675579242641837,1.0089592342257723
176,1547136000,851,653,0,1504,2,-0.6287158662687047,0.6932314033892033
176,1547150400,1566,662,0,2228,2,-0.6287158662687047,1.7091734012810968
176,1547164800,571,234,0,805,2,-0.6287158662687047,-0.2876297244097379
176,1547179200,104,32,0,136,2,-0.6287158662687047,-1.2263938080971366
176,1547193600,225,407,182,632,2,1.681814942268785,-0.5303893454529666
176,1547208000,692,886,194,1578,2,1.8341576329415865,0.7970707788643415
176,1547222400,818,635,0,1453,2,-0.6287158662687047,0.621666428399581
176,1547236800,1651,682,0,2333,2,-0.6287158662687047,1.8565130556714957
176,1547251200,417,276,0,693,2,-0.6287158662687047,-0.4447920224261634
176,1547265600,131,58,0,189,2,-0.6287158662687047,-1.1520223635000781
176,1547280000,76,177,101,253,2,0.6535017802273747,-1.0622153360621207
176,1547294400,337,419,82,756,2,0.412292519995439,-0.356388229791924
176,1547308800,583,443,0,1026,2,-0.6287158662687047,0.022485167211958826
176,1547323200,571,393,0,964,2,-0.6287158662687047,-0.06451539061856243
176,1547337600,295,242,0,537,2,-0.6287158662687047,-0.6636966518061845
176,1547352000,113,39,0,152,2,-0.6287158662687047,-1.203942051237647
176,1547366400,60,101,41,161,2,-0.10821167313663284,-1.1913129380041845
176,1547380800,254,283,29,537,2,-0.26055436380943436,-0.6636966518061845
176,1547395200,410,376,0,786,2,-0.6287158662687047,-0.3142911856803815
176,1547409600,424,301,0,725,2,-0.6287158662687047,-0.3998885087071847
176,1547424000,228,151,0,379,2,-0.6287158662687047,-0.885407750793642
176,1547438400,44,34,0,78,2,-0.6287158662687047,-1.3077814267127854
176,1547452800,197,436,239,633,2,2.405442722964592,-0.5289861106492485
176,1547467200,754,917,163,1671,2,1.4406056820368491,0.9275716156101235
176,1547481600,786,611,0,1397,2,-0.6287158662687047,0.5430852793913682
176,1547496000,1396,581,0,1977,2,-0.6287158662687047,1.3569614655478575
176,1547510400,313,192,0,505,3,-0.5367660300549988,-0.3112589162604047
176,1547524800,57,23,0,80,3,-0.5367660300549988,-1.0896010359776784
176,1547539200,199,388,189,587,3,1.1113821362009826,-0.16108467198554247
176,1547539766,24,20,0,44,3,-0.5367660300549988,-1.1555311920007887
176,1547553600,596,898,302,1494,3,2.096782891687363,1.4999889811522629
176,1547568000,643,573,0,1216,3,-0.5367660300549988,0.9908616651960227
176,1547582400,1271,655,0,1926,3,-0.5367660300549988,2.2911508534295857
176,1547596800,343,212,0,555,3,-0.5367660300549988,-0.21968925511719603
176,1547611200,60,34,0,94,3,-0.5367660300549988,-1.06396153085758
176,1547624994,141,122,0,263,3,-0.5367660300549988,-0.7544560761935347
176,1547625600,177,393,216,570,3,1.3468318742375514,-0.1922183567742334
176,1547640000,536,930,394,1466,3,2.899056073145301,1.448709970912066
176,1547654400,632,574,0,1206,3,-0.5367660300549988,0.972547732967381
176,1547668800,1182,623,0,1805,3,-0.5367660300549988,2.069552273463021
176,1547683200,327,202,0,529,3,-0.5367660300549988,-0.2673054789116645
176,1547697600,74,36,0,110,3,-0.5367660300549988,-1.0346592392917533
176,1547712000,166,391,225,557,3,1.425315120249741,-0.21602646867146766
176,1547719177,298,354,56,652,3,-0.0484258326458191,-0.042044112499371185
176,1547726400,593,910,317,1503,3,2.227588301707679,1.5164715201580405
176,1547740800,690,625,0,1315,3,-0.5367660300549988,1.1721695942595758
176,1547755200,1191,634,0,1825,3,-0.5367660300549988,2.1061801379203042
176,1547769600,342,212,0,554,3,-0.5367660300549988,-0.2215206483400602
176,1547784000,54,32,0,86,3,-0.5367660300549988,-1.0786126766404933
176,1547797214,111,69,0,180,3,-0.5367660300549988,-0.906461713691261
176,1547797916,28,25,0,53,3,-0.5367660300549988,-1.1390486529950112
176,1547798400,150,408,258,558,3,1.713087022294436,-0.2141950754486035
176,1547812800,564,870,306,1434,3,2.1316643343594475,1.3901053877804126
176,1547827200,665,591,0,1256,3,-0.5367660300549988,1.0641173941105897
176,1547841600,1127,556,0,1683,3,-0.5367660300549988,1.8461223002735918
176,1547856000,354,217,0,571,3,-0.5367660300549988,-0.19038696355136925
176,1547870400,103,45,0,148,3,-0.5367660300549988,-0.9650662968229147
176,1547884800,64,74,10,138,3,-0.44956242337478813,-0.9833802290515564
176,1547899200,229,239,10,468,3,-0.44956242337478813,-0.37902046550637913
176,1547913600,406,278,0,684,3,-0.5367660300549988,0.016560470632282366
176,1547928000,359,304,0,663,3,-0.5367660300549988,-0.021898787047865277
176,1547942400,235,157,0,392,3,-0.5367660300549988,-0.5182063504440563
176,1547956800,72,43,0,115,3,-0.5367660300549988,-1.0255022731774324
176,1547971200,34,49,15,83,3,-0.4059606200346828,-1.0841068563090859
176,1547985600,145,158,13,303,3,-0.42340134137072494,-0.6812003472789677
176,1548000000,253,278,25,531,3,-0.31875701335447215,-0.2636426924659362
176,1548014400,277,253,0,530,3,-0.5367660300549988,-0.2654740856888004
176,1548028800,167,112,0,279,3,-0.5367660300549988,-0.725153784627708
176,1548043200,48,22,0,70,3,-0.5367660300549988,-1.10791496820632
176,1548057600,59,214,155,273,3,0.8148898734882665,-0.736142143964893
176,1548072000,219,573,354,792,3,2.550241646424458,0.21435093870161312
176,1548086400,360,408,48,768,3,-0.11818871798998762,0.17039750135287293
176,1548100800,499,310,0,809,3,-0.5367660300549988,0.24548462349030406
176,1548115200,186,123,0,309,4,-0.662031000703511,-0.744704651219272
176,1548129600,35,15,0,50,4,-0.662031000703511,-1.1918497086588997
176,1548144000,153,391,238,544,4,1.344861729988423,-0.33899388481652093
176,1548158400,558,874,316,1432,4,2.002582877021914,1.194074883547917
176,1548172800,609,570,0,1179,4,-0.662031000703511,0.7572883988675083
176,1548187200,1227,619,0,1846,4,-0.662031000703511,1.9088164039340398
176,1548201600,344,180,0,524,4,-0.662031000703511,-0.37352246068058487
176,1548216000,51,13,0,64,4,-0.662031000703511,-1.1676797055540549
176,1548230400,167,360,193,527,4,0.9654072220844859,-0.36834317430097524
176,1548244800,542,934,392,1476,4,2.6434393792596746,1.2700377504488576
176,1548259200,624,646,22,1270,4,-0.47651990795047505,0.9143934190489992
176,1548273600,1187,606,0,1793,4,-0.662031000703511,1.8173156778942705
176,1548288000,374,195,0,569,4,-0.662031000703511,-0.295833164986441
176,1548302400,54,27,0,81,4,-0.662031000703511,-1.1383304160696006
176,1548316800,153,362,209,515,4,1.1003243804503302,-0.3890603198194136
176,1548331200,555,930,375,1485,4,2.5000898984959647,1.2855756095876862
176,1548345600,606,633,27,1239,4,-0.4343582959611487,0.8608741264597001
176,1548360000,1257,643,0,1900,4,-0.662031000703511,2.0020435587670127
176,1548374400,372,211,0,583,4,-0.662031000703511,-0.2716631618815963
176,1548388800,56,29,0,85,4,-0.662031000703511,-1.1314247008967877
176,1548403200,157,419,262,576,4,1.5472374675371894,-0.28374816343401865
176,1548407700,178,185,7,363,4,-0.603004743918454,-0.6514774963862994
176,1548408340,26,38,12,64,4,-0.5608431319291277,-1.1676797055540549
176,1548417600,502,875,373,1377,4,2.483225253700234,1.099121299921741
176,1548432000,575,643,68,1218,4,-0.08863307764867268,0.824619121802433
176,1548446400,1076,678,0,1754,4,-0.662031000703511,1.7499849549593458
176,1548460800,357,223,0,580,4,-0.662031000703511,-0.2768424482612059
176,1548475200,91,47,0,138,4,-0.662031000703511,-1.0399239748570184
176,1548489600,63,105,42,168,4,-0.3078734599931697,-0.9881311110609226
176,1548495957,53,79,26,132,4,-0.44279061835901395,-1.0502825476162376
176,1548504000,193,335,142,528,4,0.5353587797933572,-0.36661674550777207
176,1548518400,370,382,12,752,4,-0.5608431319291277,0.020103304169743784
176,1548532800,346,398,52,744,4,-0.22355023601451698,0.006291873824118217
176,1548547200,197,203,6,400,4,-0.6114370663163193,-0.5875996310377811
176,1548561600,73,56,0,129,4,-0.662031000703511,-1.0554618339958473
176,1548576000,53,99,46,152,4,-0.2741441704017086,-1.0157539717521737
176,1548590400,132,226,94,358,4,0.13060730469582432,-0.6601096403523153
176,1548604800,272,410,138,682,4,0.5016294902018962,-0.10074671135447992
176,1548619200,260,278,18,538,4,-0.5102491975419361,-0.3493524575757401
176,1548633600,151,104,0,255,4,-0.662031000703511,-0.8379318060522445
176,1548648000,51,26,0,77,4,-0.662031000703511,-1.1452361312424133
176,1548662400,150,411,261,561,4,1.538805145139324,-0.3096445953320666
176,1548676800,560,762,202,1322,4,1.0412981236652734,1.0041677162955653
176,1548691200,560,544,0,1104,4,-0.662031000703511,0.6278062393772686
176,1548705600,1315,558,0,1873,4,-0.662031000703511,1.9554299813505263
176,1548720000,349,187,0,536,5,-0.6451295350239835,-0.4850818637937651
176,1548734400,62,23,0,85,5,-0.6451295350239835,-1.2659453518520212
176,1548748800,160,390,230,550,5,1.2771256495323644,-0.4608421989759922
176,1548763200,552,946,394,1498,5,2.647777172433413,1.1805293901132026
176,1548777600,632,610,0,1242,5,-0.6451295350239835,0.7372898048739263
176,1548792000,1217,637,0,1854,5,-0.6451295350239835,1.7969094383365711
176,1548806400,345,239,0,584,5,-0.6451295350239835,-0.40197444156140083
176,1548820800,66,21,0,87,5,-0.6451295350239835,-1.2624825425923394
176,1548835200,166,362,196,528,5,0.9929661874675132,-0.4989331008324925
176,1548849600,535,941,406,1476,5,2.748068747279831,1.1424384882567022
176,1548864000,659,554,0,1213,5,-0.6451295350239835,0.6870790706085396
176,1548878400,1157,644,0,1801,5,-0.6451295350239835,1.705144992955002
176,1548892800,353,201,0,554,5,-0.6451295350239835,-0.4539165804566285
176,1548907200,64,20,0,84,5,-0.6451295350239835,-1.267676756481862
176,1548921600,171,354,183,525,5,0.8843169813838935,-0.5041273147220152
176,1548936000,694,842,148,1536,5,0.5917998880818405,1.2463227660471576
176,1548950400,595,527,0,1122,5,-0.6451295350239835,0.5295212492930156
176,1548964800,1350,639,0,1989,5,-0.6451295350239835,2.0306490633650958
176,1548979200,490,193,0,683,5,-0.6451295350239835,-0.23056538320714948
176,1548993600,72,24,0,96,5,-0.6451295350239835,-1.2468999009237711
176,1549008000,197,389,192,586,5,0.9595356625187071,-0.398511632301719
176,1549022400,544,745,201,1289,5,1.0347543436535207,0.8186658224764497
176,1549036800,639,574,0,1213,5,-0.6451295350239835,0.6870790706085396
176,1549051200,1428,565,0,1993,5,-0.6451295350239835,2.0375746818844593
176,1549065600,388,221,0,609,5,-0.6451295350239835,-0.35868932581537777
176,1549080000,72,40,0,112,5,-0.6451295350239835,-1.2191974268463164
176,1549094400,73,149,76,222,5,-0.009949560996668463,-1.0287429175638148
176,1549108800,219,381,162,600,5,0.7088067254026617,-0.37427196748394603
176,1549123200,397,427,30,824,5,-0.3944005979079381,0.013562669600420626
176,1549137600,381,421,40,802,5,-0.31082428553592295,-0.024528232256079672
176,1549152000,260,195,0,455,5,-0.6451295350239835,-0.6253256388108799
176,1549166400,77,50,0,127,5,-0.6451295350239835,-1.1932263573987025
176,1549180800,47,83,36,130,5,-0.344254810484729,-1.1880321435091796
176,1549195200,177,280,103,457,5,0.2157064824077724,-0.621862829551198
176,1549209600,296,392,96,688,5,0.15720306374736182,-0.22190836005794487
176,1549224000,309,416,107,725,5,0.24913700735657845,-0.15784638875383072
176,1549238400,253,164,0,417,5,-0.6451295350239835,-0.691119014744835
176,1549252800,43,35,0,78,5,-0.6451295350239835,-1.2780651842609076
176,1549267200,167,357,190,524,5,0.9428204000443041,-0.5058587193518562
176,1549281600,530,982,452,1512,5,3.1325197841911003,1.2047690549309755
176,1549296000,619,565,0,1184,5,-0.6451295350239835,0.6368683363431528
176,1549310400,1102,587,0,1689,5,-0.6451295350239835,1.5112276744128188
176,1549324800,319,228,0,547,6,-0.6996416249533594,-0.49489751942253435
176,1549339200,63,27,0,90,6,-0.6996416249533594,-1.3299065724988461
176,1549353600,158,387,229,545,6,1.0867011275821887,-0.49855182600054887
176,1549368000,525,873,348,1398,6,2.0149753090307922,1.0600099295226328
176,1549382400,624,613,0,1237,6,-0.6996416249533594,0.765838249992466
176,1549396800,1115,569,0,1684,6,-0.6996416249533594,1.5825757701787053
176,1549411200,376,192,0,568,6,-0.6996416249533594,-0.4565273003533822
176,1549425600,62,21,0,83,6,-0.6996416249533594,-1.342696645521897
176,1549440000,167,352,185,519,6,0.743473699147411,-0.5460578115147373
176,1549454400,540,947,407,1487,6,2.4752120880683353,1.2226265722442777
176,1549468800,666,548,0,1214,6,-0.6996416249533594,0.7238137243452993
176,1549483200,1138,617,0,1755,6,-0.6996416249533594,1.71230365369822
176,1549497600,387,213,0,600,6,-0.6996416249533594,-0.3980583951051503
176,1549512000,36,23,0,59,6,-0.6996416249533594,-1.3865483244580707
176,1549526400,165,419,254,584,6,1.2817167119201307,-0.42729284772926623
176,1549540800,542,867,325,1409,6,1.8355609714398857,1.0801086157017123
176,1549555200,682,635,0,1317,6,-0.6996416249533594,0.9120105131130457
176,1549569600,1120,694,0,1814,6,-0.6996416249533594,1.8201056977496475
176,1549584000,400,244,0,644,6,-0.6996416249533594,-0.31766365038883143
176,1549598400,222,64,0,286,6,-0.6996416249533594,-0.9717845278534258
176,1549612800,174,410,236,584,6,1.1413054911968126,-0.42729284772926623
176,1549627200,565,925,360,1490,6,2.1085827895130045,1.2281080321112994
176,1549641600,669,617,0,1286,6,-0.6996416249533594,0.8553687611538211
176,1549656000,1075,612,0,1687,6,-0.6996416249533594,1.5880572300457272
176,1549670400,369,217,0,586,6,-0.6996416249533594,-0.4236385411512517
176,1549684800,99,50,0,149,6,-0.6996416249533594,-1.2221045284474186
176,1549699200,79,139,60,218,6,-0.23160422254229865,-1.0960309515059186
176,1549713600,240,398,158,638,6,0.5328568680624337,-0.3286265701228749
176,1549728000,360,481,121,841,6,0.24423380324227967,0.04228554754559623
176,1549742400,410,459,49,869,6,-0.31741107965099313,0.09344583963779914
176,1549756800,239,237,0,476,6,-0.6996416249533594,-0.6246254029420489
176,1549771200,76,64,0,140,6,-0.6996416249533594,-1.238548908048484
176,1549785600,43,100,57,143,6,-0.2550060926628517,-1.233067448181462
176,1549800000,195,317,122,512,6,0.25203442661579734,-0.558847884537788
176,1549814400,301,476,175,777,6,0.6654674654122342,-0.07465226295086758
176,1549828800,308,379,71,687,6,-0.14579736543360422,-0.2390960589615198
176,1549843200,189,131,0,320,6,-0.6996416249533594,-0.9096613160271794
176,1549857600,37,23,0,60,6,-0.6996416249533594,-1.3847211711690637
176,1549872000,175,397,222,572,6,1.032096763967565,-0.4492186871973532
176,1549886400,540,928,388,1468,6,2.3270002439714994,1.18791065975314
176,1549900800,702,560,0,1262,6,-0.6996416249533594,0.8115170822176472
176,1549915200,1176,569,0,1745,6,-0.6996416249533594,1.6940321208081475
176,1549929600,402,166,0,568,7,-0.5299673058593812,-0.010249671709792865
176,1549944000,292,184,0,476,7,-0.5299673058593812,-0.17821616685402206
176,1549958400,162,443,281,605,7,2.0778625982726338,0.05730207090256018
176,1549972800,531,922,391,1453,7,3.098721279605451,1.6055149826667598
176,1549987200,596,598,2,1194,7,-0.5114062389260573,1.1326527843802885
176,1550001600,1166,628,0,1794,7,-0.5299673058593812,2.2280864483643916
176,1550016000,318,201,0,519,7,-0.5299673058593812,-0.09971008760182798
176,1550030400,83,57,0,140,7,-0.5299673058593812,-0.79165901868512
176,1550044800,153,363,210,516,7,1.4189447221396336,-0.1051872559217485
176,1550046872,79,105,26,184,7,-0.2886734357261699,-0.7113272166596191
176,1550059200,547,913,366,1460,7,2.8667079429389015,1.6182950420799076
176,1550073600,616,643,27,1259,7,-0.2793929022595079,1.251324764645233
176,1550088000,1156,698,0,1854,7,-0.5299673058593812,2.3376298147628023
176,1550102400,399,245,0,644,7,-0.5299673058593812,0.1285052590615269
176,1550116800,58,25,0,83,7,-0.5299673058593812,-0.8957252167636098
176,1550131200,167,430,263,597,7,1.9108129958727182,0.04269628871610547
176,1550145600,567,910,343,1477,7,2.6532556732056762,1.649332329226124
176,1550160000,621,610,0,1231,7,-0.5299673058593812,1.2002045269926416
176,1550174400,1218,621,0,1839,7,-0.5299673058593812,2.3102439731631996
176,1550177152,62,76,14,138,7,-0.4000398373261136,-0.7953104642317337
176,1550177232,2,0,0,2,7,-0.5299673058593812,-1.0436087614014637
176,1550177313,2,0,0,2,7,-0.5299673058593812,-1.0436087614014637
176,1550177393,4,7,3,11,7,-0.5021257054593953,-1.0271772564417023
176,1550177474,1,4,3,5,7,-0.5021257054593953,-1.0381315930815433
176,1550177554,6,0,0,6,7,-0.5299673058593812,-1.0363058703082364
176,1550177636,5,1,0,6,7,-0.5299673058593812,-1.0363058703082364
176,1550177716,4,0,0,4,7,-0.5299673058593812,-1.03995731585485
176,1550177797,2,0,0,2,7,-0.5299673058593812,-1.0436087614014637
176,1550177877,3,1,0,4,7,-0.5299673058593812,-1.03995731585485
176,1550177958,2,8,6,10,7,-0.4742841050594094,-1.029002979215009
176,1550178038,3,1,0,4,7,-0.5299673058593812,-1.03995731585485
176,1550188800,325,182,0,507,7,-0.5299673058593812,-0.12161876088151005
176,1550203200,69,33,0,102,7,-0.5299673058593812,-0.8610364840707799
176,1550217600,163,378,215,541,7,1.4653473894729434,-0.05954418658907752
176,1550232000,513,856,343,1369,7,2.6532556732056762,1.4521542697089853
176,1550245983,628,409,0,1037,7,-0.5299673058593812,0.8460143089711147
176,1550246048,4,0,0,4,7,-0.5299673058593812,-1.03995731585485
176,1550246400,579,521,0,1100,7,-0.5299673058593812,0.9610348436894456
176,1550260800,1095,564,0,1659,7,-0.5299673058593812,1.9816138739679685
176,1550275200,353,210,0,563,7,-0.5299673058593812,-0.01937828557632706
176,1550289600,87,37,0,124,7,-0.5299673058593812,-0.8208705830580295
176,1550304000,54,118,64,172,7,0.06398683600698517,-0.7332358899393012
176,1550318400,184,341,157,525,7,0.9270764484065489,-0.08875575096198696
176,1550332800,391,340,0,731,7,-0.5299673058593812,0.2873431403392219
176,1550347200,377,385,8,762,7,-0.45572303812608544,0.34394054631173393
176,1550361600,223,204,0,427,7,-0.5299673058593812,-0.2676765827460572
176,1550376000,75,36,0,111,7,-0.5299673058593812,-0.8446049791110184
176,1550390400,49,84,35,133,7,-0.2051486345262121,-0.8044390780982679
176,1550404800,169,252,83,421,7,0.24031697187356268,-0.27863091938589823
176,1550419200,297,414,117,711,7,0.5558551097400699,0.25082868487308513
176,1550433600,301,295,0,596,7,-0.5299673058593812,0.040870565942798635
176,1550448000,202,143,0,345,7,-0.5299673058593812,-0.417385850157218
176,1550462400,45,24,0,69,7,-0.5299673058593812,-0.9212853355899057
176,1550476800,66,162,96,228,7,0.3609639069401684,-0.6309954146341182
176,1550491200,240,392,152,632,7,0.880673781073239,0.10659658578184485
176,1550505600,396,446,50,842,7,-0.06594063252628249,0.48999836817628106
176,1550520000,517,381,0,898,7,-0.5299673058593812,0.592238843481464
176,1550534400,241,149,0,390,8,-0.7049717294192301,-0.9303419654853576
176,1550548800,43,26,0,69,8,-0.7049717294192301,-1.4598059901658036
176,1550563200,136,395,259,531,8,1.282377145895933,-0.6977736555789936
176,1550577600,566,914,348,1480,8,1.9652885354829968,0.867526529535471
176,1550592000,584,609,25,1193,8,-0.513142687400392,0.39414280653457395
176,1550606400,1086,698,0,1784,8,-0.7049717294192301,1.3689504033761426
176,1550620800,344,228,0,572,8,-0.7049717294192301,-0.6301474094360083
176,1550635200,61,34,0,95,8,-0.7049717294192301,-1.4169210535873251
176,1550649600,146,409,263,555,8,1.3130697926189472,-0.6581875602757827
176,1550664000,560,913,353,1473,8,2.0036543438867644,0.8559805850720346
176,1550678400,651,448,0,1099,8,-0.7049717294192301,0.2390972665969979
176,1550692800,1160,558,0,1718,8,-0.7049717294192301,1.2600886412923125
176,1550707200,363,224,0,587,8,-0.7049717294192301,-0.6054060998715015
176,1550721600,49,21,0,70,8,-0.7049717294192301,-1.4581565695281697
176,1550736000,161,428,267,589,8,1.3437624393419612,-0.6021072585962339
176,1550750400,814,902,88,1716,8,-0.029733501512919914,1.256789800017045
176,1550764800,613,623,10,1236,8,-0.628240112611695,0.4650678939528268
176,1550779200,1166,603,0,1769,8,-0.7049717294192301,1.3442090938116358
176,1550793600,391,258,0,649,8,-0.7049717294192301,-0.5031420203382067
176,1550808000,64,28,0,92,8,-0.7049717294192301,-1.4218693155002264
176,1550822400,133,438,305,571,8,1.6353425832105952,-0.6317968300736421
176,1550836800,617,845,228,1462,8,1.0445091337925738,0.8378369580580629
176,1550851200,630,689,59,1319,8,-0.25225519025477217,0.6019698068764312
176,1550865600,1324,554,0,1878,8,-0.7049717294192301,1.5239959433137187
176,1551484800,8636,8216,0,16852,9,-0.5687508549209166,4.096455428468884
176,1551499200,91,41,0,132,9,-0.5687508549209166,-0.35255318451290063
176,1551513600,75,81,6,156,9,-0.5027023685430038,-0.346167047747855
176,1551528000,216,317,101,533,9,0.5430653324406173,-0.24585148273026333
176,1551542400,334,366,32,700,9,-0.21649226090538115,-0.20141461440682087
176,1551556800,371,368,0,739,9,-0.5687508549209166,-0.19103714216362172
176,1551571200,286,182,0,468,9,-0.5687508549209166,-0.2631472698022619
176,1551585600,87,49,0,136,9,-0.5687508549209166,-0.351488828385393
176,1551600000,46,74,28,120,9,-0.2605245851573231,-0.35574625289542344
176,1551614400,180,224,44,404,9,-0.08439528814955535,-0.28017696784238355
176,1551628800,292,368,76,660,9,0.2678633058659801,-0.21205817568189692
176,1551643200,290,294,4,584,9,-0.5247185306689747,-0.2322809421045414
176,1551657600,149,109,0,258,9,-0.5687508549209166,-0.31902596649641113
176,1551672000,31,15,0,46,9,-0.5687508549209166,-0.37543684125431415
176,1551686400,133,300,167,433,9,1.2695986825976593,-0.2724603859179534
176,1551700800,445,818,373,1263,9,3.537263381572669,-0.0516064894601256
176,1551715200,448,547,99,995,9,0.5210491703146463,-0.12291835000313507
176,1551729600,1151,595,0,1746,9,-0.5687508549209166,0.07691451293641757
176,1551744000,305,200,0,505,10,-0.6070522170756022,-0.48227932966323733
176,1551758400,56,22,0,78,10,-0.6070522170756022,-1.0191676419055138
176,1551772800,165,418,253,583,10,1.7884477051100072,-0.3842060548274116
176,1551787200,542,842,300,1384,10,2.233461524646464,0.6229310367558754
176,1551801600,599,589,0,1188,10,-0.6070522170756022,0.3764904999889287
176,1551816000,1311,604,0,1915,10,-0.6070522170756022,1.2905837154459194
176,1551830400,397,203,0,600,10,-0.6070522170756022,-0.3628311103119112
176,1551844800,65,19,0,84,10,-0.6070522170756022,-1.0116235438412196
176,1551859200,178,380,202,558,10,1.3055603690172557,-0.41563979676197116
176,1551862886,170,282,112,452,10,0.453406246500636,-0.5489188625645035
176,1551863543,42,65,23,107,10,-0.38927949687691044,-0.9827045012614248
176,1551873600,582,735,153,1317,10,0.8416097912026518,0.5386886083712559
176,1551888000,651,588,0,1239,10,-0.6070522170756022,0.44061533353543014
176,1551902400,1337,619,0,1956,10,-0.6070522170756022,1.3421350522185969
176,1551916800,355,234,0,589,10,-0.6070522170756022,-0.37666195676311737
176,1551931200,64,16,0,80,10,-0.6070522170756022,-1.0166529425507491
176,1551945600,160,409,249,569,10,1.750574188553713,-0.40180895031076497
176,1551960000,606,924,318,1530,10,2.403892349149788,0.8065040896537029
176,1551974400,765,616,0,1381,10,-0.6070522170756022,0.6191589877237282
176,1551988800,1585,703,0,2288,10,-0.6070522170756022,1.7595751451095474
176,1552003200,401,268,0,669,10,-0.6070522170756022,-0.2760739825725269
176,1552017600,68,125,57,193,10,-0.06735460614840957,-0.8745724290065401
176,1552032000,147,383,236,530,10,1.6274852597457568,-0.45084558772867783
176,1552046400,600,843,243,1443,10,1.6937639137192715,0.6971146677214358
176,1552060800,654,643,0,1297,10,-0.6070522170756022,0.5135416148236082
176,1552075200,1334,702,0,2036,10,-0.6070522170756022,1.4427230264091875
176,1552089600,2438,1885,0,4323,10,-0.6070522170756022,4.318281738582692
176,1552104000,122,66,0,188,10,-0.6070522170756022,-0.880859177393452
176,1552118400,88,105,17,193,10,-0.4460897717113518,-0.8745724290065401
176,1552132800,241,279,38,520,10,-0.24725380979080713,-0.46341908450250163
176,1552147200,393,321,0,714,10,-0.6070522170756022,-0.21949324709031975
176,1552161600,422,348,0,770,10,-0.6070522170756022,-0.14908166515690643
176,1552176000,273,254,0,527,10,-0.6070522170756022,-0.45461763676082495
176,1552194000,109,75,0,184,10,-0.6070522170756022,-0.8858885761029816
176,1552208400,61,82,21,143,10,-0.40821625515505755,-0.9374399128756592
176,1552222800,195,217,22,412,10,-0.398747876015984,-0.5992128496597987
176,1552237200,318,281,0,599,10,-0.6070522170756022,-0.3640884599892935
176,1552251600,268,286,18,554,10,-0.4366213925722782,-0.42066919547150067
176,1552266000,166,105,0,271,10,-0.6070522170756022,-0.7764991541707145
176,1552280400,27,21,0,48,10,-0.6070522170756022,-1.0568881322269854
176,1552294800,303,586,283,889,10,2.0724990792822138,0.0005429464515968722
176,1552309200,448,724,276,1172,10,2.006220425308699,0.3563729051508106
176,1552323600,740,606,0,1346,10,-0.6070522170756022,0.5751517490153448
176,1552338000,1034,639,0,1673,10,-0.6070522170756022,0.9863050935193833
176,1552352400,274,126,0,400,11,-0.688456588673104,-0.7523839414773712
176,1552366800,33,18,0,51,11,-0.688456588673104,-1.3574418885032549
176,1552381200,321,703,382,1024,11,1.999889894918848,0.3294388635201974
176,1552395600,509,599,90,1108,11,-0.0550765270938483,0.4750688565006393
176,1552410000,821,1429,608,2250,11,3.590377605106757,2.4549432848776
176,1552424400,1119,665,0,1784,11,-0.688456588673104,1.647043561914672
176,1552438800,305,133,0,438,11,-0.688456588673104,-0.6865037065576475
176,1552453200,32,23,0,55,11,-0.688456588673104,-1.3505071269327578
176,1552464328,114,404,290,518,11,1.3524347208600533,-0.5478084751477028
176,1552467600,334,552,218,886,11,0.8457306715966487,0.09018958933804279
176,1552472540,143,341,198,484,11,0.7049795468012586,-0.6067539484969293
176,1552477767,120,277,157,397,11,0.41643974097070874,-0.7575850126552441
176,1552482000,486,641,155,1127,11,0.4023646284911697,0.5080089739605012
176,1552496400,925,670,0,1595,11,-0.688456588673104,1.3193760777086776
176,1552510800,1106,621,0,1727,11,-0.688456588673104,1.5482232095350863
176,1552525200,296,159,0,455,11,-0.688456588673104,-0.6570309698830342
176,1552539600,35,23,0,58,11,-0.688456588673104,-1.3453060557548848
176,1552552203,164,488,324,652,11,1.5917116330122165,-0.31549396253604545
176,1552554000,334,521,187,855,11,0.627566428163794,0.03644518716668922
176,1552568400,526,812,286,1338,11,1.3242844959009752,0.8738176468042304
176,1552582800,719,605,0,1324,11,-0.688456588673104,0.84954598130749
176,1552597200,1146,553,0,1699,11,-0.688456588673104,1.4996798785416057
176,1552611600,295,179,0,474,11,-0.688456588673104,-0.6240908524231724
176,1552626000,40,20,0,60,11,-0.688456588673104,-1.3418386749696363
176,1552640400,285,630,345,915,11,1.7395003140473762,0.14046661072414773
176,1552654800,493,799,306,1292,11,1.4650356206963653,0.7940678887435121
176,1552669200,782,693,0,1475,11,-0.688456588673104,1.1113332305937607
176,1552683600,924,596,0,1520,11,-0.688456588673104,1.1893492982618545
176,1552698000,240,158,0,398,11,-0.688456588673104,-0.7558513222626199
176,1552712400,58,29,0,87,11,-0.688456588673104,-1.2950290343687798
176,1552726800,95,179,84,274,11,-0.09730186453246535,-0.9708289309480341
176,1552741200,354,444,90,798,11,-0.0550765270938483,-0.06237516521289638
176,1552755600,606,537,0,1143,11,-0.688456588673104,0.5357480202424901
176,1552770000,500,419,0,919,11,-0.688456588673104,0.14740137229464498
176,1552784400,263,176,0,439,11,-0.688456588673104,-0.6847700161650232
176,1552798800,54,31,0,85,11,-0.688456588673104,-1.2984964151540284
176,1552813200,77,124,47,201,11,-0.35769144540393716,-1.0973883296096087
176,1552827600,289,339,50,628,11,-0.3365787766846286,-0.35710253195902886
176,1552842000,355,451,96,806,11,-0.012851189655231245,-0.0485056420719019
176,1552856400,304,306,2,610,11,-0.674381476193565,-0.3883089590262664
176,1552870800,128,99,0,227,11,-0.688456588673104,-1.0523123794013767
176,1552885200,18,35,17,53,11,-0.5688181325970224,-1.3539745077180063
176,1552899600,420,723,303,1143,11,1.443922951977057,0.5357480202424901
176,1552914000,513,778,265,1291,11,1.1764958148658156,0.7923341983508878
176,1552928400,1029,657,0,1686,11,-0.688456588673104,1.4771419034374897
176,1552942800,1047,567,0,1614,11,-0.688456588673104,1.3523161951685394
176,1552957200,252,124,0,376,12,-0.6569094389512582,-0.7852315387127213
176,1552971600,29,38,9,67,12,-0.598161440345861,-1.3624690623860471
176,1552986000,316,733,417,1049,12,2.065081163098806,0.47198805168258023
176,1553000400,445,858,413,1303,12,2.0389709414964075,0.9464810323072558
176,1553014800,772,605,0,1377,12,-0.6569094389512582,1.0847191447727125
176,1553029200,1066,550,0,1616,12,-0.6569094389512582,1.5311908863841197
176,1553043600,302,140,0,442,12,-0.6569094389512582,-0.6619380870543411
176,1553058000,26,42,16,68,12,-0.5524685525416634,-1.3606009797851626
176,1553072400,335,671,336,1006,12,1.5363491756502325,0.39166049984454465
176,1553086800,428,874,446,1302,12,2.2543802697161968,0.9446129497063712
176,1553101200,776,658,0,1434,12,-0.6569094389512582,1.1911998530231316
176,1553115600,1062,626,0,1688,12,-0.6569094389512582,1.6656928336478072
176,1553130000,286,137,0,423,12,-0.6569094389512582,-0.6974316564711476
176,1553144400,29,41,12,70,12,-0.5785787741440621,-1.3568648145833935
176,1553158800,327,728,401,1055,12,1.9606402766892113,0.4831965472878875
176,1553173200,485,893,408,1378,12,2.006333164493409,1.086587227373597
176,1553187600,804,657,0,1461,12,-0.6569094389512582,1.2416380832470144
176,1553202000,1040,643,0,1683,12,-0.6569094389512582,1.6563524206433844
176,1553216400,279,166,0,445,12,-0.6569094389512582,-0.6563338392516874
176,1553230800,203,108,0,311,12,-0.6569094389512582,-0.906656907770217
176,1553245200,283,701,418,984,12,2.0716087184994056,0.35056268262508455
176,1553259600,501,780,279,1281,12,1.164278517816051,0.9053832150877956
176,1553274000,748,672,0,1420,12,-0.6569094389512582,1.165046696610748
176,1553288400,905,601,0,1506,12,-0.6569094389512582,1.3257018002868193
176,1553302800,331,198,0,529,12,-0.6569094389512582,-0.4994149007773853
176,1553317200,65,35,0,100,12,-0.6569094389512582,-1.300822336556857
176,1553331600,88,206,118,294,12,0.11334209831950341,-0.9384143119852544
176,1553346000,254,429,175,683,12,0.48541275615368484,-0.21173018024116477
176,1553360400,362,392,30,754,12,-0.46108277693326793,-0.07909631557836176
176,1553374800,349,359,10,708,12,-0.5916338849452614,-0.16502811521905103
176,1553389200,248,186,0,434,12,-0.6569094389512582,-0.6768827478614176
176,1553403600,53,34,0,87,12,-0.6569094389512582,-1.325107410368356
176,1553418000,62,114,52,176,12,-0.3174765581200751,-1.1588480588896313
176,1553432400,372,354,0,726,12,-0.6569094389512582,-0.13140262840312913
176,1553446800,348,432,84,780,12,-0.10859478530088551,-0.030526167955363486
176,1553461200,233,311,78,544,12,-0.14776011770448355,-0.4713936617641171
176,1553475600,143,87,0,230,12,-0.6569094389512582,-1.0579715984418656
176,1553490000,25,31,6,56,12,-0.6177441065476601,-1.383017970995777
176,1553499469,61,271,210,332,12,0.7138771951746734,-0.8674271731516415
176,1553499566,3,4,1,7,12,-0.6503818835506585,-1.47455401843912
176,1553504400,307,504,197,811,12,0.6290189749668776,0.02738439267205754
176,1553518800,468,780,312,1248,12,1.3796878460358404,0.8437364892586056
176,1553533200,643,618,0,1261,12,-0.6569094389512582,0.8680215630701047
176,1553547600,989,545,0,1534,12,-0.6569094389512582,1.3780081131115867
176,1553562000,223,141,0,364,13,-0.6899694658011439,-0.804139343701365
176,1553576400,25,48,23,73,13,-0.5272471747943311,-1.3421102812851453
176,1553590800,328,720,392,1048,13,2.083384363532361,0.46036966422752074
176,1553605200,435,757,322,1192,13,1.5881426082942347,0.7265820869493914
176,1553619600,806,671,0,1477,13,-0.6899694658011439,1.2534608402530938
176,1553634000,1061,571,0,1632,13,-0.6899694658011439,1.5400089341551073
176,1553648400,267,137,0,404,13,-0.6899694658011439,-0.7301914485008454
176,1553662800,27,38,11,65,13,-0.6121457614065813,-1.3568998603252493
176,1553677200,318,685,367,1003,13,1.906512308090173,0.37717828212693616
176,1553691600,479,788,309,1267,13,1.496169139464297,0.8652343904503658
176,1553706000,685,645,0,1330,13,-0.6899694658011439,0.9817023253911842
176,1553720400,1089,575,0,1664,13,-0.6899694658011439,1.5991672503155232
176,1553734800,265,166,0,431,13,-0.6899694658011439,-0.6802766192404947
176,1553749200,25,43,18,68,13,-0.5626215858827688,-1.3513537681852104
176,1553763600,320,689,369,1009,13,1.9206620725255479,0.38827046640701407
176,1553778000,492,814,322,1306,13,1.5881426082942347,0.9373335882708724
176,1553792400,654,609,0,1263,13,-0.6899694658011439,0.8578396009303138
176,1553806800,1043,582,0,1625,13,-0.6899694658011439,1.5270680524950164
176,1553821200,260,150,0,410,13,-0.6899694658011439,-0.7190992642207674
176,1553835600,30,43,13,73,13,-0.5979959969712063,-1.3421102812851453
176,1553850000,270,570,300,840,13,1.4324951995051096,0.07584060918481864
176,1553864400,509,727,218,1236,13,0.8523548576547336,0.807924771669963
176,1553878800,695,619,0,1314,13,-0.6899694658011439,0.9521231673109763
176,1553893200,1044,597,0,1641,13,-0.6899694658011439,1.5566472105752243
176,1553907600,311,180,0,491,13,-0.6899694658011439,-0.5693547764397152
176,1553922000,72,28,0,100,13,-0.6899694658011439,-1.2921954520247947
176,1553936400,89,130,41,219,13,-0.399899294875956,-1.0722004638032487
176,1553950800,255,388,133,643,13,0.2509898691512951,-0.28835277467774056
176,1553965200,365,397,32,762,13,-0.46357323483514357,-0.06835778645619466
176,1553979600,283,381,98,664,13,0.0033689915322321867,-0.24953012969746774
176,1553994000,223,193,0,416,13,-0.6899694658011439,-0.7080070799406895
176,1554008400,38,32,0,70,13,-0.6899694658011439,-1.3476563734251843
176,1554022800,51,105,54,156,13,-0.3079258260460183,-1.1886683987440672
176,1554037200,194,288,94,482,13,-0.02493053733851786,-0.585993052859832
176,1554051600,287,360,73,647,13,-0.1735030639099556,-0.2809579851576886
176,1554066000,207,310,103,517,13,0.03874340262066975,-0.5212886445593774
176,1554080400,156,89,0,245,13,-0.6899694658011439,-1.024134331922911
176,1554094800,15,27,12,42,13,-0.6050708791888938,-1.399419900065548
176,1554109200,335,708,373,1043,13,1.9489616013962978,0.4511261773274558
176,1554123600,447,866,419,1313,13,2.2744061834099236,0.9502744699309633
176,1554138000,720,642,0,1362,13,-0.6899694658011439,1.0408606415516
176,1554152400,1078,572,0,1650,13,-0.6899694658011439,1.5732854869953412
176,1554166800,217,131,0,348,14,-0.7618938925784076,-0.8835924737389768
176,1554181200,23,36,13,59,14,-0.6692242411309114,-1.4213504684363143
176,1554195600,339,717,378,1056,14,1.932654434125713,0.43382157555415457
176,1554210000,458,766,308,1224,14,1.4336640032545798,0.7464282991152366
176,1554224400,797,683,0,1480,14,-0.7618938925784076,1.2227814016845044
176,1554238800,1078,592,0,1670,14,-0.7618938925784076,1.576324719997633
176,1554253200,245,157,0,402,14,-0.7618938925784076,-0.7831117411657719
176,1554267600,22,30,8,52,14,-0.7048664147645637,-1.4343757485846926
176,1554282000,342,687,345,1029,14,1.6974160881436076,0.3835812092675521
176,1554296400,504,793,289,1297,14,1.2982237434467008,0.8822633635197544
176,1554310800,649,690,41,1339,14,-0.46962806878245794,0.9604150444100249
176,1554325200,990,600,0,1590,14,-0.7618938925784076,1.4274643754447367
176,1554339600,235,169,0,404,14,-0.7618938925784076,-0.7793902325519495
176,1554354000,30,31,1,61,14,-0.754765457851677,-1.4176289598224918
176,1554368400,310,788,478,1098,14,2.6454979067987607,0.511973256444425
176,1554382800,498,847,349,1345,14,1.7259298270505294,0.9715795702514921
176,1554397200,696,744,48,1440,14,-0.4197290256953446,1.1483512294080562
176,1554411600,1005,595,0,1600,14,-0.7618938925784076,1.4460719185138486
176,1554426000,432,175,0,607,14,-0.7618938925784076,-0.4016571082489753
176,1554440400,46,38,0,84,14,-0.7618938925784076,-1.3748316107635343
176,1554454800,444,666,222,1110,14,0.8206186167557586,0.5343023081273595
176,1554469200,593,909,316,1502,14,1.4906914810684238,1.2637179964365508
176,1554483600,726,610,0,1336,14,-0.7618938925784076,0.9548327814892913
176,1554498000,978,652,0,1630,14,-0.7618938925784076,1.501894547721185
176,1554512400,281,211,0,492,14,-0.7618938925784076,-0.6156438535437636
176,1554526800,40,29,0,69,14,-0.7618938925784076,-1.4027429253672024
176,1554541200,79,195,116,274,14,0.06500453572232795,-1.0212882924504059
176,1554555600,294,416,122,710,14,0.10777514408271081,-0.2099994146371215
176,1554570000,356,468,112,824,14,0.03649079681540603,0.0021265763507555997
176,1554584400,297,422,125,719,14,0.12916044826290224,-0.19325262587492067
176,1554598800,216,169,0,385,14,-0.7618938925784076,-0.8147445643832623
176,1554613200,50,93,43,143,14,-0.455371199328997,-1.2650471066557734
176,1554627600,61,128,67,189,14,-0.2842887658874655,-1.179452408537858
176,1554642000,229,355,126,584,14,0.13628888298963274,-0.444454457307933
176,1554656400,262,430,168,692,14,0.4356831415123128,-0.24349299216152312
176,1554670800,227,327,100,554,14,-0.04905041990535971,-0.500277086515269
176,1554685200,144,84,0,228,14,-0.7618938925784076,-1.106882990568321
176,1554699600,23,40,17,63,14,-0.6407105022239894,-1.4139074512086696
176,1554714000,307,622,315,929,14,1.4835630463416931,0.19750577857643187
176,1554728400,433,815,382,1248,14,1.9611681730326351,0.7910864024811055
176,1554742800,627,569,0,1196,14,-0.7618938925784076,0.6943271785217229
176,1554757200,955,543,0,1498,14,-0.7618938925784076,1.256274979208906
176,1554771600,319,122,0,441,15,-0.7825797323154943,-0.7594191027419681
176,1554786000,107,110,3,217,15,-0.7622739155379505,-1.1833563791079822
176,1554800400,309,513,204,822,15,0.5982158085574782,-0.038347217494417406
176,1554814800,490,812,322,1302,15,1.3969112684741978,0.8700898032898985
176,1554829200,687,651,0,1338,15,-0.7825797323154943,0.9382225798487221
176,1554843600,1069,599,0,1668,15,-0.7825797323154943,1.5627730316379393
176,1554858000,319,163,0,482,15,-0.7825797323154943,-0.6818234405499745
176,1554872400,70,43,0,113,15,-0.7825797323154943,-1.3801844002779173
176,1554886800,349,729,380,1078,15,1.789490392840043,0.4461525269238844
176,1554901200,469,925,456,1394,15,2.3039044178711503,1.0442068989402256
176,1554915600,691,677,0,1368,15,-0.7825797323154943,0.9949998936477419
176,1554930000,1009,651,0,1660,15,-0.7825797323154943,1.5476324146248674
176,1554944400,286,183,0,469,15,-0.7825797323154943,-0.7064269431962164
176,1554958800,26,41,15,67,15,-0.6810506484277757,-1.4672429481030809
176,1554973200,402,679,277,1081,15,1.092324016811042,0.45183025830378637
176,1554987600,537,898,361,1435,15,1.660886886582266,1.1218025611322193
176,1555002000,688,677,0,1365,15,-0.7825797323154943,0.9893221622678399
176,1555016400,1044,598,0,1642,15,-0.7825797323154943,1.5135660263454556
176,1555030800,270,178,0,448,15,-0.7825797323154943,-0.7461710628555301
176,1555045200,35,24,0,59,15,-0.7825797323154943,-1.4823835651161528
176,1555059600,289,655,366,944,15,1.694729914544839,0.19254719195492953
176,1555074000,472,764,292,1236,15,1.1938531006987605,0.745179712932055
176,1555088400,759,662,0,1421,15,-0.7825797323154943,1.0953064813593434
176,1555102800,934,548,0,1482,15,-0.7825797323154943,1.210753686084017
176,1555117200,274,195,0,469,15,-0.7825797323154943,-0.7064269431962164
176,1555131600,40,30,0,70,15,-0.7825797323154943,-1.461565216723179
176,1555146000,72,237,165,309,15,0.33424019044941,-1.009239283457655
176,1555160400,282,526,244,808,15,0.8689600322580612,-0.06484329726729328
176,1555174800,376,506,130,882,15,0.09733899471140002,0.07520741010362207
176,1555189200,328,546,218,874,15,0.6929762868526823,0.060066793090550144
176,1555203600,203,261,58,464,15,-0.39000060794964914,-0.7158898288293863
176,1555218000,60,30,0,90,15,-0.7825797323154943,-1.423713674190499
176,1555232400,67,143,76,210,15,-0.2681657072843868,-1.19660441899442
176,1555246800,241,414,173,655,15,0.3883890351895266,-0.35440759764229396
176,1555261200,286,467,181,753,15,0.44253787992964316,-0.1689350392321628
176,1555275600,262,392,130,654,15,0.09733899471140002,-0.35630017476892795
176,1555290000,156,96,0,252,15,-0.7825797323154943,-1.1171161796757925
176,1555304400,18,32,14,50,15,-0.6878192540202903,-1.4994167592558587
176,1555318800,299,718,419,1017,15,2.0534660109481115,0.3307053221992109
176,1555333200,466,838,372,1304,15,1.7353415480999266,0.8738749575431665
176,1555347600,664,661,0,1325,15,-0.7825797323154943,0.9136190772024803
176,1555362000,1024,633,0,1657,15,-0.7825797323154943,1.5419546832449653
176,1555376400,226,156,0,382,16,-0.6495565272825076,-0.7686758355205554
176,1555390800,26,31,5,57,16,-0.616194211619407,-1.385018987818436
176,1555405200,343,688,345,1031,16,1.652443253471434,0.4621140286065969
176,1555419600,635,812,177,1447,16,0.5314694471912538,1.251033263547884
176,1555434000,815,546,0,1361,16,-0.6495565272825076,1.087939383247522
176,1555448400,1019,520,0,1539,16,-0.6495565272825076,1.4255057866598995
176,1555462800,300,189,0,489,16,-0.6495565272825076,-0.565756705379407
176,1555477200,37,33,0,70,16,-0.6495565272825076,-1.3603652617265207
176,1555488326,81,317,236,398,16,0.9251447720158409,-0.7383327880228137
176,1555491600,321,747,426,1068,16,2.1929127672136635,0.5322823259451248
176,1555506000,543,756,213,1299,16,0.7716781199655781,0.9703600741937723
176,1555520400,778,619,0,1397,16,-0.6495565272825076,1.156211240117441
176,1555534800,1101,526,0,1627,16,-0.6495565272825076,1.5923925478974794
176,1555549200,322,206,0,528,16,-0.6495565272825076,-0.49179552710366137
176,1555563600,45,34,0,79,16,-0.6495565272825076,-1.343297297509041
176,1555578000,319,703,384,1022,16,1.9126693156436185,0.44504606438911715
176,1555592400,525,908,383,1433,16,1.9059968525109985,1.22448309698736
176,1555606800,792,688,0,1480,16,-0.6495565272825076,1.3136157990119766
176,1555621200,978,592,0,1570,16,-0.6495565272825076,1.4842954411867744
176,1555635600,330,204,0,534,16,-0.6495565272825076,-0.4804168842920082
176,1555650000,52,34,0,86,16,-0.6495565272825076,-1.330022214228779
176,1555664400,183,625,442,808,16,2.2996721773355855,0.03920780410682038
176,1555678800,476,752,276,1228,16,1.1920432973206456,0.835712800922543
176,1555693200,808,554,0,1362,16,-0.6495565272825076,1.0898358237161307
176,1555707600,630,421,0,1051,16,-0.6495565272825076,0.5000428379787741
176,1555722000,262,163,0,425,16,-0.6495565272825076,-0.6871288953703742
176,1555736400,52,22,0,74,16,-0.6495565272825076,-1.3527794998520852
176,1555750800,87,200,113,287,16,0.10443180670356604,-0.9488376800383974
176,1555765200,238,310,72,548,16,-0.16913918173385892,-0.45386671773148407
176,1555779600,395,394,0,789,16,-0.6495565272825076,0.003175435203251975
176,1555794000,284,328,44,612,16,-0.35596814944722227,-0.33249452774051685
176,1555808400,208,166,0,374,16,-0.6495565272825076,-0.7838473592694263
176,1555822800,53,34,0,87,16,-0.6495565272825076,-1.3281257737601702
176,1555837200,72,110,38,182,16,-0.39600292824294303,-1.147963929242328
176,1555851600,201,257,56,458,16,-0.27589859185578086,-0.6245463599062818
176,1555866000,270,326,56,596,16,-0.27589859185578086,-0.36283757523825866
176,1555880400,228,259,31,487,16,-0.44271017017128383,-0.5695495863166248
176,1555894800,151,86,0,237,16,-0.6495565272825076,-1.0436597034688406
176,1555909200,23,49,26,72,16,-0.47607248583438444,-1.356572380789303
176,1555923600,256,697,441,953,16,2.2929997142029652,0.31419167205510556
176,1555938000,477,864,387,1341,16,1.9326867050414789,1.0500105738753445
176,1555952400,672,707,35,1379,16,-0.4160203176408034,1.1220753116824813
176,1555966800,985,623,0,1608,16,-0.6495565272825076,1.556360178993911
176,1555981200,242,133,0,375,17,-0.6651812584571835,-0.8078379827630174
176,1555995600,29,42,13,71,17,-0.5768199765627318,-1.3967012447487461
176,1556010000,324,714,390,1038,17,1.985657198376367,0.47642630242296335
176,1556024400,544,823,279,1367,17,1.2311877914314333,1.1137158195062027
176,1556038800,693,597,0,1290,17,-0.6651812584571835,0.9645629538058701
176,1556053200,1020,572,0,1592,17,-0.6651812584571835,1.549552115383798
176,1556067600,325,152,0,477,17,-0.6651812584571835,-0.6102588619651742
176,1556082000,37,39,2,76,17,-0.6515872150888062,-1.3870159937292441
176,1556091015,87,79,0,166,17,-0.6651812584571835,-1.212681475378206
176,1556096400,280,730,450,1010,17,2.3934784994276823,0.4221888967137515
176,1556110800,464,849,385,1313,17,1.9516720899554238,1.0091151084955798
176,1556125200,698,611,0,1309,17,-0.6651812584571835,1.001366907679978
176,1556139600,860,549,0,1409,17,-0.6651812584571835,1.1950719280700204
176,1556154000,299,162,0,461,17,-0.6651812584571835,-0.641251665227581
176,1556168400,45,32,0,77,17,-0.6651812584571835,-1.3850789435253437
176,1556182800,332,685,353,1017,17,1.734167396061389,0.43574824814105445
176,1556197200,470,821,351,1291,17,1.7205733526930118,0.9665000040097704
176,1556211600,745,679,0,1424,17,-0.6651812584571835,1.2241276811285269
176,1556226000,1007,573,0,1580,17,-0.6651812584571835,1.526307512936993
176,1556240400,311,160,0,471,17,-0.6651812584571835,-0.6218811631885768
176,1556254800,57,52,0,109,17,-0.6651812584571835,-1.32309333700053
176,1556269200,283,687,404,970,17,2.080815501955007,0.3447068885577345
176,1556283600,497,835,338,1332,17,1.6322120707985601,1.045919062369688
176,1556298000,762,717,0,1479,17,-0.6651812584571835,1.3306654423430502
176,1556312400,956,588,0,1544,17,-0.6651812584571835,1.4565737055965777
176,1556326800,285,175,0,460,17,-0.6651812584571835,-0.6431887154314815
176,1556341200,69,25,0,94,17,-0.6651812584571835,-1.3521490900590365
176,1556355600,104,263,159,367,17,0.4155451893288025,-0.8233343843942208
176,1556370000,318,425,107,743,17,0.062100061750995784,-0.0950035077276616
176,1556384400,433,415,0,848,17,-0.6651812584571835,0.10838676368188287
176,1556398800,384,381,0,765,17,-0.6651812584571835,-0.05238840324185228
176,1556413200,275,222,0,497,17,-0.6651812584571835,-0.5715178578871658
176,1556427600,60,26,0,86,17,-0.6651812584571835,-1.3676454916902399
176,1556442000,76,147,71,223,17,-0.18259271887979348,-1.1022696137558818
176,1556456400,222,316,94,538,17,-0.02626122014345589,-0.49209879952724844
176,1556470800,295,383,88,678,17,-0.06704335024858744,-0.22091177098118914
176,1556485200,281,316,35,597,17,-0.42728549951058276,-0.3778128374971234
176,1556499600,164,107,0,271,17,-0.6651812584571835,-1.0092912039686615
176,1556514000,37,37,0,74,17,-0.6651812584571835,-1.390890094137045
176,1556523750,68,309,241,377,17,0.9729009674322668,-0.8039638823552167
176,1556528400,275,526,251,801,17,1.0408711842741527,0.01734540409856296
176,1556542800,490,785,295,1275,17,1.3399401383784508,0.9355072007473637
176,1556557200,737,587,0,1324,17,-0.6651812584571835,1.0304226607384845
176,1556571600,1030,554,0,1584,17,-0.6651812584571835,1.5340557137525945
176,1556586000,262,154,0,416,18,-0.7042968981789114,-0.7234984399958182
176,1556600400,36,37,1,73,18,-0.6969726099444816,-1.362599315407986
176,1556614800,355,714,359,1069,18,1.9251225779813546,0.49321547150314876
176,1556629200,478,801,323,1279,18,1.6614482015418848,0.8845017217554965
176,1556643600,803,630,0,1433,18,-0.7042968981789114,1.1714449719405515
176,1556658000,1012,478,0,1490,18,-0.7042968981789114,1.2776512398661886
176,1556672400,299,142,0,441,18,-0.7042968981789114,-0.6769167435372053
176,1556686800,40,33,0,73,18,-0.7042968981789114,-1.362599315407986
176,1556701200,353,704,351,1057,18,1.8665282721059167,0.4708562572030146
176,1556715600,467,827,360,1294,18,1.9324468662157843,0.9124507396306641
176,1556730000,779,668,0,1447,18,-0.7042968981789114,1.1975307219573745
176,1556744400,1073,603,0,1676,18,-0.7042968981789114,1.6242190615182681
176,1556758800,292,182,0,474,18,-0.7042968981789114,-0.6154289042118364
176,1556773200,34,36,2,70,18,-0.689648321710052,-1.3681891189830195
176,1556787600,352,649,297,1001,18,1.4710167074467124,0.36651325713572186
176,1556790374,106,181,75,287,18,-0.15497528059668314,-0.9638599937222603
176,1556793653,104,233,129,337,18,0.24053628406252117,-0.8706966008050346
176,1556802000,483,803,320,1286,18,1.6394753368385957,0.8975445967639081
176,1556816400,812,639,0,1451,18,-0.7042968981789114,1.2049837933907526
176,1556830800,1099,605,0,1704,18,-0.7042968981789114,1.6763905615519143
176,1556845200,296,150,0,446,18,-0.7042968981789114,-0.6676004042454827
176,1556859600,47,40,0,87,18,-0.7042968981789114,-1.3365135653911628
176,1556874000,344,705,361,1049,18,1.939771154450214,0.4559501143362585
176,1556888400,472,812,340,1284,18,1.78596110152719,0.8938180610472191
176,1556902800,817,718,0,1535,18,-0.7042968981789114,1.3614982934916917
176,1556917200,988,644,0,1632,18,-0.7042968981789114,1.5422352757511095
176,1556931600,309,195,0,504,18,-0.7042968981789114,-0.559530868461501
176,1556946000,41,38,0,79,18,-0.7042968981789114,-1.351419708257919
176,1556960400,83,207,124,290,18,0.20391484289037262,-0.9582701901472268
176,1556974800,280,398,118,678,18,0.15996911348379436,-0.23532226110955579
176,1556989200,398,399,1,797,18,-0.6969726099444816,-0.013593385966558756
176,1557003600,359,401,42,760,18,-0.39667679233286357,-0.08253429672530573
176,1557018000,235,170,0,405,18,-0.7042968981789114,-0.7439943864376078
176,1557032400,64,30,0,94,18,-0.7042968981789114,-1.3234706903827513
176,1557046800,58,140,82,198,18,-0.10370526295567518,-1.129690833114922
176,1557061200,211,323,112,534,18,0.1160233840772161,-0.5036328327111657
176,1557075600,309,436,127,745,18,0.22588770759366175,-0.11048331460047342
176,1557090000,261,304,43,565,18,-0.38935250409843386,-0.44587152910248573
176,1557104400,152,101,0,253,18,-0.7042968981789114,-1.0272111009059737
176,1557118800,23,36,13,59,18,-0.6090811511313251,-1.3886850654248093
176,1557133200,330,625,295,955,18,1.456368130977853,0.28080293565187425
176,1557147600,447,803,356,1250,18,1.9031497132780655,0.8304669538635056
176,1557162000,756,605,0,1361,18,-0.7042968981789114,1.0372896861397465
176,1557176400,924,547,0,1471,18,-0.7042968981789114,1.242249150557643
176,1557190800,280,120,0,400,19,-0.6663806845820456,-0.7939921399071325
176,1557205200,34,41,7,75,19,-0.6150400343548125,-1.405996923335466
176,1557219600,358,708,350,1066,19,1.9006518267796078,0.46014689321062185
176,1557234000,476,753,277,1229,19,1.3652421886956059,0.7670908307454476
176,1557248400,802,592,0,1394,19,-0.6663806845820456,1.0778009515629092
176,1557262800,992,562,0,1554,19,-0.6663806845820456,1.3790956141737811
176,1557277200,310,185,0,495,19,-0.6663806845820456,-0.6150984339819273
176,1557291600,43,21,0,64,19,-0.6663806845820456,-1.4267109313899635
176,1557306000,342,707,365,1049,19,2.010667505837964,0.4281343353082167
176,1557320400,445,852,407,1297,19,2.318711407201363,0.8951410623550682
176,1557334800,856,658,0,1514,19,-0.6663806845820456,1.3037719485210633
176,1557349200,994,581,0,1575,19,-0.6663806845820456,1.418640538641458
176,1557363600,643,452,0,1095,19,-0.6663806845820456,0.5147565508088424
176,1557378000,45,46,1,91,19,-0.6590463059781552,-1.3758674570743787
176,1557392400,351,685,334,1036,19,1.783301769117361,0.40365414397108335
176,1557406800,482,816,334,1298,19,1.783301769117361,0.8970241539963861
176,1557421200,876,707,0,1583,19,-0.6663806845820456,1.4337052717720016
176,1557435600,1003,566,0,1569,19,-0.6663806845820456,1.4073419887935503
176,1557450000,407,159,0,566,19,-0.6663806845820456,-0.4813989274483529
176,1557464400,59,29,0,88,19,-0.6663806845820456,-1.3815167319983326
176,1557478800,319,590,271,909,19,1.3212359170722632,0.1645015055237038
176,1557493200,486,740,254,1226,19,1.1965514808061257,0.7614415558214938
176,1557507600,812,546,0,1358,19,-0.6663806845820456,1.0100096524754631
176,1557522000,904,515,0,1419,19,-0.6663806845820456,1.124878242595858
176,1557536400,312,152,0,464,19,-0.6663806845820456,-0.6734742748627837
176,1557550800,59,37,0,96,19,-0.6663806845820456,-1.366451998867789
176,1557565200,110,216,106,326,19,0.1110634474303409,-0.9333409213646607
176,1557579600,277,350,73,627,19,-0.1309710464980436,-0.3665303373279579
176,1557594000,373,434,61,807,19,-0.21898358974472884,-0.027573841890727056
176,1557608400,307,311,4,618,19,-0.6370431701664838,-0.3834781620998195
176,1557622800,195,144,0,339,19,-0.6663806845820456,-0.9088607300275273
176,1557637200,48,31,0,79,19,-0.6663806845820456,-1.3984645567701943
176,1557651600,56,112,56,168,19,-0.25565548276418104,-1.2308694006928966
176,1557666000,183,314,131,497,19,0.29442291252760183,-0.6113322506992913
176,1557680400,258,346,88,604,19,-0.020955367439686998,-0.4098414450782708
176,1557694800,209,232,23,441,19,-0.4976899766925655,-0.7167853826130965
176,1557709200,155,80,0,235,19,-0.6663806845820456,-1.1047022607245942
176,1557723600,18,37,19,55,19,-0.5270274911081273,-1.443658756161825
176,1557738000,337,617,280,954,19,1.3872453245072771,0.2492406293830115
176,1557752400,436,811,375,1247,19,2.0840112918768687,0.8009864802891706
176,1557766800,752,621,0,1373,19,-0.6663806845820456,1.0382560270952323
176,1557781200,1083,546,0,1629,19,-0.6663806845820456,1.5203274872726273
176,1557795600,259,152,0,411,20,-0.7058494377695542,-0.8130487357905135
176,1557810000,37,35,0,72,20,-0.7058494377695542,-1.4691092571951796
176,1557824400,351,712,361,1063,20,1.9497558166875129,0.44875498089338695
176,1557838800,460,784,324,1244,20,1.6775746687237691,0.7990409819973532
176,1557853200,783,646,0,1429,20,-0.7058494377695542,1.1570681101975397
176,1557867600,1099,617,0,1716,20,-0.7058494377695542,1.7124939793513425
176,1557882000,299,164,0,463,20,-0.7058494377695542,-0.7124140835396503
176,1557896400,33,31,0,64,20,-0.7058494377695542,-1.48459151138762
176,1557910800,371,697,326,1068,20,1.6922871632082959,0.45843138976366227
176,1557925200,486,830,344,1316,20,1.824699613569036,0.9383812697293177
176,1557939600,807,667,0,1474,20,-0.7058494377695542,1.2441557900300175
176,1557954000,978,482,0,1460,20,-0.7058494377695542,1.2170618451932467
176,1557968400,314,197,0,511,20,-0.7058494377695542,-0.6195205583850073
176,1557982800,47,37,0,84,20,-0.7058494377695542,-1.445885875906519
176,1557997200,348,700,352,1048,20,1.8835495915071427,0.41972575428256104
176,1558011600,465,790,325,1255,20,1.6849309159660326,0.8203290815119589
176,1558026000,840,679,0,1519,20,-0.7058494377695542,1.3312434698624953
176,1558040400,1013,508,0,1521,20,-0.7058494377695542,1.3351140334106053
176,1558054800,330,197,0,527,20,-0.7058494377695542,-0.5885560500001263
176,1558069200,41,51,10,92,20,-0.6322869653469207,-1.4304036217140783
176,1558083600,287,637,350,924,20,1.8688370970226162,0.17975081429973333
176,1558098000,480,733,253,1213,20,1.1552811145230717,0.7390472470016463
176,1558112400,794,510,0,1304,20,-0.7058494377695542,0.9151578884406569
176,1558126800,977,515,0,1492,20,-0.7058494377695542,1.2789908619630086
176,1558141200,330,205,0,535,20,-0.7058494377695542,-0.5730737958076858
176,1558155600,63,31,0,94,20,-0.7058494377695542,-1.4265330581659683
176,1558170000,92,217,125,309,20,0.21368146751336384,-1.0104474767441298
176,1558184400,305,433,128,738,20,0.23575020924015386,-0.18021159567450823
176,1558198800,410,489,79,899,20,-0.12470590563075,0.13136876994835678
176,1558213200,355,427,72,782,20,-0.1761996363265934,-0.0950591976160855
176,1558227600,265,243,0,508,20,-0.7058494377695542,-0.6253264037071725
176,1558242000,58,53,0,111,20,-0.7058494377695542,-1.3936332680070322
176,1558256400,72,157,85,229,20,-0.08056842217716993,-1.1652700186685347
176,1558270800,236,321,85,557,20,-0.08056842217716993,-0.5304975967784745
176,1558285200,341,420,79,761,20,-0.12470590563075,-0.1357001148712418
176,1558299600,286,359,73,645,20,-0.16884338908433005,-0.360192800661629
176,1558314000,178,126,0,304,20,-0.7058494377695542,-1.0201238856144053
176,1558328400,25,24,0,49,20,-0.7058494377695542,-1.513620737998446
176,1558342800,302,641,339,943,20,1.7879183773577194,0.2165211680067795
176,1558357200,425,745,320,1170,20,1.6481496797547157,0.6558301307172786
176,1558371600,725,623,0,1348,20,-0.7058494377695542,1.0003102864990796
176,1558386000,1116,539,0,1655,20,-0.7058494377695542,1.5944417911339837
176,1558400400,310,113,0,423,21,-0.6936144676291282,-0.5652570780274576
176,1558414800,42,42,0,84,21,-0.6936144676291282,-1.2860446750031664
176,1558429200,342,630,288,972,21,2.054048814146663,0.6020361099951506
176,1558443600,487,800,313,1287,21,2.2925612518008114,1.2717944965654995
176,1558458000,780,674,0,1454,21,-0.6936144676291282,1.6268727523027957
176,1558472400,1003,522,0,1525,21,-0.6936144676291282,1.777834166418652
176,1558486800,319,147,0,466,21,-0.6936144676291282,-0.47382974271785444
176,1558501200,36,41,5,77,21,-0.6459119800982984,-1.3009281947047298
176,1558515600,364,640,276,1004,21,1.9395628440726718,0.6700750572022971
176,1558527082,332,595,263,927,21,1.8155363764925143,0.5063563404851007
176,1558527439,416,418,2,834,21,-0.6745334726167963,0.30861815016433103
176,1558527535,336,625,289,961,21,2.0635893116528288,0.578647721892694
176,1558527812,374,560,186,934,21,1.0809180685177369,0.521239860186664
176,1558529133,49,38,0,87,21,-0.6936144676291282,-1.2796660237024966
176,1558530000,106,126,20,232,21,-0.5028045175058093,-0.9713645441701136
176,1558544400,805,635,0,1440,21,-0.6936144676291282,1.597105712899669
176,1558558800,980,598,0,1578,21,-0.6936144676291282,1.8905236727304886
176,1558573200,310,137,0,447,21,-0.6936144676291282,-0.5142278676220977
176,1558587600,43,47,4,90,21,-0.6554524776044643,-1.2732873724018265
176,1558602000,331,619,288,950,21,2.054048814146663,0.5552593337902373
176,1558616400,491,684,193,1175,21,1.1477015510608986,1.0336581813404866
176,1558630800,754,633,0,1387,21,-0.6936144676291282,1.4844162065878326
176,1558645200,949,504,0,1453,21,-0.6936144676291282,1.6247465352025723
176,1558659600,287,144,0,431,21,-0.6936144676291282,-0.548247341225671
176,1558674000,44,40,0,84,21,-0.6936144676291282,-1.2860446750031664
176,1558688400,290,617,327,907,21,2.4261282168871348,0.4638319984806341
176,1558702800,489,625,136,1114,21,0.6038931932094399,0.9039589382268635
176,1558717200,870,670,0,1540,21,-0.6936144676291282,1.809727422922002
176,1558731600,634,491,0,1125,21,-0.6936144676291282,0.92734732632932
176,1558746000,291,175,0,466,21,-0.6936144676291282,-0.47382974271785444
176,1558760400,46,27,0,73,21,-0.6936144676291282,-1.3094330631056232
176,1558774800,93,189,96,282,21,0.2222732929628022,-0.8650536891589472
176,1558789200,227,368,141,595,21,0.6515956807402695,-0.19954773678904483
176,1558803600,335,365,30,700,21,-0.40739954244414994,0.023705058734404812
176,1558818000,302,359,57,661,21,-0.1498061097776695,-0.05921740817430506
176,1558832400,217,147,0,364,21,-0.6936144676291282,-0.6907038869406341
176,1558846800,51,22,0,73,21,-0.6936144676291282,-1.3094330631056232
176,1558861200,65,143,78,208,21,0.050544337851815266,-1.0223937545754735
176,1558875600,205,283,78,488,21,0.050544337851815266,-0.42705296651294117
176,1558890000,263,293,30,556,21,-0.40739954244414994,-0.2824702036977547
176,1558904400,258,293,35,551,21,-0.3596970549133202,-0.29310128919887135
176,1558918800,200,131,0,331,21,-0.6936144676291282,-0.760869051248004
176,1558933200,31,25,0,56,21,-0.6936144676291282,-1.3455787538094197
176,1558947600,66,153,87,219,21,0.13640881540730873,-0.999005366473017
176,1558962000,172,303,131,475,21,0.5561907056786102,-0.45469378881584444
176,1558976400,343,379,36,722,21,-0.3501565574071543,0.07048183493931807
176,1558990800,270,298,28,568,21,-0.4264805374564818,-0.25695559849507477
176,1559005200,190,98,0,288,22,-0.6690192311679238,-0.9894678915677678
176,1559019600,25,31,6,56,22,-0.6209733929649267,-1.4245676314222888
176,1559034000,336,596,260,932,22,1.4129670909619503,0.21830897251116108
176,1559048400,438,758,320,1196,22,1.893425472991921,0.7134224695869953
176,1559062800,734,691,0,1425,22,-0.6690192311679238,1.142895919702018
176,1559077200,1005,556,0,1561,22,-0.6690192311679238,1.3979543878925995
176,1559091600,297,121,0,418,22,-0.6690192311679238,-0.7456620028561828
176,1559106000,49,26,0,75,22,-0.6690192311679238,-1.388934463072134
176,1559120400,345,614,269,959,22,1.4850358482664459,0.2689455801666441
176,1559134800,466,756,290,1222,22,1.6531962819769357,0.7621836473293123
176,1559149200,833,690,0,1523,22,-0.6690192311679238,1.32668805119229
176,1559163600,1226,583,0,1809,22,-0.6690192311679238,1.863061006357777
176,1559178000,349,132,0,481,22,-0.6690192311679238,-0.6275099183267224
176,1559192400,20,42,22,62,22,-0.49285115775693444,-1.4133150519432927
176,1559206800,341,621,280,962,22,1.5731198849719406,0.27457186990614224
176,1559221200,443,750,307,1193,22,1.7893261568854275,0.7077961798474972
176,1559235600,819,558,0,1377,22,-0.6690192311679238,1.0528752838700484
176,1559250000,1174,670,0,1844,22,-0.6690192311679238,1.9287010533185884
176,1559264400,329,141,0,470,22,-0.6690192311679238,-0.6481396473715488
176,1559278800,44,40,0,84,22,-0.6690192311679238,-1.3720555938536398
176,1559293200,302,674,372,976,22,2.309822737417896,0.3008278886904668
176,1559307600,513,810,297,1323,22,1.7092497598804324,0.9516020685590822
176,1559322000,832,685,0,1517,22,-0.6690192311679238,1.3154354717132937
176,1559336400,788,542,0,1330,22,-0.6690192311679238,0.9647300779512444
176,1559350800,285,245,0,530,22,-0.6690192311679238,-0.5356138525815864
176,1559365200,57,36,0,93,22,-0.6690192311679238,-1.3551767246351454
176,1559379600,101,225,124,326,22,0.3239280916940161,-0.9182015548674584
176,1559394000,326,376,50,702,22,-0.26863724614294804,-0.21303990751702784
176,1559408400,470,349,0,819,22,-0.6690192311679238,0.006385392323398696
176,1559422800,365,375,10,740,22,-0.5889428341629287,-0.14177357081671835
176,1559437200,235,224,0,459,22,-0.6690192311679238,-0.6687693764163752
176,1559451600,45,42,0,87,22,-0.6690192311679238,-1.3664293041141415
176,1559466000,68,138,70,206,22,-0.10848445213295774,-1.143253144447383
176,1559480400,246,356,110,602,22,0.21182113588702287,-0.4005828988336317
176,1559494800,343,394,51,737,22,-0.26062960644244854,-0.14739986055621648
176,1559509200,267,306,39,573,22,-0.35672128284844273,-0.45497036631544685
176,1559523600,171,136,0,307,22,-0.6690192311679238,-0.9538347232176131
176,1559538000,20,54,34,74,22,-0.3967594813509403,-1.3908098929853001
176,1559552400,317,578,261,895,22,1.4209747306624498,0.14891806572401764
176,1559566800,418,755,337,1173,22,2.0295553479004127,0.6702875815841765
176,1559581200,688,628,0,1316,22,-0.6690192311679238,0.93847405916692
176,1559595600,1030,503,0,1533,22,-0.6690192311679238,1.3454423503239503
176,1559610000,259,150,0,409,23,-0.6679014636460623,-0.7349347753122706
176,1559624400,28,28,0,56,23,-0.6679014636460623,-1.3772824130402506
176,1559638800,311,680,369,991,23,2.1805126485131767,0.32411997017692007
176,1559653200,466,806,340,1272,23,1.9566535448475453,0.8354505259887115
176,1559667600,726,584,0,1310,23,-0.6679014636460623,0.9045984303333665
176,1559682000,1010,520,0,1530,23,-0.6679014636460623,1.3049284028550538
176,1559696400,335,160,0,495,23,-0.6679014636460623,-0.5784421496901565
176,1559710800,39,30,0,69,23,-0.6679014636460623,-1.3536265510276053
176,1559725200,364,674,310,1038,23,1.7250751617451683,0.4096450097610987
176,1559739600,453,815,362,1268,23,2.126477692455955,0.8281717992155899
176,1559754000,741,455,0,1196,23,-0.6679014636460623,0.6971547172994014
176,1559768400,1292,1218,0,2510,23,-0.6679014636460623,3.0882164622698425
176,1559782800,276,177,0,453,23,-0.6679014636460623,-0.6548687808079332
176,1559797200,40,28,0,68,23,-0.6679014636460623,-1.3554462327208858
176,1559811600,345,625,280,970,23,1.493496778642791,0.2859066546180318
176,1559826000,488,795,307,1283,23,1.7019173234349305,0.8554670246147958
176,1559840400,780,615,0,1395,23,-0.6679014636460623,1.0592713742622002
176,1559854800,1080,498,0,1578,23,-0.6679014636460623,1.3922731241325128
176,1559869200,365,156,0,521,23,-0.6679014636460623,-0.5311304256648662
176,1559883600,49,28,0,77,23,-0.6679014636460623,-1.3390690974813622
176,1559898000,294,626,332,920,23,1.8948993093535782,0.19492256995401194
176,1559912400,449,738,289,1187,23,1.5629702935735041,0.6807775820598778
176,1559926800,837,579,0,1416,23,-0.6679014636460623,1.0974846898210886
176,1559941200,803,468,0,1271,23,-0.6679014636460623,0.8336308442954311
176,1559955600,342,184,0,526,23,-0.6679014636460623,-0.5220320171984643
176,1559970000,65,31,0,96,23,-0.6679014636460623,-1.3044951453090348
176,1559984400,83,200,117,283,23,0.23525423045320856,-0.9642146686656006
176,1559998800,250,388,138,638,23,0.39735909862487256,-0.31822766755105986
176,1560013200,374,400,26,774,23,-0.4672001982906688,-0.07075095726492593
176,1560027600,387,365,0,752,23,-0.6679014636460623,-0.11078395451709466
176,1560042000,244,161,0,405,23,-0.6679014636460623,-0.7422135020853922
176,1560056400,66,45,0,111,23,-0.6679014636460623,-1.2771999199098287
176,1560070800,64,118,54,182,23,-0.25106037406178344,-1.1480025196869206
176,1560085200,199,316,117,515,23,0.23525423045320856,-0.5420485158245486
176,1560099600,328,416,88,744,23,0.01139512678757733,-0.12534140806333782
176,1560114000,297,306,9,603,23,-0.5984279487153491,-0.38191652681587374
176,1560128400,188,93,0,281,23,-0.6679014636460623,-0.9678540320521614
176,1560142800,27,47,20,74,23,-0.5135158749111441,-1.3445281425612035
176,1560157200,318,591,273,909,23,1.4394618225855698,0.17490607132792757
176,1560171600,462,665,203,1127,23,0.8991122620133564,0.571596680463054
176,1560186000,748,571,0,1319,23,-0.6679014636460623,0.9209755655728901
176,1560200400,1046,473,0,1519,23,-0.6679014636460623,1.2849119042289694
176,1560214800,268,113,0,381,24,-0.7001022451615757,-1.0824282153888836
176,1560229200,33,36,3,69,24,-0.6792382709680188,-1.6805996158930872
176,1560243600,358,615,257,973,24,1.0872448774197978,0.052563672747297736
176,1560258000,466,777,311,1243,24,1.462796412903822,0.5702120001067047
176,1560272400,814,533,0,1347,24,-0.7001022451615757,0.7696024669414393
176,1560286800,999,538,0,1537,24,-0.7001022451615757,1.1338735121202812
176,1560301200,303,183,0,486,24,-0.7001022451615757,-0.8811205325268919
176,1560315600,39,38,0,77,24,-0.7001022451615757,-1.6652618876750307
176,1560330000,356,631,275,987,24,1.2124287225811392,0.07940469712889661
176,1560344400,490,756,266,1246,24,1.1498368000004686,0.5759636481884759
176,1560358800,836,693,0,1529,24,-0.7001022451615757,1.1185357839022247
176,1560373200,1027,531,0,1558,24,-0.7001022451615757,1.1741350486926796
176,1560387600,311,147,0,458,24,-0.7001022451615757,-0.9348025812900896
176,1560402000,43,43,0,86,24,-0.7001022451615757,-1.648006943429717
176,1560416400,360,633,273,993,24,1.1985194064521012,0.090907993292439
176,1560430800,502,846,344,1348,24,1.6923001290329478,0.7715196829686963
176,1560445200,793,566,0,1359,24,-0.7001022451615757,0.7926090592685241
176,1560459600,992,550,0,1542,24,-0.7001022451615757,1.1434595922565665
176,1560474000,312,147,0,459,24,-0.7001022451615757,-0.9328853652628326
176,1560488400,41,41,0,82,24,-0.7001022451615757,-1.6556758075387454
176,1560502800,317,687,370,1004,24,1.8731212387104408,0.1119973695922667
176,1560517200,467,784,317,1251,24,1.5045243612909356,0.5855497283247613
176,1560531600,847,570,0,1417,24,-0.7001022451615757,0.9038075888494337
176,1560546000,730,532,0,1262,24,-0.7001022451615757,0.6066391046245889
176,1561165200,9903,8847,0,18750,25,-0.8356623906559392,4.103647572489389
176,1561179600,58,48,0,106,25,-0.8356623906559392,-0.3727969417766427
176,1561194000,102,233,131,335,25,0.5668229596406477,-0.3178137947177003
176,1561208400,314,469,155,783,25,0.8237668406110148,-0.2102485113884157
176,1561222800,386,469,83,855,25,0.05293519769991357,-0.19296123371049495
176,1561237200,350,492,142,842,25,0.6845889050853993,-0.1960825477356751
176,1561251600,260,246,0,506,25,-0.8356623906559392,-0.27675651023263853
176,1561266000,48,54,6,102,25,-0.7714264204133474,-0.3737573460920827
176,1561280400,79,141,62,220,25,-0.1718906981491576,-0.3454254187866015
176,1561294800,237,331,94,568,25,0.17070114314466514,-0.26187024334331793
176,1561309200,374,449,75,823,25,-0.03271276262354212,-0.20064446823401527
176,1561323600,281,329,48,610,25,-0.32177462871520507,-0.2517859980311975
176,1561338000,218,153,0,371,25,-0.8356623906559392,-0.3091701558787399
176,1561352400,27,40,13,67,25,-0.6964844551303238,-0.38216088385218305
176,1561366800,319,622,303,941,25,2.408254106594945,-0.17231254092853407
176,1561381200,465,758,293,1223,25,2.3011941561906255,-0.10460403669001117
176,1561395600,662,624,0,1286,25,-0.8356623906559392,-0.08947766872183052
176,1561410000,973,495,0,1468,25,-0.8356623906559392,-0.04577927236930865
176,1561424400,317,190,0,507,26,-0.631488785587777,-0.5903853389378956
176,1561438800,40,33,0,73,26,-0.631488785587777,-1.4393949354706208
176,1561453200,329,634,305,963,26,1.80934632460461,0.3016616104144607
176,1561467600,508,742,234,1250,26,1.2411519219040872,0.8631034403796498
176,1561482000,720,638,0,1358,26,-0.631488785587777,1.0743777178578395
176,1561496400,1047,510,0,1557,26,-0.631488785587777,1.4636701365445037
176,1561510800,444,195,0,639,26,-0.631488785587777,-0.3321612220201083
176,1561525200,45,25,0,70,26,-0.631488785587777,-1.4452636654005704
176,1561539600,316,589,273,905,26,1.5532587064860646,0.1881994984354329
176,1561554000,496,822,326,1318,26,1.9774038239949054,0.99612798545851
176,1561568400,712,604,0,1316,26,-0.631488785587777,0.9922154988385435
176,1561582800,1028,525,0,1553,26,-0.631488785587777,1.4558451633045708
176,1561597200,417,240,0,657,26,-0.631488785587777,-0.29694884244041
176,1561611600,33,21,0,54,26,-0.631488785587777,-1.4765635583603023
176,1561626000,341,587,246,928,26,1.3371847786985416,0.23319309456504736
176,1561640400,506,787,281,1293,26,1.6172806110157008,0.947221902708929
176,1561654800,776,616,0,1392,26,-0.631488785587777,1.1408899903972696
176,1561669200,1124,500,0,1624,26,-0.631488785587777,1.5947384383133807
176,1561683600,397,222,0,619,26,-0.631488785587777,-0.37128608821977305
176,1561698000,57,34,0,91,26,-0.631488785587777,-1.4041825558909224
176,1561711465,241,243,2,484,26,-0.6154833094553679,-0.6353789350675101
176,1561712400,304,623,319,927,26,1.9213846575314737,0.23123685125506413
176,1561726800,491,785,294,1276,26,1.72131620587636,0.913965766439214
176,1561741200,1240,625,0,1865,26,-0.631488785587777,2.0661930760193408
176,1561755600,877,518,0,1395,26,-0.631488785587777,1.1467587203272194
176,1561770000,359,173,0,532,26,-0.631488785587777,-0.5414792561883147
176,1561784400,60,40,0,100,26,-0.631488785587777,-1.3865763661010733
176,1561797314,69,39,0,108,26,-0.631488785587777,-1.3709264196212074
176,1561798800,96,173,77,269,26,-0.015277954490026842,-1.0559712467139062
176,1561813200,262,347,85,609,26,0.04874395003960954,-0.3908485213196054
176,1561827600,396,360,0,756,26,-0.631488785587777,-0.10328075475206948
176,1561842000,286,309,23,595,26,-0.4474258100650724,-0.41823592765937073
176,1561856400,236,158,0,394,26,-0.631488785587777,-0.8114408329660014
176,1561870800,63,38,0,101,26,-0.631488785587777,-1.3846201227910901
176,1561885200,72,145,73,217,26,-0.04728890675484503,-1.1576958988330346
176,1561899600,253,496,243,749,26,1.313176564499928,-0.11697445792195214
176,1561914000,479,496,17,975,26,-0.4954422384622997,0.3251365301342595
176,1561928400,488,340,0,828,26,-0.631488785587777,0.03756876356672362
176,1561942800,245,141,0,386,26,-0.631488785587777,-0.8270907794458674
176,1561957200,39,43,4,82,26,-0.5994778333229588,-1.4217887456807716
176,1561971600,282,648,366,930,26,2.2975133466430875,0.23710558118501385
176,1561986000,422,726,304,1148,26,1.8013435865384055,0.6635666227613596
176,1562000400,697,561,0,1258,26,-0.631488785587777,0.8787533868595158
176,1562014800,943,493,0,1436,26,-0.631488785587777,1.2269646960365321
176,1562029200,338,142,0,480,27,-0.5906729125878253,-0.35282538502379596
176,1562043600,56,27,0,83,27,-0.5906729125878253,-1.2892724959211537
176,1562058000,292,614,322,906,27,2.3364305427465077,0.6520271823370967
176,1562063356,184,300,116,484,27,0.4638115620046672,-0.3433901496495153
176,1562072400,530,643,113,1173,27,0.436540411799689,1.2818291435703322
176,1562086800,745,599,0,1344,27,-0.5906729125878253,1.6851854558208315
176,1562101200,968,601,0,1569,27,-0.5906729125878253,2.21591744562412
176,1562115600,394,161,0,555,27,-0.5906729125878253,-0.17591472175603318
176,1562130000,50,26,0,76,27,-0.5906729125878253,-1.3057841578261449
176,1562143401,195,466,271,661,27,1.8728209892618772,0.0741190156624049
176,1562144400,257,575,318,832,27,2.30006900913987,0.4774753279129041
176,1562158800,423,717,294,1140,27,2.0818998075000437,1.2039884517325166
176,1562173200,855,708,0,1563,27,-0.5906729125878253,2.2017645925626987
176,1562187600,690,479,0,1169,27,-0.5906729125878253,1.2723939081960516
176,1562202000,333,143,0,476,27,-0.5906729125878253,-0.36226062039807666
176,1562216400,52,29,0,81,27,-0.5906729125878253,-1.293990113608294
176,1562230800,117,172,55,289,27,-0.09070182549655728,-0.8033578741456986
176,1562245200,232,265,33,497,27,-0.2906902603330645,-0.31272563468310305
176,1562259600,262,306,44,568,27,-0.19069604291481088,-0.14525020678962097
176,1562274000,409,264,0,673,27,-0.5906729125878253,0.10242472178524695
176,1562288400,237,264,27,501,27,-0.345232560743021,-0.3032903993088224
176,1562302800,27,30,3,57,27,-0.563401762382847,-1.350601525853978
176,1562313283,32,193,161,225,27,0.8728788150793411,-0.9543216401341895
176,1562317200,162,471,309,633,27,2.2182555585249353,0.008072368042440128
176,1562331600,286,496,210,782,27,1.3183076017606528,0.3595348857343955
176,1562346000,555,572,17,1127,27,-0.4361363947596152,1.1733239367661044
176,1562360400,476,470,0,946,27,-0.5906729125878253,0.7463795360799035
176,1562374800,312,154,0,466,27,-0.5906729125878253,-0.38584870883377836
176,1562389200,70,37,0,107,27,-0.5906729125878253,-1.2326610836754697
176,1562403600,131,133,2,264,27,-0.5724921457845065,-0.8623280952349528
176,1562418000,183,225,42,408,27,-0.20887680971812972,-0.5226596217608482
176,1562432400,336,292,0,628,27,-0.5906729125878253,-0.0037216761754107256
176,1562446800,321,224,0,545,27,-0.5906729125878253,-0.19950281019173488
176,1562461200,205,137,0,342,27,-0.5906729125878253,-0.6783410054364795
176,1562475600,54,28,0,82,27,-0.5906729125878253,-1.2916313047647239
176,1562490000,83,92,9,175,27,-0.5088594619728906,-1.072262082312698
176,1562504400,189,183,0,372,27,-0.5906729125878253,-0.6075767401293743
176,1562518800,296,258,0,554,27,-0.5906729125878253,-0.17827353059960335
176,1562533200,273,229,0,502,27,-0.5906729125878253,-0.3009315904652522
176,1562547600,187,113,0,300,27,-0.5906729125878253,-0.7774109768664267
176,1562562000,37,28,0,65,27,-0.5906729125878253,-1.3317310551054167
176,1562576400,303,559,256,862,27,1.7364652382369858,0.5482395932200091
176,1562590800,405,727,322,1132,27,2.3364305427465077,1.1851179809839552
176,1562605200,627,617,0,1244,27,-0.5906729125878253,1.4493045714638144
176,1562619600,894,499,0,1393,27,-0.5906729125878253,1.8007670891557697
176,1562634000,277,120,0,397,28,-0.5558543545850593,-0.766141577561811
176,1562648400,34,28,0,62,28,-0.5558543545850593,-1.4322075684351847
176,1562662800,354,627,273,981,28,1.7342735755882392,0.3950003289159509
176,1562677200,457,727,270,1184,28,1.7091073345973238,0.7986164368183236
176,1562691600,684,556,0,1240,28,-0.5558543545850593,0.9099588114120816
176,1562706000,1018,505,0,1523,28,-0.5558543545850593,1.4726354544483944
176,1562720400,326,117,0,443,28,-0.5558543545850593,-0.6746817698597956
176,1562734800,36,36,0,72,28,-0.5558543545850593,-1.4123250015434423
176,1562749200,335,593,258,928,28,1.6084423706336624,0.28962272438971565
176,1562763600,473,772,299,1245,28,1.9523809975095057,0.9199000948579529
176,1562778000,719,644,0,1363,28,-0.5558543545850593,1.1545143841805143
176,1562792400,1042,561,0,1603,28,-0.5558543545850593,1.6316959895823344
176,1562806800,334,143,0,477,28,-0.5558543545850593,-0.6070810424278711
176,1562821200,48,26,0,74,28,-0.5558543545850593,-1.4083484881650938
176,1562835600,334,627,293,961,28,1.902048515527675,0.3552351951324659
176,1562850000,603,766,163,1369,28,0.8115114059213424,1.1664439243155598
176,1562864400,751,611,0,1362,28,-0.5558543545850593,1.15252612749134
176,1562878800,1003,569,0,1572,28,-0.5558543545850593,1.5700600322179326
176,1562893200,294,127,0,421,28,-0.5558543545850593,-0.718423417021629
176,1562907600,47,28,0,75,28,-0.5558543545850593,-1.4063602314759194
176,1562922000,319,556,237,875,28,1.4322786836972548,0.1842451198634804
176,1562936400,459,763,304,1222,28,1.9943247324943647,0.8741701910069452
176,1562950800,825,569,0,1394,28,-0.5558543545850593,1.2161503415449162
176,1562965200,752,460,0,1212,28,-0.5558543545850593,0.8542876241152026
176,1562979600,354,224,0,578,28,-0.5558543545850593,-0.4062671168212718
176,1562994000,63,29,0,92,28,-0.5558543545850593,-1.3725598677599573
176,1563008400,108,137,29,245,28,-0.3125806916728774,-1.068356594316297
176,1563022800,346,313,0,659,28,-0.5558543545850593,-0.24521832499815757
176,1563037200,399,306,0,705,28,-0.5558543545850593,-0.15375851729614207
176,1563051600,384,371,0,755,28,-0.5558543545850593,-0.05434568283742957
176,1563066000,377,269,0,646,28,-0.5558543545850593,-0.2710656619574228
176,1563080400,53,37,0,90,28,-0.5558543545850593,-1.3765363811383058
176,1563094800,81,72,0,153,28,-0.5558543545850593,-1.251276209720328
176,1563109200,238,212,0,450,28,-0.5558543545850593,-0.6607639730355758
176,1563123600,311,248,0,559,28,-0.5558543545850593,-0.4440439939155825
176,1563138000,249,249,0,498,28,-0.5558543545850593,-0.5653276519552118
176,1563152400,198,89,0,287,28,-0.5558543545850593,-0.9848498133709785
176,1563166800,30,29,0,59,28,-0.5558543545850593,-1.4381723385027074
176,1563181200,323,642,319,965,28,2.1201559374489416,0.3631882218891629
176,1563195600,430,768,338,1198,28,2.2795421303914054,0.8264520304667631
176,1563210000,730,585,0,1315,28,-0.5558543545850593,1.0590780631001504
176,1563224400,1047,502,0,1549,28,-0.5558543545850593,1.5243301283669248
176,1563238800,282,177,0,459,29,-0.6714413709908716,-0.6187741916325927
176,1563253200,50,34,0,84,29,-0.6714413709908716,-1.3514229300338358
176,1563267600,332,620,288,952,29,1.486877742351032,0.3444146831189083
176,1563282000,495,745,250,1240,29,1.2020995260073086,0.9070889142110631
176,1563296400,787,673,0,1460,29,-0.6714413709908716,1.3369095074064592
176,1563310800,1033,504,0,1537,29,-0.6714413709908716,1.4873467150248476
176,1563325200,306,174,0,480,29,-0.6714413709908716,-0.5777458622821231
176,1563339600,40,27,0,67,29,-0.6714413709908716,-1.3846363395080257
176,1563354000,340,642,302,982,29,1.5917960325829301,0.4030265821910078
176,1563368400,467,858,391,1325,29,2.2587765919142826,1.0731559615820117
176,1563382800,747,579,0,1326,29,-0.6714413709908716,1.0751096915510816
176,1563397200,1029,615,0,1644,29,-0.6714413709908716,1.6963958217153359
176,1563411600,303,163,0,466,29,-0.6714413709908716,-0.6050980818491029
176,1563426000,26,25,0,51,29,-0.6714413709908716,-1.4158960190131453
176,1563440400,331,608,277,939,29,1.404441942883112,0.3190161935209986
176,1563454800,456,838,382,1294,29,2.191329119622348,1.012590332540842
176,1563469200,724,551,0,1275,29,-0.6714413709908716,0.9754694631285125
176,1563483600,1010,536,0,1546,29,-0.6714413709908716,1.5049302847464776
176,1563498000,317,178,0,495,29,-0.6714413709908716,-0.5484399127460734
176,1563512400,39,38,0,77,29,-0.6714413709908716,-1.3650990398173257
176,1563526800,271,583,312,854,29,1.6667376684628572,0.1529491461500501
176,1563541200,430,735,305,1165,29,1.6142785233469081,0.7605591665308145
176,1563555600,840,637,0,1477,29,-0.6714413709908716,1.3701229168806488
176,1563570000,575,586,11,1161,29,-0.5890055715229517,0.7527442466545345
176,1563584400,298,144,0,442,29,-0.6714413709908716,-0.6519876011067824
176,1563598800,65,33,0,98,29,-0.6714413709908716,-1.324070710466856
176,1563613200,90,163,73,253,29,-0.12436742906740306,-1.021242565261009
176,1563627600,227,344,117,571,29,0.20537576880427666,-0.39995643509675477
176,1563642000,292,398,106,690,29,0.12293996933635673,-0.16746256877742693
176,1563656400,278,377,99,655,29,0.07048082422040768,-0.2358431176948763
176,1563670800,215,140,0,355,29,-0.6714413709908716,-0.8219621084158708
176,1563685200,61,25,0,86,29,-0.6714413709908716,-1.347515470095696
176,1563699600,65,123,58,188,29,-0.23677988288729387,-1.1482350132505579
176,1563714000,174,243,69,417,29,-0.15434408341937395,-0.700830850333532
176,1563728400,296,326,30,622,29,-0.44661646335109007,-0.3003162066741857
176,1563742800,245,236,0,481,29,-0.6714413709908716,-0.5757921323130532
176,1563757200,156,99,0,255,29,-0.6714413709908716,-1.017335105322869
176,1563771600,37,49,12,86,29,-0.581511407934959,-1.347515470095696
176,1563786000,297,613,316,910,29,1.696714322814828,0.26235802441796907
176,1563800400,439,804,365,1243,29,2.0639283386264715,0.912950104118273
176,1563814800,733,616,0,1349,29,-0.6714413709908716,1.1200454808396911
176,1563829200,988,535,0,1523,29,-0.6714413709908716,1.459994495457868
176,1563843600,321,240,0,561,30,-0.706778980180087,-0.48101466573766266
176,1563858000,39,48,9,87,30,-0.6390595327686874,-1.4636811236301783
176,1563872400,330,572,242,902,30,1.1141217168819904,0.22592470586855648
176,1563879438,195,307,112,502,30,0.13595192093955213,-0.6033296889774483
176,1563879526,241,555,314,796,30,1.655877296173187,0.006172291234365193
176,1563886800,411,689,278,1100,30,1.3849995065275886,0.6364056313173289
176,1563901200,736,674,0,1410,30,-0.706778980180087,1.2790777873229826
176,1563915600,977,616,0,1593,30,-0.706778980180087,1.6584616729650299
176,1563930000,365,182,0,547,30,-0.706778980180087,-0.5100385695572728
176,1563944400,55,27,0,82,30,-0.706778980180087,-1.4740468035657535
176,1563958800,336,656,320,992,30,1.7010235944474532,0.4125069447089076
176,1563973200,449,764,315,1213,30,1.663401679218898,0.8706699978613253
176,1563987600,746,614,0,1360,30,-0.706778980180087,1.175420987967232
176,1564002000,968,635,0,1603,30,-0.706778980180087,1.67919303283618
176,1564016400,361,216,0,577,30,-0.706778980180087,-0.4478444899438225
176,1564030800,50,22,0,72,30,-0.706778980180087,-1.4947781634369035
176,1564045200,320,670,350,990,30,1.9267550858187852,0.4083606727346775
176,1564059600,457,820,363,1277,30,2.024572065413029,1.003350701036686
176,1564074000,680,660,0,1340,30,-0.706778980180087,1.1339582682249318
176,1564088400,924,554,0,1478,30,-0.706778980180087,1.4200510344468034
176,1564102800,332,175,0,507,30,-0.706778980180087,-0.5929640090418733
176,1564117200,66,34,0,100,30,-0.706778980180087,-1.4367303557976832
176,1564131600,284,606,322,890,30,1.7160723605388755,0.20104707402317634
176,1564146000,443,704,261,1147,30,1.2570849947505005,0.7338430227117344
176,1564160400,842,635,0,1477,30,-0.706778980180087,1.4179778984596885
176,1564174800,729,586,0,1315,30,-0.706778980180087,1.0821298685470564
176,1564189200,330,211,0,541,30,-0.706778980180087,-0.5224773854799629
176,1564203600,64,44,0,108,30,-0.706778980180087,-1.4201452679007631
176,1564218000,88,190,102,278,30,0.060708090482441496,-1.067712150091211
176,1564232400,241,370,129,611,30,0.26386643271664023,-0.37735786638191204
176,1564246800,366,412,46,778,30,-0.36065736007737803,-0.031144156533705024
176,1564261200,356,366,10,722,30,-0.6315351497229763,-0.1472397718121457
176,1564275600,229,172,0,401,30,-0.706778980180087,-0.8127164236760646
176,1564290000,57,42,0,99,30,-0.706778980180087,-1.4388034917847983
176,1564304400,66,149,83,215,30,-0.08225518738606871,-1.1983197172794569
176,1564318800,226,336,110,562,30,0.12090315484813,-0.47894152975054766
176,1564333200,311,383,72,694,30,-0.1650234008888904,-0.20528757945136605
176,1564347600,288,297,9,585,30,-0.6390595327686874,-0.4312594020469024
176,1564362000,183,118,0,301,30,-0.706778980180087,-1.0200300223875658
176,1564376400,41,39,0,80,30,-0.706778980180087,-1.4781930755399835
176,1564390800,308,681,373,989,30,2.09981589587014,0.4062875367475625
176,1564405200,425,738,313,1163,30,1.648352913127476,0.7670131985055746
176,1564419600,710,582,0,1292,30,-0.706778980180087,1.0344477408434112
176,1564434000,980,576,0,1556,30,-0.706778980180087,1.5817556414417744
176,1564448400,300,136,0,436,31,-0.7053725643263641,-0.9704644177705619
176,1564462800,35,35,0,70,31,-0.7053725643263641,-1.6597075812324487
176,1564477200,320,624,304,944,31,1.335229429854902,-0.01380997230980108
176,1564491600,498,755,257,1253,31,1.0197416215439825,0.5680920427440869
176,1564506000,745,660,0,1405,31,-0.7053725643263641,0.8543351051654169
176,1564520400,979,551,0,1530,31,-0.7053725643263641,1.089732360446116
176,1564534800,322,143,0,465,31,-0.7053725643263641,-0.9158522545454397
176,1564549200,38,37,0,75,31,-0.7053725643263641,-1.6502916910212206
176,1564563600,316,623,307,939,31,1.3553669495343224,-0.023225862521029043
176,1564578000,490,808,318,1298,31,1.4292045216921971,0.6528350546451386
176,1564592400,773,694,0,1467,31,-0.7053725643263641,0.9710921437846437
176,1564606800,1030,721,0,1751,31,-0.7053725643263641,1.5059147077823918
176,1564621200,313,137,0,450,31,-0.7053725643263641,-0.9440999251791237
176,1564635600,35,42,7,77,31,-0.6583850184077165,-1.6465253349367295
176,1564650000,337,690,353,1027,31,1.664142251285435,0.14249380519658308
176,1564664400,486,787,301,1273,31,1.3150919101754814,0.6057556035889987
176,1564678800,801,568,0,1369,31,-0.7053725643263641,0.7865406956445756
176,1564693200,938,559,0,1497,31,-0.7053725643263641,1.0275874850520115
176,1564707600,339,137,0,476,31,-0.7053725643263641,-0.8951372960807382
176,1564722000,40,37,0,77,31,-0.7053725643263641,-1.6465253349367295
176,1564736400,295,652,357,947,31,1.690992277524662,-0.008160438183064304
176,1564750800,445,763,318,1208,31,1.4292045216921971,0.48334903084303527
176,1564765200,868,598,0,1466,31,-0.7053725643263641,0.969208965742398
176,1564779600,751,581,0,1332,31,-0.7053725643263641,0.7168631080814887
176,1565398800,9109,8964,0,18073,32,-0.718621348395696,4.104037949266003
176,1565413200,53,34,0,87,32,-0.718621348395696,-0.37129981446634697
176,1565427600,107,237,130,344,32,0.4833614645034666,-0.307352199361309
176,1565442000,260,365,105,625,32,0.25221092356131997,-0.23743282253439968
176,1565456400,400,392,0,792,32,-0.718621348395696,-0.19587931388637886
176,1565470800,321,358,37,679,32,-0.376518547801319,-0.22399635866018935
176,1565485200,271,166,0,437,32,-0.718621348395696,-0.28421162268905786
176,1565499600,64,38,0,102,32,-0.718621348395696,-0.36756746339017743
176,1565514000,71,154,83,225,32,0.04879844753223091,-0.33696218456558724
176,1565528400,204,301,97,505,32,0.17824275045983304,-0.267291631143756
176,1565542800,321,461,140,782,32,0.5758216808803254,-0.19836754793715855
176,1565557200,254,351,97,605,32,0.17824275045983304,-0.24240929063595906
176,1565571600,219,118,0,337,32,-0.718621348395696,-0.3090939631968547
176,1565586000,37,48,11,85,32,-0.6169151103811515,-0.3717974612765029
176,1565600400,274,635,361,909,32,2.619192462808902,-0.1667669754922565
176,1565614800,408,746,338,1154,32,2.406533965142127,-0.10580524124815412
176,1565629200,706,550,0,1256,32,-0.718621348395696,-0.08042525393020128
176,1565643600,925,504,0,1429,32,-0.718621348395696,-0.03737880485171265
176,1565658000,303,116,0,419,33,-0.6775472011372842,-0.6873162460549116
176,1565672400,40,30,0,70,33,-0.6775472011372842,-1.4055488608503672
176,1565686800,305,586,281,891,33,1.4068503094029947,0.2840470610610056
176,1565701200,427,771,344,1198,33,1.8741707477091782,0.915844805308011
176,1565715600,909,633,0,1542,33,-0.6775472011372842,1.6237875545619844
176,1565730000,957,565,0,1522,33,-0.6775472011372842,1.5826280923960558
176,1565744400,306,140,0,446,33,-0.6775472011372842,-0.6317509721309078
176,1565758800,43,35,0,78,33,-0.6775472011372842,-1.3890850759839959
176,1565772687,222,603,381,825,33,2.148628782904873,0.1482208359134409
176,1565773200,318,565,247,883,33,1.154645628412356,0.2675832761946341
176,1565787600,461,822,361,1283,33,2.0002730882044975,1.0907725195132079
176,1565802000,784,641,0,1425,33,-0.6775472011372842,1.3830047008913018
176,1565816400,924,533,0,1457,33,-0.6775472011372842,1.4488598403567876
176,1565830800,328,146,0,474,33,-0.6775472011372842,-0.5741277250986077
176,1565845200,38,44,6,82,33,-0.6330404927271714,-1.38085318355081
176,1565859600,294,672,378,966,33,2.126375428699817,0.43839504418323816
176,1565874000,443,798,355,1241,33,1.9557663797943847,1.0043376489647577
176,1565888400,799,654,0,1453,33,-0.6775472011372842,1.440627947923602
176,1565902800,898,551,0,1449,33,-0.6775472011372842,1.432396055490416
176,1565917200,343,156,0,499,33,-0.6775472011372842,-0.5226783973911968
176,1565931600,38,26,0,64,33,-0.6775472011372842,-1.4178966995001459
176,1565946000,292,560,268,852,33,1.3104191078477505,0.20378610983744463
176,1565946076,0,5,5,5,33,-0.6404582774621902,-1.5393171128896355
176,1565960400,446,687,241,1133,33,1.1101389200022433,0.7820765532687428
176,1565974800,808,594,0,1402,33,-0.6775472011372842,1.3356713194004837
176,1565989200,668,464,0,1132,33,-0.6775472011372842,0.7800185801604463
176,1566003600,332,193,0,525,33,-0.6775472011372842,-0.4691710965754895
176,1566018000,70,45,0,115,33,-0.6775472011372842,-1.3129400709770276
176,1566032400,80,198,118,278,33,0.19775139759493263,-0.9774904543247088
176,1566046800,241,337,96,578,33,0.03456013342451932,-0.36009852183577845
176,1566061200,364,390,26,754,33,-0.4846847980267957,0.0021047452243940384
176,1566075600,322,383,61,705,33,-0.22506233230113817,-0.09873593708213126
176,1566090000,269,157,0,426,33,-0.6775472011372842,-0.6729104342968365
176,1566104400,61,33,0,94,33,-0.6775472011372842,-1.3561575062512528
176,1566118800,76,160,84,236,33,-0.054453283395706105,-1.063925324873159
176,1566133200,193,313,120,506,33,0.21258696706497018,-0.5082725856331217
176,1566147600,329,338,9,667,33,-0.6107871385221151,-0.17693891519739577
176,1566162000,281,299,18,580,33,-0.544027075906946,-0.3559825756191856
176,1566176400,201,89,0,290,33,-0.6775472011372842,-0.9527947770251516
176,1566190800,32,46,14,78,33,-0.5736982148470211,-1.3890850759839959
176,1566205200,275,599,324,874,33,1.7258150530088026,0.2490615182199662
176,1566219600,407,689,282,1096,33,1.4142680941380135,0.7059315482617747
176,1566234000,654,523,0,1177,33,-0.6775472011372842,0.8726273700337859
176,1566248400,855,506,0,1361,33,-0.6775472011372842,1.25129442196033
176,1566262800,261,126,0,387,34,-0.6527730941595338,-0.7889684740016449
176,1566277200,41,47,6,88,34,-0.60495366981994,-1.410034486445239
176,1566291600,295,636,341,931,34,2.0649641891407113,0.3409977827519175
176,1566306000,430,657,227,1087,34,1.15639512668843,0.6650322240268361
176,1566320400,747,623,0,1370,34,-0.6527730941595338,1.2528639348012078
176,1566334800,948,533,0,1481,34,-0.6527730941595338,1.4834269026314384
176,1566349200,324,144,0,468,34,-0.6527730941595338,-0.6207198218012063
176,1566363600,39,48,9,87,34,-0.5810439576501432,-1.4121116302995653
176,1566378000,313,597,284,910,34,1.6106796579145708,0.29737776181106307
176,1566392400,421,699,278,1120,34,1.5628602335749768,0.7335779712196073
176,1566406800,713,603,0,1316,34,-0.6527730941595338,1.140698166667582
176,1566421200,939,627,0,1566,34,-0.6527730941595338,1.6599841302491825
176,1566435600,304,128,0,432,34,-0.6527730941595338,-0.6954970005569568
176,1566450000,40,47,7,87,34,-0.596983765763341,-1.4121116302995653
176,1566464400,295,649,354,944,34,2.1685729418764974,0.3680006528581607
176,1566478800,430,683,253,1113,34,1.363612632160003,0.7190379642393225
176,1566493200,794,696,0,1490,34,-0.6527730941595338,1.5021211973203759
176,1566507600,845,596,0,1441,34,-0.6527730941595338,1.4003411484583823
176,1566522000,298,169,0,467,34,-0.6527730941595338,-0.6227969656555328
176,1566536400,42,52,10,94,34,-0.5730740535935441,-1.3975716233192805
176,1566550800,267,594,327,861,34,1.953385532348326,0.19559771294906939
176,1566565200,437,731,294,1168,34,1.6903786984805602,0.8332808762272746
176,1566579600,862,607,0,1469,34,-0.6527730941595338,1.4585011763795215
176,1566594000,647,525,0,1172,34,-0.6527730941595338,0.8415894516445802
176,1566608400,335,177,0,512,34,-0.6527730941595338,-0.5293254922108447
176,1566622800,75,45,0,120,34,-0.6527730941595338,-1.343565883106794
176,1566637200,110,223,113,333,34,0.24782606423614864,-0.9011342421352706
176,1566651600,264,366,102,630,34,0.1601571196135601,-0.28422251740032933
176,1566666000,376,417,41,793,34,-0.32600702783897645,0.054351930854874095
176,1566680400,360,349,0,709,34,-0.6527730941595338,-0.12012815290854363
176,1566694800,260,158,0,418,34,-0.6527730941595338,-0.7245770145175264
176,1566709200,53,34,0,87,34,-0.6527730941595338,-1.4121116302995653
176,1566723600,89,137,48,226,34,-0.27021769944278373,-1.1233886345481956
176,1566738000,187,260,73,447,34,-0.07097009802780972,-0.6643398427420608
176,1566752400,307,344,37,651,34,-0.35788664406537224,-0.2406024964594749
176,1566766800,297,266,0,563,34,-0.6527730941595338,-0.42339115564019825
176,1566781200,195,110,0,305,34,-0.6527730941595338,-0.9592942700564098
176,1566795600,31,36,5,67,34,-0.612923573876539,-1.4536545073860934
176,1566810000,283,573,290,856,34,1.6584990822541645,0.18521199367743738
176,1566824400,400,741,341,1141,34,2.0649641891407113,0.7771979921604618
176,1566838800,689,577,0,1266,34,-0.6527730941595338,1.036840973951262
176,1566853200,964,570,0,1534,34,-0.6527730941595338,1.5935155269107375
176,1566867600,277,99,0,376,35,-0.5971053261923652,-0.6709565237679799
176,1566882000,44,37,0,81,35,-0.5971053261923652,-1.31608700099018
176,1566896400,290,696,406,986,35,2.573819626231245,0.6630420901491116
176,1566910800,435,738,303,1173,35,1.769373148153334,1.0719892062187775
176,1566925200,775,591,0,1366,35,-0.5971053261923652,1.4940576201302507
176,1566939600,988,522,0,1510,35,-0.5971053261923652,1.8089687683336297
176,1566954000,288,149,0,437,35,-0.5971053261923652,-0.5375566623762708
176,1566968400,36,36,0,72,35,-0.5971053261923652,-1.3357689477528911
176,1566982800,299,670,371,969,35,2.300464026884382,0.6258650795973238
176,1566997200,417,706,289,1123,35,1.6600309084145888,0.9626450575370487
176,1567011600,766,610,0,1376,35,-0.5971053261923652,1.5159264498665965
176,1567026000,948,541,0,1489,35,-0.5971053261923652,1.7630442258873036
176,1567040400,287,149,0,436,35,-0.5971053261923652,-0.5397435453499053
176,1567054800,45,33,0,78,35,-0.5971053261923652,-1.3226476499110835
176,1567069200,296,608,312,904,35,1.8396645879853843,0.4837176863110764
176,1567083600,400,708,308,1108,35,1.8084239480600286,0.92984181293253
176,1567098000,801,539,0,1340,35,-0.5971053261923652,1.4371986628157516
176,1567112400,885,550,0,1435,35,-0.5971053261923652,1.6449525453110365
176,1567126800,288,181,0,469,35,-0.5971053261923652,-0.46757640721996424
176,1567141200,56,33,0,89,35,-0.5971053261923652,-1.2985919372011032
176,1567155600,248,664,416,912,35,2.6519212260446343,0.501212750100153
176,1567170000,425,618,193,1043,35,0.9102555502060504,0.7876944196462825
176,1567184400,882,573,0,1455,35,-0.5971053261923652,1.688690204783728
176,1567198800,571,448,0,1019,35,-0.5971053261923652,0.7352092282790527
176,1567213200,325,158,0,483,35,-0.5971053261923652,-0.4369600455890802
176,1567227600,75,33,0,108,35,-0.5971053261923652,-1.2570411607020464
176,1567242000,100,203,103,303,35,0.20734115188554572,-0.830598980843304
176,1567256400,225,362,137,587,35,0.47288659125106974,-0.20952421633108426
176,1567270800,351,343,0,694,35,-0.5971053261923652,0.024472261847815403
176,1567285200,351,329,0,680,35,-0.5971053261923652,-0.006144099783068666
176,1567299600,240,166,0,406,35,-0.5971053261923652,-0.6053500345589425
176,1567314000,51,29,0,80,35,-0.5971053261923652,-1.3182738839638144
176,1567328400,66,136,70,202,35,-0.050394127498639335,-1.0514741611803962
176,1567342800,216,224,8,440,35,-0.5346240463416537,-0.530996013455367
176,1567357200,308,363,55,671,35,-0.16754652721872346,-0.025826046545779854
176,1567371600,293,315,22,608,35,-0.42528180660290854,-0.16359967388475816
176,1567386000,199,132,0,331,35,-0.5971053261923652,-0.7693662575815358
176,1567400400,45,31,0,76,35,-0.5971053261923652,-1.3270214158583526
176,1567414800,71,142,71,213,35,-0.04258396751730039,-1.0274184484704159
176,1567429200,211,282,71,493,35,-0.04258396751730039,-0.41509121585273445
176,1567443600,245,321,76,566,35,-0.003533167610605685,-0.25544875877741036
176,1567458000,262,229,0,491,35,-0.5971053261923652,-0.4194649818000036
176,1567472400,182,88,0,270,36,-0.6520528817473247,-0.9959268526782048
176,1567486800,31,33,2,64,36,-0.6358831736071084,-1.4005835226026824
176,1567501200,310,586,276,896,36,1.5793668416025166,0.23375797922821767
176,1567515600,409,704,295,1113,36,1.732979068934571,0.6600225295855559
176,1567530000,764,544,0,1308,36,-0.6520528817473247,1.043071319077173
176,1567544400,1040,561,0,1601,36,-0.6520528817473247,1.6186266796979107
176,1567558800,257,149,0,406,36,-0.6520528817473247,-0.7287748764173846
176,1567573200,39,49,10,88,36,-0.5712043410462434,-1.3534390562037142
176,1567583188,111,96,0,207,36,-0.6520528817473247,-1.1196810769754966
176,1567587600,287,627,340,914,36,2.0967975020894367,0.26911632902744387
176,1567602000,453,712,259,1165,36,1.4419243224106786,0.7621688734499871
176,1567616400,838,605,0,1443,36,-0.6520528817473247,1.3082589425713695
176,1567630800,966,553,0,1519,36,-0.6520528817473247,1.4575497528347692
176,1567645200,312,139,0,451,36,-0.6520528817473247,-0.6403790019193191
176,1567659600,47,44,0,91,36,-0.6520528817473247,-1.347545997903843
176,1567674000,309,599,290,908,36,1.6925547985840304,0.2573302124277018
176,1567688400,449,773,324,1222,36,1.9674398369677064,0.8741369811475367
176,1567702800,806,580,0,1386,36,-0.6520528817473247,1.19629083487382
176,1567717200,974,571,0,1545,36,-0.6520528817473247,1.5086229247669847
176,1567731600,318,184,0,502,36,-0.6520528817473247,-0.5401970108215115
176,1567746000,55,41,0,96,36,-0.6520528817473247,-1.3377242340707247
176,1567760400,311,693,382,1004,36,2.4363613730339777,0.4459080780235749
176,1567774800,463,718,255,1181,36,1.4095849061302461,0.7935985177159659
176,1567789200,826,652,0,1478,36,-0.6520528817473247,1.3770112894031983
176,1567803600,911,609,0,1520,36,-0.6520528817473247,1.4595141056013927
176,1567818000,312,195,0,507,36,-0.6520528817473247,-0.5303752469883931
176,1567832400,91,42,0,133,36,-0.6520528817473247,-1.2650431817056487
176,1567846800,97,207,110,304,36,0.2372810659645686,-0.9291388586129997
176,1567861200,271,352,81,623,36,0.002820297931433113,-0.3025103260600464
176,1567875600,394,411,17,805,36,-0.5146103625554866,0.055001877465462985
176,1567890000,344,422,78,766,36,-0.02143426427889125,-0.02160788043286046
176,1567904400,259,186,0,445,36,-0.6520528817473247,-0.6521651185190611
176,1567918800,56,47,0,103,36,-0.6520528817473247,-1.323973764704359
176,1567933200,90,136,46,226,36,-0.2801495945223511,-1.0823583744096466
176,1567947600,221,297,76,518,36,-0.03760397241910749,-0.5087673665555326
176,1567962000,293,335,42,628,36,-0.3124890108027836,-0.292688562226928
176,1567976400,267,280,13,547,36,-0.5469497788359191,-0.45180113632344593
176,1567990800,186,83,0,269,36,-0.6520528817473247,-0.9978912054448285
176,1568005200,30,43,13,73,36,-0.5469497788359191,-1.3829043477030694
176,1568019600,358,626,268,984,36,1.5146880090416517,0.40662102269110134
176,1568034000,447,738,291,1185,36,1.7006396526541385,0.8014559287824606
176,1568048400,822,613,0,1435,36,-0.6520528817473247,1.29254412043838
176,1568062800,962,520,0,1482,36,-0.6520528817473247,1.384868700469693
176,1568077200,279,151,0,430,37,-0.6260252072466866,-0.7170812590691673
176,1568091600,35,36,1,71,37,-0.6186237544252383,-1.3856958638197552
176,1568106000,356,706,350,1062,37,1.9644832802602241,0.45997843508785674
176,1568120400,505,744,239,1249,37,1.1429220170794612,0.8082540091501408
176,1568134800,812,554,0,1366,37,-0.6260252072466866,1.0261590474671847
176,1568149200,1119,513,0,1632,37,-0.6260252072466866,1.5215670832990968
176,1568163600,318,132,0,450,37,-0.6260252072466866,-0.6798325345705273
176,1568178000,37,29,0,66,37,-0.6260252072466866,-1.3950080449444153
176,1568192400,350,629,279,979,37,1.4389801299373937,0.3053962284185008
176,1568206800,456,720,264,1176,37,1.327958337615669,0.6722961647301048
176,1568221200,844,611,0,1455,37,-0.6260252072466866,1.1919158714861329
176,1568235600,1048,563,0,1611,37,-0.6260252072466866,1.4824559225755247
176,1568250000,287,186,0,473,37,-0.6260252072466866,-0.6369965013970913
176,1568264400,36,36,0,72,37,-0.6260252072466866,-1.3838334275948232
176,1568275687,172,140,0,312,37,-0.6260252072466866,-0.9368487336111433
176,1568278800,312,696,384,1008,37,2.216132676189467,0.3594068789415288
176,1568293200,530,823,293,1353,37,1.5426004694376703,1.0019473765430689
176,1568307600,868,648,0,1516,37,-0.6260252072466866,1.3055244812069848
176,1568322000,1230,649,0,1879,37,-0.6260252072466866,1.9815888308573009
176,1568336400,321,145,0,466,37,-0.6260252072466866,-0.6500335549716153
176,1568350800,48,29,0,77,37,-0.6260252072466866,-1.3745212464701633
176,1568365200,308,725,417,1033,37,2.4603806192972613,0.40596778456482874
176,1568379600,460,803,343,1263,37,1.912673110510086,0.8343281162991888
176,1568394000,866,626,0,1492,37,-0.6260252072466866,1.2608260118086168
176,1568408400,874,609,0,1483,37,-0.6260252072466866,1.2440640857842287
176,1568422800,269,204,0,473,37,-0.6260252072466866,-0.6369965013970913
176,1568437200,48,42,0,90,37,-0.6260252072466866,-1.3503095755460472
176,1568451600,101,201,100,302,37,0.114120074898145,-0.9554730958604633
176,1568466000,306,400,94,706,37,0.0697113579694551,-0.20304886098793526
176,1568480400,441,408,0,849,37,-0.6260252072466866,0.06327951917734076
176,1568494800,367,357,0,724,37,-0.6260252072466866,-0.16952500893915926
176,1568509200,198,169,0,367,37,-0.6260252072466866,-0.8344147412398832
176,1568523600,50,27,0,77,37,-0.6260252072466866,-1.3745212464701633
176,1568538000,67,150,83,217,37,-0.011704623066476376,-1.1137801749796832
176,1568552400,276,333,57,609,37,-0.2041423964241326,-0.38370517480633926
176,1568566800,405,398,0,803,37,-0.6260252072466866,-0.022392547169531245
176,1568581200,255,302,47,557,37,-0.27815692463861574,-0.48055185850280324
176,1568595600,129,106,0,235,37,-0.6260252072466866,-1.0802563229309072
176,1568610000,21,63,42,84,37,-0.31516418874585733,-1.3614841928956394
176,1568624400,336,647,311,983,37,1.67582662022374,0.3128459733182288
176,1568638800,432,765,333,1197,37,1.8386585822956028,0.7114073254536768
176,1568653200,753,544,0,1297,37,-0.6260252072466866,0.8976509479468767
176,1568667600,968,534,0,1502,37,-0.6260252072466866,1.2794503740579368
176,1568682000,269,123,0,392,38,-0.6353631241797546,-0.8147452322907571
176,1568696400,42,37,0,79,38,-0.6353631241797546,-1.4085602139226412
176,1568710800,339,693,354,1032,38,2.0737217425551444,0.3994451454868972
176,1568725200,436,767,331,1203,38,1.8977077540384701,0.7238616370493642
176,1568739600,853,634,0,1487,38,-0.6353631241797546,1.2626586171881984
176,1568754000,982,503,0,1485,38,-0.6353631241797546,1.2588642722576433
176,1568768400,366,159,0,525,38,-0.6353631241797546,-0.5624212944088384
176,1568782800,52,33,0,85,38,-0.6353631241797546,-1.3971771791309757
176,1568797200,340,601,261,941,38,1.3620130063790268,0.226802451146637
176,1568811600,468,788,320,1256,38,1.8135271508348434,0.8244117777090763
176,1568826000,893,652,0,1545,38,-0.6353631241797546,1.3726946201742982
176,1568840400,1016,603,0,1619,38,-0.6353631241797546,1.5130853826048396
176,1568854800,332,176,0,508,38,-0.6353631241797546,-0.5946732263185573
176,1568869200,42,42,0,84,38,-0.6353631241797546,-1.3990743515962534
176,1568883600,328,728,400,1056,38,2.425749719588493,0.44497728465355924
176,1568898000,460,784,324,1244,38,1.8441382792725258,0.8016457081257452
176,1568912400,818,586,0,1404,38,-0.6353631241797546,1.1051933025701588
176,1568926800,953,572,0,1525,38,-0.6353631241797546,1.3347511708687465
176,1568941200,318,180,0,498,38,-0.6353631241797546,-0.6136449509713332
176,1568955600,39,39,0,78,38,-0.6353631241797546,-1.4104573863879188
176,1568970000,311,596,285,907,38,1.5456797770051216,0.1622985873271991
176,1568984400,501,667,166,1168,38,0.634998705984068,0.6574606007646487
176,1568998800,800,671,0,1471,38,-0.6353631241797546,1.232303857743757
176,1569013200,835,588,0,1423,38,-0.6353631241797546,1.1412395794104329
176,1569027600,335,201,0,536,38,-0.6353631241797546,-0.541552397290785
176,1569042000,64,49,0,113,38,-0.6353631241797546,-1.3440563501032035
176,1569056400,95,226,131,321,38,0.36715133215434637,-0.9494444773254657
176,1569070800,275,375,100,650,38,0.1299150867623072,-0.3252747362491403
176,1569085200,391,417,26,808,38,-0.43639078933481856,-0.025521486735281818
176,1569099600,294,311,17,605,38,-0.5052658283196041,-0.41064749718663157
176,1569114000,232,189,0,421,38,-0.6353631241797546,-0.7597272307977072
176,1569128400,63,30,0,93,38,-0.6353631241797546,-1.3819997994087552
176,1569142800,70,136,66,206,38,-0.1302795049579938,-1.167619310832388
176,1569157200,223,290,67,513,38,-0.1226267228485732,-0.5851873639921694
176,1569171600,340,329,0,669,38,-0.6353631241797546,-0.28922845940886616
176,1569186000,275,290,15,565,38,-0.5205713925384454,-0.48653439579773494
176,1569200400,203,110,0,313,38,-0.6353631241797546,-0.9646218570476864
176,1569214800,28,36,8,64,38,-0.5741408673043897,-1.437017800901805
176,1569229200,371,695,324,1066,38,1.8441382792725258,0.4639490093063351
176,1569243600,496,788,292,1284,38,1.599249251771066,0.8775326067368486
176,1569258000,915,635,0,1550,38,-0.6353631241797546,1.3821804825006863
176,1569272400,1124,585,0,1709,38,-0.6353631241797546,1.6838309044798223
176,1569286800,297,143,0,440,39,-0.7203985466583674,-0.7695616940527017
176,1569301200,34,41,7,75,39,-0.6686270549161137,-1.4600727136504728
176,1569315600,387,733,346,1120,39,1.8385923308873173,0.5168697945130085
176,1569330000,498,800,302,1298,39,1.5131715256502938,0.8536121547552091
176,1569344400,909,683,0,1592,39,-0.7203985466583674,1.409804592458619
176,1569358800,1010,584,0,1594,39,-0.7203985466583674,1.4135882144838123
176,1569373200,324,158,0,482,39,-0.7203985466583674,-0.6901056315236431
176,1569387600,37,52,15,89,39,-0.6094596357821095,-1.4335873594741197
176,1569402000,392,748,356,1140,39,1.9125516048048226,0.5547060147649411
176,1569416400,543,850,307,1393,39,1.5501511626090465,1.033334200951889
176,1569430800,920,657,0,1577,39,-0.7203985466583674,1.3814274272696696
176,1569445200,1085,600,0,1685,39,-0.7203985466583674,1.5857430166301059
176,1569459600,345,174,0,519,39,-0.7203985466583674,-0.6201086240575677
176,1569474000,39,36,0,75,39,-0.7203985466583674,-1.4600727136504728
176,1569488400,381,751,370,1132,39,2.01609458828933,0.5395715266641681
176,1569502800,552,776,224,1328,39,0.9362891890937521,0.910366485133108
176,1569517200,870,656,0,1526,39,-0.7203985466583674,1.2849450656272414
176,1569531600,1007,529,0,1536,39,-0.7203985466583674,1.3038631757532078
176,1569546000,363,179,0,542,39,-0.7203985466583674,-0.5765969707678452
176,1569560400,50,32,0,82,39,-0.7203985466583674,-1.4468300365622961
176,1569574800,302,689,387,991,39,2.141825353949089,0.27282617388804287
176,1569589200,501,774,273,1275,39,1.2986896312895284,0.8101005014654865
176,1569603600,865,634,0,1499,39,-0.7203985466583674,1.2338661682871324
176,1569618000,893,608,0,1501,39,-0.7203985466583674,1.2376497903123256
176,1569632400,363,195,0,558,39,-0.7203985466583674,-0.5463279945662991
176,1569646800,67,43,0,110,39,-0.7203985466583674,-1.3938593282095906
176,1569661200,121,239,118,360,39,0.15232088556819556,-0.9209065750604324
176,1569675600,288,479,191,767,39,0.6922235851659846,-0.15093949293360284
176,1569690000,392,443,51,835,39,-0.3432062496790902,-0.022296344077031835
176,1569704400,379,494,115,873,39,0.13013310339294398,0.049592474401640205
176,1569718800,239,222,0,461,39,-0.7203985466583674,-0.7298336627881724
176,1569733200,58,48,0,106,39,-0.7203985466583674,-1.401426572259977
176,1569747600,65,153,88,218,39,-0.06955693618432045,-1.189543738849154
176,1569762000,225,323,98,548,39,0.004402337733184891,-0.5652461046922654
176,1569776400,315,442,127,757,39,0.2188842320939504,-0.16985760305956918
176,1569790800,274,315,41,589,39,-0.41716552359659553,-0.4876818531758035
176,1569805200,175,107,0,282,39,-0.7203985466583674,-1.0684678340429696
176,1569819600,21,32,11,53,39,-0.6390433453491116,-1.5016925559275986
176,1569834000,254,566,312,820,39,1.5871307995677992,-0.050673509265981326
176,1569848400,408,760,352,1168,39,1.8829678952378206,0.6076767231176469
176,1569862800,686,555,0,1241,39,-0.7203985466583674,0.7457789270372011
176,1569877200,831,497,0,1328,39,-0.7203985466583674,0.910366485133108
176,1569891600,241,115,0,356,40,-0.6912073923925331,-0.893727070440056
176,1569906000,28,35,7,63,40,-0.6406941004801779,-1.4575641118034994
176,1569920400,276,695,419,971,40,2.3323739377898676,0.2897534088722913
176,1569934800,423,755,332,1178,40,1.704565881164882,0.6880956189823009
176,1569949200,772,617,0,1389,40,-0.6912073923925331,1.094135263104098
176,1569963600,919,599,0,1518,40,-0.6912073923925331,1.342377509984249
176,1569978000,302,129,0,431,40,-0.6912073923925331,-0.7494001827190381
176,1569992400,34,42,8,76,40,-0.6334779159212701,-1.4325474512651897
176,1570006800,357,681,324,1038,40,1.646836404693619,0.41868542856973395
176,1570021200,446,776,330,1222,40,1.6901335120470664,0.7727673931119647
176,1570035600,805,629,0,1434,40,-0.6912073923925331,1.1807313957367087
176,1570050000,1039,658,0,1697,40,-0.6912073923925331,1.686837682011745
176,1570064400,303,142,0,445,40,-0.6912073923925331,-0.7224591636777814
176,1570078800,29,45,16,74,40,-0.5757484394500071,-1.4363961682710835
176,1570093200,334,682,348,1016,40,1.8200248341074081,0.376349541504902
176,1570107600,509,805,296,1314,40,1.4447832370441986,0.94980837538308
176,1570122000,802,632,0,1434,40,-0.6912073923925331,1.1807313957367087
176,1570136400,1046,582,0,1628,40,-0.6912073923925331,1.5540569453084085
176,1570150800,330,166,0,496,40,-0.6912073923925331,-0.6243168800274891
176,1570165200,49,41,0,90,40,-0.6912073923925331,-1.405606432223933
176,1570179600,318,652,334,970,40,1.718998250282698,0.28782905036934436
176,1570194000,481,669,188,1150,40,0.6654353046821477,0.6342135808997874
176,1570208400,826,561,0,1387,40,-0.6912073923925331,1.0902865460982043
176,1570222800,974,574,0,1548,40,-0.6912073923925331,1.4001082650726562
176,1570237200,325,211,0,536,40,-0.6912073923925331,-0.5473425399096129
176,1570251600,60,43,0,103,40,-0.6912073923925331,-1.3805897716856232
176,1570266000,106,270,164,376,40,0.4922468752683587,-0.8552399003811179
176,1570280400,272,456,184,728,40,0.6365705664465162,-0.1778657073438069
176,1570294800,440,405,0,845,40,-0.6912073923925331,0.04728423750098109
176,1570309200,333,473,140,806,40,0.31905844585456966,-0.02776574411394825
176,1570323600,221,211,0,432,40,-0.6912073923925331,-0.7474758242160912
176,1570338000,70,36,0,106,40,-0.6912073923925331,-1.3748166961767825
176,1570352400,82,142,60,224,40,-0.2582363188580605,-1.1477423928290476
176,1570366800,225,331,106,556,40,0.07370817085170184,-0.5088553698506748
176,1570381200,320,377,57,697,40,-0.2798848725347841,-0.23752082093516103
176,1570395600,308,297,0,605,40,-0.6912073923925331,-0.4145618032062764
176,1570410000,171,87,0,258,40,-0.6912073923925331,-1.082314203728853
176,1570424400,25,48,23,73,40,-0.525235147537652,-1.4383205267740304
176,1570438800,334,703,369,1037,40,1.9715647098444735,0.4167610700667871
176,1570453200,428,746,318,1174,40,1.6035392973401719,0.6803981849705132
176,1570467600,796,611,0,1407,40,-0.6912073923925331,1.1287737161571423
176,1570482000,984,586,0,1570,40,-0.6912073923925331,1.442444152137488
176,1570496400,284,178,0,462,41,-0.6837827766173156,-0.6897464645194911
176,1570510800,35,47,12,82,41,-0.5917105031962291,-1.4675021218411726
176,1570525200,364,674,310,1038,41,1.694750953427421,0.4891673739470575
176,1570539600,455,816,361,1271,41,2.086058115467039,0.9660543954100884
176,1570554000,860,577,0,1437,41,-0.6837827766173156,1.305810814134823
176,1570568400,961,528,0,1489,41,-0.6837827766173156,1.412240535663053
176,1570582800,315,162,0,477,41,-0.6837827766173156,-0.6590455833094248
176,1570597200,36,52,16,88,41,-0.5610197453892002,-1.4552217693571459
176,1570611600,266,614,348,880,41,1.9863131525941955,0.1657847585343584
176,1570626000,410,719,309,1129,41,1.6870782639756638,0.6754193866214602
176,1570640400,759,551,0,1310,41,-0.6837827766173156,1.045876686556261
176,1570654800,933,605,0,1538,41,-0.6837827766173156,1.5125300809492699
176,1570669200,296,171,0,467,41,-0.6837827766173156,-0.679512837449469
176,1570683600,33,44,11,77,41,-0.5993831926479862,-1.4777357489111946
176,1570698000,347,714,367,1061,41,2.1320942521775823,0.5362420584691593
176,1570712400,500,843,343,1343,41,1.9479497053354091,1.113418625218407
176,1570726800,797,624,0,1421,41,-0.6837827766173156,1.2730632075107522
176,1570741200,951,575,0,1526,41,-0.6837827766173156,1.4879693759812167
176,1570755600,331,215,0,546,41,-0.6837827766173156,-0.5178215297431195
176,1570770000,49,40,0,89,41,-0.6837827766173156,-1.4531750439431415
176,1570784400,312,569,257,881,41,1.2880984124842887,0.1678314839483628
176,1570798800,526,759,233,1285,41,1.1039538656421155,0.9947085512061504
176,1570813200,834,606,0,1440,41,-0.6837827766173156,1.3119509903768363
176,1570827600,848,525,0,1373,41,-0.6837827766173156,1.1748203876385397
176,1570842000,328,194,0,522,41,-0.6837827766173156,-0.5669429396792256
176,1570856400,70,37,0,107,41,-0.6837827766173156,-1.4163339864910618
176,1570870800,103,221,118,324,41,0.22159457869003574,-0.9721945716521017
176,1570885200,300,376,76,676,41,-0.10065837828376728,-0.2517472259225442
176,1570899600,412,478,66,890,41,-0.17738527280133942,0.18625201267440264
176,1570914000,373,406,33,779,41,-0.43058402470932755,-0.040934508280088495
176,1570928400,252,165,0,417,41,-0.6837827766173156,-0.7818491081496902
176,1570942800,55,46,0,101,41,-0.6837827766173156,-1.4286143389750885
176,1570957200,65,125,60,190,41,-0.22342140951188272,-1.2464557771286946
176,1570971600,294,344,50,638,41,-0.30014830402945486,-0.3295227916547124
176,1570986000,324,433,109,757,41,0.15254037362422082,-0.08596246738818583
176,1571000400,283,319,36,602,41,-0.4075659563540559,-0.40320490655887165
176,1571014800,193,117,0,310,41,-0.6837827766173156,-1.0008487274481637
176,1571029200,23,41,18,64,41,-0.5456743664856858,-1.504343179293252
176,1571043600,238,541,303,779,41,1.6410421272651206,-0.040934508280088495
176,1571058000,429,736,307,1165,41,1.6717328850721493,0.7491015015256194
176,1571072400,594,570,0,1164,41,-0.6837827766173156,0.747054776111615
176,1571086800,827,536,0,1363,41,-0.6837827766173156,1.1543531334984956
176,1571101200,268,122,0,390,42,-0.7255439917463278,-0.8343528604074624
176,1571115600,34,40,6,74,42,-0.6806649819475858,-1.4258560473807993
176,1571130000,360,592,232,952,42,1.0097777204716933,0.2176243265514471
176,1571144400,442,751,309,1193,42,1.5857250128888813,0.6687390988950364
176,1571158800,829,589,0,1418,42,-0.7255439917463278,1.0899043427842794
176,1571173200,971,630,0,1601,42,-0.7255439917463278,1.432452074480864
176,1571187600,310,164,0,474,42,-0.7255439917463278,-0.6771178360221449
176,1571202000,36,50,14,86,42,-0.6208263022159299,-1.4033939010400398
176,1571216400,342,664,322,1006,42,1.682962867452822,0.31870398508486547
176,1571230800,492,814,322,1306,42,1.682962867452822,0.8802576436038563
176,1571245200,856,650,0,1506,42,-0.7255439917463278,1.2546267492831835
176,1571259600,1128,665,0,1793,42,-0.7255439917463278,1.791846415933018
176,1571274000,288,156,0,444,42,-0.7255439917463278,-0.733273201874044
176,1571288400,42,46,4,88,42,-0.6956246518804998,-1.3996502099832464
176,1571302800,322,617,295,939,42,1.4810073233584835,0.19329033468229084
176,1571317200,506,843,337,1349,42,1.7951603919496768,0.9607470013249116
176,1571331600,816,614,0,1430,42,-0.7255439917463278,1.112366489125039
176,1571346000,979,608,0,1587,42,-0.7255439917463278,1.406246237083311
176,1571360400,330,194,0,524,42,-0.7255439917463278,-0.5835255596023131
176,1571374800,41,57,16,98,42,-0.605866632283016,-1.38093175469928
176,1571389200,275,700,425,975,42,2.453385868997892,0.2606767737045697
176,1571403600,474,811,337,1285,42,1.7951603919496768,0.8409488875075269
176,1571418000,883,707,0,1590,42,-0.7255439917463278,1.4118617736685009
176,1571432400,899,628,0,1527,42,-0.7255439917463278,1.2939355053795127
176,1571446800,364,236,0,600,42,-0.7255439917463278,-0.4412652994441688
176,1571461200,61,31,0,92,42,-0.7255439917463278,-1.3921628278696598
176,1571475600,88,215,127,303,42,0.2243950489937096,-0.9972034213779697
176,1571490000,275,435,160,710,42,0.47122960288679017,-0.23536229132053882
176,1571504400,395,467,72,862,42,-0.18699587416142469,0.049158228995749856
176,1571518800,362,411,49,773,42,-0.3590320783899354,-0.11743602303155076
176,1571533200,233,180,0,413,42,-0.7255439917463278,-0.7913004132543398
176,1571547600,65,61,0,126,42,-0.7255439917463278,-1.3285200799041743
176,1571562000,70,142,72,212,42,-0.18699587416142469,-1.1675413644620636
176,1571576400,224,370,146,594,42,0.3665119133563924,-0.4524963726145486
176,1571590800,334,470,136,804,42,0.2917135636918225,-0.059408811651255035
176,1571605200,257,293,36,550,42,-0.4562699329538762,-0.5348575758640006
176,1571619600,176,86,0,262,42,-0.7255439917463278,-1.0739490880422318
176,1571634000,19,49,30,68,42,-0.5011489427526181,-1.4370871205511793
176,1571648400,326,619,293,945,42,1.4660476534255695,0.20452140785267064
176,1571662800,435,769,334,1204,42,1.772720887050306,0.6893293997073994
176,1571677200,739,653,0,1392,42,-0.7255439917463278,1.041236359045967
176,1571691600,949,607,0,1556,42,-0.7255439917463278,1.3482190257030153
176,1571706000,309,183,0,492,43,-0.6985255103100084,-0.6491075905813799
176,1571720400,35,42,7,77,43,-0.6469258871866058,-1.445752098667104
176,1571734800,360,667,307,1027,43,1.5644865323877928,0.3778919559869631
176,1571749200,464,718,254,1182,43,1.1738036715963156,0.6754338806936794
176,1571763600,789,716,0,1505,43,-0.6985255103100084,1.2954728592760623
176,1571778000,1022,692,0,1714,43,-0.6985255103100084,1.6966745512999568
176,1571792400,287,187,0,474,43,-0.6985255103100084,-0.6836608463537728
176,1571806800,30,49,19,79,43,-0.5584693904036299,-1.441912848025727
176,1571821200,330,702,372,1032,43,2.0436258899622457,0.38749008259040557
176,1571835600,475,799,324,1274,43,1.689799902830342,0.8520394101970206
176,1571850000,781,667,0,1448,43,-0.6985255103100084,1.1860542159968182
176,1571864400,955,585,0,1540,43,-0.6985255103100084,1.3626597455001594
176,1571878800,337,183,0,520,43,-0.6985255103100084,-0.5953580816021021
176,1571893200,39,39,0,78,43,-0.6985255103100084,-1.4438324733464154
176,1571907600,351,637,286,988,43,1.409687663017585,0.30302656848011195
176,1571922000,468,854,386,1322,43,2.146825136209051,0.9441814255900681
176,1571936400,876,660,0,1536,43,-0.6985255103100084,1.3549812442174054
176,1571950800,1039,636,0,1675,43,-0.6985255103100084,1.6218091637931058
176,1571965200,319,189,0,508,43,-0.6985255103100084,-0.618393585450364
176,1571979600,45,47,2,92,43,-0.6837827608461791,-1.4169577188567766
176,1571994000,310,722,412,1032,43,2.338480879238832,0.38749008259040557
176,1572008400,467,800,333,1267,43,1.756142275417574,0.8386020329522011
176,1572022800,821,588,0,1409,43,-0.6985255103100084,1.111188828489967
176,1572037200,842,570,0,1412,43,-0.6985255103100084,1.1169477044520324
176,1572051600,339,182,0,521,43,-0.6985255103100084,-0.5934384562814137
176,1572066000,80,38,0,118,43,-0.6985255103100084,-1.3670474605188758
176,1572080400,106,235,129,341,43,0.25238183010698295,-0.9389710140053421
176,1572094800,281,402,121,683,43,0.19341083225166567,-0.282459154329878
176,1572109200,423,468,45,891,43,-0.36681364737384864,0.11682291237332827
176,1572123600,339,366,27,705,43,-0.4994983925483125,-0.2402273972747312
176,1572138000,271,211,0,482,43,-0.6985255103100084,-0.6683038437882648
176,1572152400,80,58,0,138,43,-0.6985255103100084,-1.328654954105106
176,1572166800,60,148,88,208,43,-0.04984453390151817,-1.1942811816569114
176,1572181200,196,311,115,507,43,0.1491825838601777,-0.6203132107710525
176,1572195600,279,401,122,680,43,0.20078220698358032,-0.2882180302919435
176,1572210000,267,312,45,579,43,-0.36681364737384864,-0.4821001876814811
176,1572224400,197,88,0,285,43,-0.6985255103100084,-1.0464700319638978
176,1572238800,23,42,19,65,43,-0.5584693904036299,-1.4687876025153659
176,1572253200,313,636,323,949,43,1.6824285280984272,0.2281611809732608
176,1572267600,454,698,244,1152,43,1.1000899242771691,0.6178451210730246
176,1572282000,802,590,0,1392,43,-0.6985255103100084,1.0785551980382626
176,1572296400,962,525,0,1487,43,-0.6985255103100084,1.2609196035036694
176,1572310800,309,154,0,463,44,-0.5832728214560041,-0.7028561312605617
176,1572325200,36,29,0,65,44,-0.5832728214560041,-1.4564383784973274
176,1572339600,360,679,319,1039,44,1.6428688846964747,0.38775536222782286
176,1572354000,464,733,269,1197,44,1.293943852384174,0.6869161538444284
176,1572368400,826,618,0,1444,44,-0.5832728214560041,1.1545915685868433
176,1572382800,1035,569,0,1604,44,-0.5832728214560041,1.45753920566695
176,1572397200,320,180,0,500,44,-0.5832728214560041,-0.6327994901857871
176,1572411600,44,27,0,71,44,-0.5832728214560041,-1.4450778421068236
176,1572426000,348,703,355,1051,44,1.8940949079613312,0.4104764350088309
176,1572440400,463,834,371,1297,44,2.0057509183012674,0.8762584270194952
176,1572454800,811,626,0,1437,44,-0.5832728214560041,1.1413376094645886
176,1572469200,1049,666,0,1715,44,-0.5832728214560041,1.6677091288912742
176,1572483600,355,205,0,560,44,-0.5832728214560041,-0.5191941262807469
176,1572498000,46,28,0,74,44,-0.5832728214560041,-1.4393975739115714
176,1572510967,191,532,341,723,44,1.796395898913887,-0.21056622100538813
176,1572512400,339,628,289,967,44,1.4335138653090942,0.2514289255417748
176,1572526800,508,754,246,1262,44,1.1334383375205157,0.8099886314082217
176,1572541200,896,707,0,1603,44,-0.5832728214560041,1.4556457829351994
176,1572555600,926,564,0,1490,44,-0.5832728214560041,1.241689014247374
176,1572570000,342,229,0,571,44,-0.5832728214560041,-0.4983664762314896
176,1572584400,69,58,0,127,44,-0.5832728214560041,-1.339046169128786
176,1572598800,314,686,372,1000,44,2.0127294189475133,0.3139118756895468
176,1572613200,477,777,300,1254,44,1.5102773724178005,0.7948412495542164
176,1572627600,807,705,0,1512,44,-0.5832728214560041,1.2833443143458887
176,1572642000,852,658,0,1510,44,-0.5832728214560041,1.2795574688823874
176,1572656400,401,225,0,626,44,-0.5832728214560041,-0.3942282259852029
176,1572670800,71,36,0,107,44,-0.5832728214560041,-1.3769146237637995
176,1572685200,125,142,17,267,44,-0.46463831046982185,-1.0739669866836925
176,1572699600,294,316,22,610,44,-0.42974580723859174,-0.42452298969321356
176,1572714000,469,354,0,823,44,-0.5832728214560041,-0.021223947830321346
176,1572728400,381,364,0,745,44,-0.5832728214560041,-0.16891092090687343
176,1572742800,247,203,0,450,44,-0.5832728214560041,-0.7274706267733204
176,1572753600,90,39,0,129,44,-0.5832728214560041,-1.3352593236652848
176,1572768000,67,101,34,168,44,-0.3460037994836396,-1.2614158371270088
176,1572782400,341,200,0,541,44,-0.5832728214560041,-0.5551691581840097
176,1572796800,418,273,0,691,44,-0.5832728214560041,-0.2711557484214095
176,1572811200,341,344,3,685,44,-0.5623373195172661,-0.2825162848119135
176,1572825600,233,129,0,362,44,-0.5832728214560041,-0.8940918271673791
176,1572840000,42,24,0,66,44,-0.5832728214560041,-1.4545449557655767
176,1572854400,197,384,187,581,44,0.7217067993920007,-0.47943224891398295
176,1572868800,480,949,469,1429,44,2.689643981633377,1.1261902276105833
176,1572883200,677,634,0,1311,44,-0.5832728214560041,0.9027663452640045
176,1572897600,1133,611,0,1744,44,-0.5832728214560041,1.7226183881120436
176,1572912000,380,231,0,611,45,-0.658308289786409,-0.40727587323591513
176,1572926400,74,34,0,108,45,-0.658308289786409,-1.309647147277021
176,1572940800,167,440,273,607,45,1.3566844626671322,-0.41445178794001936
176,1572955200,518,937,419,1455,45,2.4342996343089527,1.1068421293300754
176,1572969600,702,657,0,1359,45,-0.658308289786409,0.9346201764315741
176,1572984000,1189,683,0,1872,45,-0.658308289786409,1.8549312372329403
176,1572998400,391,241,0,632,45,-0.658308289786409,-0.369602321039368
176,1573012800,72,31,0,103,45,-0.658308289786409,-1.3186170406571511
176,1573027200,196,407,211,603,45,0.8990670610110166,-0.4216277026441236
176,1573041600,528,904,376,1432,45,2.1169198234829367,1.0655806197814761
176,1573056000,685,646,0,1331,45,-0.658308289786409,0.8843887735028446
176,1573070400,1122,686,0,1808,45,-0.658308289786409,1.740116601967273
176,1573084800,456,282,0,738,45,-0.658308289786409,-0.17944058138060615
176,1573099200,69,42,0,111,45,-0.658308289786409,-1.3042652112489428
176,1573113600,169,448,279,617,45,1.400970017666111,-0.3965120011797588
176,1573128000,542,918,376,1460,45,2.1169198234829367,1.1158120227102057
176,1573142400,667,585,0,1252,45,-0.658308289786409,0.7426644580967863
176,1573156800,1198,601,0,1799,45,-0.658308289786409,1.7239707938830384
176,1573171200,438,245,0,683,45,-0.658308289786409,-0.2781094085620392
176,1573185600,75,41,0,116,45,-0.658308289786409,-1.2952953178688125
176,1573200000,166,355,189,521,45,0.7366866926814272,-0.5687339540782601
176,1573214400,529,884,355,1413,45,1.9619203809865107,1.0314950249369812
176,1573228800,667,614,0,1281,45,-0.658308289786409,0.7946898397015418
176,1573243200,1079,746,0,1825,45,-0.658308289786409,1.770614239459716
176,1573257600,395,273,0,668,45,-0.658308289786409,-0.30501908870243
176,1573272000,96,59,0,155,45,-0.658308289786409,-1.2253301495037963
176,1573286400,71,158,87,229,45,-0.016167742301214524,-1.0925757274778682
176,1573300800,227,373,146,600,45,0.4193068818554116,-0.42700963867220176
176,1573315200,377,477,100,854,45,0.07978429352990649,0.028660945038416274
176,1573329600,388,416,28,804,45,-0.4516423664578406,-0.06103798876288649
176,1573344000,296,253,0,549,45,-0.658308289786409,-0.5185025511495306
176,1573358400,88,59,0,147,45,-0.658308289786409,-1.2396819789120048
176,1573372800,60,91,31,151,45,-0.42949958895835116,-1.2325060642079007
176,1573387200,192,307,115,499,45,0.1904981810273538,-0.6082014849508334
176,1573401600,307,401,94,708,45,0.035498738530927554,-0.2332599416613878
176,1573416000,341,346,5,687,45,-0.6214036606205932,-0.27093349385793497
176,1573430400,227,126,0,353,45,-0.658308289786409,-0.8701223716506374
176,1573444800,52,27,0,79,45,-0.658308289786409,-1.3616725288817766
176,1573459200,130,405,275,535,45,1.3714463143334583,-0.5436182526138954
176,1573473600,539,926,387,1465,45,2.1981100076477316,1.124781916090336
176,1573488000,754,583,0,1337,45,-0.658308289786409,0.895152645559001
176,1573502400,1010,630,0,1640,45,-0.658308289786409,1.4387281843948958
176,1573516800,384,197,0,581,46,-0.649335523708229,-0.46684624235039
176,1573531200,80,26,0,106,46,-0.649335523708229,-1.3152323358911333
176,1573545600,164,415,251,579,46,1.137947789851079,-0.47041839432319316
176,1573560000,533,929,396,1462,46,2.1704421343375317,1.1066867016693887
176,1573574400,668,660,0,1328,46,-0.649335523708229,0.867352519491579
176,1573588800,1214,709,0,1923,46,-0.649335523708229,1.9300677314005104
176,1573603200,438,259,0,697,46,-0.649335523708229,-0.2596614279278085
176,1573617600,88,33,0,121,46,-0.649335523708229,-1.2884411960951099
176,1573632000,170,391,221,561,46,0.9243282703021577,-0.5025677620784214
176,1573646400,540,994,454,1534,46,2.583439872132113,1.2352841726903012
176,1573660800,637,613,0,1250,46,-0.649335523708229,0.7280385925522569
176,1573675200,1206,657,0,1863,46,-0.649335523708229,1.8229031722164162
176,1573689600,430,236,0,666,46,-0.649335523708229,-0.31502978350625704
176,1573704000,94,37,0,131,46,-0.649335523708229,-1.2705804362310942
176,1573718400,168,401,233,569,46,1.0097760781217262,-0.4882791541872088
176,1573732800,515,951,436,1466,46,2.45526816040276,1.113831005614995
176,1573747200,648,658,10,1306,46,-0.5781290171919219,0.8280588477907446
176,1573761600,1126,622,0,1748,46,-0.649335523708229,1.6175044337802362
176,1573776000,495,301,0,796,46,-0.649335523708229,-0.08283990527405358
176,1573790400,99,38,0,137,46,-0.649335523708229,-1.2598639803126848
176,1573804800,166,445,279,611,46,1.3373260080967388,-0.4132639627583431
176,1573819200,506,919,413,1425,46,2.2914931954152538,1.0406018901725307
176,1573833600,675,702,27,1377,46,-0.4570779561141998,0.9548702428252557
176,1573848000,1021,694,0,1715,46,-0.649335523708229,1.5585639262289845
176,1573862400,423,273,0,696,46,-0.649335523708229,-0.26144750391421007
176,1573876800,103,85,0,188,46,-0.649335523708229,-1.168774105006205
176,1573891200,67,150,83,217,46,-0.05832151962288009,-1.1169779014005596
176,1573905600,215,389,174,604,46,0.5896576896755145,-0.425766494663154
176,1573920000,398,472,74,870,46,-0.12240737548755648,0.04932971771966222
176,1573934400,402,411,9,813,46,-0.5852496678435526,-0.05247661350522698
176,1573948800,308,227,0,535,46,-0.649335523708229,-0.549005737724862
176,1573963200,87,66,0,153,46,-0.649335523708229,-1.2312867645302599
176,1573977600,52,109,57,161,46,-0.24345843656527855,-1.2169981566390473
176,1573992000,164,292,128,456,46,0.2621077597005018,-0.6901057406505856
176,1574006400,341,409,68,750,46,-0.16513127939734074,-0.16499940064852556
176,1574020800,380,315,0,695,46,-0.649335523708229,-0.26323357990061164
176,1574035200,212,117,0,329,46,-0.649335523708229,-0.9169373909235844
176,1574049600,46,33,0,79,46,-0.649335523708229,-1.3634563875239756
176,1574064000,153,346,193,499,46,0.724950052056498,-0.6133044732353183
176,1574078400,505,829,324,1334,46,1.657755287420121,0.8780689754099883
176,1574092800,629,607,0,1236,46,-0.649335523708229,0.703033528742635
176,1574107200,1130,683,0,1813,46,-0.649335523708229,1.733599372896338
176,1574121600,375,233,0,608,47,-0.6843642984651326,-0.1481172304098977
176,1574136000,70,39,0,109,47,-0.6843642984651326,-1.0017664090322496
176,1574150400,180,432,252,612,47,1.4689363091913343,-0.14127435122254414
176,1574164800,582,921,339,1503,47,2.212337709453686,1.382976987760453
176,1574179200,634,674,40,1308,47,-0.34257055121807434,1.0493866273769688
176,1574193600,1208,776,0,1984,47,-0.6843642984651326,2.205833210039714
176,1574208000,468,283,0,751,47,-0.6843642984651326,0.09651570053799076
176,1574222400,89,30,0,119,47,-0.6843642984651326,-0.9846592110638658
176,1574236800,173,394,221,567,47,1.2040461550748642,-0.2182567420802713
176,1574251200,506,945,439,1451,47,3.0668220775713317,1.2940195583248573
176,1574265600,647,687,40,1334,47,-0.34257055121807434,1.0938653420947666
176,1574280000,1253,808,0,2061,47,-0.6843642984651326,2.3375586343962698
176,1574294400,453,244,0,697,47,-0.6843642984651326,0.004136831508718198
176,1574308800,77,37,0,114,47,-0.6843642984651326,-0.9932128100480577
176,1574323200,177,409,232,586,47,1.2980394355678053,-0.18575306594034205
176,1574337600,560,837,277,1397,47,1.6825574012207458,1.2016406892955847
176,1574352000,643,650,7,1293,47,-0.6245503926968974,1.023725830424393
176,1574366400,1261,656,0,1917,47,-0.6843642984651326,2.091214983651543
176,1574380800,474,258,0,732,47,-0.6843642984651326,0.06401202439806152
176,1574395200,102,43,0,145,47,-0.6843642984651326,-0.9401804963460679
176,1574409600,158,377,219,535,47,1.1869564677125113,-0.2729997755790995
176,1574424000,519,943,424,1462,47,2.9386494223536848,1.3128374760900794
176,1574438400,662,668,6,1330,47,-0.6330952363780739,1.0870224629074132
176,1574452800,1046,716,0,1762,47,-0.6843642984651326,1.8260534151415937
176,1574467200,450,236,0,686,47,-0.6843642984651326,-0.014681086256503988
176,1574481600,116,70,0,186,47,-0.6843642984651326,-0.8700409846756944
176,1574496000,85,156,71,241,47,-0.07768039710160417,-0.7759513958495834
176,1574510400,220,384,164,604,47,0.7169900652478063,-0.1549601095972512
176,1574524800,402,456,54,858,47,-0.22294273968160394,0.27956271879969746
176,1574539200,394,494,100,888,47,0.17012006965251306,0.3308843127048489
176,1574553600,302,266,0,568,47,-0.6843642984651326,-0.2165460222834329
176,1574568000,112,78,0,190,47,-0.6843642984651326,-0.8631981054883408
176,1574582400,46,116,70,162,47,-0.08622524078278063,-0.9110982597998154
176,1574596800,148,342,194,490,47,0.9733353756830999,-0.3499821664368266
176,1574611200,316,425,109,741,47,0.24702366278310117,0.07940850256960695
176,1574625600,347,330,0,677,47,-0.6843642984651326,-0.030077564428049413
176,1574640000,232,127,0,359,47,-0.6843642984651326,-0.5740864598226545
176,1574654400,52,44,0,96,47,-0.6843642984651326,-1.0240057663911486
176,1574665089,28,176,148,204,47,0.5802725663489829,-0.8392480283326035
176,1574665887,77,81,4,158,47,-0.6501849237404268,-0.917941138987169
176,1574665949,10,37,27,47,47,-0.45365351907336826,-1.1078310364362292
176,1574666030,3,1,0,4,47,-0.6843642984651326,-1.1813919877002796
176,1574666117,33,266,233,299,47,1.3065842792489817,-0.6767296476329573
176,1574666197,2,0,0,2,47,-0.6843642984651326,-1.1848134272939563
176,1574666278,1,7,6,8,47,-0.6330952363780739,-1.174549108512926
176,1574666364,14,9,0,23,47,-0.6843642984651326,-1.1488883115603503
176,1574668800,141,195,54,336,47,-0.22294273968160394,-0.6134330151499372
176,1574674235,218,299,81,517,47,0.007768039710160393,-0.3037927319221903
176,1574674323,254,422,168,676,47,0.7511694399725121,-0.031788284224887796
176,1574674404,3,12,9,15,47,-0.6074607053345444,-1.1625740699350573
176,1574674491,202,519,317,721,47,2.024351148467804,0.045194106632839334
176,1574674571,4,0,0,4,47,-0.6843642984651326,-1.1813919877002796
176,1574683200,444,544,100,988,47,0.17012006965251306,0.501956292388687
176,1574697600,623,608,0,1231,47,-0.6843642984651326,0.9176612030204134
176,1574712000,1093,753,0,1846,47,-0.6843642984651326,1.9697538780760178
176,1574726400,408,256,0,664,48,-0.7167475239396517,0.01720026890765084
176,1574740800,72,31,0,103,48,-0.7167475239396517,-1.167807731098404
176,1574755200,170,409,239,579,48,1.1304184953944236,-0.16234639775993323
176,1574769600,553,907,354,1460,48,2.019222228546803,1.698601994406438
176,1574784000,839,650,0,1489,48,-0.7167475239396517,1.759859092445967
176,1574798400,1110,667,0,1777,48,-0.7167475239396517,2.368205445390252
176,1574812800,406,234,0,640,48,-0.7167475239396517,-0.0334952605043729
176,1574827200,90,34,0,124,48,-0.7167475239396517,-1.1234491428628832
176,1574841600,134,418,284,552,48,1.478211260541007,-0.21937886834845993
176,1574856000,413,890,477,1303,48,2.9698557866141306,1.366968739502783
176,1574870400,785,611,0,1396,48,-0.7167475239396517,1.563413915974375
176,1574884800,722,538,0,1260,48,-0.7167475239396517,1.2761392493062405
176,1574899200,323,224,0,547,48,-0.7167475239396517,-0.2299404369759649
176,1574913600,78,36,0,114,48,-0.7167475239396517,-1.1445722801178932
176,1574928000,67,138,71,205,48,-0.16800782781948706,-0.9523517310973032
176,1574942400,161,216,55,377,48,-0.29166747764938333,-0.589033770311133
176,1574956800,264,264,0,528,48,-0.7167475239396517,-0.2700743977604837
176,1574971200,224,229,5,453,48,-0.6781038833678091,-0.42849792717305785
176,1574985600,151,123,0,274,48,-0.7167475239396517,-0.8066020840377349
176,1575000000,37,44,7,81,48,-0.6626464271390721,-1.2142786330594257
176,1575014400,62,274,212,336,48,0.9217428363064738,-0.6756386330566736
176,1575028800,225,534,309,759,48,1.6714294634002198,0.21787007283024482
176,1575043200,391,566,175,957,48,0.6357798960748386,0.6361081904794407
176,1575057600,418,506,88,924,48,-0.036619449875222275,0.566401837537908
176,1575072000,297,210,0,507,48,-0.7167475239396517,-0.31443298599600444
176,1575086400,96,44,0,140,48,-0.7167475239396517,-1.0896521232548675
176,1575100800,67,166,99,233,48,0.048396559382831404,-0.8932069467832755
176,1575115200,166,375,209,541,48,0.8985566519633682,-0.24261431932897082
176,1575129600,313,419,106,732,48,0.10249765618341102,0.16083760224171811
176,1575144000,373,513,140,886,48,0.36527441207194056,0.4861339159688704
176,1575158400,250,206,0,456,48,-0.7167475239396517,-0.4221609859965549
176,1575172800,86,43,0,129,48,-0.7167475239396517,-1.1128875742353783
176,1575187200,58,118,60,176,48,-0.2530238370775407,-1.013608829136832
176,1575201600,133,296,163,429,48,0.5430351587024165,-0.4791934565850816
176,1575216000,253,387,134,640,48,0.3189020433857295,-0.0334952605043729
176,1575230400,269,308,39,577,48,-0.4153271274792796,-0.1665710252109352
176,1575244800,202,110,0,312,48,-0.7167475239396517,-0.7263341624686973
176,1575259200,45,26,0,71,48,-0.7167475239396517,-1.2354017703144358
176,1575273600,160,374,214,534,48,0.9372002925352108,-0.2574005154074777
176,1575288000,460,915,455,1375,48,2.7998237680980234,1.519055327738854
176,1575302400,653,607,0,1260,48,-0.7167475239396517,1.2761392493062405
176,1575316800,1014,632,0,1646,48,-0.7167475239396517,2.091492347349622
176,1575331200,378,201,0,579,49,-0.626278507816848,-0.47891621512214033
176,1575345600,68,40,0,108,49,-0.626278507816848,-1.3270738308380023
176,1575360000,162,419,257,581,49,1.053654447793256,-0.4753146965840687
176,1575374400,542,977,435,1519,49,2.217187778916207,1.2137974977715122
176,1575388800,612,558,0,1170,49,-0.626278507816848,0.5853325128780178
176,1575403200,1159,567,0,1726,49,-0.626278507816848,1.586554666461923
176,1575417600,476,273,0,749,49,-0.626278507816848,-0.17278713938605422
176,1575432000,97,50,0,147,49,-0.626278507816848,-1.2568442193456062
176,1575446400,181,431,250,612,49,1.0078975190412296,-0.4194911592439589
176,1575460800,482,1002,520,1484,49,2.7728076280479534,1.1507709233552592
176,1575475200,685,608,0,1293,49,-0.626278507816848,0.8068259029694212
176,1575489600,1179,638,0,1817,49,-0.626278507816848,1.7504237599441808
176,1575504000,450,248,0,698,49,-0.626278507816848,-0.26462586210688005
176,1575518400,95,23,0,118,49,-0.626278507816848,-1.3090662381476443
176,1575532800,198,426,228,624,49,0.8640900286777189,-0.3978820480155293
176,1575547200,590,967,377,1557,49,1.838058940685133,1.2822263499948727
176,1575561600,719,637,0,1356,49,-0.626278507816848,0.9202737369186768
176,1575576000,1087,621,0,1708,49,-0.626278507816848,1.5541409996192785
176,1575590400,452,281,0,733,49,-0.626278507816848,-0.20159928769062702
176,1575604800,92,48,0,140,49,-0.626278507816848,-1.2694495342288568
176,1575619200,138,389,251,527,49,1.014434223148662,-0.5725556971120019
176,1575633600,539,904,365,1443,49,1.7596184913959454,1.0769397933247913
176,1575648000,665,644,0,1309,49,-0.626278507816848,0.835638051273994
176,1575662400,1055,722,0,1777,49,-0.626278507816848,1.6783933891827487
176,1575676800,408,272,0,680,49,-0.626278507816848,-0.29703952894952446
176,1575691200,124,68,0,192,49,-0.626278507816848,-1.1758100522389952
176,1575705600,72,158,86,230,49,-0.06412195457766934,-1.1073812000156347
176,1575720000,233,429,196,662,49,0.6549154972398848,-0.32945319579216886
176,1575734400,392,418,26,810,49,-0.45632420102360793,-0.06294082397487039
176,1575748800,419,416,0,835,49,-0.626278507816848,-0.01792184224897537
176,1575763200,298,256,0,554,49,-0.626278507816848,-0.5239351968480354
176,1575777600,105,58,0,163,49,-0.626278507816848,-1.2280320710410333
176,1575792000,58,104,46,162,49,-0.32559011887496175,-1.2298328303100692
176,1575806400,180,251,71,431,49,-0.162172516189154,-0.7454285869394388
176,1575820800,319,389,70,708,49,-0.1687092202965863,-0.24661826941652204
176,1575835200,319,353,34,672,49,-0.40403056816414945,-0.31144560310181085
176,1575849600,219,132,0,351,49,-0.626278507816848,-0.8894893284623028
176,1575864000,43,27,0,70,49,-0.626278507816848,-1.3955026830613628
176,1575878400,149,425,276,574,49,1.1778518258344697,-0.48792001146731934
176,1575892800,525,1028,503,1553,49,2.6616836582216044,1.2750233129187294
176,1575907200,594,627,33,1221,49,-0.4105672722715818,0.6771712355988436
176,1575921600,1163,682,0,1845,49,-0.626278507816848,1.8008450194771832
176,1575936000,400,228,0,628,50,-0.6723117737084693,-0.4573088177316036
176,1575950400,72,32,0,104,50,-0.6723117737084693,-1.3270333649695167
176,1575964800,155,450,295,605,50,1.5151732253062191,-0.4954837501485349
176,1575979200,543,912,369,1455,50,2.063898275906514,0.9153289696076221
176,1575993600,932,696,0,1628,50,-0.6723117737084693,1.2024708525697576
176,1576008000,1175,666,0,1841,50,-0.6723117737084693,1.5560039223439475
176,1576022400,1882,207,0,2089,50,-0.6723117737084693,1.9676292805786848
176,1576036800,90,38,0,128,50,-0.6723117737084693,-1.287198652882284
176,1576051200,146,397,251,543,50,1.1889042763006386,-0.5983900897072193
176,1576065600,520,942,422,1462,50,2.456904055390509,0.9269474272997316
176,1576080000,646,712,66,1358,50,-0.1829083502000983,0.7543303415883901
176,1576094400,1191,782,0,1973,50,-0.6723117737084693,1.7750948388237269
176,1576108800,451,281,0,732,50,-0.6723117737084693,-0.28469173202026204
176,1576123200,73,32,0,105,50,-0.6723117737084693,-1.3253735852992155
176,1576137600,177,411,234,588,50,1.0628458187303005,-0.5237000045436581
176,1576152000,518,906,388,1424,50,2.2047871402498327,0.8638757998282799
176,1576166400,692,636,0,1328,50,-0.6723117737084693,0.7045369514793492
176,1576180800,1200,624,0,1824,50,-0.6723117737084693,1.5277876679488243
176,1576195200,495,289,0,784,50,-0.6723117737084693,-0.19838318916459124
176,1576209600,111,47,0,158,50,-0.6723117737084693,-1.2374052627732433
176,1576224000,151,415,264,566,50,1.2853019203250147,-0.560215157290288
176,1576238400,530,915,385,1445,50,2.1825415300903614,0.8987311729046085
176,1576252800,716,681,0,1397,50,-0.6723117737084693,0.8190617487301431
176,1576267200,1118,682,0,1800,50,-0.6723117737084693,1.4879529558615916
176,1576281600,413,277,0,690,50,-0.6723117737084693,-0.3544024781729192
176,1576296000,100,65,0,165,50,-0.6723117737084693,-1.2257868050811338
176,1576310400,70,135,65,205,50,-0.19032355358658876,-1.1593956182690794
176,1576324800,216,369,153,585,50,0.46221434442457254,-0.5286793435545621
176,1576339200,417,452,35,869,50,-0.41277965518130283,-0.05730191718897555
176,1576353600,438,456,18,894,50,-0.5388381127516408,-0.015807425431441525
176,1576368000,297,237,0,534,50,-0.6723117737084693,-0.6133281067399315
176,1576382400,114,75,0,189,50,-0.6723117737084693,-1.1859520929939011
176,1576396800,57,103,46,160,50,-0.3312124179299077,-1.2340857034326407
176,1576411200,225,301,76,526,50,-0.10875631633519359,-0.6266063441023424
176,1576425600,346,502,156,848,50,0.484459954584044,-0.09215729026530414
176,1576440000,356,414,58,770,50,-0.24222997729202203,-0.22162010454881031
176,1576454400,233,172,0,405,50,-0.6723117737084693,-0.8274396842088071
176,1576468800,48,29,0,77,50,-0.6723117737084693,-1.3718474160676535
176,1576483200,174,355,181,529,50,0.6698400392463058,-0.6216270050914383
176,1576497600,523,869,346,1392,50,1.893348598017233,0.8107628503786364
176,1576512000,689,666,0,1355,50,-0.6723117737084693,0.749351002577486
176,1576526400,1127,663,0,1790,50,-0.6723117737084693,1.471355159158578
176,1576540800,426,197,0,623,51,-0.6720960476260989,-0.36514114299094247
176,1576555200,76,27,0,103,51,-0.6720960476260989,-1.301576389928728
176,1576569600,160,380,220,540,51,0.8359582214523744,-0.5146106150983197
176,1576584000,511,985,474,1496,51,2.5770754230247936,1.206989569656532
176,1576598400,673,697,24,1370,51,-0.5075810364539017,0.9800841059754533
176,1576612800,1108,662,0,1770,51,-0.6720960476260989,1.7004189113122115
176,1576627200,461,246,0,707,51,-0.6720960476260989,-0.21387083387022326
176,1576641600,59,39,0,98,51,-0.6720960476260989,-1.3105805749954376
176,1576656000,171,412,241,583,51,0.979908856228047,-0.4371746235246183
176,1576670400,513,899,386,1412,51,1.9738537153934044,1.0557192605358128
176,1576684800,677,676,0,1353,51,-0.6720960476260989,0.949469876748641
176,1576699200,1183,760,0,1943,51,-0.6720960476260989,2.011963714620359
176,1576713600,454,271,0,725,51,-0.6720960476260989,-0.18145576763006915
176,1576728000,79,40,0,119,51,-0.6720960476260989,-1.2727629977152577
176,1576742400,154,401,247,555,51,1.0210376090210962,-0.4875980598981913
176,1576756800,521,941,420,1462,51,2.20691664788735,1.1457611112029076
176,1576771200,649,735,86,1384,51,-0.08258392425905928,1.0052958241622398
176,1576785600,1223,808,0,2031,51,-0.6720960476260989,2.170437371794446
176,1576800000,453,264,0,717,51,-0.6720960476260989,-0.19586246373680433
176,1576814400,93,34,0,127,51,-0.6720960476260989,-1.2583563016085224
176,1576828800,154,440,286,594,51,1.2883745021759165,-0.41736541637785746
176,1576843200,512,890,378,1402,51,1.9190153783360053,1.037710890402394
176,1576857600,680,702,22,1382,51,-0.5212906207182515,1.001694150135556
176,1576872000,899,684,0,1583,51,-0.6720960476260989,1.363662389817277
176,1576886400,401,237,0,638,51,-0.6720960476260989,-0.33812858779081406
176,1576900800,101,61,0,162,51,-0.6720960476260989,-1.1953270061415562
176,1576915200,69,147,78,216,51,-0.1374222613164583,-1.0980818074210938
176,1576929600,197,380,183,577,51,0.582330912561904,-0.44797964560466963
176,1576944000,349,431,82,780,51,-0.11000309278775879,-0.08240973189626492
176,1576958400,417,397,0,814,51,-0.6720960476260989,-0.021181273442640484
176,1576972800,280,200,0,480,51,-0.6720960476260989,-0.6226608358988335
176,1576987200,82,50,0,132,51,-0.6720960476260989,-1.249352116541813
176,1577001600,47,98,51,145,51,-0.32250164888518,-1.2259412353683683
176,1577016000,163,273,110,436,51,0.08193108691313782,-0.7018976644858769
176,1577030400,317,382,65,699,51,-0.22653455903473171,-0.22827752997695844
176,1577044800,356,388,32,744,51,-0.4527426993965027,-0.14723986437657316
176,1577059200,238,158,0,396,51,-0.6720960476260989,-0.7739311450195527
176,1577073600,52,35,0,87,51,-0.6720960476260989,-1.3303897821421984
176,1577088000,83,372,289,455,51,1.3089388785724412,-0.6676817612323809
176,1577102400,370,814,444,1184,51,2.3714316590595472,0.6451284214938607
176,1577116800,618,606,0,1224,51,-0.6720960476260989,0.7171619020275366
176,1577131200,878,556,0,1434,51,-0.6720960476260989,1.0953376748293346
176,1577145600,354,175,0,529,52,-0.6636169757742819,-0.18182906800515186
176,1577160000,85,29,0,114,52,-0.6636169757742819,-1.1834980488299922
176,1577174400,77,328,251,405,52,1.0224347585421558,-0.48112293215522467
176,1577188800,301,657,356,958,52,1.7277552051685543,0.8536311555463098
176,1577203200,625,497,0,1122,52,-0.6636169757742819,1.2494714274867287
176,1577217600,441,405,0,846,52,-0.6636169757742819,0.5833012137333408
176,1577232000,232,165,0,397,52,-0.6636169757742819,-0.5004322137132938
176,1577246400,43,34,0,77,52,-0.6636169757742819,-1.2728034760360625
176,1577260800,40,67,27,107,52,-0.4822488609274938,-1.200393670193303
176,1577275200,118,166,48,284,52,-0.34118477160221417,-0.7731758157210216
176,1577289600,185,260,75,445,52,-0.159816656755426,-0.3845765243648786
176,1577304000,226,256,30,482,52,-0.46209684816673957,-0.2952710971588085
176,1577318400,152,118,0,270,52,-0.6636169757742819,-0.8069670584476426
176,1577332800,34,24,0,58,52,-0.6636169757742819,-1.3186630197364768
176,1577347200,71,340,269,411,52,1.1433468351066813,-0.46664097098667273
176,1577361600,262,689,427,951,52,2.204686173839738,0.8367355341829992
176,1577376000,524,591,67,1115,52,-0.21355535745077064,1.232575806123418
176,1577390400,674,565,0,1239,52,-0.6636169757742819,1.5318696702734909
176,1577404800,334,173,0,507,52,-0.6636169757742819,-0.2349295922898422
176,1577419200,78,30,0,108,52,-0.6636169757742819,-1.1979800099985443
176,1577433600,78,342,264,420,52,1.1097601471720908,-0.4449180292338449
176,1577448000,332,814,482,1146,52,2.574139741120232,1.3073992721609362
176,1577462400,564,639,75,1203,52,-0.159816656755426,1.4449779032621795
176,1577476800,691,619,0,1310,52,-0.6636169757742819,1.703239544101355
