remote_unit_id,time_stamp,entries,exits,num_people_exited,sum_exit_entry,week_num,z_score_num_people_exited,z_score_sum_exit_entry
132,1546300800,0,0,0,0,1,-0.6940217608023367,-1.4763982887653704
132,1546315200,135,172,37,307,1,0.49032564652072835,-1.0234939856213765
132,1546329600,129,160,31,289,1,0.2982693101980691,-1.0500486353171155
132,1546344000,267,250,0,517,1,-0.6940217608023367,-0.7136897391710876
132,1546358400,393,446,53,839,1,1.0024758767144861,-0.2386565612806446
132,1546372800,403,442,39,845,1,0.5543444252949481,-0.2298050113820649
132,1546387200,211,258,47,469,1,0.810419540391827,-0.784502138359725
132,1546401600,48,59,11,107,1,-0.34191847754412813,-1.318545648907366
132,1546416000,574,599,25,1173,1,0.10621297387540996,0.25407971640695776
132,1546430400,1037,887,0,1924,1,-0.6940217608023367,1.361998712045848
132,1546444800,786,799,13,1585,1,-0.27789969876990844,0.861886142776096
132,1546459200,990,924,0,1914,1,-0.6940217608023367,1.3472461288815487
132,1546473600,297,324,27,621,1,0.17023175264962967,-0.5602628742623731
132,1546488000,62,87,25,149,1,0.10621297387540996,-1.256584799617308
132,1546502400,700,573,0,1273,1,-0.6940217608023367,0.40160554804995247
132,1546516800,1090,898,0,1988,1,-0.6940217608023367,1.4564152442973648
132,1546531200,891,878,0,1769,1,-0.6940217608023367,1.1333336729992063
132,1546545600,1126,1005,0,2131,1,-0.6940217608023367,1.6673771835468472
132,1546560000,356,370,14,726,1,-0.24589030938279854,-0.40536075103722863
132,1546574400,76,75,0,151,1,-0.6940217608023367,-1.2536342829844482
132,1546588800,683,537,0,1220,1,-0.6940217608023367,0.32341685727916525
132,1546601570,1033,880,0,1913,1,-0.6940217608023367,1.3457708705651186
132,1546603200,118,75,0,193,1,-0.6940217608023367,-1.1916734336943904
132,1546606062,165,116,0,281,1,-0.6940217608023367,-1.0618507018485552
132,1546617600,789,706,0,1495,1,-0.6940217608023367,0.7291128942974008
132,1546632000,1085,954,0,2039,1,-0.6940217608023367,1.531653418435292
132,1546646400,357,370,13,727,1,-0.27789969876990844,-0.4038854927207987
132,1546660800,110,132,22,242,1,0.010184805714080359,-1.1193857761893231
132,1546675200,189,237,48,426,1,0.8424289297789368,-0.8479382459662128
132,1546689600,489,576,87,1065,1,2.0907951158762215,0.09475181823252346
132,1546704000,622,765,143,1387,1,3.883320921554374,0.5697849961229664
132,1546718400,642,743,101,1385,1,2.5389265672957597,0.5668344794901066
132,1546732800,416,384,0,800,1,-0.6940217608023367,-0.29619163562141254
132,1546747200,115,128,13,243,1,-0.27789969876990844,-1.1179105178728932
132,1546761600,139,201,62,340,1,1.290560381198475,-0.9748104611791882
132,1546776000,404,476,72,880,1,1.6106542750695734,-0.17817097030701678
132,1546790400,653,580,0,1233,1,-0.6940217608023367,0.34259521539275456
132,1546804800,602,541,0,1143,1,-0.6940217608023367,0.20982196691405933
132,1546819200,305,316,11,621,1,-0.34191847754412813,-0.5602628742623731
132,1546833600,70,100,30,170,1,0.2662599208109593,-1.2256043749722794
132,1546848000,705,574,0,1279,1,-0.6940217608023367,0.41045709794853213
132,1546862400,1214,1025,0,2239,1,-0.6940217608023367,1.8267050817212815
132,1546876800,852,882,30,1734,1,0.2662599208109593,1.081699631924158
132,1546891200,1177,1025,0,2202,1,-0.6940217608023367,1.7721205240133735
132,1546905600,329,370,41,699,2,1.6338921397170239,-0.6144148186287695
132,1546920000,73,72,0,145,2,-0.687528870673005,-1.390749545745479
132,1546934400,756,636,0,1392,2,-0.687528870673005,0.3567042533782337
132,1546948800,1231,961,0,2192,2,-0.687528870673005,1.477765231164096
132,1546963200,853,763,0,1616,2,-0.687528870673005,0.6706013271582751
132,1546977600,1163,1012,0,2175,2,-0.687528870673005,1.4539426853861463
132,1546992000,291,295,4,586,2,-0.4610487720983681,-0.7727646817410225
132,1547006400,68,102,34,170,2,1.2375519672114093,-1.355716390189671
132,1547020800,746,622,0,1368,2,-0.687528870673005,0.32307242404465786
132,1547035200,1133,912,0,2045,2,-0.687528870673005,1.2717702764959438
132,1547049600,872,880,8,1752,2,-0.23456867352373112,0.8611816933818718
132,1547064000,1222,1039,0,2261,2,-0.687528870673005,1.5744567404981267
132,1547078400,306,343,37,649,2,1.407412041142387,-0.6844811297403859
132,1547092800,74,92,18,166,2,0.3316315729128613,-1.3613216950786002
132,1547107200,683,550,0,1233,2,-0.687528870673005,0.1338933840432936
132,1547121600,1127,916,0,2043,2,-0.687528870673005,1.2689676240514791
132,1547136000,879,847,0,1726,2,-0.687528870673005,0.8247472116038312
132,1547150400,1133,921,0,2054,2,-0.687528870673005,1.2843822124960347
132,1547164800,346,301,0,647,2,-0.687528870673005,-0.6872837821848505
132,1547179200,67,104,37,171,2,1.407412041142387,-1.3543150639674386
132,1547193600,694,631,0,1325,2,-0.687528870673005,0.26281539648866775
132,1547208000,1082,1031,0,2113,2,-0.687528870673005,1.367060459607742
132,1547222400,815,842,27,1657,2,0.8412117947057945,0.7280557022698005
132,1547236800,1112,913,0,2025,2,-0.687528870673005,1.2437437520512973
132,1547251200,334,375,41,709,2,1.6338921397170239,-0.6004015564064462
132,1547265600,72,95,23,167,2,0.6147316961311575,-1.359920368856368
132,1547280000,172,159,0,331,2,-0.687528870673005,-1.130102868410266
132,1547294400,446,495,49,941,2,2.086852336866298,-0.2752938728485461
132,1547308800,533,590,57,1123,2,2.539812534015572,-0.020252500402262466
132,1547323200,522,561,39,1083,2,1.5206520904297054,-0.07630554929155559
132,1547337600,302,326,24,628,2,0.6713517207748168,-0.7139089804072647
132,1547352000,94,111,17,205,2,0.27501154826920204,-1.3066699724115394
132,1547366400,130,128,0,258,2,-0.687528870673005,-1.232399682633226
132,1547380800,340,331,0,671,2,-0.687528870673005,-0.6536519528512746
132,1547395200,488,452,0,940,2,-0.687528870673005,-0.27669519907077844
132,1547409600,410,458,48,868,2,2.0302323122226387,-0.37759068707150606
132,1547424000,233,221,0,454,2,-0.687528870673005,-0.9577397430756898
132,1547438400,73,79,6,152,2,-0.34780872281104963,-1.3809402621898528
132,1547452800,687,621,0,1308,2,-0.687528870673005,0.23899285071071819
132,1547467200,1108,1043,0,2151,2,-0.687528870673005,1.4203108560525706
132,1547481600,788,710,0,1498,2,-0.687528870673005,0.5052448329348604
132,1547496000,1143,933,0,2076,2,-0.687528870673005,1.315211389385146
132,1547510400,293,332,39,625,3,1.3564982561823937,-0.49884035173478825
132,1547524800,76,61,0,137,3,-0.46775801937323924,-1.2014800088686608
132,1547539200,761,617,0,1378,3,-0.46775801937323924,0.5853556765885849
132,1547553600,1099,902,0,2001,3,-0.46775801937323924,1.4823731077246558
132,1547568000,842,802,0,1644,3,-0.46775801937323924,0.9683518831410647
132,1547582400,1134,1023,0,2157,3,-0.46775801937323924,1.7069874243494183
132,1547596800,323,363,40,686,3,1.4032740581197176,-0.41101039459305416
132,1547611200,55,74,19,129,3,0.4209822174359153,-1.2129986917724949
132,1547625600,733,696,0,1429,3,-0.46775801937323924,0.6587872801005265
132,1547640000,1145,961,0,2106,3,-0.46775801937323924,1.6335558208374767
132,1547654400,1131,818,0,1949,3,-0.46775801937323924,1.407501668849735
132,1547668800,1115,1054,0,2169,3,-0.46775801937323924,1.7242654487051692
132,1547683200,345,306,0,651,3,-0.46775801937323924,-0.4614046322973278
132,1547697600,74,113,39,187,3,1.3564982561823937,-1.1294882407196984
132,1547712000,877,573,0,1450,3,-0.46775801937323924,0.6890238227230907
132,1547719165,768,625,0,1393,3,-0.46775801937323924,0.6069532070332736
132,1547721526,148,107,0,255,3,-0.46775801937323924,-1.0315794360371098
132,1547721618,6,5,0,11,3,-0.46775801937323924,-1.382899264604046
132,1547726400,271,220,0,491,3,-0.46775801937323924,-0.6917782903740074
132,1547740800,867,819,0,1686,3,-0.46775801937323924,1.028824968386193
132,1547755200,1223,1062,0,2285,3,-0.46775801937323924,1.891286350810762
132,1547769600,436,333,0,769,3,-0.46775801937323924,-0.2915040594657766
132,1547784000,132,73,0,205,3,-0.46775801937323924,-1.1035712041860721
132,1547796577,601,390,0,991,3,-0.46775801937323924,0.028139391115616235
132,1547798400,278,232,0,510,3,-0.46775801937323924,-0.6644214184774017
132,1547812800,1364,992,0,2356,3,-0.46775801937323924,1.9935146615822885
132,1547827200,757,833,76,1590,3,3.087202927863379,0.8906007735401853
132,1547841600,1151,1019,0,2170,3,-0.46775801937323924,1.7257052840681486
132,1547856000,348,405,57,753,3,2.198462691054224,-0.3145414252734446
132,1547870400,103,93,0,196,3,-0.46775801937323924,-1.1165297224528852
132,1547884800,200,201,1,401,3,-0.4209822174359153,-0.8213634730421396
132,1547899200,481,454,0,935,3,-0.46775801937323924,-0.05249138921122161
132,1547913600,571,499,0,1070,3,-0.46775801937323924,0.14188638479097676
132,1547928000,510,502,0,1012,3,-0.46775801937323924,0.058375933738180424
132,1547942400,267,281,14,548,3,0.18710320774929567,-0.6097076746841903
132,1547956800,83,79,0,162,3,-0.46775801937323924,-1.1654841247941796
132,1547971200,115,118,3,233,3,-0.32743061356126746,-1.0632558140226531
132,1547985600,299,295,0,594,3,-0.46775801937323924,-0.5434752479871449
132,1548000000,422,430,8,852,3,-0.09355160387464784,-0.17199772433849914
132,1548014400,338,423,85,761,3,3.508185145299294,-0.30302274236961063
132,1548028800,158,220,62,378,3,2.432341700740844,-0.8544796863906623
132,1548043200,48,49,1,97,3,-0.4209822174359153,-1.2590734233878307
132,1548057600,228,218,0,446,3,-0.46775801937323924,-0.7565708817080735
132,1548072000,433,387,0,820,3,-0.46775801937323924,-0.21807245595383504
132,1548086400,447,463,16,910,3,0.2806548116239435,-0.08848727328570279
132,1548100800,607,502,0,1109,3,-0.46775801937323924,0.1980399639471674
132,1548115200,154,200,46,354,4,0.5347008486569377,-1.0757314342968731
132,1548129600,62,65,3,127,4,-0.3706671634004596,-1.3957526018983415
132,1548144000,607,530,0,1137,4,-0.43383237354399895,0.02813012619629751
132,1548158400,1103,875,0,1978,4,-0.43383237354399895,1.2137592096889622
132,1548172800,819,799,0,1618,4,-0.43383237354399895,0.7062366531403781
132,1548187200,1068,1066,0,2134,4,-0.43383237354399895,1.4336856508600155
132,1548201600,294,306,12,600,4,-0.18117153296984156,-0.728924353988674
132,1548216000,66,81,15,147,4,-0.1180063228263022,-1.367556904312309
132,1548230400,711,582,0,1293,4,-0.43383237354399895,0.24805656736735068
132,1548244800,1150,965,0,2115,4,-0.43383237354399895,1.4068997381532846
132,1548259200,849,922,73,1771,4,1.1031877399487917,0.9219337396735264
132,1548273600,1099,1085,0,2184,4,-0.43383237354399895,1.5041748948250966
132,1548288000,325,353,28,678,4,0.15570958779570163,-0.6189611334031474
132,1548302400,71,84,13,155,4,-0.1601164629219951,-1.3562786252778962
132,1548316800,694,628,0,1322,4,-0.43383237354399895,0.28894032886709775
132,1548331200,1096,963,0,2059,4,-0.43383237354399895,1.3279517849123939
132,1548345600,778,777,0,1555,4,-0.43383237354399895,0.6174202057443758
132,1548360000,1091,1030,0,2121,4,-0.43383237354399895,1.4153584474290943
132,1548374400,304,314,10,618,4,-0.22328167306553445,-0.7035482261612448
132,1548388800,73,95,22,168,4,0.02937916750862293,-1.337951421846975
132,1548403200,643,579,0,1222,4,-0.43383237354399895,0.14796184093693546
132,1548409774,763,560,0,1323,4,-0.43383237354399895,0.29035011374639935
132,1548417600,434,363,0,797,4,-0.43383237354399895,-0.45119673276625427
132,1548432000,1002,876,0,1878,4,-0.43383237354399895,1.0727807217588001
132,1548446400,1040,1134,94,2174,4,1.545344210953567,1.4900770460320805
132,1548460800,382,436,54,818,4,0.7031414090397092,-0.42159125030092015
132,1548475200,87,115,28,202,4,0.15570958779570163,-1.2900187359507198
132,1548489600,155,195,40,350,4,0.408370428369859,-1.0813705738140797
132,1548504000,428,453,25,881,4,0.09254437765216227,-0.33277480290491795
132,1548518400,353,647,294,1000,4,5.756358220522857,-0.16501040226802483
132,1548532800,1104,868,0,1972,4,-0.43383237354399895,1.2053005004131525
132,1548547200,322,313,0,635,4,-0.43383237354399895,-0.6795818832131172
132,1548561600,72,79,7,151,4,-0.2864468832090738,-1.3619177647951026
132,1548576000,137,132,0,269,4,-0.43383237354399895,-1.1955631490375112
132,1548590400,306,356,50,662,4,0.6189211288483235,-0.6415176914719734
132,1548604800,478,480,2,958,4,-0.39172223344830603,-0.22422136719869298
132,1548619200,455,474,19,929,4,-0.03378604263491641,-0.26510512869844005
132,1548633600,216,257,41,473,4,0.42942549841770544,-0.9079670336599801
132,1548648000,54,64,10,118,4,-0.22328167306553445,-1.408440665812056
132,1548662400,685,627,0,1312,4,-0.43383237354399895,0.2748424800740815
132,1548676800,1065,890,0,1955,4,-0.43383237354399895,1.181334157465025
132,1548691200,836,832,0,1668,4,-0.43383237354399895,0.7767258971054593
132,1548705600,1199,953,0,2152,4,-0.43383237354399895,1.4590617786874447
132,1548720000,310,286,0,596,5,-0.5247901259160588,-0.7106381754620018
132,1548734400,68,77,9,145,5,-0.1199520287808134,-1.3610492848358535
132,1548748800,782,614,0,1396,5,-0.5247901259160588,0.44308441322775743
132,1548763200,1251,927,0,2178,5,-0.5247901259160588,1.570848243671997
132,1548777600,807,726,0,1533,5,-0.5247901259160588,0.6406594065408787
132,1548792000,1183,957,0,2140,5,-0.5247901259160588,1.5160464207092335
132,1548806400,331,245,0,576,5,-0.5247901259160588,-0.7394812401792458
132,1548820800,73,80,7,153,5,-0.2099160503664235,-1.349512058948956
132,1548835200,661,542,0,1203,5,-0.5247901259160588,0.16474883870635304
132,1548849600,1112,948,0,2060,5,-0.5247901259160588,1.4006741618402576
132,1548864000,830,789,0,1619,5,-0.5247901259160588,0.7646845848250278
132,1548878400,1046,916,0,1962,5,-0.5247901259160588,1.2593431447257621
132,1548892800,285,238,0,523,5,-0.5247901259160588,-0.8159153616799423
132,1548907200,62,70,8,132,5,-0.16493403957361844,-1.379797276902062
132,1548921600,623,500,0,1123,5,-0.5247901259160588,0.049376579837377116
132,1548936000,974,749,0,1723,5,-0.5247901259160588,0.9146685213546966
132,1548950400,774,708,0,1482,5,-0.5247901259160588,0.5671095915119065
132,1548964800,966,895,0,1861,5,-0.5247901259160588,1.11368566790368
132,1548979200,279,271,0,550,5,-0.5247901259160588,-0.7769772243116629
132,1548993600,56,66,10,122,5,-0.07497001798800837,-1.394218809260684
132,1549008000,720,528,0,1248,5,-0.5247901259160588,0.22964573432015198
132,1549022400,1058,889,0,1947,5,-0.5247901259160588,1.237710846187829
132,1549036800,823,739,0,1562,5,-0.5247901259160588,0.6824818503808825
132,1549051200,1074,937,0,2011,5,-0.5247901259160588,1.3300086532830098
132,1549065600,329,319,0,648,5,-0.5247901259160588,-0.6356462071971674
132,1549080000,72,104,32,176,5,0.9146342194537025,-1.3163425345241253
132,1549094400,163,209,46,372,5,1.5443823705529731,-1.0336805002951344
132,1549108800,454,420,0,874,5,-0.5247901259160588,-0.3097195758923104
132,1549123200,572,616,44,1188,5,1.454418348967363,0.14311654016842004
132,1549137600,568,554,0,1122,5,-0.5247901259160588,0.047934426601514916
132,1549152000,266,310,44,576,5,1.454418348967363,-0.7394812401792458
132,1549166400,73,110,37,183,5,1.1395442734177277,-1.30624746187309
132,1549180800,113,130,17,243,5,0.2399040575616269,-1.219718267721358
132,1549195200,327,278,0,605,5,-0.5247901259160588,-0.697658796339242
132,1549209600,549,473,0,1022,5,-0.5247901259160588,-0.09628089698470499
132,1549224000,448,539,91,987,5,3.5685728562291996,-0.14675626023988195
132,1549238400,272,226,0,498,5,-0.5247901259160588,-0.8519691925764973
132,1549252800,57,75,18,132,5,0.2848860683544319,-1.379797276902062
132,1549267200,719,651,0,1370,5,-0.5247901259160588,0.40558842909534026
132,1549281600,977,1020,43,1997,5,1.409436338174558,1.309818507980939
132,1549296000,655,739,84,1394,5,3.253698780679564,0.44020010675603305
132,1549310400,1380,1116,0,2496,5,-0.5247901259160588,2.0294529726761765
132,1549324800,347,315,0,662,6,-0.5478063481182122,-0.5805870390569869
132,1549339200,83,71,0,154,6,-0.5478063481182122,-1.2917766067797776
132,1549353600,689,565,0,1254,6,-0.5478063481182122,0.2482008036435879
132,1549355444,251,175,0,426,6,-0.5478063481182122,-0.9109821925659999
132,1549368000,849,816,0,1665,6,-0.5478063481182122,0.8235923633563181
132,1549368690,51,35,0,86,6,-0.5478063481182122,-1.386975210333222
132,1549382400,759,802,43,1561,6,2.3404914273824438,0.677994499098109
132,1549396800,1031,978,0,2009,6,-0.5478063481182122,1.305185298979625
132,1549411200,366,348,0,714,6,-0.5478063481182122,-0.5077881069278823
132,1549425600,79,89,10,168,6,0.12389080897496356,-1.2721768942834801
132,1549440000,753,630,0,1383,6,-0.5478063481182122,0.42879815450232805
132,1549454400,1147,949,0,2096,6,-0.5478063481182122,1.4269835123494732
132,1549468800,833,859,26,1692,6,1.1986062603240446,0.8613918088848916
132,1549483200,1154,1048,0,2202,6,-0.5478063481182122,1.5753813355357247
132,1549497600,350,351,1,701,6,-0.4806366324088946,-0.5259878399601585
132,1549512000,63,82,19,145,6,0.7284182503588217,-1.3043764219559686
132,1549526400,753,577,0,1330,6,-0.5478063481182122,0.35459924290920225
132,1549526926,59,75,16,134,6,0.526909103230869,-1.3197761960602024
132,1549540800,987,935,0,1922,6,-0.5478063481182122,1.183387085609777
132,1549555200,885,853,0,1738,6,-0.5478063481182122,0.9257908642298687
132,1549569600,1153,1122,0,2275,6,-0.5478063481182122,1.6775798364092753
132,1549584000,334,351,17,685,6,0.5940788189401865,-0.5483875113844984
132,1549598400,109,72,0,181,6,-0.5478063481182122,-1.253977161251204
132,1549612800,870,678,0,1548,6,-0.5478063481182122,0.6597947660658329
132,1549627200,1154,1004,0,2158,6,-0.5478063481182122,1.51378223911879
132,1549641600,846,862,16,1708,6,0.526909103230869,0.8837914803092315
132,1549656000,1153,1032,0,2185,6,-0.5478063481182122,1.5515816846473636
132,1549670400,341,375,34,716,6,1.7359639859985854,-0.5049881479998399
132,1549684800,114,116,2,230,6,-0.413466916699577,-1.1853781675141633
132,1549699200,183,177,0,360,6,-0.5478063481182122,-1.003380837191402
132,1549713600,499,464,0,963,6,-0.5478063481182122,-0.1591932203865933
132,1549728000,615,550,0,1165,6,-0.5478063481182122,0.12360263134569743
132,1549742400,563,564,1,1127,6,-0.4806366324088946,0.07040341171289027
132,1549756800,318,298,0,616,6,-0.5478063481182122,-0.6449860944019641
132,1549771200,79,111,32,190,6,1.6016245545799501,-1.2413773460750128
132,1549785600,108,127,19,235,6,0.7284182503588217,-1.178378270194057
132,1549800000,306,362,56,668,6,3.213697731603572,-0.5721871622728595
132,1549814400,444,500,56,944,6,3.213697731603572,-0.1857928302029969
132,1549828800,471,453,0,924,6,-0.5478063481182122,-0.21379241948342173
132,1549843200,238,234,0,472,6,-0.5478063481182122,-0.8465831372210227
132,1549857600,53,72,19,125,6,0.7284182503588217,-1.3323760112363936
132,1549872000,710,578,0,1288,6,-0.5478063481182122,0.2958001054203101
132,1549886400,1099,912,0,2011,6,-0.5478063481182122,1.3079852579076676
132,1549900800,842,656,0,1498,6,-0.5478063481182122,0.5897957928647708
132,1549915200,1170,968,0,2138,6,-0.5478063481182122,1.4857826498383653
132,1549929600,310,318,8,628,7,-0.4173942206469816,-0.524505444058834
132,1549944000,59,76,17,135,7,-0.054366474117884214,-1.2404088121218038
132,1549958400,713,593,0,1306,7,-0.7400855508950682,0.46004320410890104
132,1549963296,547,455,0,1002,7,-0.7400855508950682,0.01859366274755668
132,1549972800,430,408,0,838,7,-0.7400855508950682,-0.21955674772369488
132,1549987200,768,732,0,1500,7,-0.7400855508950682,0.7417577140566011
132,1550001600,895,762,0,1657,7,-0.7400855508950682,0.9697431679833479
132,1550016000,248,294,46,542,7,1.1153895980314297,-0.6493891958913196
132,1550030400,55,52,0,107,7,-0.7400855508950682,-1.2810686382998222
132,1550044800,785,643,0,1428,7,-0.7400855508950682,0.6372038753131247
132,1550045275,47,49,2,96,7,-0.6594127183330466,-1.2970421414411866
132,1550059200,1177,978,0,2155,7,-0.7400855508950682,1.6929072192923922
132,1550073600,832,846,14,1678,7,-0.1753757229609167,1.0002380376168618
132,1550074015,31,33,2,64,7,-0.6594127183330466,-1.343510514216065
132,1550088000,1125,1099,0,2224,7,-0.7400855508950682,1.7931046480882238
132,1550102400,329,384,55,713,7,1.478417344560527,-0.4010738288755634
132,1550116800,75,70,0,145,7,-0.7400855508950682,-1.2258874456296542
132,1550131200,643,650,7,1293,7,-0.45773063692799243,0.4411654276691067
132,1550145600,1164,1030,0,2194,7,-0.7400855508950682,1.7495405486117752
132,1550146480,38,31,0,69,7,-0.7400855508950682,-1.3362498309699902
132,1550160000,862,880,18,1742,7,-0.014030057836873392,1.0931747831666185
132,1550174400,1261,1096,0,2357,7,-0.7400855508950682,1.986238822433812
132,1550188800,372,389,17,761,7,-0.054366474117884214,-0.33137126971324593
132,1550203200,74,103,29,177,7,0.42967052125424565,-1.1794190728547758
132,1550217600,682,575,0,1257,7,-0.7400855508950682,0.38888850829736854
132,1550232000,1108,1015,0,2123,7,-0.7400855508950682,1.646438846517514
132,1550246400,926,1013,87,1939,7,2.769182665552873,1.3792457030619634
132,1550260800,1096,1111,15,2207,7,-0.13503930667990585,1.7684183250515697
132,1550275200,376,446,70,822,7,2.083463588775689,-0.24279093411113406
132,1550289600,77,121,44,198,7,1.034716765469408,-1.1489242032212619
132,1550304000,181,225,44,406,7,1.034716765469408,-0.8468797801845526
132,1550318400,482,508,26,990,7,0.30866127241121316,0.0011680229569772985
132,1550332800,660,630,0,1290,7,-0.7400855508950682,0.43680901772146186
132,1550347200,549,584,35,1133,7,0.6716890189403106,0.20882356379471492
132,1550361600,328,355,27,683,7,0.34899768869222403,-0.4446379283520119
132,1550376000,70,112,42,182,7,0.9540439329073863,-1.1721583896087011
132,1550390400,111,135,24,246,7,0.22798843984919154,-1.0792216440589444
132,1550404800,323,375,52,698,7,1.3574080957174945,-0.42285587861378765
132,1550419200,564,477,0,1041,7,-0.7400855508950682,0.07522699206693967
132,1550433600,459,525,66,984,7,1.9221179236516461,-0.0075447969383123925
132,1550448000,238,244,6,482,7,-0.49806705320900324,-0.7365173948442165
132,1550462400,61,60,0,121,7,-0.7400855508950682,-1.2607387252108129
132,1550476800,236,238,2,474,7,-0.6594127183330466,-0.7481344880379361
132,1550491200,564,434,0,998,7,-0.7400855508950682,0.012785116150696886
132,1550505600,605,548,0,1153,7,-0.7400855508950682,0.2378662967790139
132,1550520000,588,677,89,1265,7,2.849855498114895,0.40050560149108816
132,1550534400,264,290,26,554,8,0.3780483582199844,-0.9974969938512364
132,1550548800,69,56,0,125,8,-0.7840313241902142,-1.607512974410296
132,1550563200,558,503,0,1061,8,-0.7840313241902142,-0.27656901682689305
132,1550577600,1136,986,0,2122,8,-0.7840313241902142,1.2321185248354902
132,1550592000,802,858,56,1660,8,1.7189095302317519,0.5751782380795797
132,1550606400,1069,926,0,1995,8,-0.7840313241902142,1.0515310434112464
132,1550620800,307,393,86,700,8,3.059770702243519,-0.7898924876469876
132,1550635200,67,71,4,138,8,-0.6052498345886451,-1.5890276416660822
132,1550649600,576,536,0,1112,8,-0.7840313241902142,-0.20404963452266917
132,1550664000,1056,961,0,2017,8,-0.7840313241902142,1.0828139142091469
132,1550678400,746,785,39,1531,8,0.9590881994250837,0.3917468593100722
132,1550692800,900,857,0,1757,8,-0.7840313241902142,0.7131072593248682
132,1550707200,285,268,0,553,8,-0.7840313241902142,-0.9989189425238683
132,1550721600,72,100,28,172,8,0.4674391030207689,-1.5406813867965996
132,1550736000,561,447,0,1008,8,-0.7840313241902142,-0.35193229647638063
132,1550750400,1033,926,0,1959,8,-0.7840313241902142,1.0003408911965002
132,1550764800,810,829,19,1639,8,0.06518075141723866,0.545317315954311
132,1550779200,1079,1089,10,2168,8,-0.3370776001862916,1.2975281637765548
132,1550793600,371,411,40,782,8,1.003783571825476,-0.6732926964911766
132,1550808000,89,117,28,206,8,0.4674391030207689,-1.492335131927117
132,1550822400,530,516,0,1046,8,-0.7840313241902142,-0.2978982469163707
132,1550836800,996,1026,30,2022,8,0.5568298478215534,1.0899236575723061
132,1550851200,825,835,10,1660,8,-0.3370776001862916,0.5751782380795797
132,1550865600,1050,1095,45,2145,8,1.2272604338274373,1.2648233443060224
132,1551484800,24,0,0,24,9,-0.8511770056979967,-1.4435040363998923
132,1551499200,90,131,41,221,9,0.5026346973302824,-1.0775975875419312
132,1551513600,183,213,30,396,9,0.13941692334708564,-0.7525537877950114
132,1551528000,479,478,0,957,9,-0.8511770056979967,0.2894437645365429
132,1551542400,618,696,78,1314,9,1.7243672098192173,0.9525331160202594
132,1551556800,566,604,38,1170,9,0.4035753044257743,0.6850685036570796
132,1551571200,306,309,3,615,9,-0.7521176127934884,-0.3457846898260089
132,1551585600,102,143,41,245,9,0.5026346973302824,-1.033020152148068
132,1551600000,134,143,9,277,9,-0.553998826984472,-0.9735835716229169
132,1551614400,352,376,24,728,9,-0.05870186246193083,-0.13589926484656925
132,1551628800,506,603,97,1109,9,2.351743364881103,0.5717675220310104
132,1551643200,445,522,77,967,9,1.6913474121843812,0.30801769595065265
132,1551657600,242,208,0,450,9,-0.8511770056979967,-0.6522545581588189
132,1551672000,59,51,0,110,9,-0.8511770056979967,-1.2837682262385488
132,1551686400,434,385,0,819,9,-0.8511770056979967,0.03312351102182904
132,1551700800,998,764,0,1762,9,-0.8511770056979967,1.784645243372374
132,1551715200,741,730,0,1471,9,-0.8511770056979967,1.2441438392217816
132,1551729600,880,906,26,1786,9,0.007337732807741325,1.8292226787662373
132,1551744000,291,341,50,632,10,0.7935671277274833,-0.6651898225759922
132,1551758400,67,63,0,130,10,-0.5300474901652106,-1.250416971506866
132,1551772800,797,739,0,1536,10,-0.5300474901652106,0.38868536195291203
132,1551787200,1179,952,0,2131,10,-0.5300474901652106,1.0823310862833302
132,1551801600,898,843,0,1741,10,-0.5300474901652106,0.627672544285241
132,1551816000,1135,1184,49,2319,10,0.7670948353696293,1.3014998193490757
132,1551830400,375,392,17,767,10,-0.08001852008169469,-0.5078080195766537
132,1551844800,64,97,33,161,10,0.34353815764396733,-1.2142774463736845
132,1551859200,720,602,0,1322,10,-0.5300474901652106,0.13920605942062717
132,1551873600,1234,913,0,2147,10,-0.5300474901652106,1.100983744416585
132,1551888000,884,777,0,1661,10,-0.5300474901652106,0.5344092536189663
132,1551902400,1124,1112,0,2236,10,-0.5300474901652106,1.2047391552828157
132,1551916800,353,356,3,709,10,-0.450630613091649,-0.5754239053097028
132,1551931200,76,85,9,161,10,-0.29179685894452567,-1.2142774463736845
132,1551945600,677,644,0,1321,10,-0.5300474901652106,0.13804026828729873
132,1551960000,1108,1083,0,2191,10,-0.5300474901652106,1.1522785542830363
132,1551974400,842,899,57,1741,10,0.9788731742324603,0.627672544285241
132,1551988800,1294,1094,0,2388,10,-0.5300474901652106,1.3819394075487377
132,1552003200,353,413,60,766,10,1.058290051306022,-0.508973810709982
132,1552017600,61,279,218,340,10,5.240912243846934,-1.005600833507895
132,1552032000,729,680,0,1409,10,-0.5300474901652106,0.24062988802020094
132,1552046400,1141,1054,0,2195,10,-0.5300474901652106,1.15694171881635
132,1552060800,957,960,3,1917,10,-0.450630613091649,0.8328517837510453
132,1552075200,1117,1154,37,2271,10,0.44942732707538285,1.245541844949311
132,1552089600,365,368,3,733,10,-0.450630613091649,-0.5474449181098203
132,1552104000,101,114,13,215,10,-0.18590768951311018,-1.1513247251739491
132,1552118400,301,222,0,523,10,-0.5300474901652106,-0.7922610561087915
132,1552132800,703,576,0,1279,10,-0.5300474901652106,0.08907704068750452
132,1552147200,619,701,82,1320,10,1.6406804831788073,0.1368744771539703
132,1552161600,611,645,34,1256,10,0.3700104500018212,0.06226384462095054
132,1552176000,351,356,5,707,10,-0.3976860283759412,-0.5777554875763596
132,1552194000,79,126,47,205,10,0.7141502506539216,-1.1629826365072335
132,1552208400,171,166,0,337,10,-0.5300474901652106,-1.0090982069078802
132,1552218076,201,228,27,429,10,0.18470440349684408,-0.9018454226416642
132,1552218161,2,10,8,12,10,-0.3182691513023796,-1.3879803252396212
132,1552222800,152,151,0,303,10,-0.5300474901652106,-1.048735105441047
132,1552237200,507,518,11,1025,10,-0.23885227422881794,-0.20703390717791767
132,1552251600,394,471,77,865,10,1.5083190213895379,-0.3935604885104671
132,1552266000,172,206,34,378,10,0.3700104500018212,-0.9613007704414144
132,1552280400,55,59,4,114,10,-0.42415832073379506,-1.269069629640121
132,1552294800,558,520,0,1078,10,-0.5300474901652106,-0.1452469771115107
132,1552309200,2049,1892,0,3941,10,-0.5300474901652106,3.1924130376077957
132,1552323600,1033,1027,0,2060,10,-0.5300474901652106,0.9995599158170114
132,1552338000,981,961,0,1942,10,-0.5300474901652106,0.8619965620842562
132,1552352400,241,276,35,517,11,0.1858819011012044,-0.8394818328295846
132,1552366800,69,122,53,191,11,0.6155433446302179,-1.271618256233411
132,1552381200,1105,1124,19,2229,11,-0.19603938203569646,1.4298971759659702
132,1552395600,838,985,147,1823,11,2.8593308830595103,0.8917150044875851
132,1552410000,1126,1047,0,2173,11,-0.6495709057607663,1.3556651523137793
132,1552424400,992,951,0,1943,11,-0.6495709057607663,1.050783626599423
132,1552438800,290,286,0,576,11,-0.6495709057607663,-0.7612730936245975
132,1552453200,54,75,21,129,11,-0.14829922164358386,-1.353803710991194
132,1552464330,797,680,0,1477,11,-0.6495709057607663,0.4330671440651191
132,1552467600,430,398,0,828,11,-0.6495709057607663,-0.42722898718973784
132,1552472546,386,407,21,793,11,-0.14829922164358386,-0.47362400197235727
132,1552477769,238,280,42,518,11,0.35297246247359854,-0.8381562609786526
132,1552482000,207,262,55,469,11,0.6632835050223305,-0.9031092816743197
132,1552486141,252,208,0,460,11,-0.6495709057607663,-0.9150394283327076
132,1552496400,776,791,15,1567,11,-0.2915197028199217,0.5523686106489976
132,1552510800,1009,1014,5,2023,11,-0.5302205047804847,1.1568293746739817
132,1552525200,300,262,0,562,11,-0.6495709057607663,-0.7798310995376453
132,1552539600,61,69,8,130,11,-0.4586102641923158,-1.3524781391402618
132,1552551978,957,748,0,1705,11,-0.6495709057607663,0.7352975260776112
132,1552554000,271,237,0,508,11,-0.6495709057607663,-0.8514119794879724
132,1552568400,770,952,182,1722,11,3.694783689921481,0.7578322475434549
132,1552582800,1115,1124,9,2239,11,-0.4347401839962595,1.44315289447529
132,1552597200,1483,1041,0,2524,11,-0.6495709057607663,1.8209408719909053
132,1552611600,399,287,0,686,11,-0.6495709057607663,-0.6154601900220794
132,1552626000,80,74,0,154,11,-0.6495709057607663,-1.3206644147178943
132,1552640400,1120,1088,0,2208,11,-0.6495709057607663,1.4020601670963986
132,1552654800,854,973,119,1827,11,2.190968637569934,0.8970172918913131
132,1552669200,1117,1115,0,2232,11,-0.6495709057607663,1.433873891518766
132,1552683600,1340,942,0,2282,11,-0.6495709057607663,1.5001524840653653
132,1552698000,479,282,0,761,11,-0.6495709057607663,-0.5160423012021808
132,1552712400,77,82,5,159,11,-0.5302205047804847,-1.3140365554632345
132,1552726800,346,290,0,636,11,-0.6495709057607663,-0.6817387825686786
132,1552741200,653,576,0,1229,11,-0.6495709057607663,0.10432532503398731
132,1552755600,677,779,102,1456,11,1.785177274236977,0.4052301351955474
132,1552770000,541,611,70,1152,11,1.0213347079631752,0.0022562925122246195
132,1552784400,281,283,2,564,11,-0.6018307453686537,-0.7771799558357814
132,1552798800,48,77,29,125,11,0.04266141992486657,-1.3591059983949219
132,1552813200,194,191,0,385,11,-0.6495709057607663,-1.0144573171526063
132,1552827600,440,514,74,954,11,1.1168150287474004,-0.260206933972308
132,1552842000,614,554,0,1168,11,-0.6495709057607663,0.023465442127136346
132,1552856400,447,522,75,969,11,1.1406851089434566,-0.24032335620832826
132,1552870800,191,209,18,400,11,-0.21990946223175276,-0.9945737393886266
132,1552885200,45,72,27,117,11,-0.005078740467246034,-1.3697105732023778
132,1552899600,1083,1075,0,2158,11,-0.6495709057607663,1.3357815745497994
132,1552914000,846,855,9,1701,11,-0.4347401839962595,0.7299952386738833
132,1552928400,916,993,77,1909,11,1.1884252693355692,1.0057141836677357
132,1552942800,833,893,60,1726,11,0.7826339060026121,0.7631345349471829
132,1552957200,209,310,101,519,12,1.2606425905554806,-0.9473242664727092
132,1552971600,49,71,22,120,12,-0.291997392912628,-1.4679611567242394
132,1552986000,1151,1059,0,2210,12,-0.7243781478024811,1.2591844588790144
132,1553000400,875,857,0,1732,12,-0.7243781478024811,0.6354640740664041
132,1553014800,1048,1027,0,2075,12,-0.7243781478024811,1.0830291200721056
132,1553029200,1011,964,0,1975,12,-0.7243781478024811,0.9525436839188398
132,1553043600,276,275,0,551,12,-0.7243781478024811,-0.9055689269036642
132,1553058000,43,78,35,121,12,-0.036499674114078444,-1.4666563023627068
132,1553072400,1190,1099,0,2289,12,-0.7243781478024811,1.3622679534400943
132,1553086800,858,799,0,1657,12,-0.7243781478024811,0.5375999969514548
132,1553101200,1075,1008,0,2083,12,-0.7243781478024811,1.0934679549643669
132,1553115600,995,969,0,1964,12,-0.7243781478024811,0.9381902859419806
132,1553130000,273,276,3,549,12,-0.6654171357720465,-0.9081786356267295
132,1553144400,59,65,6,124,12,-0.6064561237416121,-1.4627417392781088
132,1553158800,1163,1037,0,2200,12,-0.7243781478024811,1.2461359152636877
132,1553173200,927,698,0,1625,12,-0.7243781478024811,0.4958446573824098
132,1553187600,997,1081,84,2078,12,0.9265301890496852,1.0869436831567036
132,1553202000,910,913,3,1823,12,-0.6654171357720465,0.754205820965876
132,1553216400,226,280,54,506,12,0.33692006874534014,-0.9642873731726338
132,1553230800,52,72,20,124,12,-0.331304734266251,-1.4627417392781088
132,1553245200,1023,934,0,1957,12,-0.7243781478024811,0.9290563054112521
132,1553259600,854,993,139,1847,12,2.007482076274318,0.7855223256426597
132,1553274000,980,1115,135,2095,12,1.9288673935670717,1.1091262073027588
132,1553288400,880,1020,140,1900,12,2.0271357469511293,0.8546796068038905
132,1553302800,302,326,24,628,12,-0.252690051559005,-0.8050951410656496
132,1553317200,54,92,38,146,12,0.022461337916356062,-1.4340349433243904
132,1553331600,319,368,49,687,12,0.2386517153612826,-0.7281087337352228
132,1553346000,556,630,74,1186,12,0.7299934822815701,-0.07698640733042678
132,1553360400,715,646,0,1361,12,-0.7243781478024811,0.15136310593778826
132,1553374800,520,730,210,1250,12,3.4028926943279343,0.006524271807663287
132,1553389200,278,321,43,599,12,0.12072969130041358,-0.8429359175500967
132,1553403600,60,94,34,154,12,-0.05615334479088995,-1.4235961084321291
132,1553418000,199,224,25,423,12,-0.23303638088219347,-1.0725902851798443
132,1553432400,425,542,117,967,12,1.5751013213844647,-0.36274951250607873
132,1553446800,608,667,59,1275,12,0.4351884221293976,0.03914563084597972
132,1553461200,485,588,103,1073,12,1.2999499319091037,-0.22443495018361706
132,1553475600,236,208,0,444,12,-0.7243781478024811,-1.0451883435876586
132,1553490000,47,47,0,94,12,-0.7243781478024811,-1.5018873701240887
132,1553504400,1160,1080,0,2240,12,-0.7243781478024811,1.298330089724994
132,1553518800,837,776,0,1613,12,-0.7243781478024811,0.4801864050440179
132,1553533200,1055,1085,30,2140,12,-0.13476802749813596,1.1678446535717284
132,1553547600,988,898,0,1886,12,-0.7243781478024811,0.8364116457424333
132,1553562000,263,274,11,537,13,-0.5791640029901441,-0.9767953647956225
132,1553576400,46,75,29,121,13,-0.34651363834585674,-1.5101256339740323
132,1553590800,1180,1098,0,2278,13,-0.7213392258283199,1.2552430934726746
132,1553605200,879,862,0,1741,13,-0.7213392258283199,0.5667855104226599
132,1553619600,1053,1121,68,2174,13,0.1575621517167661,1.121910526178072
132,1553634000,1085,1017,0,2102,13,-0.7213392258283199,1.0296033642048856
132,1553648400,297,309,12,606,13,-0.5662389827321282,-0.8883343345713189
132,1553662800,64,86,22,150,13,-0.4369887801519685,-1.472946360401499
132,1553677200,1154,997,0,2151,13,-0.7213392258283199,1.0924235161033042
132,1553691600,898,906,8,1804,13,-0.617939063764192,0.6475542771491979
132,1553706000,971,1097,126,2068,13,0.9072133266816923,0.9860138710508811
132,1553720400,1002,888,0,1890,13,-0.7213392258283199,0.7578100539505038
132,1553734800,307,253,0,560,13,-0.7213392258283199,-0.9473083547208546
132,1553749200,59,68,9,127,13,-0.6050140435061762,-1.5024333704762667
132,1553763600,1123,1049,0,2172,13,-0.7213392258283199,1.1193464383454836
132,1553778000,854,799,0,1653,13,-0.7213392258283199,0.45396564578876547
132,1553792400,1006,1204,198,2210,13,1.8378147852588425,1.1680641071646651
132,1553806800,1114,1049,0,2163,13,-0.7213392258283199,1.1078080430988353
132,1553821200,277,346,69,623,13,0.17048717197478208,-0.8665395879943165
132,1553835601,68,79,11,147,13,-0.5791640029901441,-1.4767924921503817
132,1553850000,1111,1001,0,2112,13,-0.7213392258283199,1.0424238033678284
132,1553864400,913,959,46,1872,13,-0.12678829395958524,0.7347332634572072
132,1553878800,1040,1126,86,2166,13,0.39021251636105353,1.111654174847718
132,1553893200,1009,944,0,1953,13,-0.7213392258283199,0.8385788206770418
132,1553907600,282,376,94,658,13,0.4936126784251813,-0.8216680509240176
132,1553922000,60,98,38,158,13,-0.230188456023713,-1.462690009071145
132,1553936400,319,423,104,742,13,0.622862881005341,-0.7139763619553003
132,1553950800,626,777,151,1403,13,1.2303388331320917,0.1334546667152019
132,1553965200,723,1056,333,1779,13,3.5826925200909985,0.6155031792418415
132,1553979600,559,844,285,1403,13,2.962291547706232,0.1334546667152019
132,1553994000,298,465,167,763,13,1.4371391572603471,-0.6870534397131209
132,1554008400,78,141,63,219,13,0.09293705042668625,-1.3844853301771953
132,1554022800,187,226,39,413,13,-0.217263435765697,-1.13576881041611
132,1554037200,460,505,45,965,13,-0.1397133142176012,-0.42808056862168153
132,1554051600,536,680,144,1216,13,1.1398636913259799,-0.10628754563182369
132,1554066000,425,532,107,957,13,0.661637941779389,-0.4383369199520356
132,1554080400,213,219,6,432,13,-0.6437891042802241,-1.1114099760065193
132,1554094800,53,59,6,112,13,-0.6437891042802241,-1.5216640292206807
132,1554109200,1056,1074,18,2130,13,-0.4886888611840324,1.0655005938611248
132,1554123600,909,769,0,1678,13,-0.7213392258283199,0.48601674369612186
132,1554138000,1062,1111,49,2173,13,-0.08801323318553733,1.1206284822617778
132,1554152400,1043,930,0,1973,13,-0.7213392258283199,0.8642196990029269
132,1554166800,265,323,58,588,14,0.4644313595301007,-0.9216904273909777
132,1554181200,60,79,19,139,14,-0.4089768688399393,-1.4849738988800745
132,1554195600,1199,1148,0,2347,14,-0.8344834416355997,1.2850258896453723
132,1554210000,871,888,17,1759,14,-0.45376703439737726,0.5473629024837044
132,1554224400,1093,1081,0,2174,14,-0.8344834416355997,1.0679923917219565
132,1554238800,983,983,0,1966,14,-0.8344834416355997,0.8070503826579651
132,1554253200,241,333,92,574,14,1.2258641740065457,-0.9392538318472079
132,1554267600,68,68,0,136,14,-0.8344834416355997,-1.4887374855492668
132,1554282000,1265,1165,0,2430,14,-0.8344834416355997,1.3891517874930228
132,1554296400,963,867,0,1830,14,-0.8344834416355997,0.6364344536545862
132,1554310800,1086,1207,121,2293,14,1.875321574589396,1.2172813295999132
132,1554325200,1079,1055,0,2134,14,-0.8344834416355997,1.0178112361327274
132,1554339600,268,299,31,567,14,-0.1402358754953116,-0.948035534075323
132,1554354000,66,68,2,134,14,-0.7896932760781619,-1.491246543328728
132,1554368400,1165,1054,0,2219,14,-0.8344834416355997,1.1244461917598392
132,1554382800,857,943,86,1800,14,1.0914936773342319,0.5987985869626643
132,1554397200,1094,1182,88,2276,14,1.13628384289167,1.1959543384744908
132,1554411600,1108,967,0,2075,14,-0.8344834416355997,0.9437940316386144
132,1554426000,282,360,78,642,14,0.9123330151044802,-0.8539458673455185
132,1554440400,64,92,28,156,14,-0.20742112383146852,-1.4636469077546521
132,1554454800,1113,972,0,2085,14,-0.8344834416355997,0.9563393205359217
132,1554469200,892,935,43,1827,14,0.12850511784931606,0.632670866985394
132,1554483600,1016,1110,94,2126,14,1.2706543395639838,1.0077750050148815
132,1554498000,1007,961,0,1968,14,-0.8344834416355997,0.8095594404374266
132,1554512400,280,367,87,647,14,1.113888760112951,-0.8476732228968648
132,1554526800,52,90,38,142,14,0.016529703955721207,-1.4812103122108824
132,1554541200,330,506,176,836,14,3.1070511274189396,-0.6105672627377572
132,1554555600,650,743,93,1393,14,1.2482592567852648,0.08820532884225812
132,1554570000,822,931,109,1753,14,1.6065805812447684,0.5398357291453201
132,1554584400,658,695,37,1353,14,-0.0058653788229977655,0.038024173253029016
132,1554598800,292,349,57,641,14,0.4420362767513817,-0.8552003962352491
132,1554613200,75,104,29,179,14,-0.18502604105274956,-1.4347927432908454
132,1554627600,214,236,22,450,14,-0.34179162050378237,-1.0948154141738182
132,1554642000,496,616,120,1112,14,1.8529264918106771,-0.26431728917207636
132,1554656400,631,638,7,1269,14,-0.677717862184567,-0.06735625348435212
132,1554670800,522,459,0,981,14,-0.8344834416355997,-0.4286605737268017
132,1554685200,212,222,10,434,14,-0.6105326138484101,-1.1148878764095098
132,1554699600,56,66,10,122,14,-0.6105326138484101,-1.5063008900054968
132,1554714000,1119,1051,0,2170,14,-0.8344834416355997,1.0629742761630336
132,1554728400,913,926,13,1839,14,-0.5433473655122532,0.6477252136621627
132,1554742800,1057,1010,0,2067,14,-0.8344834416355997,0.9337578005207686
132,1554757200,996,924,0,1920,14,-0.8344834416355997,0.7493420537303517
132,1554771600,280,273,0,553,15,-0.7831963274753312,-0.8945829045876775
132,1554786000,59,56,0,115,15,-0.7831963274753312,-1.437160457293066
132,1554800400,1205,1107,0,2312,15,-0.7831963274753312,1.2843986369848757
132,1554814800,879,883,4,1762,15,-0.7116269849853736,0.6030797922634975
132,1554829200,1045,1016,0,2061,15,-0.7831963274753312,0.9734694914847559
132,1554843600,1041,930,0,1971,15,-0.7831963274753312,0.8619809532576213
132,1554858000,256,268,12,524,15,-0.5684883000054585,-0.930506989127532
132,1554872400,61,62,1,123,15,-0.7653039918528418,-1.4272503650062096
132,1554886800,1212,1108,0,2320,15,-0.7831963274753312,1.2943087292717321
132,1554887407,68,89,21,157,15,-0.40745727940305393,-1.3851324727870697
132,1554901200,851,816,0,1667,15,-0.7831963274753312,0.48539744635707766
132,1554915600,1075,1105,30,2180,15,-0.2464262588006494,1.1208821142517449
132,1554930000,1073,1080,7,2153,15,-0.6579499781179055,1.0874355527836046
132,1554944400,391,261,0,652,15,-0.7831963274753312,-0.7719455125378294
132,1554958800,103,192,89,295,15,0.8092215429262248,-1.2141833808387967
132,1554973200,1187,1051,0,2238,15,-0.7831963274753312,1.192730283331454
132,1554987600,891,898,7,1789,15,-0.6579499781179055,0.6365263537316379
132,1555002000,1072,1097,25,2169,15,-0.3358879369130964,1.1072557373573175
132,1555016400,1059,995,0,2054,15,-0.7831963274753312,0.9647981607337566
132,1555030800,316,297,0,613,15,-0.7831963274753312,-0.8202572124362544
132,1555045200,59,71,12,130,15,-0.5684883000054585,-1.4185790342552103
132,1555059600,1077,993,0,2070,15,-0.7831963274753312,0.9846183453074694
132,1555059687,6,7,1,13,15,-0.7653039918528418,-1.5635141339504852
132,1555074000,910,1025,115,1935,15,1.274422269110949,0.8173855379667674
132,1555088400,1105,1242,137,2347,15,1.6680536528057157,1.3277552907398726
132,1555102800,1163,948,0,2111,15,-0.7831963274753312,1.0354075682776085
132,1555117200,273,418,145,691,15,1.8111923377856307,-0.7236338126394044
132,1555131600,71,105,34,176,15,-0.1748569163106918,-1.361596003605786
132,1555146000,357,437,80,794,15,0.6481905223238204,-0.5960413744461281
132,1555160400,656,745,89,1401,15,0.8092215429262248,0.15588687781910202
132,1555174800,778,934,156,1712,15,2.008008029633014,0.5411417154706449
132,1555189200,625,830,205,1455,15,2.8847324751349945,0.2227800007553828
132,1555203600,293,384,91,677,15,0.8450062141712036,-0.7409764741414031
132,1555218000,58,99,41,157,15,-0.04961056695326606,-1.3851324727870697
132,1555232400,219,325,106,544,15,1.1133912485085444,-0.905731758410391
132,1555246800,547,637,90,1184,15,0.8271138785487142,-0.11292437546187813
132,1555261200,630,783,153,1413,15,1.954331022765546,0.17075201624938663
132,1555275600,481,585,104,1066,15,1.0776065772635657,-0.2590982366930102
132,1555290000,199,301,102,500,15,1.041821906018587,-0.9602372659881012
132,1555304400,52,68,16,120,15,-0.4969189575155009,-1.4309666496137807
132,1555318800,1136,1040,0,2176,15,-0.7831963274753312,1.1159270681083169
132,1555333200,898,947,49,1845,15,0.09352811802664909,0.7058969997396328
132,1555347600,1019,1023,4,2042,15,-0.7116269849853736,0.9499330223034719
132,1555362000,952,888,0,1840,15,-0.7831963274753312,0.6997031920603476
132,1555376400,250,297,47,547,16,-0.05187108916915899,-0.9709486924803951
132,1555390800,88,68,0,156,16,-0.9660990357755869,-1.502180390894956
132,1555405200,1174,1116,0,2290,16,-0.9660990357755869,1.3971762444418039
132,1555419600,1055,919,0,1974,16,-0.9660990357755869,0.9678432094059951
132,1555434000,998,1000,2,1998,16,-0.9271957188987177,1.0004507816871957
132,1555448400,1034,968,0,2002,16,-0.9660990357755869,1.005885377067396
132,1555462800,306,384,78,690,16,0.5511303224223147,-0.7766619076382411
132,1555477200,60,89,29,149,16,-0.40200094106098244,-1.5116909328103063
132,1555491600,1122,1095,0,2217,16,-0.9660990357755869,1.297994878753152
132,1555506000,879,942,63,1821,16,0.2593554458457952,0.7599699361133407
132,1555520400,1068,1053,0,2121,16,-0.9660990357755869,1.1675645896283493
132,1555534800,1143,954,0,2097,16,-0.9660990357755869,1.1349570173471486
132,1555549200,302,384,82,686,16,0.6289369561760533,-0.7820965030184411
132,1555563600,47,70,23,117,16,-0.5187108916915902,-1.5551676958519072
132,1555578000,1223,1066,0,2289,16,-0.9660990357755869,1.395817595596754
132,1555592400,1019,920,0,1939,16,-0.9660990357755869,0.920290499829244
132,1555606800,1105,1124,19,2229,16,-0.5965175254453288,1.3142986648937522
132,1555621200,1059,967,0,2026,16,-0.9660990357755869,1.0384929493485966
132,1555635600,264,423,159,687,16,2.1267146559355203,-0.7807378541733911
132,1555650000,75,88,13,163,16,-0.7132274760759366,-1.4926698489796058
132,1555664400,720,793,73,1513,16,0.45387203023014155,0.3415060918379321
132,1555678800,772,889,117,1661,16,1.3097450015212657,0.5425861209053363
132,1555693200,919,997,78,1916,16,0.5511303224223147,0.8890415763930934
132,1555707600,768,891,123,1659,16,1.4264549521518735,0.5398688232152362
132,1555722000,312,326,14,638,16,-0.693775817637502,-0.8473116475808424
132,1555736400,59,110,51,169,16,0.02593554458457956,-1.4845179559093056
132,1555750800,287,358,71,645,16,0.4149687133532723,-0.8378011056654923
132,1555765200,541,643,102,1184,16,1.017970124944746,-0.10548937818352713
132,1555779600,638,834,196,1472,16,2.8464260181576018,0.28580148919088094
132,1555794000,522,636,114,1158,16,1.2513900262059618,-0.14081424815482788
132,1555808400,295,388,93,683,16,0.8429051989988343,-0.7861724495535912
132,1555822800,72,105,33,177,16,-0.3241943073072439,-1.4736487651489054
132,1555837200,212,245,33,457,16,-0.3241943073072439,-1.0932270885348976
132,1555851600,506,673,167,1179,16,2.2823279234429976,-0.11228262240877727
132,1555866000,617,640,23,1257,16,-0.5187108916915902,-0.006308012494875086
132,1555880400,608,592,0,1200,16,-0.9660990357755869,-0.08375099666272669
132,1555894800,238,306,68,544,16,0.35661373803796836,-0.9750246390155451
132,1555909200,58,70,12,128,16,-0.7326791345143713,-1.540222558556357
132,1555923600,896,983,87,1879,16,0.7261952483682265,0.8387715691262424
132,1555938000,844,913,69,1757,16,0.376065396476403,0.673016410030139
132,1555952400,938,864,0,1802,16,-0.9660990357755869,0.7341556080573902
132,1555966800,833,880,47,1713,16,-0.05187108916915899,0.6132358608479377
132,1555981200,264,262,0,526,17,-0.6840222128190817,-0.9592207887428454
132,1555995600,56,78,22,134,17,-0.2665608359070398,-1.5141068105221998
132,1556010000,1098,1033,0,2131,17,-0.6840222128190817,1.3126977443078278
132,1556024400,826,845,19,1671,17,-0.3234873873041364,0.6615559840565446
132,1556038800,1048,1014,0,2062,17,-0.6840222128190817,1.2150264802701354
132,1556053200,937,1016,79,1953,17,0.815043640637796,1.0607341936018966
132,1556067600,272,285,13,557,17,-0.43734049009832965,-0.915339496204172
132,1556082000,49,75,26,124,17,-0.19065876737757764,-1.5282620661798365
132,1556096400,1096,941,0,2037,17,-0.6840222128190817,1.1796383411260438
132,1556110800,943,832,0,1775,17,-0.6840222128190817,0.8087706428959651
132,1556125200,977,998,21,1975,17,-0.28553635303940533,1.091875756048697
132,1556139600,907,931,24,1838,17,-0.2286098016423087,0.8979487535390757
132,1556154000,320,292,0,612,17,-0.6840222128190817,-0.8374855900871707
132,1556168400,59,63,4,122,17,-0.6081201442896195,-1.5310931173113638
132,1556182800,917,900,0,1817,17,-0.6840222128190817,0.8682227166580389
132,1556197200,868,945,77,1813,17,0.7770926063730649,0.8625606143949842
132,1556211600,1016,990,0,2006,17,-0.6840222128190817,1.1357570485873705
132,1556226000,891,947,56,1838,17,0.37860674659338855,0.8979487535390757
132,1556240400,283,360,77,643,17,0.7770926063730649,-0.7936042975484973
132,1556254800,74,68,0,142,17,-0.6840222128190817,-1.5027826059960905
132,1556269200,806,831,25,1637,17,-0.20963428450994318,0.6134281148205801
132,1556283600,768,875,107,1643,17,1.3463581203440311,0.6219212682151621
132,1556298000,921,941,20,1862,17,-0.3045118701717709,0.9319213671174035
132,1556312400,819,932,113,1751,17,1.4602112231382243,0.7747980293176373
132,1556326800,286,296,10,582,17,-0.4942670414954263,-0.8799513570600804
132,1556341200,74,85,11,159,17,-0.4752915243630607,-1.4787186713781084
132,1556355600,339,355,16,694,17,-0.380413938701233,-0.7214124936945506
132,1556370000,550,609,59,1159,17,0.4355332979904852,-0.06319310561444903
132,1556384400,684,723,39,1407,17,0.05602295534317439,0.2878572346949385
132,1556398800,576,587,11,1163,17,-0.4752915243630607,-0.0575310033513944
132,1556413200,311,346,35,657,17,-0.019879113186287774,-0.773786939627806
132,1556427600,54,112,58,166,17,0.4165577808581197,-1.4688099924177627
132,1556442000,231,220,0,451,17,-0.6840222128190817,-1.06538520617512
132,1556456400,424,525,101,949,17,1.232505017549838,-0.3604534744248175
132,1556470800,581,674,93,1255,17,1.0807008804909135,0.07269734869886227
132,1556485200,465,507,42,972,17,0.112949506740271,-0.3278963864122533
132,1556499600,300,220,0,520,17,-0.6840222128190817,-0.9677139421374273
132,1556514000,76,51,0,127,17,-0.6840222128190817,-1.5240154894825455
132,1556528400,880,1176,296,2056,17,4.9327308583611185,1.2065333268755534
132,1556542800,871,851,0,1722,17,-0.6840222128190817,0.7337477879104912
132,1556557200,965,1025,60,1990,17,0.45450881512285074,1.113108639535152
132,1556571600,975,880,0,1855,17,-0.6840222128190817,0.9220126881570578
132,1556586000,259,255,0,514,18,-0.772069643901654,-0.9283737686504849
132,1556600400,62,59,0,121,18,-0.772069643901654,-1.4139587416542414
132,1556614800,1135,1153,18,2288,18,-0.3955430687969065,1.2635543283181256
132,1556629200,873,893,20,1766,18,-0.35370678267415673,0.6185788679925254
132,1556643600,1042,1135,93,2177,18,1.1733176608062084,1.1264043741109577
132,1556658000,1066,931,0,1997,18,-0.772069643901654,0.9039990429641991
132,1556672400,315,369,54,684,18,0.3575100814125886,-0.7183242892341017
132,1556686800,76,73,0,149,18,-0.772069643901654,-1.3793623568091902
132,1556701200,1100,1047,0,2147,18,-0.772069643901654,1.0893368189198314
132,1556715600,859,963,104,1822,18,1.4034172344813318,0.6877716376826281
132,1556730000,1006,1112,106,2118,18,1.4452535206040815,1.0535048489017425
132,1556744400,1070,1000,0,2070,18,-0.772069643901654,0.9941967605959401
132,1556758800,333,310,0,643,18,-0.772069643901654,-0.7689832813286412
132,1556773200,70,87,17,157,18,-0.41646121185828133,-1.3694776754248896
132,1556787600,1170,1099,0,2269,18,-0.772069643901654,1.2400782100304122
132,1556787807,15,16,1,31,18,-0.7511515008402792,-1.5251614072276207
132,1556790051,173,186,13,359,18,-0.5001337841037807,-1.119889470471305
132,1556802000,706,710,4,1416,18,-0.6883970716561545,0.18612405742938354
132,1556816400,1213,1144,0,2357,18,-0.772069643901654,1.3488097052577164
132,1556830800,1095,935,0,2030,18,-0.772069643901654,0.9447733536744382
132,1556845200,317,360,43,677,18,0.12741050773746512,-0.7269733854453646
132,1556859600,68,120,52,188,18,0.3156737952898389,-1.3311745350607256
132,1556874000,1133,950,0,2083,18,-0.772069643901654,1.0102593678454281
132,1556888400,918,1065,147,1983,18,2.302897386120451,0.8867008505416734
132,1556902800,1137,1294,157,2431,18,2.5120788167341996,1.440243008062495
132,1556917200,1065,877,0,1942,18,-0.772069643901654,0.8360418584471339
132,1556931600,356,406,50,762,18,0.27383750916708915,-0.621948645737173
132,1556946000,58,120,62,178,18,0.5248552259035876,-1.3435303867911013
132,1556960400,324,341,17,665,18,-0.41646121185828133,-0.7418004075218152
132,1556974800,582,689,107,1271,18,1.4661716636654565,0.006964207338939036
132,1556989200,772,858,86,1630,18,1.0268906593765843,0.4505392844594188
132,1557003600,691,669,0,1360,18,-0.772069643901654,0.11693128773928083
132,1557018000,332,331,0,663,18,-0.772069643901654,-0.7442715778678903
132,1557032400,72,131,59,203,18,0.46210079671946297,-1.3126407574651624
132,1557046800,219,200,0,419,18,-0.772069643901654,-1.045754360089052
132,1557061200,446,614,168,1060,18,2.742178390409323,-0.25374426417198365
132,1557075600,549,647,98,1196,18,1.2779083761130827,-0.08570468063887708
132,1557090000,472,528,56,1000,18,0.39934636753533836,-0.32787937455423655
132,1557104400,212,233,21,445,18,-0.3327886396127819,-1.0136291455900759
132,1557118800,57,61,4,118,18,-0.6883970716561545,-1.417665497173354
132,1557133200,1157,1129,0,2286,18,-0.772069643901654,1.2610831579720505
132,1557147600,941,919,0,1860,18,-0.772069643901654,0.734723874258055
132,1557162000,1051,1118,67,2169,18,0.6294459412104618,1.1165196927266574
132,1557176400,1008,964,0,1972,18,-0.772069643901654,0.8731094136382603
132,1557190800,291,403,112,694,19,0.8543754006483265,-0.6233021238180693
132,1557205200,71,73,2,144,19,-0.8673050164287471,-1.3300128763768733
132,1557219600,1098,1154,56,2252,19,-0.022116448045456448,1.3786166988848698
132,1557226468,418,492,74,910,19,0.25961307474897377,-0.34575753735861176
132,1557227081,43,48,5,91,19,-0.8203500959630088,-1.3981140943507215
132,1557229046,87,104,17,191,19,-0.6325304141000553,-1.2696212302491208
132,1557234000,276,242,0,518,19,-0.8986082967392394,-0.8494495646368866
132,1557248400,1006,1117,111,2123,19,0.8387237604930804,1.2128609041938048
132,1557262800,1007,957,0,1964,19,-0.8986082967392394,1.0085572502722597
132,1557277200,279,402,123,681,19,1.0265434423560338,-0.6400061961512774
132,1557291600,78,71,0,149,19,-0.8986082967392394,-1.3235882331717932
132,1557305197,1122,1028,0,2150,19,-0.8986082967392394,1.247553977501237
132,1557306000,127,124,0,251,19,-0.8986082967392394,-1.1925255117881604
132,1557320400,858,826,0,1684,19,-0.8986082967392394,0.6487772307877777
132,1557334800,1051,1141,90,2192,19,0.5100393172329117,1.3015209804239092
132,1557349200,1014,929,0,1943,19,-0.8986082967392394,0.9815737488109235
132,1557363600,264,395,131,659,19,1.1517565635980027,-0.6682746262536295
132,1557378000,72,75,3,147,19,-0.851653376273501,-1.3261580904538253
132,1557392400,1235,1112,0,2347,19,-0.8986082967392394,1.5006849197813903
132,1557406800,903,886,0,1789,19,-0.8986082967392394,0.7836947380944584
132,1557421200,1067,1147,80,2214,19,0.3535229156804505,1.3297894105262615
132,1557435600,1065,989,0,2054,19,-0.8986082967392394,1.1242008279637004
132,1557450000,305,405,100,710,19,0.666555718785373,-0.6027432655618132
132,1557464400,59,105,46,164,19,-0.1786328495979177,-1.304314303556553
132,1557478800,1122,987,0,2109,19,-0.8986082967392394,1.1948719032195807
132,1557493200,814,922,108,1736,19,0.791768840027342,0.7155935201206101
132,1557507600,1045,1124,79,2169,19,0.3378712755252044,1.2719676216805411
132,1557522000,933,948,15,1881,19,-0.6638336944105475,0.9019081730679311
132,1557536400,341,453,112,794,19,0.8543754006483265,-0.4948092597164686
132,1557550800,84,136,52,220,19,-0.08472300866644095,-1.2323582996596567
132,1557565200,316,435,119,751,19,0.9639368817350494,-0.550061191280157
132,1557579600,570,768,198,1338,19,2.2004164539994933,0.20419192099623926
132,1557594000,683,987,304,1670,19,3.859490310455582,0.6307882298135536
132,1557608400,598,726,128,1324,19,1.1048016431322645,0.18620292002201513
132,1557622800,317,395,78,712,19,0.3222196353699583,-0.6001734082797812
132,1557637200,63,122,59,185,19,0.024838472420281928,-1.277330802095217
132,1557651600,187,202,15,389,19,-0.6638336944105475,-1.0152053593279515
132,1557666000,382,491,109,873,19,0.8074204801825882,-0.39329989707620405
132,1557680400,455,476,21,931,19,-0.5699238534790708,-0.31877403589727565
132,1557694800,459,461,2,920,19,-0.8673050164287471,-0.3329082509484517
132,1557709200,194,314,120,508,19,0.9795885218902955,-0.8622988510470466
132,1557723600,64,65,1,129,19,-0.8829566565839932,-1.3492868059921133
132,1557738000,1159,1074,0,2233,19,-0.8986082967392394,1.3542030547055657
132,1557752400,757,845,88,1602,19,0.47873603692241956,0.5434130822244652
132,1557766800,973,1056,83,2029,19,0.4004778361461889,1.0920776119383002
132,1557781200,873,841,0,1714,19,-0.8986082967392394,0.6873250900182579
132,1557795600,227,258,31,485,20,-0.07410591966851324,-0.9539162024654604
132,1557810000,60,58,0,118,20,-0.6904502759359039,-1.413444224821961
132,1557824400,1156,1079,0,2235,20,-0.6904502759359039,1.2372937134034117
132,1557838800,844,824,0,1668,20,-0.6904502759359039,0.5273417006618971
132,1557853200,949,1158,209,2107,20,3.464903609866827,1.0770223595570028
132,1557867600,964,976,12,1940,20,-0.45186536383239784,0.867918327585516
132,1557882000,223,264,41,487,20,0.12471484041774182,-0.9514119625616103
132,1557896400,60,72,12,132,20,-0.45186536383239784,-1.39591454549501
132,1557910800,1130,991,0,2121,20,-0.6904502759359039,1.0945520388839536
132,1557925200,887,933,46,1820,20,0.22412522046086936,0.7176639333545077
132,1557939600,1038,1118,80,2156,20,0.9001158047541366,1.138376237201331
132,1557954000,1115,1040,0,2155,20,-0.6904502759359039,1.137124117249406
132,1557968400,317,346,29,663,20,-0.11387007168576424,-0.731038851022798
132,1557982800,58,55,0,113,20,-0.6904502759359039,-1.4197048245815864
132,1557997200,1147,1059,0,2206,20,-0.6904502759359039,1.2009822347975847
132,1558011600,911,959,48,1870,20,0.2638893724781204,0.7802699309507611
132,1558026000,1114,1118,4,2232,20,-0.6109219719014019,1.2335373535476364
132,1558040400,1115,1054,0,2169,20,-0.6904502759359039,1.154653796576357
132,1558054800,299,316,17,615,20,-0.3524549837892703,-0.7911406087152013
132,1558069200,75,66,0,141,20,-0.6904502759359039,-1.3846454659276843
132,1558082655,996,979,0,1975,20,-0.6904502759359039,0.9117425259028935
132,1558083119,73,52,0,125,20,-0.6904502759359039,-1.4046793851584856
132,1558083600,61,75,14,136,20,-0.4121012118151468,-1.3909060656873098
132,1558098000,787,934,147,1721,20,2.2322148973320455,0.5937040581139258
132,1558112400,1022,1181,159,2203,20,2.4707998094355514,1.1972258749418094
132,1558126800,1045,1033,0,2078,20,-0.6904502759359039,1.0407108809511756
132,1558141200,296,433,137,729,20,2.0333941372457907,-0.6483989341957433
132,1558155600,79,120,41,199,20,0.12471484041774182,-1.3120225087160304
132,1558170000,371,408,37,779,20,0.0451865363832398,-0.5857929365994899
132,1558184400,595,684,89,1279,20,1.0790544888317661,0.04026703936304496
132,1558198800,742,740,0,1482,20,-0.6904502759359039,0.2944473896038341
132,1558213200,638,648,10,1286,20,-0.49162951584964887,0.049031879026520446
132,1558227600,315,328,13,643,20,-0.4319832878237723,-0.7560812500612993
132,1558242000,81,116,35,197,20,0.005422384365988787,-1.3145267486198804
132,1558256400,238,273,35,511,20,0.005422384365988787,-0.9213610837154086
132,1558270800,468,561,93,1029,20,1.1585827928662682,-0.2727629486182225
132,1558285200,606,601,0,1207,20,-0.6904502759359039,-0.04988559717556006
132,1558299600,523,522,0,1045,20,-0.6904502759359039,-0.25272902938742137
132,1558314000,268,293,25,561,20,-0.19339837572026627,-0.8587550861191551
132,1558328400,79,54,0,133,20,-0.6904502759359039,-1.394662425543085
132,1558342800,1112,1065,0,2177,20,-0.6904502759359039,1.1646707561917575
132,1558357200,827,867,40,1694,20,0.10483276440911632,0.5598968194119489
132,1558371600,986,1110,124,2096,20,1.774927149133659,1.063249040085827
132,1558386000,1089,1054,0,2143,20,-0.6904502759359039,1.1220986778263051
132,1558400400,311,305,0,616,21,-0.833632496461265,-0.5427380446856678
132,1558414800,65,74,9,139,21,-0.6919653426064428,-1.1949753905363771
132,1558428601,1035,1074,39,2109,21,-0.21974149642370205,1.4987511740881456
132,1558428682,9,8,0,17,21,-0.833632496461265,-1.3617950051984034
132,1558429200,66,52,0,118,21,-0.833632496461265,-1.2236902422404965
132,1558443600,886,906,20,1792,21,-0.5188165990061046,1.065293650745012
132,1558454727,714,729,15,1443,21,-0.5975205733698946,0.5880801629003629
132,1558458000,324,328,4,652,21,-0.7706693169702329,-0.4935125846214633
132,1558472400,991,1072,81,2063,21,0.441371888232135,1.4358519751172176
132,1558486800,310,287,0,597,21,-0.833632496461265,-0.5687181486084424
132,1558501200,60,89,29,149,21,-0.3771494451512823,-1.1813016516296537
132,1558515600,1166,1004,0,2170,21,-0.833632496461265,1.5821609814191588
132,1558530000,897,943,46,1840,21,-0.10955593231439587,1.1309275974972846
132,1558544400,1105,1201,96,2306,21,0.6774838113235054,1.768123830550598
132,1558558800,1064,1005,0,2069,21,-0.833632496461265,1.4440562184612518
132,1558573200,332,335,3,667,21,-0.7864101118429909,-0.47300197626137813
132,1558587600,63,69,6,132,21,-0.7391877272247168,-1.2045470077710836
132,1558599184,799,718,0,1517,21,-0.833632496461265,0.6892658308101166
132,1558602000,380,323,0,703,21,-0.833632496461265,-0.4237765161971736
132,1558616400,775,864,89,1639,21,0.5672982472141992,0.8560854454721428
132,1558630800,1025,1120,95,2145,21,0.6617430164507474,1.5479766341523502
132,1558645200,941,846,0,1787,21,-0.833632496461265,1.05845678129165
132,1558659600,267,362,95,629,21,0.6617430164507474,-0.5249621841069273
132,1558674000,73,86,13,159,21,-0.6290021631154107,-1.1676279127229303
132,1558686998,916,911,0,1827,21,-0.833632496461265,1.113151736918544
132,1558687079,6,8,2,14,21,-0.802150906715749,-1.3658971268704205
132,1558687150,7,6,0,13,21,-0.833632496461265,-1.3672645007610928
132,1558688400,150,149,0,299,21,-0.833632496461265,-0.9761955680288017
132,1558688959,39,55,16,94,21,-0.5817797784971366,-1.2565072156166328
132,1558702800,798,889,91,1687,21,0.5987798369597153,0.9217193922244155
132,1558717200,1157,1243,86,2400,21,0.5200758625959251,1.8966569762737986
132,1558731600,803,910,107,1713,21,0.8506325549238437,0.9572711133818965
132,1558746000,347,338,0,685,21,-0.833632496461265,-0.44838924622927584
132,1558760400,92,113,21,205,21,-0.5030758041333465,-1.1047287137520023
132,1558774800,288,405,117,693,21,1.0080405036514237,-0.43745025510389707
132,1558789200,458,711,253,1169,21,3.1487886063465154,0.21341971685613992
132,1558803600,650,780,130,1430,21,1.212670836997278,0.5703043023216224
132,1558818000,582,733,151,1315,21,1.5432275293251967,0.41305630489430256
132,1558832400,255,405,150,660,21,1.5274867344524385,-0.48257359349608453
132,1558846800,70,107,37,177,21,-0.25122308616921807,-1.143015182690828
132,1558861200,178,285,107,463,21,0.8506325549238437,-0.7519462499585369
132,1558875600,391,654,263,1045,21,3.3061965550740955,0.04386535441276894
132,1558890000,627,759,132,1386,21,1.2441524267427941,0.5101398511320392
132,1558904400,472,581,109,1053,21,0.8821141446693597,0.05480434553814771
132,1558918800,263,353,90,616,21,0.5830390420869572,-0.5427380446856678
132,1558933200,49,99,50,148,21,-0.04659275282336377,-1.182669025520326
132,1558947600,265,257,0,522,21,-0.833632496461265,-0.6712711904088684
132,1558962000,441,471,30,912,21,-0.36140865027852426,-0.13799537304665316
132,1558976400,676,742,66,1418,21,0.20525996514076464,0.5538958156335543
132,1558990800,693,551,0,1244,21,-0.833632496461265,0.31597275865656593
132,1559005200,299,232,0,531,22,-0.4912663064962039,-1.1167067965038011
132,1559019600,68,67,0,135,22,-0.4912663064962039,-1.6138711907286316
132,1559034000,1182,1102,0,2284,22,-0.4912663064962039,1.0841244738904616
132,1559048400,870,848,0,1718,22,-0.4912663064962039,0.37353092052870884
132,1559062800,1060,1064,4,2124,22,-0.47252164615294656,0.8832499711733584
132,1559077200,964,962,0,1926,22,-0.4912663064962039,0.6346677740609431
132,1559091600,260,311,51,571,22,-0.2522718871196723,-1.0664881708245253
132,1559106000,71,76,5,147,22,-0.4678354810671322,-1.598805603024849
132,1559120400,1214,1046,0,2260,22,-0.4912663064962039,1.0539932984828961
132,1559134800,845,874,29,1719,22,-0.3553675190075879,0.3747863861706907
132,1559149200,1076,1108,32,2184,22,-0.3413090237501448,0.9585779096922721
132,1559163600,876,860,0,1736,22,-0.4912663064962039,0.39612930208438296
132,1559178000,261,311,50,572,22,-0.2569580522054866,-1.0652327051825434
132,1559192400,66,85,19,151,22,-0.4022291698657314,-1.5937837404569213
132,1559206800,1176,1018,0,2194,22,-0.4912663064962039,0.9711325661120911
132,1559221200,813,805,0,1618,22,-0.4912663064962039,0.2479843563305193
132,1559235600,1056,1115,59,2171,22,-0.21478256643315752,0.9422568563465075
132,1559250000,972,895,0,1867,22,-0.4912663064962039,0.5605953011840112
132,1559264400,251,327,76,578,22,-0.13511775997431363,-1.057699911330652
132,1559278800,73,69,0,142,22,-0.4912663064962039,-1.6050829312347583
132,1559293200,1028,1051,23,2079,22,-0.383484509522474,0.8267540172841731
132,1559307600,825,1462,637,2287,22,2.4938208531675343,1.0878908708164072
132,1559322000,1077,1646,569,2723,22,2.1751616273321592,1.6352738907205138
132,1559336400,1112,1401,289,2513,22,0.8630354033041422,1.3716261059043158
132,1559350800,1068,358,0,1426,22,-0.4912663064962039,0.006934953069995368
132,1559365200,88,103,15,191,22,-0.4209738302089887,-1.5435651147776455
132,1559379600,345,427,82,772,22,-0.10700076945942755,-0.8141395767861642
132,1559394000,515,859,344,1374,22,1.1207744830239312,-0.05834926031306319
132,1559408400,684,1591,907,2275,22,3.759085426337408,1.0728252831126246
132,1559422800,769,756,0,1525,22,-0.4912663064962039,0.13122605162620302
132,1559437200,1154,283,0,1437,22,-0.4912663064962039,0.020745075131796218
132,1559451600,105,86,0,191,22,-0.4912663064962039,-1.5435651147776455
132,1559466000,239,230,0,469,22,-0.4912663064962039,-1.1945456663066785
132,1559480400,512,661,149,1173,22,0.20697229129013364,-0.31069785435142416
132,1559494800,720,889,169,1609,22,0.30069559300642057,0.23668516555268224
132,1559509200,546,1273,727,1819,22,2.9155757108908253,0.5003329503688803
132,1559523600,759,229,0,988,22,-0.4912663064962039,-0.5429589981180748
132,1559538000,69,65,0,134,22,-0.4912663064962039,-1.6151266563706135
132,1559552400,1085,1003,0,2088,22,-0.4912663064962039,0.8380532080620101
132,1559566800,922,933,11,1855,22,-0.4397184905522461,0.5455297134802285
132,1559581200,1020,1145,125,2165,22,0.09450432923058934,0.9347240624946161
132,1559595600,954,985,31,1939,22,-0.3459951888359592,0.6509888274067077
132,1559610000,287,271,0,558,23,-0.7556035072005568,-0.8755803090004659
132,1559624400,72,66,0,138,23,-0.7556035072005568,-1.4191413178129024
132,1559638800,1022,1034,12,2056,23,-0.5029381165723782,1.0631206224305576
132,1559653200,849,903,54,1752,23,0.38139075062624694,0.6696859874806037
132,1559667600,938,1008,70,1946,23,0.7182779381304851,0.9207594058368244
132,1559682000,954,897,0,1851,23,-0.7556035072005568,0.7978110824149637
132,1559696400,275,320,45,595,23,0.191891707655113,-0.8276951725098465
132,1559710800,71,76,5,147,23,-0.6503262611054824,-1.4074935819097787
132,1559725200,1164,1020,0,2184,23,-0.7556035072005568,1.2287773108305384
132,1559725922,73,71,0,144,23,-0.7556035072005568,-1.4113761605441533
132,1559726019,11,9,0,20,23,-0.7556035072005568,-1.5718560774316346
132,1559739600,814,866,52,1680,23,0.3392798521882172,0.5765041002556145
132,1559754000,981,986,5,1967,23,-0.6503262611054824,0.9479374562774462
132,1559768400,946,993,47,1939,23,0.23400260609314277,0.9117000556899504
132,1559782800,278,289,11,567,23,-0.5239935657913931,-0.8639325730973422
132,1559797200,54,56,2,110,23,-0.7134926087625271,-1.4553787184003981
132,1559811600,1095,1043,0,2138,23,-0.7556035072005568,1.1692444384367953
132,1559826000,902,848,0,1750,23,-0.7556035072005568,0.667097601724354
132,1559840400,1036,1055,19,2091,23,-0.355549972039274,1.1084173731649274
132,1559854800,1054,1052,0,2106,23,-0.7556035072005568,1.1278302663368
132,1559869200,304,341,37,645,23,0.023448113902993915,-0.762985528603604
132,1559883600,67,88,21,155,23,-0.31343907360124423,-1.39714003888478
132,1559898000,1085,1135,50,2220,23,0.2971689537501874,1.275368254443033
132,1559912400,868,937,69,1805,23,0.6972224889114702,0.7382782100212206
132,1559926800,995,1109,114,2104,23,1.64471770376714,1.1252418805805504
132,1559941200,952,1145,193,2097,23,3.308098192069316,1.1161825304336765
132,1559955600,346,367,21,713,23,-0.31343907360124423,-0.6749804128911143
132,1559970000,78,104,26,182,23,-0.20816182750616982,-1.3621968311754091
132,1559984400,334,395,61,729,23,0.5287788951593512,-0.6542733268411167
132,1559998800,549,749,200,1298,23,3.45548633660242,0.08212242081192228
132,1560013200,1056,942,0,1998,23,-0.7556035072005568,0.9880574354993165
132,1560027600,764,639,0,1403,23,-0.7556035072005568,0.2180126730150314
132,1560042000,348,315,0,663,23,-0.7556035072005568,-0.7396900567973568
132,1560056400,79,98,19,177,23,-0.355549972039274,-1.3686677955660334
132,1560070800,214,290,76,504,23,0.8446106334445744,-0.9454667244192076
132,1560085200,507,622,115,1129,23,1.665773152986155,-0.13659617559117718
132,1560099600,647,730,83,1377,23,0.9919987779776787,0.18436365818378533
132,1560114000,549,592,43,1141,23,0.14978080921708323,-0.12106586105367899
132,1560128400,280,261,0,541,23,-0.7556035072005568,-0.8975815879285883
132,1560142800,71,60,0,131,23,-0.7556035072005568,-1.4282006679597763
132,1560157200,1049,1075,26,2124,23,-0.20816182750616982,1.1511257381430475
132,1560171600,859,877,18,1736,23,-0.3766054212582889,0.6489789014306061
132,1560186000,932,1017,85,1949,23,1.0341096764157083,0.9246419844711988
132,1560200400,884,876,0,1760,23,-0.7556035072005568,0.6800395305056024
132,1560214800,261,359,98,620,24,0.8055844823578345,-1.0839629826447903
132,1560229200,65,66,1,131,24,-0.8014426598264318,-1.7111267355692261
132,1560243600,1070,1003,0,2073,24,-0.8180099499520428,0.7795726676603331
132,1560258000,804,874,70,1678,24,0.34170035884072675,0.2729680001651344
132,1560272400,1015,1000,0,2015,24,-0.8180099499520428,0.7051851468635697
132,1560286800,1001,1039,38,2040,24,-0.18845292517882503,0.7372487334138987
132,1560301200,298,450,152,748,24,1.7002181491408281,-0.9197974195071056
132,1560315600,72,71,0,143,24,-0.8180099499520428,-1.6957362140250682
132,1560330000,1101,1121,20,2222,24,-0.4866641474398229,0.9706716435002941
132,1560344400,888,912,24,1800,24,-0.4203949869373789,0.42943830253074006
132,1560358800,1076,1054,0,2130,24,-0.8180099499520428,0.8526776449950833
132,1560373200,1037,1056,19,2093,24,-0.5032314375654339,0.8052235369005963
132,1560387600,315,376,61,691,24,0.1925947477102278,-0.9929023968418558
132,1560402000,60,80,20,140,24,-0.4866641474398229,-1.6995838444111075
132,1560416400,1034,1012,0,2046,24,-0.8180099499520428,0.7449439941859778
132,1560430800,741,765,24,1506,24,-0.4203949869373789,0.05237052469887066
132,1560445200,918,1144,226,2062,24,2.9261976184360416,0.7654646895781884
132,1560459600,1071,1027,0,2098,24,-0.8180099499520428,0.8116362542106621
132,1560474000,285,339,54,624,24,0.07662371683095084,-1.0788328087967376
132,1560488400,62,100,38,162,24,-0.18845292517882503,-1.6713678882468181
132,1560502800,1021,1073,52,2094,24,0.04348913657972886,0.8065060803626095
132,1560517200,843,962,119,1805,24,1.1534975749956653,0.4358510198408059
132,1560531600,1043,1212,169,2255,24,1.981862081276215,1.0129955777467285
132,1560546000,1021,967,0,1988,24,-0.8180099499520428,0.6705564733892144
132,1561165200,24,3,0,27,25,-0.4774092915361407,-1.5159330805971705
132,1561179600,73,110,37,183,25,1.128421961812696,-1.2991616750710284
132,1561194000,363,398,35,761,25,1.0416202724424888,-0.4959958263908346
132,1561208400,609,699,90,1308,25,3.4286667301231923,0.2640936532424975
132,1561222800,915,749,0,1664,25,-0.4774092915361407,0.7587771171354888
132,1561237200,884,671,0,1555,25,-0.4774092915361407,0.6073150453255561
132,1561251600,518,412,0,930,25,-0.4774092915361407,-0.2611601370708472
132,1561266000,121,105,0,226,25,-0.4774092915361407,-1.2394105825221557
132,1561280400,260,232,0,492,25,-0.4774092915361407,-0.8697875448942466
132,1561294800,537,496,0,1033,25,-0.4774092915361407,-0.11803542701191991
132,1561309200,770,673,0,1443,25,-0.4774092915361407,0.4516842926401206
132,1561323600,653,522,0,1175,25,-0.4774092915361407,0.07928213442854291
132,1561338000,398,281,0,679,25,-0.4774092915361407,-0.6099397703212427
132,1561352400,77,72,0,149,25,-0.4774092915361407,-1.3464067249933926
132,1561366800,1134,1166,32,2300,25,0.9114177383871777,1.6425374627420688
132,1561381200,949,953,4,1902,25,-0.3038059127957259,1.0894924665920391
132,1561395600,1196,972,0,2168,25,-0.4774092915361407,1.4591155042199484
132,1561410000,1127,1001,0,2128,25,-0.4774092915361407,1.4035330925465785
132,1561424400,366,312,0,678,26,-0.9976702737646874,-1.1061891398654837
132,1561438800,71,70,0,141,26,-0.9976702737646874,-1.905426385525598
132,1561453200,1029,985,0,2014,26,-0.9976702737646874,0.8822297804360293
132,1561467600,794,880,86,1674,26,-0.031043388346755265,0.3761950252694765
132,1561482000,892,1077,185,1969,26,1.0817015146343527,0.8152545922522209
132,1561496400,909,1022,113,1931,26,0.272432494284456,0.7586977666747826
132,1561510800,293,355,62,648,26,-0.3007997284633875,-1.1508392653213562
132,1561525200,55,83,28,138,26,-0.6829545436286165,-1.9098913980711851
132,1561539600,998,1148,150,2146,26,0.688306851964264,1.0786903324418673
132,1561554000,959,841,0,1800,26,-0.9976702737646874,0.5637255521841402
132,1561568400,983,1045,62,2028,26,-0.3007997284633875,0.9030665056487697
132,1561582800,1347,1006,0,2353,26,-0.9976702737646874,1.3867761980873863
132,1561597200,469,320,0,789,26,-0.9976702737646874,-0.9409836756787563
132,1561611600,103,81,0,184,26,-0.9976702737646874,-1.841427872372181
132,1561626000,1010,962,0,1972,26,-0.9976702737646874,0.819719604797808
132,1561640400,825,943,118,1768,26,0.3286317318087544,0.5160987516978764
132,1561654800,996,1173,177,2169,26,0.9917827345954753,1.1129220952913694
132,1561669200,1088,1157,69,2245,26,-0.22212079592936976,1.226035746446246
132,1561683600,344,463,119,807,26,0.33987157931361406,-0.9141936004052329
132,1561698000,78,104,26,182,26,-0.7054342386383359,-1.8444045474025725
132,1561712400,903,1022,119,1925,26,0.33987157931361406,0.7497677415836081
132,1561726800,801,948,147,1749,26,0.654587309449685,0.48782033890915727
132,1561741200,898,1162,264,2060,26,1.969649467518267,0.9506933061350334
132,1561755600,1005,1025,20,2030,26,-0.7728733236674938,0.9060431806791611
132,1561770000,340,544,204,884,26,1.2952586172266864,-0.7995916117351607
132,1561784400,161,428,267,589,26,2.0033690100328463,-1.2386511787179049
132,1561798800,718,670,0,1388,26,-0.9976702737646874,-0.049469504076506056
132,1561813200,917,801,0,1718,26,-0.9976702737646874,0.4416818759380892
132,1561827600,1002,959,0,1961,26,-0.9976702737646874,0.8033478921306548
132,1561842000,752,890,138,1642,26,0.5534286819059479,0.32856822478321274
132,1561856400,437,738,301,1175,26,2.3855238251980753,-0.36648539481319936
132,1561870800,123,305,182,428,26,1.0479819721197736,-1.4782735186644196
132,1561885200,473,400,0,873,26,-0.9976702737646874,-0.8159633244023139
132,1561899600,740,619,0,1359,26,-0.9976702737646874,-0.0926312920171826
132,1561914000,879,853,0,1732,26,-0.9976702737646874,0.46251860115082966
132,1561928400,718,920,202,1638,26,1.2727789222169672,0.3226148747224298
132,1561942800,371,621,250,992,26,1.8122916024502316,-0.6388511600940204
132,1561957200,138,257,119,395,26,0.33987157931361406,-1.5273886566658792
132,1561971600,919,1016,97,1935,26,0.09259493420670117,0.7646511167355655
132,1561986000,820,968,148,1788,26,0.6658271569545446,0.5458655020017913
132,1562000400,952,992,40,1944,26,-0.5480763735703004,0.7780461543723273
132,1562014800,908,943,35,1851,26,-0.6042756110945987,0.6396307654591231
132,1562029200,306,416,110,722,27,0.4293547076368725,-0.467676619989283
132,1562043600,65,107,42,172,27,-0.48940431709657517,-1.34630090606297
132,1562058000,936,1017,81,1953,27,0.03753100591231395,1.4988442821138237
132,1562061955,300,261,0,561,27,-1.0568731264907634,-0.7248739110035805
132,1562072400,506,661,155,1167,27,1.03735700341636,0.24321030237942742
132,1562086800,898,972,74,1870,27,-0.057047128986717426,1.3662518898517946
132,1562101200,926,1009,83,1935,27,0.06455333016918006,1.470089305478685
132,1562115600,306,426,120,732,27,0.5644663289212031,-0.4517016329697614
132,1562130000,77,91,14,168,27,-0.8677168566927007,-1.3526909008707786
132,1562144400,865,896,31,1761,27,-0.6380271005093388,1.1921245313390094
132,1562158800,847,880,33,1727,27,-0.6110047762524726,1.137809575472636
132,1562173200,1099,1013,0,2112,27,-1.0568731264907634,1.752846575724217
132,1562187600,893,855,0,1748,27,-1.0568731264907634,1.1713570482136313
132,1562202000,491,364,0,855,27,-1.0568731264907634,-0.255209292629646
132,1562216400,64,93,29,157,27,-0.6650494247662049,-1.3702633865922524
132,1562230336,225,225,0,450,27,-1.0568731264907634,-0.9021962669202701
132,1562230417,5,4,0,9,27,-1.0568731264907634,-1.6066931944811718
132,1562230800,6,9,3,15,27,-1.0163396401054643,-1.597108202269459
132,1562245200,330,504,174,834,27,1.294069083856588,-0.28875676537064127
132,1562259600,516,640,124,1156,27,0.6185109774349353,0.22563781665795368
132,1562274000,505,492,0,997,27,-1.0568731264907634,-0.028364476952439484
132,1562288400,338,334,0,672,27,-1.0568731264907634,-0.5475515550868909
132,1562302800,61,122,61,183,27,-0.23269223665634714,-1.3287284203414964
132,1562317200,611,727,116,1338,27,0.5104216804074708,0.5163825804132465
132,1562331600,621,757,136,1378,27,0.780644922976132,0.5802825284913328
132,1562346000,845,874,29,1719,27,-0.6650494247662049,1.1250295858570187
132,1562360400,689,813,124,1502,27,0.6185109774349353,0.7783723675334004
132,1562374800,282,388,106,670,27,0.3753100591231403,-0.5507465524907952
132,1562389200,64,113,49,177,27,-0.3948261821975438,-1.3383134125532092
132,1562403600,271,410,139,681,27,0.821178409361431,-0.5331740667693214
132,1562418000,447,661,214,1108,27,1.83451556899391,0.14895787896425008
132,1562432400,552,854,302,1406,27,3.023497836296019,0.6250124921459932
132,1562446800,489,629,140,1118,27,0.8346895714898641,0.16493286598377166
132,1562461200,265,324,59,589,27,-0.2597145609132132,-0.68014394734892
132,1562475600,61,75,14,136,27,-0.8677168566927007,-1.4038108593332477
132,1562490000,222,311,89,533,27,0.14562030293977837,-0.7696038746582409
132,1562504400,401,637,236,1038,27,2.1317611358194375,0.037132969827599005
132,1562518800,575,797,222,1372,27,1.9426048660213746,0.5706975362796198
132,1562533200,519,675,156,1194,27,1.050868165544793,0.2863427673321357
132,1562547600,256,320,64,576,27,-0.19215875027104798,-0.7009114304742982
132,1562562000,72,89,17,161,27,-0.8271833703074015,-1.363873391784444
132,1562576400,859,946,87,1805,27,0.11859797868291228,1.2624144742249044
132,1562590800,730,817,87,1547,27,0.11859797868291228,0.8502598091212475
132,1562605200,1045,871,0,1916,27,-1.0568731264907634,1.439736830141594
132,1562619600,876,868,0,1744,27,-1.0568731264907634,1.1649670534058227
132,1562634000,274,287,13,561,28,-0.6523085146294769,-1.0109751991292422
132,1562648400,66,63,0,129,28,-0.7951727139827439,-1.6234337638371208
132,1562662800,1062,1057,0,2119,28,-0.7951727139827439,1.1978452726644504
132,1562677200,813,876,63,1689,28,-0.10283082480921964,0.5882221642746636
132,1562691600,992,1007,15,1999,28,-0.6303294070366666,1.0277178935789284
132,1562706000,1032,932,0,1964,28,-0.7951727139827439,0.9780974080123179
132,1562720400,353,285,0,638,28,-0.7951727139827439,-0.9018101308826989
132,1562734800,81,77,0,158,28,-0.7951727139827439,-1.5823196472247865
132,1562749200,1161,1040,0,2201,28,-0.7951727139827439,1.3140989817062236
132,1562763600,879,923,44,1802,28,-0.3116323469409174,0.7484254462468634
132,1562778000,933,1073,140,2006,28,0.7433648175139767,1.0376419906922505
132,1562792400,985,913,0,1898,28,-0.7951727139827439,0.8845273495152809
132,1562806800,276,289,13,565,28,-0.6523085146294769,-1.0053042864930581
132,1562821200,66,70,4,136,28,-0.7512144987971233,-1.6135096667237987
132,1562835600,1001,1097,96,2098,28,0.2598244504721502,1.168072981324484
132,1562850000,805,877,72,1682,28,-0.003924840641573312,0.5782980671613415
132,1562864400,955,1057,102,2012,28,0.3257617732505811,1.0461483596465266
132,1562878800,807,862,55,1669,28,-0.19074725518046082,0.5598676010937432
132,1562893200,234,275,41,509,28,-0.34460100833013285,-1.084697063399635
132,1562907600,79,88,9,167,28,-0.6962667298150975,-1.5695600937933722
132,1562922000,906,831,0,1737,28,-0.7951727139827439,0.6562731159088724
132,1562936400,864,932,68,1796,28,-0.0478830558271939,0.7399190772925872
132,1562950800,942,979,37,1921,28,-0.38855922351575345,0.9171350971733392
132,1562965200,917,975,58,1892,28,-0.15777859379124537,0.8760209805610047
132,1562979600,375,526,151,901,28,0.8642499092744332,-0.5289476250535967
132,1562994000,84,134,50,218,28,-0.24569502416248654,-1.4972559576820255
132,1563008400,343,512,169,855,28,1.062061877609726,-0.5941631203697135
132,1563022800,581,957,376,1538,28,3.3368995134655908,0.3741452122587152
132,1563037200,697,1106,409,1803,28,3.6995547887469606,0.7498431744059094
132,1563051600,670,810,140,1480,28,0.7433648175139767,0.2919169790340463
132,1563066000,437,688,251,1125,28,1.9632052889149478,-0.21137651742728925
132,1563080400,87,146,59,233,28,-0.14678903999484022,-1.4759900352963353
132,1563094800,189,234,45,423,28,-0.30064279314451225,-1.2066216850775922
132,1563109200,481,570,89,1051,28,0.18289757389731418,-0.31628840119669444
132,1563123600,611,639,28,1250,28,-0.48746520768339974,-0.0341604975465373
132,1563138000,528,630,102,1158,28,0.3257617732505811,-0.16459148817877073
132,1563152400,267,299,32,566,28,-0.4435069924977792,-1.003886558334012
132,1563166800,57,54,0,111,28,-0.7951727139827439,-1.6489528706999492
132,1563181200,896,1003,107,1899,28,0.38070954223260683,0.8859450776743268
132,1563195600,769,859,90,1628,28,0.19388712769371932,0.5017407465728566
132,1563210000,988,974,0,1962,28,-0.7951727139827439,0.9752619516942259
132,1563224400,926,1037,111,1963,28,0.42466775741822743,0.9766796798532719
132,1563238800,302,325,23,627,29,-0.3196593808539971,-0.7518739316651315
132,1563253200,62,58,0,120,29,-0.5555870880663875,-1.4935418916774175
132,1563267600,924,1051,127,1975,29,0.7471441648020292,1.2200558712866663
132,1563274298,481,447,0,928,29,-0.5555870880663875,-0.3115542946558651
132,1563282000,426,406,0,832,29,-0.5555870880663875,-0.4519884645990198
132,1563296400,999,988,0,1987,29,-0.5555870880663875,1.2376101425295605
132,1563310800,1050,990,0,2040,29,-0.5555870880663875,1.3151415071856771
132,1563325200,333,312,0,645,29,-0.5555870880663875,-0.72554252480079
132,1563339600,61,75,14,136,29,-0.4119789184588455,-1.4701361966868915
132,1563354000,1011,909,0,1920,29,-0.5555870880663875,1.1395987947567339
132,1563368400,789,831,42,1620,29,-0.12476257924376154,0.7007420136843753
132,1563382800,942,1052,110,1994,29,0.5727628159928709,1.2478501340879156
132,1563397200,885,964,79,1849,29,0.25477329757617084,1.0357360232362756
132,1563411600,235,200,0,435,29,-0.5555870880663875,-1.032742271551441
132,1563426000,50,55,5,105,29,-0.504298456063694,-1.5154847307310353
132,1563440400,977,1001,24,1978,29,-0.30940165445345835,1.2244444390973899
132,1563454800,807,869,62,1676,29,0.08039194876701272,0.7826619461512155
132,1563469200,1026,998,0,2024,29,-0.5555870880663875,1.2917358121951514
132,1563483600,919,945,26,1864,29,-0.28888620165238094,1.0576788622898936
132,1563498000,255,313,58,568,29,0.03936104316485787,-0.8381824319426954
132,1563512400,65,62,0,127,29,-0.5555870880663875,-1.4833019001190624
132,1563526800,962,870,0,1832,29,-0.5555870880663875,1.010867472308842
132,1563541200,812,908,96,1720,29,0.42915464638532896,0.8470276073751615
132,1563555600,950,1019,69,1969,29,0.1521960335707837,1.211278735665219
132,1563570000,489,1114,625,1603,29,5.855491912270309,0.6758734627569416
132,1563584400,390,497,107,887,29,0.5419896367912548,-0.3715313880690874
132,1563598800,60,88,28,148,29,-0.2683707488513035,-1.4525819254439973
132,1563613200,323,320,0,643,29,-0.5555870880663875,-0.7284682366746057
132,1563627600,453,553,100,1006,29,0.4701855519874838,-0.19745153157705186
132,1563642000,568,591,23,1159,29,-0.3196593808539971,0.02636542676985099
132,1563656400,453,592,139,1045,29,0.8702368816084937,-0.14040015003764525
132,1563670800,277,337,60,614,29,0.05987649596593529,-0.7708910588449337
132,1563685200,72,90,18,162,29,-0.37094801285669066,-1.4321019423272872
132,1563699600,217,240,23,457,29,-0.3196593808539971,-1.000559440939468
132,1563714000,410,474,64,884,29,0.10090740156809015,-0.375919955879811
132,1563728400,515,600,85,1115,29,0.31631965597940315,-0.03800023445409493
132,1563742800,439,493,54,932,29,-0.0016698624372969845,-0.3057028709082336
132,1563757200,228,221,0,449,29,-0.5555870880663875,-1.0122622884347308
132,1563771600,55,51,0,106,29,-0.5555870880663875,-1.5140218747941274
132,1563786000,917,1004,87,1921,29,0.33683510878048056,1.1410616506936417
132,1563800400,801,724,0,1525,29,-0.5555870880663875,0.5617706996781284
132,1563814800,906,992,86,1898,29,0.3265773823799418,1.1074159641447607
132,1563829200,721,816,95,1537,29,0.41889691998479023,0.5793249709210228
132,1563843600,225,244,19,469,30,-0.3418410748937172,-1.0630563865138327
132,1563858000,58,59,1,117,30,-0.47009220294479437,-1.5527978218428502
132,1563872400,989,893,0,1882,30,-0.47721726561429867,0.902865909281343
132,1563879214,464,501,37,965,30,-0.21358994684264,-0.3729661821865806
132,1563886800,369,386,17,755,30,-0.3560912002327258,-0.6651414703090059
132,1563901200,898,976,78,1874,30,0.07853762260703587,0.8917354221147744
132,1563915600,819,1005,186,1824,30,0.848044390913499,0.8221698773237208
132,1563930000,309,277,0,586,30,-0.47721726561429867,-0.9002730117027672
132,1563944400,61,88,27,149,30,-0.2848405735376829,-1.508275873176576
132,1563958800,1094,1091,0,2185,30,-0.47721726561429867,1.324433110715128
132,1563973200,883,879,0,1762,30,-0.47721726561429867,0.7359086017828143
132,1563987600,1016,1029,13,2045,30,-0.3845914509107429,1.1296495853001778
132,1564002000,975,1193,218,2168,30,1.0760463963376363,1.3007808254861697
132,1564016400,323,414,91,737,30,0.1711634373105916,-0.6901850664337852
132,1564030800,89,100,11,189,30,-0.3988415762497515,-1.452623437343733
132,1564045200,1018,971,0,1989,30,-0.47721726561429867,1.0517361751341978
132,1564059600,871,891,20,1762,30,-0.3347160122242129,0.7359086017828143
132,1564074000,987,1123,136,2110,30,0.4917912574382846,1.2200847935285475
132,1564088400,912,1042,130,1954,30,0.4490408814212589,1.0030402937804603
132,1564102800,307,383,76,690,30,0.0642874972680273,-0.7555766785373756
132,1564117200,73,84,11,157,30,-0.3988415762497515,-1.4971453860100075
132,1564127370,460,473,13,933,30,-0.3845914509107429,-0.41748813085285497
132,1564131600,418,476,58,894,30,-0.06396363078304991,-0.4717492557898768
132,1564146000,896,611,0,1507,30,-0.47721726561429867,0.38112432334844076
132,1564160400,1016,1129,113,2145,30,0.327914816039686,1.2687806748822852
132,1564174800,1116,969,0,2085,30,-0.47721726561429867,1.1853020211330207
132,1564189200,495,396,0,891,30,-0.47721726561429867,-0.47592318847734
132,1564203600,80,124,44,204,30,-0.16371450815610997,-1.431753773906417
132,1564218000,292,355,63,647,30,-0.02833831743552847,-0.8154030470576817
132,1564232400,471,1175,704,1646,30,4.538826853716721,0.5745165378675698
132,1564246800,729,1354,625,2083,30,3.975946902825882,1.1825193993413785
132,1564261200,1147,640,0,1787,30,-0.47721726561429867,0.7706913741783411
132,1564275600,399,347,0,746,30,-0.47721726561429867,-0.6776632683713956
132,1564290000,77,102,25,179,30,-0.29909069887669143,-1.4665365463019437
132,1564304400,201,226,25,427,30,-0.29909069887669143,-1.1214914441383177
132,1564318800,472,554,82,1026,30,0.10703787328505303,-0.2880962175414952
132,1564333200,583,605,22,1188,30,-0.32046588688520433,-0.06270385241848143
132,1564347600,603,587,0,1190,30,-0.47721726561429867,-0.059921230626839295
132,1564362000,295,251,0,546,30,-0.47721726561429867,-0.95592544753561
132,1564376400,45,73,28,118,30,-0.2777155108681786,-1.5514065109470292
132,1564390800,944,946,2,1890,30,-0.4629671402752901,0.9139963964479115
132,1564405200,864,936,72,1800,30,0.03578724659001013,0.7887784158240151
132,1564419600,1000,992,0,1992,30,-0.47721726561429867,1.055910107821661
132,1564434000,1025,937,0,1962,30,-0.47721726561429867,1.0141707809470288
132,1564448400,280,401,121,681,31,0.7798274679494354,-1.0122506522523311
132,1564462800,67,77,10,144,31,-0.7343564785646287,-1.7716596054060678
132,1564477200,1026,952,0,1978,31,-0.8707694467190489,0.8219270241729881
132,1564491600,831,901,70,1732,31,0.08412133036189241,0.4740413584824496
132,1564506000,925,983,58,1908,31,-0.07957423142341181,0.7229351680821845
132,1564520400,950,999,49,1949,31,-0.20234590276238998,0.780916112363941
132,1564534800,292,462,170,754,31,1.4482510119060943,-0.9090162880433502
132,1564549200,63,90,27,153,31,-0.5024544327021144,-1.7589320810515359
132,1564563600,1005,933,0,1938,31,-0.8707694467190489,0.7653602492639575
132,1564578000,1086,878,0,1964,31,-0.8707694467190489,0.8021286529548275
132,1564592400,996,975,0,1971,31,-0.8707694467190489,0.8120278385639078
132,1564606800,890,920,30,1810,31,-0.4615305422557883,0.5843465695550594
132,1564621200,284,328,44,612,31,-0.2705523868396001,-1.1098283389704091
132,1564635600,59,102,43,161,31,-0.2841936836550421,-1.7476187260697298
132,1564650000,979,886,0,1865,31,-0.8707694467190489,0.6621258850549765
132,1564664400,922,928,6,1850,31,-0.7889216658263968,0.6409133444640901
132,1564678800,894,1086,192,1980,31,1.7483595418458187,0.8247553629184398
132,1564693200,840,1114,274,1954,31,2.866945880712064,0.7879869592275698
132,1564707600,343,398,55,741,31,-0.12049812186973786,-0.9274004898887852
132,1564722000,87,92,5,179,31,-0.8025629626418388,-1.7221636773606661
132,1564736400,905,864,0,1769,31,-0.8707694467190489,0.526365625273303
132,1564750800,829,925,96,1754,31,0.4387950475633849,0.5051530846824165
132,1564765200,939,1041,102,1980,31,0.520642828456037,0.8247553629184398
132,1564779600,758,938,180,1696,31,1.5846639800605145,0.423131261064322
132,1565398800,9933,6469,0,16402,32,-1.008646091862404,4.064504967320688
132,1565413200,96,124,28,220,32,-0.6688348416627706,-0.49332874469091054
132,1565427600,320,446,126,766,32,0.5205045340359464,-0.3395419935625993
132,1565442000,580,826,246,1406,32,1.9768384634629468,-0.1592791350971795
132,1565456400,715,839,124,1554,32,0.4962323018788297,-0.11759334907705118
132,1565470800,670,820,150,1490,32,0.8117713199213465,-0.13561963492359316
132,1565485200,322,422,100,744,32,0.20496551599342966,-0.3457385293223481
132,1565499600,64,139,75,203,32,-0.09843738597052877,-0.4981169768688983
132,1565514000,220,297,77,517,32,-0.0741651538134121,-0.4096755119343017
132,1565528400,479,779,300,1258,32,2.632188731705097,-0.20096492111730785
132,1565542800,704,760,56,1464,32,-0.3290235914631372,-0.14294281354875085
132,1565557200,558,651,93,1209,32,0.12001270344352129,-0.21476629621856655
132,1565571600,306,321,15,627,32,-0.826604350684029,-0.3786928331355577
132,1565586000,67,86,19,153,32,-0.7780598863697956,-0.5122000126865092
132,1565600400,859,946,87,1805,32,0.04719600697217127,-0.04689650927264437
132,1565614800,801,793,0,1594,32,-1.008646091862404,-0.10632692042296245
132,1565629200,1005,947,0,1952,32,-1.008646091862404,-0.005492383968868259
132,1565643600,1165,958,0,2123,32,-1.008646091862404,0.04267159852736109
132,1565658000,328,346,18,674,33,-0.6065777939266384,-0.8795174743053567
132,1565672400,67,97,30,164,33,-0.45559171497528983,-1.6540664346907261
132,1565686800,918,996,78,1914,33,0.1483526008301041,1.0036996058473067
132,1565701200,765,737,0,1502,33,-0.8330569123536611,0.37798554373206683
132,1565715600,900,943,43,1843,33,-0.2920234627779956,0.8958702407740492
132,1565730000,903,999,96,1902,33,0.3748317192571268,0.9854749244264743
132,1565744400,282,352,70,634,33,0.047695214862538436,-0.9402664123747975
132,1565758800,67,81,14,148,33,-0.6569064869104212,-1.6783660099185025
132,1565773200,980,932,0,1912,33,-0.8330569123536611,1.0006621589438345
132,1565787600,882,875,0,1757,33,-0.8330569123536611,0.7652600239247516
132,1565802000,887,1038,151,1925,33,1.0668512477841408,1.0204055638164027
132,1565816400,881,937,56,1818,33,-0.12845521058070145,0.8579021544806488
132,1565830800,313,316,3,629,33,-0.7953103926158239,-0.9478600296334775
132,1565845200,75,93,18,168,33,-0.6065777939266384,-1.6479915408837822
132,1565859600,932,977,45,1909,33,-0.2668591162861042,0.9961059885886264
132,1565874000,780,842,62,1622,33,-0.05296217110502722,0.5602323579403891
132,1565888400,867,1002,135,1869,33,0.8655364758490094,0.9353570505191857
132,1565902800,940,1030,90,1970,33,0.29933867978145257,1.0887481191445236
132,1565917200,364,379,15,743,33,-0.6443243136644754,-0.7747255561355714
132,1565931600,85,83,0,168,33,-0.8330569123536611,-1.6479915408837822
132,1565942786,504,472,0,976,33,-0.8330569123536611,-0.420862991881079
132,1565946000,379,373,0,752,33,-0.8330569123536611,-0.7610570450699472
132,1565960400,780,951,171,1731,33,1.3184947127030548,0.7257732141796152
132,1565974800,1118,950,0,2068,33,-0.8330569123536611,1.2375830174146534
132,1565989200,1239,881,0,2120,33,-0.8330569123536611,1.3165566369049264
132,1566003600,540,452,0,992,33,-0.8330569123536611,-0.3965634166533027
132,1566018000,107,157,50,264,33,-0.2039482500563757,-1.5021940895171244
132,1566032400,433,491,58,924,33,-0.10329086408881004,-0.499836611371352
132,1566046800,660,856,196,1516,33,1.6330490438516974,0.39924767205637113
132,1566061200,814,1066,252,1880,33,2.3376507456246567,0.952063008488282
132,1566075600,715,1032,317,1747,33,3.155492006611128,0.7500727894073914
132,1566090000,471,416,0,887,33,-0.8330569123536611,-0.5560293790855847
132,1566104400,74,134,60,208,33,-0.07812651759691863,-1.5872426028143414
132,1566118800,265,301,36,566,33,-0.38009867549961557,-1.0435396070928467
132,1566133200,492,732,240,1224,33,2.1866646666733085,-0.044219575850546367
132,1566147600,675,889,214,1564,33,1.85952816227872,0.4721463977397
132,1566162000,597,752,155,1349,33,1.1171799407679235,0.14562085561645596
132,1566176400,309,326,17,635,33,-0.619159967172584,-0.9387476889230614
132,1566190800,70,76,6,146,33,-0.7575638728779868,-1.6814034568219745
132,1566205200,965,882,0,1847,33,-0.8330569123536611,0.9019451345809933
132,1566219600,804,855,51,1659,33,-0.19136607681043,0.6164251256546218
132,1566234000,905,945,40,1850,33,-0.3297699825158328,0.9065013049362014
132,1566248400,824,884,60,1708,33,-0.07812651759691863,0.6908425747896867
132,1566262800,300,245,0,545,34,-0.7554577691983813,-1.031249555483538
132,1566277200,106,84,0,190,34,-0.7554577691983813,-1.5741849676395956
132,1566291600,944,941,0,1885,34,-0.7554577691983813,1.0181404509646796
132,1566306000,834,863,29,1697,34,-0.3356824211675289,0.7306140918510491
132,1566320400,850,935,85,1785,34,0.47491825089204803,0.8652008982446634
132,1566334800,853,841,0,1694,34,-0.7554577691983813,0.7260259052694487
132,1566349200,265,310,45,575,34,-0.1040822291505069,-0.9853676896675332
132,1566363600,67,82,15,149,34,-0.5383325891824231,-1.6368901842548023
132,1566378000,1002,967,0,1969,34,-0.7554577691983813,1.1466096752494934
132,1566392400,802,842,40,1644,34,-0.17645728915582626,0.6495561289094405
132,1566406800,928,971,43,1899,34,-0.13303225315263464,1.039551988345482
132,1566421200,820,887,67,1707,34,0.21436803487289832,0.7459080471230508
132,1566435600,236,304,68,540,34,0.2288430468739622,-1.0388965331195388
132,1566450000,97,81,0,178,34,-0.7554577691983813,-1.5925377139659977
132,1566464400,1168,943,0,2111,34,-0.7554577691983813,1.3637838401119164
132,1566478800,834,878,44,1712,34,-0.11855724115157076,0.7535550247590516
132,1566493200,894,950,56,1844,34,0.05514290286119572,0.955435234349473
132,1566507600,971,897,0,1868,34,-0.7554577691983813,0.992140727002277
132,1566522000,311,281,0,592,34,-0.7554577691983813,-0.9593679657051304
132,1566536400,62,73,11,135,34,-0.5962326371866786,-1.6583017216356046
132,1566550800,760,732,0,1492,34,-0.7554577691983813,0.41708800877501584
132,1566565200,735,853,118,1588,34,0.9525936469271559,0.5639099793862314
132,1566579600,848,1010,162,1858,34,1.5894941749739664,0.9768467717302753
132,1566594000,781,886,105,1667,34,0.7644184909133256,0.6847322260350442
132,1566608400,353,343,0,696,34,-0.7554577691983813,-0.8003108308763135
132,1566622800,73,135,62,208,34,0.14199297486757897,-1.5466558481499928
132,1566637200,351,496,145,847,34,1.3434189709558806,-0.569372106269089
132,1566651600,620,796,176,1416,34,1.7921443429888606,0.30085394870780346
132,1566666000,801,1135,334,1936,34,4.0791962391569525,1.096139622851888
132,1566680400,891,919,28,1810,34,-0.35015743316859277,0.9034357864246675
132,1566694800,424,443,19,867,34,-0.48043254117816764,-0.5387841957250857
132,1566709200,96,116,20,212,34,-0.46595752917710376,-1.5405382660411922
132,1566723600,210,305,95,515,34,0.6196683709026868,-1.0771314212995429
132,1566738000,536,743,207,1279,34,2.2408697150218404,0.09132676148138123
132,1566752400,669,766,97,1435,34,0.6486183949048145,0.3299124637246066
132,1566766800,568,624,56,1192,34,0.05514290286119572,-0.0417306493850329
132,1566781200,290,330,40,620,34,-0.17645728915582626,-0.9165448909435259
132,1566795600,60,85,25,145,34,-0.39358246917178435,-1.643007766363603
132,1566810000,809,782,0,1591,34,-0.7554577691983813,0.5684981659678319
132,1566824400,796,722,0,1518,34,-0.7554577691983813,0.45685229248222003
132,1566838800,940,817,0,1757,34,-0.7554577691983813,0.8223778234830589
132,1566853200,962,880,0,1842,34,-0.7554577691983813,0.9523764432950726
132,1566867600,289,288,0,577,35,-0.44425854394796355,-0.7601361037927685
132,1566882000,69,53,0,122,35,-0.44425854394796355,-1.4124869599063128
132,1566896400,969,910,0,1879,35,-0.44425854394796355,1.106590961393681
132,1566910800,826,667,0,1493,35,-0.44425854394796355,0.5531680373061469
132,1566925200,913,912,0,1825,35,-0.44425854394796355,1.0291691015472386
132,1566939600,926,781,0,1707,35,-0.44425854394796355,0.8599880004013084
132,1566954000,280,274,0,554,35,-0.44425854394796355,-0.7931120811347719
132,1566968400,65,69,4,134,35,-0.41796241178399335,-1.395282102162659
132,1566982800,1003,874,0,1877,35,-0.44425854394796355,1.1037234851030722
132,1566997200,914,701,0,1615,35,-0.44425854394796355,0.7280840910332951
132,1567011600,967,827,0,1794,35,-0.44425854394796355,0.9847232190427992
132,1567026000,871,910,39,1781,35,-0.18787125534925392,0.9660846231538409
132,1567040400,288,272,0,560,35,-0.44425854394796355,-0.784509652262945
132,1567054800,77,74,0,151,35,-0.44425854394796355,-1.3709085536924825
132,1567069200,953,986,33,1939,35,-0.22731545359520927,1.1926152501119507
132,1567083600,853,887,34,1740,35,-0.2207414205542167,0.9073013591963567
132,1567098000,921,995,74,1916,35,0.042219901085485484,1.1596392727699474
132,1567112400,937,992,55,1929,35,-0.08268672669337306,1.1782778686589057
132,1567126800,447,351,0,798,35,-0.44425854394796355,-0.44327997368047567
132,1567141200,138,87,0,225,35,-0.44425854394796355,-1.2648119309399501
132,1567155600,848,849,1,1697,35,-0.437684510906971,0.8456506189482634
132,1567170000,873,897,24,1770,35,-0.28648175096414225,0.9503135035554915
132,1567184400,980,1323,343,2303,35,1.8106347891124828,1.7144959350027862
132,1567198800,835,1306,471,2141,35,2.6521110183595296,1.4822303554634584
132,1567213200,878,445,0,1323,35,-0.44425854394796355,0.3094325526043831
132,1567227600,72,131,59,203,35,-0.056390594529402836,-1.296354170136649
132,1567242000,341,350,9,691,35,-0.3850922465790306,-0.5966899552280563
132,1567256400,532,687,155,1219,35,0.5747165774058824,0.16032378549271586
132,1567270800,689,1202,513,1891,35,2.928220406081217,1.1237958191373352
132,1567285200,560,786,226,1346,35,1.0414729233163538,0.34240852994638643
132,1567299600,1013,279,0,1292,35,-0.44425854394796355,0.26498667009994387
132,1567314000,70,80,10,150,35,-0.378518213538038,-1.372342291837787
132,1567328400,205,249,44,454,35,-0.15500109014429117,-0.9364858956652212
132,1567342800,448,620,172,1068,35,0.6864751391027558,-0.05617067444826256
132,1567357200,505,1226,721,1731,35,4.295619278607669,0.8943977158886162
132,1567371600,685,714,29,1399,35,-0.25361158575917947,0.4183966516475246
132,1567386000,920,240,0,1160,35,-0.44425854394796355,0.07573323491975079
132,1567400400,65,66,1,131,35,-0.437684510906971,-1.3995833165985725
132,1567414800,225,228,3,453,35,-0.4245364448249859,-0.9379196338105257
132,1567429200,422,380,0,802,35,-0.44425854394796355,-0.4375450210992577
132,1567438312,358,311,0,669,35,-0.44425854394796355,-0.6282321944247552
132,1567438398,5,12,7,17,35,-0.39824031266101567,-1.5630294651632846
132,1567438489,6,6,0,12,35,-0.44425854394796355,-1.570198155889807
132,1567443600,200,185,0,385,35,-0.44425854394796355,-1.0354138276912312
132,1567458000,443,457,14,900,35,-0.3522220813740678,-0.29703868285941737
132,1567472400,229,252,23,481,36,-0.4786221762045725,-1.3297245129397357
132,1567486800,71,61,0,132,36,-0.6860465917333375,-1.7852943967904893
132,1567501200,992,1095,103,2087,36,0.24285405172156643,0.766680167473761
132,1567515600,844,855,11,1699,36,-0.5868436103934933,0.2602013281210607
132,1567530000,979,1112,133,2091,36,0.5134076371938685,0.771901598807294
132,1567544400,1005,1101,96,2106,36,0.17972488177802928,0.7914819663080428
132,1567558800,330,334,4,664,36,-0.6499727803370305,-1.0908440294306012
132,1567573200,63,81,18,144,36,-0.5237144404499562,-1.7696301027898904
132,1567587600,1219,1147,0,2366,36,-0.6860465917333375,1.1308750029876873
132,1567602000,883,952,69,1835,36,-0.06377334514704262,0.43772999346118246
132,1567616400,955,1113,158,2068,36,0.7388689584207869,0.7418783686394793
132,1567630800,1065,1113,48,2178,36,-0.2531608549776541,0.8854677303116366
132,1567645200,280,323,43,603,36,-0.29825311922303777,-1.1704708572669793
132,1567659600,73,120,47,193,36,-0.2621793078267308,-1.7056675689541112
132,1567674000,1203,1136,0,2339,36,-0.6860465917333375,1.0956303414863395
132,1567688400,900,891,0,1791,36,-0.6860465917333375,0.38029424879231954
132,1567702800,1095,1082,0,2177,36,-0.6860465917333375,0.8841623724782534
132,1567717200,957,940,0,1897,36,-0.6860465917333375,0.5186621791309439
132,1567731600,270,348,78,618,36,0.017392730494648012,-1.1508904897662307
132,1567746000,73,90,17,163,36,-0.532732893299033,-1.7448283039556085
132,1567760400,1249,1166,0,2415,36,-0.6860465917333375,1.1948375368234665
132,1567774800,924,946,22,1870,36,-0.48764062905364924,0.48341751762959617
132,1567789200,1143,1186,43,2329,36,-0.29825311922303777,1.0825767631525072
132,1567803600,897,927,30,1824,36,-0.41549300626103536,0.42337105729396673
132,1567818000,294,541,247,835,36,1.5415112619886167,-0.8676278399220657
132,1567832400,117,397,280,514,36,1.8391202060081489,-1.2866477044380884
132,1567846800,849,715,0,1564,36,-0.6860465917333375,0.0839780206143222
132,1567861200,933,915,0,1848,36,-0.6860465917333375,0.4546996452951647
132,1567875600,1057,1102,45,2159,36,-0.2802162135248843,0.8606659314773549
132,1567890000,956,1169,213,2125,36,1.2348838651200076,0.8162837651423245
132,1567904400,428,851,423,1279,36,3.1287589634261224,-0.28804896189990353
132,1567918800,96,344,248,440,36,1.5505297148376933,-1.3832441841084488
132,1567933200,529,383,0,912,36,-0.6860465917333375,-0.7671152867515556
132,1567947600,806,753,0,1559,36,-0.6860465917333375,0.07745123144740597
132,1567962000,924,934,10,1858,36,-0.5958620632425701,0.4677532236289972
132,1567976400,646,1009,363,1655,36,2.587651792481518,0.2027655834521978
132,1567990800,310,637,327,947,36,2.2629874899147557,-0.721427762583142
132,1568005200,109,205,96,314,36,0.17972488177802928,-1.547719271114738
132,1568019600,1209,1140,0,2349,36,-0.6860465917333375,1.1086839198201721
132,1568034000,881,841,0,1722,36,-0.6860465917333375,0.29022455828887544
132,1568048400,1213,1192,0,2405,36,-0.6860465917333375,1.181783958489634
132,1568062800,1415,1016,0,2431,36,-0.6860465917333375,1.2157232621575984
132,1568077200,304,291,0,595,37,-0.736955989926184,-0.8857670906370708
132,1568091600,54,61,7,115,37,-0.5609486292127006,-1.4741964097540625
132,1568106000,1265,1200,0,2465,37,-0.736955989926184,1.4066554650895429
132,1568120400,903,778,0,1681,37,-0.736955989926184,0.445554243865123
132,1568134800,1100,1088,0,2188,37,-0.736955989926184,1.0670827121824455
132,1568149200,1083,974,0,2057,37,-0.736955989926184,0.9064905438400999
132,1568163600,295,282,0,577,37,-0.736955989926184,-0.907833190103958
132,1568178000,81,68,0,149,37,-0.736955989926184,-1.4325159996499424
132,1568192400,1204,1182,0,2386,37,-0.736955989926184,1.3098098063182047
132,1568206800,861,934,73,1795,37,1.0985493432287146,0.5853062071554085
132,1568221200,1038,1125,87,2163,37,1.4505640646556814,1.0364353518117688
132,1568235600,992,1024,32,2016,37,0.06764908762116878,0.8562288728321902
132,1568250000,286,332,46,618,37,0.41966380904813566,-0.8575715190960483
132,1568264400,62,71,9,133,37,-0.5106608118659911,-1.4521303102871754
132,1568278800,1245,1202,0,2447,37,-0.736955989926184,1.3845893656226556
132,1568293200,887,801,0,1688,37,-0.736955989926184,0.45413550476891246
132,1568307600,1069,1114,45,2183,37,0.39451990037478085,1.0609532401083102
132,1568322000,1006,1050,44,2056,37,0.3693759917014261,0.9052646494252727
132,1568336400,275,345,70,620,37,1.0231176172086502,-0.8551197302663942
132,1568350800,67,75,8,142,37,-0.5358047205393458,-1.4410972605537318
132,1568365200,1142,1104,0,2246,37,-0.736955989926184,1.1381845882424153
132,1568379600,825,933,108,1758,37,1.9785861467961317,0.5399481138068071
132,1568394000,1021,1160,139,2181,37,2.75804731567013,1.0585014512786561
132,1568408400,937,1070,133,2007,37,2.6071838636300013,0.8451958230987465
132,1568422800,313,318,5,631,37,-0.6112364465594101,-0.8416348917032964
132,1568437200,71,82,11,153,37,-0.4603729945192815,-1.427612421990634
132,1568451600,310,394,84,704,37,1.3751323386356171,-0.7521445994209206
132,1568466000,578,568,0,1146,37,-0.736955989926184,-0.2102992680673574
132,1568480400,667,728,61,1395,37,0.7968224391484573,0.09494844122458207
132,1568494800,518,620,102,1138,37,1.827722694756003,-0.22010642338597394
132,1568509200,297,266,0,563,37,-0.736955989926184,-0.924995711911537
132,1568523600,52,74,22,126,37,-0.18378999911237898,-1.4607115711909648
132,1568538000,221,238,17,459,37,-0.30950954247915285,-1.0524887310535518
132,1568552400,495,516,21,1011,37,-0.20893390778573376,-0.37579501406901133
132,1568566800,631,700,69,1331,37,0.9979737085352955,0.01649119867564983
132,1568581200,656,554,0,1210,37,-0.736955989926184,-0.13184202551842517
132,1568595600,281,244,0,525,37,-0.736955989926184,-0.9715796996749655
132,1568610000,70,55,0,125,37,-0.736955989926184,-1.461937465605792
132,1568624400,1207,1174,0,2381,37,-0.736955989926184,1.3036803342440693
132,1568638800,907,945,38,1852,37,0.21851253966129744,0.6551821888005512
132,1568653200,1122,1079,0,2201,37,-0.736955989926184,1.0830193395751975
132,1568667600,1098,1022,0,2120,37,-0.736955989926184,0.983721891974205
132,1568682000,259,196,0,455,38,-0.6880586907793905,-1.2845266593790772
132,1568696400,62,59,0,121,38,-0.6880586907793905,-1.706041548096233
132,1568710800,1250,1191,0,2441,38,-0.6880586907793905,1.221846301675628
132,1568725200,861,904,43,1765,38,-0.25066552092807787,0.368720359242103
132,1568739600,1075,1075,0,2150,38,-0.6880586907793905,0.8545982998292437
132,1568754000,1043,969,0,2012,38,-0.6880586907793905,0.6804394535928141
132,1568768400,278,320,42,598,38,-0.2608374551106665,-1.1040577100181392
132,1568782800,66,55,0,121,38,-0.6880586907793905,-1.706041548096233
132,1568797200,1267,1342,75,2609,38,0.07483637291475953,1.4338657666591077
132,1568811600,954,842,0,1796,38,-0.6880586907793905,0.4078429986140546
132,1568826000,1047,1157,110,2204,38,0.4308540693053629,0.9227474135739336
132,1568840400,1081,960,0,2041,38,-0.6880586907793905,0.7170380517149624
132,1568854800,288,322,34,610,38,-0.34221292857137586,-1.0889134625193193
132,1568869200,55,68,13,123,38,-0.5558235464057378,-1.7035175068464297
132,1568883600,1217,1147,0,2364,38,-0.6880586907793905,1.1246707135582
132,1568898000,912,873,0,1785,38,-0.6880586907793905,0.3939607717401363
132,1568912400,1080,1139,59,2219,38,-0.08791457400665915,0.9416777229474586
132,1568926800,1158,1116,0,2274,38,-0.6880586907793905,1.0110888573170502
132,1568941200,347,358,11,705,38,-0.5761674147709152,-0.9690215031536611
132,1568955600,71,59,0,130,38,-0.6880586907793905,-1.694683362472118
132,1568970000,1152,1231,79,2383,38,0.1155241096451142,1.1486491054313315
132,1568984400,899,940,41,1839,38,-0.2710093892932552,0.4621098854848262
132,1568998800,1145,1224,79,2369,38,0.1155241096451142,1.1309808166827082
132,1569013200,1046,1022,0,2068,38,-0.6880586907793905,0.7511126085873073
132,1569027600,370,520,150,890,38,0.8377314366089096,-0.7355476875468533
132,1569042000,104,353,249,457,38,1.8447529206851876,-1.2820026181292739
132,1569056400,726,573,0,1299,38,-0.6880586907793905,-0.21938125196207253
132,1569070800,1142,760,0,1902,38,-0.6880586907793905,0.541617184853631
132,1569085200,904,886,0,1790,38,-0.6880586907793905,0.40027087486464463
132,1569099600,818,1107,289,1925,38,2.251630287988734,0.5706436592263693
132,1569114000,354,786,432,1140,38,3.7062168760989143,-0.42004253132143715
132,1569128400,61,294,233,355,38,1.682001973763769,-1.4107287218692437
132,1569142800,329,376,47,705,38,-0.20997778419772317,-0.9690215031536611
132,1569157200,715,558,0,1273,38,-0.6880586907793905,-0.2521937882095158
132,1569171600,781,882,101,1663,38,0.33930666166206486,0.23999425550213324
132,1569186000,648,868,220,1516,38,1.5497668293901163,0.05447722364158861
132,1569200400,315,554,239,869,38,1.743033578859301,-0.7620501206697882
132,1569214800,90,209,119,299,38,0.5224014769486609,-1.481401876863737
132,1569229200,1336,1209,0,2545,38,-0.6880586907793905,1.3530964466654012
132,1569243600,1002,891,0,1893,38,-0.6880586907793905,0.530258999229516
132,1569258000,979,1091,112,2070,38,0.45119793767054023,0.7536366498371107
132,1569272400,1011,1075,64,2086,38,-0.03705490309371582,0.7738289798355372
132,1569286800,266,307,41,573,39,-0.18989907953380658,-0.940505249288279
132,1569301200,62,81,19,143,39,-0.41903750968556813,-1.4711879695220451
132,1569315600,1341,1330,0,2671,39,-0.6169297902711803,1.6487327671080958
132,1569321924,493,433,0,926,39,-0.6169297902711803,-0.5048517603521874
132,1569330000,385,415,30,800,39,-0.30446829460968733,-0.6603541388392908
132,1569344400,1032,1108,76,2140,39,0.1746393320712686,0.9934013149124451
132,1569358800,1066,1016,0,2082,39,-0.6169297902711803,0.9218208549739372
132,1569373200,300,304,4,604,39,-0.5752682575163146,-0.9022467275970075
132,1569387600,63,73,10,136,39,-0.512775958384016,-1.4798269905491064
132,1569402000,1232,1265,33,2497,39,-0.27322214504353803,1.4339913872925718
132,1569416400,906,951,45,1857,39,-0.14823754677894085,0.6441380362469665
132,1569430800,1072,1274,202,2346,39,1.4869776138495392,1.2476353622802494
132,1569445200,1117,1084,0,2201,39,-0.6169297902711803,1.0686842124339793
132,1569459600,292,365,73,657,39,0.14339318250511932,-0.8368369969635433
132,1569474000,83,85,2,168,39,-0.5960990238937475,-1.4403343229968262
132,1569488400,1249,1232,0,2481,39,-0.6169297902711803,1.4142450535164317
132,1569502800,871,937,66,1808,39,0.07048550018410427,0.5836648890575374
132,1569517200,1373,1074,0,2447,39,-0.6169297902711803,1.372284094242134
132,1569531600,1082,1013,0,2095,39,-0.6169297902711803,0.937864751167051
132,1569546000,248,270,22,518,39,-0.38779136011941884,-1.0083832716437606
132,1569560400,68,94,26,162,39,-0.3461298273645531,-1.4477391981628787
132,1569574800,1152,1233,81,2385,39,0.22671624801485077,1.2957670508595909
132,1569589200,907,915,8,1822,39,-0.5336067247614489,0.60094293111166
132,1569603600,1053,1070,17,2123,39,-0.439868276063001,0.9724208352752962
132,1569618000,1015,1183,168,2198,39,1.1328545854331804,1.0649817748509531
132,1569632400,347,368,21,715,39,-0.39820674330813527,-0.7652565370250354
132,1569646800,87,144,57,231,39,-0.023252948514343633,-1.3625831337532743
132,1569661200,315,416,101,731,39,0.4350239117891795,-0.7455102032488952
132,1569675600,543,938,395,1481,39,3.497146569271811,0.18009919250767345
132,1569690000,794,1251,457,2045,39,4.14290032697223,0.876157458116613
132,1569704400,916,741,0,1657,39,-0.6169297902711803,0.3973088640452149
132,1569718800,422,369,0,791,39,-0.6169297902711803,-0.6714614515883697
132,1569733200,94,103,9,197,39,-0.5231913415727325,-1.404544093027572
132,1569747600,403,247,0,650,39,-0.6169297902711803,-0.8454760179906046
132,1569762000,432,624,192,1056,39,1.382823781962375,-0.34441279842104877
132,1569776400,574,658,84,1232,39,0.2579623975810001,-0.12720312688350735
132,1569790800,503,608,105,1111,39,0.4766854445440452,-0.2765347760655671
132,1569805200,268,303,35,571,39,-0.25239137866610517,-0.9429735410102965
132,1569819600,68,72,4,140,39,-0.5752682575163146,-1.4748904071050712
132,1569834000,822,908,86,1730,39,0.27879316395843295,0.4874015118988543
132,1569848400,761,839,78,1600,39,0.19547009844870147,0.3269625499677157
132,1569862800,934,917,0,1851,39,-0.6169297902711803,0.636733161080914
132,1569877200,932,847,0,1779,39,-0.6169297902711803,0.5478746590882834
132,1569891600,253,262,9,515,40,-0.7090834142752449,-1.164227958476762
132,1569906000,50,64,14,114,40,-0.6563354450943022,-1.686395870827049
132,1569920400,1017,1051,34,2068,40,-0.4453435683705311,0.8580333080568928
132,1569934800,813,915,102,1728,40,0.27202881249029065,0.4152974222736071
132,1569949200,924,950,26,1874,40,-0.5297403190600395,0.6054134202864297
132,1569963600,958,1009,51,1967,40,-0.26600047315532566,0.7265147066918579
132,1569978000,270,259,0,529,40,-0.804029758800942,-1.1459976572974502
132,1569992400,64,58,0,122,40,-0.804029758800942,-1.6759785558674423
132,1570006800,1177,1297,120,2474,40,0.46192150154168465,1.386712042256934
132,1570021200,806,877,71,1683,40,-0.05500859643155454,0.3567000256258193
132,1570035600,1094,1105,11,2199,40,-0.6879842266028678,1.0286168405204528
132,1570050000,1043,1040,0,2083,40,-0.804029758800942,0.8775657736061554
132,1570064400,271,282,11,553,40,-0.6879842266028678,-1.1147457124186302
132,1570078800,64,65,1,129,40,-0.7934801649647534,-1.6668634052777864
132,1570093200,1210,1138,0,2348,40,-0.804029758800942,1.222639331643128
132,1570107600,898,854,0,1752,40,-0.804029758800942,0.44654936715242727
132,1570122000,1021,1247,226,2268,40,1.5801784481776713,1.1184661820470607
132,1570136400,1015,1157,142,2172,40,0.6940125659378329,0.9934584025317802
132,1570150800,272,282,10,554,40,-0.6985338204390564,-1.1134435480486793
132,1570165200,70,78,8,148,40,-0.7196330081114335,-1.6421222822487205
132,1570179600,1138,1175,37,2313,40,-0.4136947868619654,1.1770635786948487
132,1570194000,849,989,140,1838,40,0.6729133782654557,0.5585355029681995
132,1570208400,1153,1282,129,2435,40,0.5568678460673816,1.335927631828851
132,1570222800,999,1132,133,2131,40,0.5990662214121358,0.9400696633637957
132,1570237200,334,629,295,963,40,2.3081004228746815,-0.5808583207387856
132,1570251600,112,341,229,453,40,1.611827229686237,-1.2449621494137142
132,1570266000,620,549,0,1169,40,-0.804029758800942,-0.31261246052891256
132,1570280400,768,810,42,1578,40,-0.36094681768102266,0.2199727667809811
132,1570294800,883,934,51,1817,40,-0.26600047315532566,0.5311900511992319
132,1570309200,696,595,0,1291,40,-0.804029758800942,-0.15374840739491005
132,1570323600,356,641,285,997,40,2.202604484512796,-0.5365847321604571
132,1570338000,74,303,229,377,40,1.611827229686237,-1.343926641529978
132,1570352400,356,319,0,675,40,-0.804029758800942,-0.9558816592846276
132,1570366800,658,726,68,1384,40,-0.08665737794012021,-0.03264712098948191
132,1570381200,770,801,31,1571,40,-0.4769923498790967,0.2108576161913252
132,1570395600,594,886,292,1480,40,2.276451641366116,0.09236065852579875
132,1570410000,241,519,278,760,40,2.1287573276594762,-0.8451976878388062
132,1570424400,77,196,119,273,40,0.45137190770549607,-1.4793517360048654
132,1570438800,1166,1155,0,2321,40,-0.804029758800942,1.1874808936544554
132,1570453200,939,932,0,1871,40,-0.804029758800942,0.6015069271765773
132,1570467600,1100,1107,7,2207,40,-0.7301826019476221,1.0390341554800595
132,1570482000,1009,988,0,1997,40,-0.804029758800942,0.7655796377903832
132,1570496400,296,309,13,605,41,-0.44073595112531483,-0.8498093004264436
132,1570510800,61,79,18,140,41,-0.34174712787791794,-1.467065163165526
132,1570525200,1285,1162,0,2447,41,-0.6981068915685469,1.5953203751980503
132,1570539600,812,903,91,1715,41,1.1034896915340773,0.6236401783700755
132,1570554000,1057,1080,23,2137,41,-0.24275830463052098,1.1838164667053286
132,1570568400,993,1117,124,2110,41,1.756815924966897,1.1479758037075756
132,1570582800,301,288,0,589,41,-0.6981068915685469,-0.8710482118325196
132,1570597200,58,102,44,160,41,0.1729947530085461,-1.440516523907931
132,1570611600,992,975,0,1967,41,-0.6981068915685469,0.9581530330157717
132,1570626000,765,887,122,1652,41,1.7172203956679382,0.5400119647086514
132,1570640400,951,850,0,1801,41,-0.6981068915685469,0.7377993271777337
132,1570654800,902,931,29,1833,41,-0.12397171673364467,0.7802771499898856
132,1570669200,295,307,12,602,41,-0.46053371577479424,-0.853791596315083
132,1570683600,62,93,31,155,41,-0.0843761874346859,-1.4471536837223298
132,1570698000,1259,1112,0,2371,41,-0.6981068915685469,1.4944355460191894
132,1570712400,871,894,23,1765,41,-0.24275830463052098,0.6900117765140628
132,1570726800,1092,1136,44,2228,41,0.1729947530085461,1.3046127753273857
132,1570741200,1100,1095,0,2195,41,-0.6981068915685469,1.260807520552354
132,1570755600,323,399,76,722,41,0.8065232217918865,-0.6944997607695133
132,1570770000,76,115,39,191,41,0.07400592976114918,-1.3993661330586589
132,1570784400,1152,1097,0,2249,41,-0.6981068915685469,1.3324888465478604
132,1570798800,885,803,0,1688,41,-0.6981068915685469,0.5877995153723223
132,1570813200,1151,1142,0,2293,41,-0.6981068915685469,1.3908958529145692
132,1570827600,1053,1254,201,2307,41,3.28124380297681,1.4094799003948857
132,1570842000,342,336,0,678,41,-0.6981068915685469,-0.7529067671362222
132,1570856400,78,100,22,178,41,-0.26255606928000036,-1.4166227485760956
132,1570870800,302,350,48,652,41,0.25218581160646364,-0.7874199981710955
132,1570885200,559,666,107,1225,41,1.4202539259257474,-0.026801483441000546
132,1570899600,707,732,25,1439,41,-0.2031627753315622,0.2572689566152653
132,1570914000,581,590,9,1171,41,-0.5199270097232324,-0.09848280943650688
132,1570928400,281,317,36,598,41,0.01461263581271103,-0.8591013241666019
132,1570942800,67,108,41,175,41,0.11360145906010796,-1.420605044464735
132,1570957200,190,208,18,398,41,-0.34174712787791794,-1.1245877167425513
132,1570971600,416,630,214,1046,41,3.538614743420042,-0.26441180479647525
132,1570986000,590,609,19,1199,41,-0.32194936322843853,-0.06131471447587397
132,1571000400,601,554,0,1155,41,-0.6981068915685469,-0.11972172084258284
132,1571014800,265,241,0,506,41,-0.6981068915685469,-0.9812250647515386
132,1571029200,59,58,0,117,41,-0.6981068915685469,-1.4975960983117602
132,1571043600,705,728,23,1433,41,-0.24275830463052098,0.24930436483798682
132,1571058000,665,694,29,1359,41,-0.12397171673364467,0.15107439958488555
132,1571072400,835,774,0,1609,41,-0.6981068915685469,0.48293239030482227
132,1571086800,729,709,0,1438,41,-0.6981068915685469,0.25594152465238557
132,1571101200,285,278,0,563,42,-0.7729061951900273,-0.9398853045031914
132,1571115600,45,75,30,120,42,-0.15340122957970012,-1.4599443652177093
132,1571130000,1189,1333,144,2522,42,2.2007176397395436,1.3598792551801957
132,1571144400,977,1002,25,1979,42,-0.2566520571814213,0.7224253726339582
132,1571158800,1171,1107,0,2278,42,-0.7729061951900273,1.0734358899107999
132,1571173200,1092,1012,0,2104,42,-0.7729061951900273,0.8691688999236078
132,1571187600,298,318,20,616,42,-0.35990288478314253,-0.8776660489323801
132,1571202000,49,72,23,121,42,-0.2979523882221098,-1.458770416999392
132,1571216400,1192,1216,24,2408,42,-0.2773022227017656,1.2260491582920354
132,1571230800,896,901,5,1797,42,-0.6696553675883061,0.5087667969002285
132,1571245200,1094,1031,0,2125,42,-0.7729061951900273,0.8938218125082689
132,1571259600,868,867,0,1735,42,-0.7729061951900273,0.4359820073645624
132,1571274000,274,259,0,533,42,-0.7729061951900273,-0.9751037510527073
132,1571288400,158,121,0,279,42,-0.7729061951900273,-1.2732865985052753
132,1571302800,1176,1330,154,2506,42,2.407219294942986,1.3410960836871206
132,1571317200,922,983,61,1905,42,0.48675390155097137,0.6355532044784857
132,1571331600,1145,1192,47,2337,42,0.19765158426615198,1.1426988347915146
132,1571346000,1079,1019,0,2098,42,-0.7729061951900273,0.8621252106137046
132,1571360400,327,342,15,669,42,-0.46315371238486375,-0.8154467933615687
132,1571374800,79,99,20,178,42,-0.35990288478314253,-1.391855368555312
132,1571389200,1202,1153,0,2355,42,-0.7729061951900273,1.163829902721224
132,1571403600,951,968,17,1919,42,-0.42185338134417527,0.6519884795349264
132,1571418000,1151,1339,188,2490,42,3.10932492263469,1.3223129121940456
132,1571432400,1077,1108,31,2185,42,-0.13275106405935588,0.9642587056073006
132,1571446800,305,390,85,695,42,0.9823578740392331,-0.7849241396853216
132,1571461200,65,94,29,159,42,-0.17405139510004436,-1.4141603847033386
132,1571475600,356,411,55,767,42,0.36285290842890594,-0.7003998679664835
132,1571490000,572,761,189,1333,42,3.129975088155034,-0.03594517639895044
132,1571504400,692,766,74,1458,42,0.7552060533154465,0.11079835089069907
132,1571518800,657,701,44,1358,42,0.13570108770511927,-0.006596470941020537
132,1571533200,286,339,53,625,42,0.3215525773882174,-0.8671005149675253
132,1571547600,62,99,37,161,42,-0.00885007093729043,-1.4118124882667042
132,1571562000,212,222,10,434,42,-0.5664045399865849,-1.0913246246661097
132,1571576400,498,543,45,1041,42,0.1563512532254635,-0.3787380561475717
132,1571590800,586,586,0,1172,42,-0.7729061951900273,-0.224950839548019
132,1571605200,423,476,53,899,42,0.3215525773882174,-0.5454387031486135
132,1571619600,192,224,32,416,42,-0.11210089853901165,-1.1124556925958193
132,1571634000,56,53,0,109,42,-0.7729061951900273,-1.4728577956191984
132,1571648400,1262,1252,0,2514,42,-0.7729061951900273,1.3504876694336583
132,1571662800,925,942,17,1867,42,-0.42185338134417527,0.5909431721824323
132,1571677200,1189,1116,0,2305,42,-0.7729061951900273,1.1051324918053642
132,1571691600,1046,1091,45,2137,42,0.1563512532254635,0.9079091911280752
132,1571706000,241,313,72,554,43,0.5877414913028829,-0.9516886303849007
132,1571720400,67,70,3,137,43,-0.6465156404331713,-1.4381146699740313
132,1571734800,1265,1285,20,2550,43,-0.3424233036286362,1.3766240195429285
132,1571749200,876,895,19,1771,43,-0.36031108814655005,0.46792885206107526
132,1571763600,1134,961,0,2095,43,-0.7001789939869129,0.8458713864180977
132,1571778000,1056,1026,0,2082,43,-0.7001789939869129,0.8307070254716739
132,1571792400,224,268,44,492,43,0.08688352480129569,-1.0240109672063062
132,1571806800,46,85,39,131,43,-0.0025553977882734587,-1.4451136057954577
132,1571821200,1255,1219,0,2474,43,-0.7001789939869129,1.2879708324715282
132,1571835600,1069,976,0,2045,43,-0.7001789939869129,0.7875469212395448
132,1571850000,1049,1151,102,2200,43,1.1243750268402979,0.9683527632930585
132,1571864400,1060,1009,0,2069,43,-0.7001789939869129,0.8155426645252501
132,1571878800,314,328,14,642,43,-0.4497500107361192,-0.8490375716706478
132,1571893200,68,70,2,138,43,-0.6644034249510852,-1.4369481806704603
132,1571907600,1279,1228,0,2507,43,-0.7001789939869129,1.326464979489373
132,1571922000,961,959,0,1920,43,-0.7001789939869129,0.6417357582931628
132,1571936400,1233,1200,0,2433,43,-0.7001789939869129,1.2401447710251148
132,1571950800,1170,1055,0,2225,43,-0.7001789939869129,0.9975149958823349
132,1571965200,447,300,0,747,43,-0.7001789939869129,-0.7265561947956868
132,1571979600,94,64,0,158,43,-0.7001789939869129,-1.413618394599039
132,1571994000,1434,1143,0,2577,43,-0.7001789939869129,1.4081192307393469
132,1572008400,992,919,0,1911,43,-0.7001789939869129,0.6312373545610231
132,1572022800,1192,1154,0,2346,43,-0.7001789939869129,1.138660201614433
132,1572037200,978,1120,142,2098,43,1.839886407556851,0.8493708543288108
132,1572051600,321,369,48,690,43,0.158434662872951,-0.793046085099237
132,1572066000,58,112,54,170,43,0.265761369980434,-1.3996205229561864
132,1572080400,344,502,158,846,43,2.1260909598434723,-0.6110737537421521
132,1572094800,587,785,198,1372,43,2.8416023405600255,0.002499619936223655
132,1572109200,733,844,111,1577,43,1.2853650875015223,0.24162992716829026
132,1572123600,630,780,150,1410,43,1.9829886837001618,0.04682621347192381
132,1572138000,328,394,66,722,43,0.48041478419539996,-0.7557184273849632
132,1572152400,74,128,54,202,43,0.265761369980434,-1.3622928652419126
132,1572166800,214,234,20,448,43,-0.3424233036286362,-1.0753364965634327
132,1572181200,368,566,198,934,43,2.8416023405600255,-0.5084226950278992
132,1572195600,495,527,32,1022,43,-0.12776988941367026,-0.40577163631364616
132,1572210000,416,428,12,844,43,-0.4855255797719468,-0.6134067323492942
132,1572224400,204,226,22,430,43,-0.3066477345928086,-1.0963333040277117
132,1572238800,54,68,14,122,43,-0.4497500107361192,-1.4556120095275973
132,1572253200,1236,1286,50,2522,43,0.19421023190877867,1.3439623190429388
132,1572267600,937,920,0,1857,43,-0.7001789939869129,0.5682469321681861
132,1572282000,1097,1030,0,2127,43,-0.7001789939869129,0.8831990441323715
132,1572296400,985,952,0,1937,43,-0.7001789939869129,0.6615660764538707
132,1572310800,317,258,0,575,44,-0.6818971196801448,-0.992119029803345
132,1572325200,48,91,43,139,44,-0.22913748801016628,-1.525192697646391
132,1572339600,1201,1157,0,2358,44,-0.6818971196801448,1.1878588366281944
132,1572354000,944,965,21,1909,44,-0.460781950725039,0.6388907704320299
132,1572368400,1225,1090,0,2315,44,-0.6818971196801448,1.1352850574601876
132,1572382800,996,1104,108,2100,44,0.45526660637468497,0.8724161616201533
132,1572397200,279,327,48,606,44,-0.17649101921133156,-0.9542170029612935
132,1572411600,65,73,8,138,44,-0.5976627696020093,-1.526415343673554
132,1572426000,1257,1196,0,2453,44,-0.6818971196801448,1.3040102092086745
132,1572440400,928,929,1,1857,44,-0.6713678259203778,0.5753131770195565
132,1572454800,1084,1123,39,2207,44,-0.27125466304923407,1.003239286526589
132,1572469200,1006,1020,14,2026,44,-0.5344870070434076,0.781940355610095
132,1572483600,298,305,7,603,44,-0.6081920633617762,-0.9578849410427824
132,1572498000,65,74,9,139,44,-0.5871334758422423,-1.525192697646391
132,1572512400,1172,1112,0,2284,44,-0.6818971196801448,1.097383030618136
132,1572526800,919,909,0,1828,44,-0.6818971196801448,0.5398564422318309
132,1572541200,1169,1118,0,2287,44,-0.6818971196801448,1.1010509686996248
132,1572555600,882,925,43,1807,44,-0.22913748801016628,0.514180875661409
132,1572570000,278,307,29,585,44,-0.37654760064690346,-0.9798925695317154
132,1572584400,59,104,45,163,44,-0.2080789004906324,-1.4958491929944802
132,1572598800,1114,1128,14,2242,44,-0.5344870070434076,1.0460318974772922
132,1572613200,873,983,110,1856,44,0.47632519389421885,0.5740905309923936
132,1572627600,1127,1091,0,2218,44,-0.6818971196801448,1.0166883928253814
132,1572642000,965,945,0,1910,44,-0.6818971196801448,0.6401134164591928
132,1572656400,320,481,161,801,44,1.0133191756423328,-0.7158010276645184
132,1572670800,59,103,44,162,44,-0.21860819425039935,-1.497071839021643
132,1572685200,322,490,168,812,44,1.0870242319607015,-0.7023519213657259
132,1572699600,590,939,349,1529,44,2.992826402478518,0.17428528011010902
132,1572714000,715,1146,431,1861,44,3.856228490779407,0.5802037611282084
132,1572728400,624,888,264,1512,44,2.097836432898328,0.1535002976483389
132,1572742800,327,459,132,786,44,0.7079696566090915,-0.7341407180719626
132,1572753600,64,129,65,193,44,0.0025069747047064433,-1.4591698121795917
132,1572768000,196,169,0,365,44,-0.6818971196801448,-1.2488746955075645
132,1572782400,559,717,158,1276,44,0.9817312943630321,-0.13504416476211725
132,1572796800,962,1098,136,2060,44,0.7500868316481594,0.8235103205336353
132,1572811200,615,688,73,1303,44,0.08674132478284198,-0.1020327220287176
132,1572825600,255,282,27,537,44,-0.39760618816643734,-1.038579578835537
132,1572840000,50,68,18,118,44,-0.4923698320043398,-1.550868264216813
132,1572854400,821,732,0,1553,44,-0.6818971196801448,0.20362878476201982
132,1572868800,1111,1227,116,2338,44,0.5395009564528205,1.1634059160849353
132,1572883200,966,1005,39,1971,44,-0.27125466304923407,0.7146948241161328
132,1572897600,1225,1224,0,2449,44,-0.6818971196801448,1.2991196251000228
132,1572912000,325,376,51,701,45,0.25390773768482805,-0.791432032157279
132,1572926400,62,78,16,140,45,-0.43985504000420017,-1.5409385249904706
132,1572940800,702,800,98,1502,45,1.1855320391529516,0.2787189495885081
132,1572955200,1203,1132,0,2335,45,-0.7570037383763274,1.3916225298559746
132,1572969600,891,954,63,1845,45,0.4917692614639234,0.736973364992759
132,1572984000,1166,953,0,2119,45,-0.7570037383763274,1.1030424898346387
132,1572998400,298,428,130,726,45,1.819829435897206,-0.7580315645622169
132,1573012800,55,81,26,136,45,-0.2416371035216207,-1.5462825998056806
132,1573027200,773,755,0,1528,45,-0.7570037383763274,0.3134554358873726
132,1573041600,1152,1076,0,2228,45,-0.7570037383763274,1.248668528549109
132,1573056000,946,999,53,1945,45,0.29355132498134395,0.8705752353730071
132,1573070400,1290,1133,0,2423,45,-0.7570037383763274,1.5091921757905928
132,1573084800,381,403,22,784,45,-0.3209242781146525,-0.680542479741673
132,1573099200,80,120,40,200,45,0.03586800755399059,-1.4607774027623217
132,1573113600,807,809,2,1616,45,-0.7173601510798114,0.4310250818219909
132,1573128000,1163,1183,20,2346,45,-0.3605678654111684,1.406318735597802
132,1573142400,932,965,33,1897,45,-0.10288454798381505,0.806446337590488
132,1573156800,1210,1213,3,2423,45,-0.6975383574315536,1.5091921757905928
132,1573171200,387,396,9,783,45,-0.5786075955420058,-0.6818784984454755
132,1573185600,73,136,63,209,45,0.4917692614639234,-1.4487532344280996
132,1573200000,764,728,0,1492,45,-0.7570037383763274,0.2653587625504833
132,1573214400,1225,1182,0,2407,45,-0.7570037383763274,1.4878158765297531
132,1573228800,962,1072,110,2034,45,1.423393562932047,0.9894809000114279
132,1573243200,1154,1187,33,2341,45,-0.10288454798381505,1.3996386420787894
132,1573257600,333,386,53,719,45,0.29355132498134395,-0.7673836954888343
132,1573272000,82,137,55,219,45,0.3331949122778598,-1.4353930473900747
132,1573286400,195,283,88,478,45,0.9873141026703721,-1.0893642031052322
132,1573300800,522,792,270,1314,45,4.594880546653319,0.02754743327364174
132,1573315200,651,748,97,1399,45,1.1657102455046937,0.1411090230968526
132,1573329600,782,738,0,1520,45,-0.7570037383763274,0.30276728625695276
132,1573344000,416,443,27,859,45,-0.22181530987336276,-0.580341076956487
132,1573358400,122,184,62,306,45,0.4719474678156655,-1.319159420159259
132,1573372800,169,201,32,370,45,-0.122706341632073,-1.2336542231159
132,1573387200,489,571,82,1060,45,0.8683833407808245,-0.31180131749218837
132,1573401600,670,711,41,1381,45,0.055689801202248534,0.11706068642840795
132,1573416000,670,627,0,1297,45,-0.7570037383763274,0.00483511530899957
132,1573430400,350,304,0,654,45,-0.7570037383763274,-0.8542249112359955
132,1573444800,84,70,0,154,45,-0.7570037383763274,-1.5222342631372359
132,1573459200,664,468,0,1132,45,-0.7570037383763274,-0.21560797081840974
132,1573473600,936,913,0,1849,45,-0.7570037383763274,0.7423174398079689
132,1573488000,794,746,0,1540,45,-0.7570037383763274,0.32948766033300236
132,1573502400,943,968,25,1911,45,-0.26145889716987863,0.8251505994437227
132,1573516800,313,429,116,742,46,1.3010356311702176,-0.7182169172966903
132,1573531200,95,115,20,210,46,-0.6644104778137903,-1.3890010169488074
132,1573545600,751,533,0,1284,46,-1.0738784171854585,-0.034824093966901996
132,1573560000,1138,1132,0,2270,46,-1.0738784171854585,1.2083960606514952
132,1573574400,901,1009,108,1910,46,1.1372484554215503,0.7544820082553259
132,1573588800,1217,1173,0,2390,46,-1.0738784171854585,1.3597007447835516
132,1573603200,336,465,129,801,46,1.567189791761802,-0.6438254475984293
132,1573617600,82,115,33,197,46,-0.3982563172222059,-1.40539235772978
132,1573632000,797,684,0,1481,46,-1.0738784171854585,0.21356776248322404
132,1573646400,1110,1130,20,2240,46,-0.6644104778137903,1.170569889618481
132,1573660800,895,996,101,1891,46,0.9939346766414664,0.7305254332677503
132,1573675200,1214,1203,0,2417,46,-1.0738784171854585,1.3937442987132644
132,1573689600,383,491,108,874,46,1.1372484554215503,-0.5517817647514283
132,1573704000,82,150,68,232,46,0.31831257667821367,-1.3612618248579302
132,1573718400,791,707,0,1498,46,-1.0738784171854585,0.23500259273526536
132,1573732800,1275,1108,0,2383,46,-1.0738784171854585,1.3508746382091819
132,1573747200,993,970,0,1963,46,-1.0738784171854585,0.8213082437469842
132,1573761600,1150,1192,42,2342,46,-0.21399574450495515,1.299178871130729
132,1573776000,394,492,98,886,46,0.9325144857357162,-0.5366512963382226
132,1573790400,89,132,43,221,46,-0.19352234753637174,-1.3751314209033687
132,1573804800,730,699,0,1429,46,-1.0738784171854585,0.1480023993593329
132,1573819200,1232,1136,0,2368,46,-1.0738784171854585,1.3319615526926747
132,1573833600,1027,1091,64,2118,46,0.23641898880388,1.0167434607508905
132,1573848000,1184,1344,160,2528,46,2.2018650977878877,1.5337011315354165
132,1573862400,422,527,105,949,46,1.0758282645158,-0.45721633716889293
132,1573876800,128,149,21,277,46,-0.6439370808452068,-1.3045225683084092
132,1573891200,218,232,14,450,46,-0.7872508596252908,-1.0863916486846943
132,1573905600,553,610,57,1163,46,0.09310521002379608,-0.1873896504667256
132,1573920000,669,763,94,1432,46,0.8506208978613825,0.15178501646263431
132,1573934400,606,722,116,1328,46,1.3010356311702176,0.02065429021485204
132,1573948800,304,363,59,667,46,0.1340520039609629,-0.8127823448792256
132,1573963200,75,140,65,215,46,0.2568923857724634,-1.3826966551099715
132,1573977600,134,146,12,280,46,-0.8281976535624577,-1.3007399512051077
132,1573992000,406,506,100,912,46,0.973461279672883,-0.503868614776277
132,1574006400,553,647,94,1200,46,0.8506208978613825,-0.14073737285934151
132,1574020800,453,490,37,943,46,-0.31636272934787224,-0.46478157137549575
132,1574035200,222,283,61,505,46,0.17499879789812975,-1.017043668457502
132,1574049600,55,58,3,113,46,-1.0124582262797084,-1.5113056366222197
132,1574064000,738,566,0,1304,46,-1.0738784171854585,-0.00960664661155925
132,1574078400,1191,1363,172,2554,46,2.4475458614108887,1.5664838130973622
132,1574092800,902,925,23,1827,46,-0.60299028690804,0.6498296017306535
132,1574107200,1117,1177,60,2294,46,0.15452540092954634,1.2386569974779065
132,1574121600,333,359,26,692,47,-0.35451864780561215,-0.847224091913682
132,1574136000,84,81,0,165,47,-0.6947070163501889,-1.4933258714898063
132,1574150400,801,838,37,1639,47,-0.21059279957521423,0.3137975119925607
132,1574164800,1279,1176,0,2455,47,-0.6947070163501889,1.314213170691076
132,1574179200,987,881,0,1868,47,-0.6947070163501889,0.5945514162106489
132,1574193600,1219,1205,0,2424,47,-0.6947070163501889,1.2762071836571862
132,1574208000,390,499,109,889,47,0.7314672979328447,-0.6057021743112218
132,1574222400,117,108,0,225,47,-0.6947070163501889,-1.4197658965855038
132,1574236800,806,652,0,1458,47,-0.6947070163501889,0.09189158769791453
132,1574251200,617,1047,430,1664,47,4.931485232656275,0.3444475015360201
132,1574265600,2100,958,0,3058,47,-0.6947070163501889,2.053490918479317
132,1574280000,1260,1220,0,2480,47,-0.6947070163501889,1.3448631602345353
132,1574294400,388,487,99,875,47,0.6006256177233921,-0.622866168455559
132,1574308800,87,133,46,220,47,-0.09283528738670686,-1.4258958944941957
132,1574323200,830,790,0,1620,47,-0.6947070163501889,0.29050351993953155
132,1574337600,1158,1269,111,2427,47,0.7576356339747352,1.2798851824024013
132,1574352000,968,913,0,1881,47,-0.6947070163501889,0.6104894107732478
132,1574366400,1244,1263,19,2507,47,-0.446107823952229,1.3779651489414715
132,1574380800,372,525,153,897,47,1.3071706908544363,-0.5958941776573148
132,1574395200,87,121,34,208,47,-0.24984530363805002,-1.4406078894750562
132,1574409600,733,744,11,1477,47,-0.550781168119791,0.11518557975094368
132,1574424000,1193,1248,55,2441,47,0.024922224801800508,1.2970491765467387
132,1574438400,1023,1023,0,2046,47,-0.6947070163501889,0.8127793417600799
132,1574452800,1031,1262,231,2293,47,2.3277357964881666,1.115601238449459
132,1574467200,384,493,109,877,47,0.7314672979328447,-0.6204141692920823
132,1574481600,118,190,72,308,47,0.24735308115787,-1.3180079313012185
132,1574496000,239,272,33,511,47,-0.2629294716589953,-1.0691300162083281
132,1574510400,659,707,48,1366,47,-0.06666695134481634,-0.02090037382201612
132,1574524800,808,889,81,1697,47,0.36511059334637735,0.3849054877333865
132,1574539200,814,812,0,1626,47,-0.6947070163501889,0.2978595174299618
132,1574553600,437,469,32,906,47,-0.2760136396799406,-0.5848601814216694
132,1574568000,93,172,79,265,47,0.33894225730448685,-1.3707259133159688
132,1574582400,150,185,35,335,47,-0.23676113561710477,-1.2849059425942824
132,1574596800,409,474,65,883,47,0.15576390501125315,-0.613058171801652
132,1574611200,569,643,74,1212,47,0.27352141719976053,-0.20970430940972612
132,1574625600,572,649,77,1221,47,0.3127739212625963,-0.19867031317408074
132,1574640000,347,325,0,672,47,-0.6947070163501889,-0.8717440835484495
132,1574654400,69,94,25,163,47,-0.3676028158265574,-1.4957778706532832
132,1574668800,739,760,21,1499,47,-0.41993948791033847,0.14215757054918796
132,1574683200,1256,1146,0,2402,47,-0.6947070163501889,1.249235192858942
132,1574697600,895,948,53,1843,47,-0.0012461112400900206,0.5639014266671896
132,1574712000,1164,1229,65,2393,47,0.15576390501125315,1.2382011966232966
132,1574726400,368,401,33,769,48,-0.29918503834918103,-0.4617470590396065
132,1574740800,85,111,26,196,48,-0.4170944234358556,-1.3018774531461441
132,1574755200,775,718,0,1493,48,-0.8550435680435041,0.5997789537581828
132,1574769600,1183,1307,124,2490,48,1.2336369677775885,2.0615765155805525
132,1574784000,926,1013,87,1939,48,0.6104016466051657,1.2537024367800254
132,1574798400,1157,1184,27,2341,48,-0.40025022556633066,1.8431132891898474
132,1574812800,354,408,54,762,48,0.05454311691084271,-0.47201043209151883
132,1574827200,91,101,10,192,48,-0.6866015893482547,-1.3077422377472367
132,1574841600,707,570,0,1277,48,-0.8550435680435041,0.2830805852991738
132,1574856000,1080,1017,0,2097,48,-0.8550435680435041,1.4853614285231893
132,1574870400,975,1085,110,2060,48,0.9978181976042394,1.4311121709630812
132,1574884800,941,1161,220,2102,48,2.850679963251983,1.4926924092745553
132,1574899200,354,447,93,801,48,0.7114668338223153,-0.4148287822308644
132,1574913600,81,103,22,184,48,-0.4844712149139554,-1.3194718069494225
132,1574928000,152,178,26,330,48,-0.4170944234358556,-1.1054071690095366
132,1574942400,349,515,166,864,48,1.941093278297636,-0.3224584247636535
132,1574956800,466,716,250,1182,48,3.356005899337731,0.14379195102322082
132,1574971200,416,533,117,949,48,1.1157275826909139,-0.19783175199043235
132,1574985600,343,332,0,675,48,-0.8550435680435041,-0.5995694971652863
132,1575000000,66,95,29,161,48,-0.3665618298272808,-1.3531943184057058
132,1575014400,310,275,0,585,48,-0.8550435680435041,-0.7315271506898734
132,1575028800,615,739,124,1354,48,1.2336369677775885,0.3959776888702094
132,1575043200,775,862,87,1637,48,0.6104016466051657,0.8109111993975221
132,1575057600,786,804,18,1590,48,-0.5518480063920551,0.7419999803346822
132,1575072000,341,361,20,702,48,-0.5181596106530053,-0.5599822011079102
132,1575086400,97,124,27,221,48,-0.40025022556633066,-1.2652225493893143
132,1575100800,188,259,71,447,48,0.3408944806927667,-0.9338622194275735
132,1575115200,530,537,7,1067,48,-0.7371341829568295,-0.024820606258195994
132,1575129600,719,781,62,1500,48,0.18929669986704223,0.6100423268100951
132,1575144000,685,744,59,1429,48,0.1387641062584674,0.5059424001406986
132,1575158400,390,416,26,806,48,-0.4170944234358556,-0.4074978014794985
132,1575172800,83,109,26,192,48,-0.4170944234358556,-1.3077422377472367
132,1575187200,151,157,6,308,48,-0.7539783808263545,-1.1376634843155469
132,1575201600,423,513,90,936,48,0.6609342402137406,-0.21689230194398382
132,1575216000,617,521,0,1138,48,-0.8550435680435041,0.07927932041120046
132,1575230400,416,489,73,905,48,0.3745828764318166,-0.2623443826024527
132,1575244800,227,262,35,489,48,-0.2654966426101312,-0.8722819811160996
132,1575259200,63,70,7,133,48,-0.7371341829568295,-1.3942478106133551
132,1575273600,716,644,0,1360,48,-0.8550435680435041,0.40477486577184857
132,1575288000,1090,1088,0,2178,48,-0.8550435680435041,1.6041233166953175
132,1575302400,948,852,0,1800,48,-0.8550435680435041,1.049901171892052
132,1575316800,988,896,0,1884,48,-0.8550435680435041,1.1730616485149998
132,1575331200,281,313,32,594,49,-0.08345976103911147,-0.918334547057068
132,1575345600,62,67,5,129,49,-0.7061135045809034,-1.5124275512647112
132,1575360000,777,707,0,1484,49,-0.8214197533849389,0.21874668680272216
132,1575374400,1310,1196,0,2506,49,-0.8214197533849389,1.5244736766956497
132,1575388800,932,926,0,1858,49,-0.8214197533849389,0.6965763288966115
132,1575403200,1189,1240,51,2429,49,0.3547039844162236,1.4260969856763195
132,1575417600,340,415,75,755,49,0.9081739786755941,-0.7126378294711958
132,1575432000,60,90,30,150,49,-0.1295822605607257,-1.4855975446230756
132,1575446400,752,784,32,1536,49,-0.08345976103911147,0.2851828937248672
132,1575460800,1210,1108,0,2318,49,-0.8214197533849389,1.2842812362848177
132,1575475200,888,988,100,1876,49,1.4847052226957718,0.7195734774465847
132,1575489600,1173,1101,0,2274,49,-0.8214197533849389,1.2280659842737718
132,1575504000,344,452,108,796,49,1.6691952207822287,-0.6602554355518122
132,1575518400,63,97,34,160,49,-0.03733726151749725,-1.4728213509842016
132,1575532800,833,819,0,1652,49,-0.8214197533849389,0.4333867399358061
132,1575547200,1167,1140,0,2307,49,-0.8214197533849389,1.2702274232820563
132,1575561600,937,915,0,1852,49,-0.8214197533849389,0.688910612713287
132,1575576000,1212,1154,0,2366,49,-0.8214197533849389,1.3456069657514131
132,1575590400,372,448,76,820,49,0.9312352284364013,-0.6295925708185145
132,1575604800,67,101,34,168,49,-0.03733726151749725,-1.4626003960731024
132,1575619200,788,754,0,1542,49,-0.8214197533849389,0.2928486099081916
132,1575633600,1176,1087,0,2263,49,-0.8214197533849389,1.2140121712710104
132,1575648000,937,994,57,1931,49,0.49307148298106623,0.789842542460392
132,1575662400,1209,1205,0,2414,49,-0.8214197533849389,1.4069326952180086
132,1575676800,376,516,140,892,49,2.407155213128056,-0.5376039766186214
132,1575691200,91,147,56,238,49,0.4700102332202591,-1.3731670406009842
132,1575705600,227,256,29,483,49,-0.15264351032153278,-1.0601502964485698
132,1575720000,568,628,60,1196,49,0.5622552322634875,-0.14920768999685038
132,1575734400,723,680,0,1403,49,-0.8214197533849389,0.11525951832784237
132,1575748800,650,808,158,1458,49,2.822257708822584,0.18552858334164962
132,1575763200,426,431,5,857,49,-0.7061135045809034,-0.5823206543546806
132,1575777600,95,128,33,223,49,-0.06039851127830436,-1.392331331059295
132,1575792000,131,141,10,272,49,-0.5908072557768678,-1.3297279822288124
132,1575806400,414,519,105,933,49,1.6000114714998073,-0.4852215826992378
132,1575820800,624,553,0,1177,49,-0.8214197533849389,-0.17348245791071107
132,1575835200,594,720,126,1314,49,2.0842977164767564,0.00155139494186336
132,1575849600,299,316,17,615,49,-0.4293785074512181,-0.8915045404154325
132,1575864000,67,82,15,149,49,-0.47550100697283226,-1.486875163986963
132,1575878400,731,675,0,1406,49,-0.8214197533849389,0.11909237641950458
132,1575892800,1112,1193,81,2305,49,1.0465414772404367,1.2676721845542813
132,1575907200,918,861,0,1779,49,-0.8214197533849389,0.5956443991495065
132,1575921600,1115,1142,27,2257,49,-0.198766009843147,1.206346455087686
132,1575936000,298,402,104,700,50,1.2491132022626645,-0.783116981852138
132,1575950400,68,130,62,198,50,0.40423755471997275,-1.428742947495779
132,1575964800,786,690,0,1476,50,-0.8429598297478105,0.21490243914281312
132,1575979200,1297,1160,0,2457,50,-0.8429598297478105,1.4765738979006056
132,1575993600,880,897,17,1777,50,-0.5009863533614828,0.6020207970287413
132,1576008000,1184,1170,0,2354,50,-0.8429598297478105,1.344104825268544
132,1576022400,324,395,71,719,50,0.5852823363362638,-0.758680939327777
132,1576036800,80,94,14,174,50,-0.5613346139002465,-1.4596095275265506
132,1576051200,814,662,0,1476,50,-0.8429598297478105,0.21490243914281312
132,1576065600,1146,1175,29,2321,50,-0.25959331120642803,1.3016632777262327
132,1576080000,958,967,9,1925,50,-0.6619150481315194,0.7923647072185
132,1576094400,1244,1088,0,2332,50,-0.8429598297478105,1.3158104602403364
132,1576108800,365,472,107,837,50,1.3094614628014285,-0.6069202541764829
132,1576123200,66,83,17,149,50,-0.5009863533614828,-1.4917622150586045
132,1576137600,767,739,0,1506,50,-0.8429598297478105,0.2534856641812777
132,1576152000,1258,1093,0,2351,50,-0.8429598297478105,1.3402465027646973
132,1576166400,884,984,100,1868,50,1.1686488548776464,0.7190565796454172
132,1576180800,1232,1183,0,2415,50,-0.8429598297478105,1.4225573828467553
132,1576195200,340,489,149,829,50,2.1543371103441205,-0.6172091141867402
132,1576209600,72,134,62,206,50,0.40423755471997275,-1.4184540874855216
132,1576224000,771,687,0,1458,50,-0.8429598297478105,0.19175250411973438
132,1576238400,1186,1137,0,2323,50,-0.8429598297478105,1.3042354927287971
132,1576252800,981,978,0,1959,50,-0.8429598297478105,0.8360923622620933
132,1576267200,1121,1211,90,2332,50,0.9674879864151007,1.3158104602403364
132,1576281600,340,424,84,764,50,0.8467914653375732,-0.7008061017700801
132,1576296000,82,160,78,242,50,0.7260949442600458,-1.3721542174393642
132,1576310400,193,261,68,454,50,0.5249340757975002,-1.0994994271675476
132,1576324800,558,634,76,1192,50,0.6858627705675368,-0.15035209122131843
132,1576339200,651,716,65,1367,50,0.46458581525873643,0.07471672150305841
132,1576353600,639,858,219,1497,50,3.56246318958194,0.24191069666973836
132,1576368000,419,423,4,842,50,-0.7624954823627922,-0.6004897166700721
132,1576382400,86,150,64,236,50,0.4444697284124819,-1.379870862447057
132,1576396800,137,168,31,305,50,-0.21936113751391886,-1.2911294448585886
132,1576411200,457,418,0,875,50,-0.8429598297478105,-0.5580481691277611
132,1576425600,586,706,120,1292,50,1.570970591802738,-0.0217413410931031
132,1576440000,553,586,33,1139,50,-0.17912896382140975,-0.21851578878927258
132,1576454400,295,323,28,618,50,-0.2797093980526826,-0.8885777969572745
132,1576468800,69,68,0,137,50,-0.8429598297478105,-1.5071955050739902
132,1576483200,773,721,0,1494,50,-0.8429598297478105,0.2380523741658919
132,1576497600,1193,1085,0,2278,50,-0.8429598297478105,1.2463606551711002
132,1576512000,893,952,59,1845,50,0.34388929418120906,0.6894761071159278
132,1576526400,1183,1072,0,2255,50,-0.8429598297478105,1.2167801826416107
132,1576540800,325,362,37,687,51,-0.26784356208080523,-0.7333646228619445
132,1576555200,61,87,26,148,51,-0.44849133679807823,-1.4572955665827265
132,1576569600,795,614,0,1409,51,-0.8754769861298144,0.23635363570281373
132,1576584000,1153,1038,0,2191,51,-0.8754769861298144,1.2866578991344493
132,1576598400,808,801,0,1609,51,-0.8754769861298144,0.5049736519257384
132,1576612800,1094,1056,0,2150,51,-0.8754769861298144,1.2315907958087497
132,1576627200,311,370,59,681,51,0.09345198735374079,-0.7414232233486322
132,1576641600,85,85,0,170,51,-0.8754769861298144,-1.4277473647982049
132,1576656000,834,729,0,1563,51,-0.8754769861298144,0.44319104819446575
132,1576670400,1162,1217,55,2379,51,0.027761887456550602,1.5391607143839985
132,1576684800,889,878,0,1767,51,-0.8754769861298144,0.7171834647418489
132,1576699200,1148,1182,34,2330,51,-0.31711113700369786,1.473348810409382
132,1576713600,298,450,152,748,51,1.6207468099634126,-0.6514355179139524
132,1576728000,68,95,27,163,51,-0.4320688118237807,-1.4371490653660073
132,1576742400,701,718,17,1419,51,-0.5962940615667561,0.24978463651395996
132,1576756800,1124,1082,0,2206,51,-0.8754769861298144,1.3068044003511687
132,1576771200,857,975,118,1832,51,1.062380960837296,0.8044849700142995
132,1576785600,1176,1175,0,2351,51,-0.8754769861298144,1.501553912112789
132,1576800000,338,384,46,722,51,-0.12004083731212731,-0.6863561200229327
132,1576814400,74,93,19,167,51,-0.5634490116181611,-1.4317766650415487
132,1576828800,683,603,0,1286,51,-0.8754769861298144,0.07115232572571503
132,1576843200,1146,1097,0,2243,51,-0.8754769861298144,1.3564991033524096
132,1576857600,945,1144,199,2089,51,2.3926054837553976,1.1496616908607578
132,1576872000,1123,1190,67,2313,51,0.22483218714812117,1.4505161090304335
132,1576886400,450,452,2,902,51,-0.8426319361812193,-0.4445981054223004
132,1576900800,100,130,30,230,51,-0.3828012369008881,-1.3471613599313275
132,1576915200,181,216,35,397,51,-0.30068861202940034,-1.1228636463851853
132,1576929600,478,566,88,1044,51,0.5697052116083696,-0.2538778939040239
132,1576944000,586,805,219,1391,51,2.7210559832413486,0.2121778342427505
132,1576958400,589,779,190,1368,51,2.2448027589867197,0.18128653237711415
132,1576972800,355,440,85,795,51,0.520437636685477,-0.5883098141015651
132,1576987200,72,96,24,168,51,-0.48133638674667334,-1.430433564960434
132,1577001600,126,150,24,276,51,-0.48133638674667334,-1.2853787562000547
132,1577016000,365,478,113,843,51,0.9802683359658083,-0.5238410102080632
132,1577030400,536,659,123,1195,51,1.1444935857087837,-0.05106978165571571
132,1577044800,555,721,166,1276,51,1.8506621596035782,0.05772132491456879
132,1577059200,295,307,12,602,51,-0.6784066864382439,-0.8475281297566875
132,1577073600,59,94,35,153,51,-0.30068861202940034,-1.4505800661771535
132,1577088000,474,415,0,889,51,-0.8754769861298144,-0.46205840647679053
132,1577102400,932,971,39,1903,51,-0.23499851213221012,0.8998450757734378
132,1577116800,845,928,83,1773,51,0.4875925867368819,0.7252420652285367
132,1577131200,922,1037,115,1959,51,1.0131133859144035,0.9750586803158566
132,1577145600,338,402,64,740,52,-0.14180808214502236,-0.3810923602467497
132,1577160000,67,100,33,167,52,-0.6394741817483086,-1.329993706999113
132,1577174400,398,365,0,763,52,-1.169247771648581,-0.34300382451323425
132,1577188800,802,856,54,1658,52,-0.3023455336299534,1.1391370225083453
132,1577203200,845,978,133,1823,52,0.9659003331010019,1.4123808658139996
132,1577217600,679,837,158,1516,52,1.3672439618133294,0.9039817149362064
132,1577232000,258,333,75,591,52,0.0347831144884018,-0.6278398308682194
132,1577246400,69,78,9,147,52,-1.024764065312143,-1.3631141728543437
132,1577260800,105,117,12,222,52,-0.9766028298666638,-1.2389124258972282
132,1577275200,197,312,115,509,52,0.676932920428126,-0.7636337408746657
132,1577289600,362,531,169,893,52,1.5438351584467536,-0.12772079645423387
132,1577304000,395,597,202,992,52,2.0736087483470262,0.03622550952915872
132,1577318400,290,296,6,586,52,-1.0729253007576225,-0.636119947332027
132,1577332800,65,98,33,163,52,-0.6394741817483086,-1.336617800170159
132,1577347200,357,307,0,664,52,-1.169247771648581,-0.5069501304966268
132,1577361600,740,753,13,1493,52,-0.9605490847181707,0.8658931792026909
132,1577376000,704,837,133,1541,52,0.9659003331010019,0.9453822972552449
132,1577390400,903,969,66,1872,52,-0.10970059184803614,1.493526007159315
132,1577404800,307,356,49,663,52,-0.38261425937241894,-0.5086061537893883
132,1577419200,75,101,26,176,52,-0.7518503977877603,-1.315089497364259
132,1577433600,416,432,16,848,52,-0.9123878492726913,-0.20224184462850323
132,1577448000,799,867,68,1666,52,-0.07759310155104993,1.1523852088504376
132,1577462400,776,915,139,1691,52,1.0622228039919606,1.193785791169476
132,1577476800,862,1037,175,1899,52,1.6401576293377123,1.5382386360638767
