remote_unit_id,time_stamp,entries,exits,num_people_exited,sum_exit_entry,week_num,z_score_num_people_exited,z_score_sum_exit_entry
174,1546300800,0,0,0,0,1,-0.6898378917605962,-1.5230707339522216
174,1546315200,58,214,156,272,1,0.094852710117082,-0.8842030980179393
174,1546329600,62,56,0,118,1,-0.6898378917605962,-1.2459149213042608
174,1546344000,192,140,0,332,1,-0.6898378917605962,-0.7432764136206711
174,1546358400,336,249,0,585,1,-0.6898378917605962,-0.14903556107885702
174,1546372800,255,393,138,648,1,0.004311486823503747,-0.00106254246172546
174,1546387200,84,308,224,392,1,0.43689733144837767,-0.6023497292234029
174,1546401600,12,87,75,99,1,-0.3125827947040202,-1.2905417046967291
174,1546416000,673,109,0,782,1,-0.6898378917605962,0.3136737193588401
174,1546430400,1190,309,0,1499,1,-0.6898378917605962,1.9977475979061947
174,1546444800,432,418,0,850,1,-0.6898378917605962,0.4733906283424107
174,1546459200,401,1049,648,1450,1,2.5696461468082212,1.8826574723150922
174,1546473600,92,453,361,545,1,1.1260166420717233,-0.24298668401036913
174,1546488000,18,112,94,130,1,-0.21701150344968756,-1.2177295844248073
174,1546502400,524,154,0,678,1,-0.6898378917605962,0.06940079973690862
174,1546516800,894,302,0,1196,1,-0.6898378917605962,1.2860678416999904
174,1546531200,442,442,0,884,1,-0.6898378917605962,0.5532490828341959
174,1546545600,371,1073,702,1444,1,2.841269816688956,1.8685648038753655
174,1546560000,86,465,379,551,1,1.2165578653653015,-0.22889401557064232
174,1546574400,15,71,56,86,1,-0.4081540859583528,-1.3210758196494705
174,1546588800,494,124,0,618,1,-0.6898378917605962,-0.07152588466035954
174,1546603200,832,336,0,1168,1,-0.6898378917605962,1.2203020556479318
174,1546617600,437,518,81,955,1,-0.28240238693949404,0.72001232603763
174,1546632000,416,910,494,1326,1,1.7950156808520517,1.5914089912274048
174,1546646400,107,488,381,595,1,1.2266180012868102,-0.125547780345979
174,1546660800,21,161,140,182,1,0.014371622745012443,-1.0955931246138415
174,1546675200,89,79,0,168,1,-0.6898378917605962,-1.1284760176398707
174,1546689600,357,217,0,574,1,-0.6898378917605962,-0.17487211988502285
174,1546704000,462,342,0,804,1,-0.6898378917605962,0.36534683697117176
174,1546718400,305,433,128,738,1,-0.04598919278403973,0.2103274841341768
174,1546732800,109,381,272,490,1,0.6783405935645863,-0.37216947804119827
174,1546747200,26,145,119,171,1,-0.09125980443082886,-1.1214296834200073
174,1546761600,69,39,0,108,1,-0.6898378917605962,-1.269402702037139
174,1546776000,380,189,0,569,1,-0.6898378917605962,-0.18661601025146188
174,1546790400,452,385,0,837,1,-0.6898378917605962,0.44285651338966925
174,1546804800,279,517,238,796,1,0.5073182828989385,0.34655661238486934
174,1546819200,67,291,224,358,1,0.43689733144837767,-0.6822081837151882
174,1546833600,16,58,42,74,1,-0.4785750374089136,-1.349261156528924
174,1546848000,570,136,0,706,1,-0.6898378917605962,0.1351665857889671
174,1546862400,864,339,0,1203,1,-0.6898378917605962,1.302509288213005
174,1546876800,371,461,90,832,1,-0.23713177529270493,0.4311126230232302
174,1546891200,352,1070,718,1422,1,2.9217509040610254,1.8168916862630338
174,1546905600,81,470,389,551,2,0.9717149583886743,-0.41190647568773187
174,1546920000,16,92,76,108,2,-0.3977280993919337,-1.4551860682069175
174,1546934400,589,125,0,714,2,-0.7302446246038385,-0.028036106431236902
174,1546948800,913,361,0,1274,2,-0.7302446246038385,1.2907823400941445
174,1546963200,406,414,8,820,2,-0.6952428851078486,0.221597385232496
174,1546977600,403,1024,621,1427,2,1.9867654037723834,1.6511023799484006
174,1546992000,79,534,455,613,2,1.2604793092305915,-0.2658944333938503
174,1547006400,15,79,64,94,2,-0.4502307086359187,-1.488156529370052
174,1547020800,614,136,0,750,2,-0.7302446246038385,0.05674507941682334
174,1547035200,923,299,0,1222,2,-0.7302446246038385,1.168320627202502
174,1547049600,420,422,2,842,2,-0.721494189729841,0.2734081099174217
174,1547064000,385,1120,735,1505,2,2.485540191590241,1.8347949492858644
174,1547078400,83,507,424,590,2,1.1248475686836303,-0.3200601910189999
174,1547092800,24,82,58,106,2,-0.4764820132579112,-1.4598961340873653
174,1547107200,565,109,0,674,2,-0.7302446246038385,-0.12223742404019272
174,1547121600,894,369,0,1263,2,-0.7302446246038385,1.2648769777516817
174,1547136000,449,405,0,854,2,-0.7302446246038385,0.30166850520010846
174,1547150400,389,1148,759,1537,2,2.5905454100782106,1.910156003373029
174,1547164800,98,513,415,611,2,1.0854706117506416,-0.27060449927429814
174,1547179200,14,125,111,139,2,-0.24459548909697756,-1.3821800470599768
174,1547193600,545,115,0,660,2,-0.7302446246038385,-0.15520788520332726
174,1547208000,845,344,0,1189,2,-0.7302446246038385,1.0906045401751134
174,1547222400,449,564,115,1013,2,-0.2270946193489826,0.6761187426957078
174,1547236800,415,925,510,1340,2,1.5011162682655226,1.4462145141489215
174,1547251200,126,486,360,612,2,0.8448336527157105,-0.26824946633407426
174,1547265600,19,148,129,167,2,-0.1658415752310001,-1.3162391247337077
174,1547280000,116,74,0,190,2,-0.7302446246038385,-1.262073367108558
174,1547294400,430,250,0,680,2,-0.7302446246038385,-0.10810722639884934
174,1547308800,426,375,0,801,2,-0.7302446246038385,0.176851759368242
174,1547323200,342,457,115,799,2,-0.2270946193489826,0.1721416934877942
174,1547337600,116,340,224,456,2,0.2498040812838809,-0.6356346050090019
174,1547352000,21,156,135,177,2,-0.13959027060900764,-1.2926887953314687
174,1547366400,74,45,0,119,2,-0.7302446246038385,-1.4292807058644548
174,1547380800,361,180,0,541,2,-0.7302446246038385,-0.4354568050899708
174,1547395200,393,301,0,694,2,-0.7302446246038385,-0.0751367652357148
174,1547409600,233,465,232,698,2,0.2848058207798709,-0.06571663347481922
174,1547424000,65,299,234,364,2,0.2935562556538684,-0.8522976355096002
174,1547438400,20,89,69,109,2,-0.42835462145092496,-1.4528310352666935
174,1547452800,562,111,0,673,2,-0.7302446246038385,-0.12459245698041661
174,1547467200,874,316,0,1190,2,-0.7302446246038385,1.0929595731153374
174,1547481600,409,466,57,875,2,-0.48085723069490993,0.3511241969448103
174,1547496000,367,1080,713,1447,2,2.3892854079762684,1.6982030387528784
174,1547510400,93,455,362,548,3,0.9390616490281996,-0.2776282931297451
174,1547524800,16,81,65,97,3,-0.4424150626120698,-1.357239472605869
174,1547539200,594,147,0,741,3,-0.744758450681489,0.18437826482788663
174,1547553600,916,283,0,1199,3,-0.744758450681489,1.2807461588413338
174,1547568000,411,482,71,893,3,-0.41450644217489263,0.5482383519240526
174,1547582400,384,1052,668,1436,3,2.3624012913242347,1.8480806367478557
174,1547596800,94,518,424,612,3,1.2274507268790302,-0.1244240459313594
174,1547611200,13,98,85,111,3,-0.34938632782147927,-1.323726043531222
174,1547625600,606,133,0,739,3,-0.744758450681489,0.1795906321029371
174,1547640000,1002,339,0,1341,3,-0.744758450681489,1.620668082312752
174,1547654400,401,478,77,879,3,-0.38659782173771545,0.5147249228494056
174,1547668800,384,1105,721,1489,3,2.6089274385192995,1.9749529039590188
174,1547683200,84,477,393,561,3,1.083256187953615,-0.24650868041757296
174,1547697600,14,109,95,123,3,-0.302871960426184,-1.2950002471815247
174,1547712000,620,117,0,737,3,-0.744758450681489,0.17480299937798754
174,1547726400,950,362,0,1312,3,-0.744758450681489,1.5512474078009835
174,1547740800,433,443,10,876,3,-0.6982440832861937,0.5075434737619814
174,1547755200,358,1092,734,1450,3,2.6693961161331834,1.8815940658225025
174,1547769600,94,508,414,602,3,1.180936359483735,-0.14836220955610716
174,1547784000,11,127,116,138,3,-0.20519178889606393,-1.259093001744403
174,1547797191,326,91,0,417,3,-0.744758450681489,-0.5912182366139407
174,1547797421,14,7,0,21,3,-0.744758450681489,-1.5391695161539518
174,1547798400,514,95,0,609,3,-0.744758450681489,-0.13160549501878374
174,1547812800,823,364,0,1187,3,-0.744758450681489,1.2520203624916366
174,1547827200,412,669,257,1081,3,0.4506607913775993,0.9982758280693104
174,1547841600,396,1024,628,1420,3,2.1763438217430537,1.8097795749482593
174,1547856000,126,609,483,735,3,1.5018854945112723,0.17001536665303799
174,1547870400,21,138,117,159,3,-0.2005403521565344,-1.2088228581324327
174,1547884800,102,82,0,184,3,-0.744758450681489,-1.1489774490705633
174,1547899200,446,192,0,638,3,-0.744758450681489,-0.062184820507015244
174,1547913600,418,327,0,745,3,-0.744758450681489,0.19395353027778575
174,1547928000,321,467,146,788,3,-0.06564868671017814,0.2968876338642011
174,1547942400,117,351,234,468,3,0.3436777463684202,-0.4691336021277271
174,1547956800,18,137,119,155,3,-0.19123747867747534,-1.2183981235823318
174,1547971200,74,53,0,127,3,-0.744758450681489,-1.2854249817316257
174,1547985600,310,167,0,477,3,-0.744758450681489,-0.44758925486545414
174,1548000000,335,325,0,660,3,-0.744758450681489,-0.00952086053257018
174,1548014400,213,425,212,638,3,0.24134613809877062,-0.062184820507015244
174,1548028800,69,263,194,332,3,0.15762027678723914,-0.7946926274242966
174,1548043200,13,83,70,96,3,-0.41915787891442213,-1.3596332889683436
174,1548057600,219,69,0,288,3,-0.744758450681489,-0.9000205473731867
174,1548072000,423,229,0,652,3,-0.744758450681489,-0.028671391432368385
174,1548086400,288,343,55,631,3,-0.48892943000736505,-0.07894153504433868
174,1548100800,264,559,295,823,3,0.6274153874797214,0.38067120655081826
174,1548115200,74,289,215,363,4,0.2368965340098354,-0.8238403511362653
174,1548129600,16,68,52,84,4,-0.4894410892950362,-1.4734796762698117
174,1548144000,522,107,0,629,4,-0.7211561593064063,-0.20447095871503476
174,1548146283,228,69,0,297,4,-0.7211561593064063,-0.9775184710603301
174,1548158400,922,288,0,1210,4,-0.7211561593064063,1.148362187889232
174,1548172800,425,471,46,896,4,-0.5161774435271174,0.41722689006868163
174,1548187200,393,994,601,1387,4,1.95693532294039,1.5604989640492237
174,1548201600,72,509,437,581,4,1.2261416405968384,-0.3162368641143546
174,1548216000,15,86,71,101,4,-0.4047759675601125,-1.4338959181075526
174,1548230400,536,107,0,643,4,-0.7211561593064063,-0.17187256964023317
174,1548244800,942,321,0,1263,4,-0.7211561593064063,1.271770375100981
174,1548259200,420,476,56,896,4,-0.47161685314031543,0.41722689006868163
174,1548273600,380,1086,706,1466,4,2.4248215220018103,1.7444470166856043
174,1548288000,82,512,430,594,4,1.194949227326077,-0.28596693140203877
174,1548302400,23,100,77,123,4,-0.3780396133280314,-1.3826698781328643
174,1548316800,531,125,0,656,4,-0.7211561593064063,-0.14160263692791739
174,1548331200,886,342,0,1228,4,-0.7211561593064063,1.1902744024139769
174,1548345600,392,441,49,833,4,-0.5028092664110768,0.27053413923207437
174,1548360000,352,928,576,1280,4,1.8455338469733853,1.31135413326324
174,1548374400,84,535,451,619,4,1.288526467138361,-0.22775552233989307
174,1548388800,15,85,70,100,4,-0.4092320265987927,-1.4362243744700385
174,1548403200,489,134,0,623,4,-0.7211561593064063,-0.21844169688994974
174,1548417600,859,411,0,1270,4,-0.7211561593064063,1.2880695696383817
174,1548432000,452,493,41,945,4,-0.5384577387205184,0.5313212518304873
174,1548446400,458,922,464,1380,4,1.3464552346412035,1.544199769511823
174,1548460800,115,480,365,595,4,0.9053053898118645,-0.283638475039553
174,1548475200,23,166,143,189,4,-0.08393971677513858,-1.2289917582087997
174,1548489600,115,98,0,213,4,-0.7211561593064063,-1.1731088055091397
174,1548504000,433,247,0,680,4,-0.7211561593064063,-0.08571968422825749
174,1548518400,449,414,0,863,4,-0.7211561593064063,0.34038783010664925
174,1548532800,356,549,193,905,4,0.1388632351588711,0.4381829973310541
174,1548547200,151,368,217,519,4,0.24580865208719577,-0.460601158588476
174,1548561600,25,159,134,184,4,-0.12404424812326031,-1.2406340400212288
174,1548576000,95,79,0,174,4,-0.7211561593064063,-1.263918603646087
174,1548590400,361,217,0,578,4,-0.7211561593064063,-0.32322223320181204
174,1548604800,398,338,0,736,4,-0.7211561593064063,0.04467387207094895
174,1548619200,241,484,243,725,4,0.36166618709288084,0.019060852083604828
174,1548633600,75,292,217,367,4,0.24580865208719577,-0.814526525686322
174,1548648000,16,84,68,100,4,-0.41814414467615313,-1.4362243744700385
174,1548662400,534,135,0,669,4,-0.7211561593064063,-0.11133270421560161
174,1548676800,878,350,0,1228,4,-0.7211561593064063,1.1902744024139769
174,1548691200,402,516,114,918,4,-0.2131654288968642,0.46845293004336985
174,1548705600,395,1318,923,1713,4,3.3917863333954124,2.319575738219604
174,1548720000,104,545,441,649,5,1.1354837107541256,-0.16869192065440328
174,1548734400,15,84,69,99,5,-0.4479505535106422,-1.4789755007205476
174,1548748800,480,241,0,721,5,-0.7416520702694298,0.0028361116451647113
174,1548763200,671,355,0,1026,5,-0.7416520702694298,0.7294479151363902
174,1548777600,373,463,90,836,5,-0.3585631353666634,0.2768044965680858
174,1548792000,376,1064,688,1440,5,2.1868500098761627,1.7157341008589062
174,1548806400,100,485,385,585,5,0.8971172623701821,-0.3211612826984637
174,1548820800,13,81,68,94,5,-0.4522070972317841,-1.49088716963024
174,1548835200,650,119,0,769,5,-0.7416520702694298,0.11718813317821003
174,1548849600,936,328,0,1264,5,-0.7416520702694298,1.29644335523774
174,1548864000,419,469,50,888,5,-0.5288248842123374,0.4006858532288849
174,1548878400,327,1130,803,1457,5,2.6763525378074755,1.7562337751518597
174,1548892800,92,482,390,574,5,0.9183999809758914,-0.3473669542997866
174,1548907200,16,77,61,93,5,-0.482002903279777,-1.4932695034121783
174,1548921600,574,92,0,666,5,-0.7416520702694298,-0.1281922463614497
174,1548936000,856,309,0,1165,5,-0.7416520702694298,1.060592310825834
174,1548950400,378,402,24,780,5,-0.6394950209620255,0.14339380477953292
174,1548964800,342,981,639,1323,5,1.9782793675402117,1.437001048372108
174,1548979200,74,479,405,553,5,0.9822481367930191,-0.3973959637204939
174,1548993600,12,85,73,97,5,-0.43092437862607486,-1.4837401682844245
174,1549008000,530,106,0,636,5,-0.7416520702694298,-0.19966225981960306
174,1549022400,856,356,0,1212,5,-0.7416520702694298,1.1725619985769409
174,1549036800,383,558,175,941,5,0.0032430809303937783,0.5269495436716225
174,1549051200,411,1016,605,1427,5,1.833556881021389,1.6847637616937063
174,1549065600,98,484,386,582,5,0.901373806091324,-0.32830828404427903
174,1549080000,16,131,115,147,5,-0.25214954233811715,-1.3646234791875023
174,1549094400,125,67,0,192,5,-0.7416520702694298,-1.2574184590002724
174,1549108800,422,248,0,670,5,-0.7416520702694298,-0.11866291123369595
174,1549123200,442,435,0,877,5,-0.7416520702694298,0.374480181627562
174,1549137600,336,559,223,895,5,0.20755717954520253,0.41736218970245403
174,1549152000,122,374,252,496,5,0.33099694745831615,-0.5331889892909852
174,1549166400,19,135,116,154,5,-0.24789299861697534,-1.3479471427139331
174,1549180800,76,67,0,143,5,-0.7416520702694298,-1.3741528143152562
174,1549195200,361,163,0,524,5,-0.7416520702694298,-0.4664836433967088
174,1549209600,366,375,9,741,5,-0.7033431767791531,0.05048278728393359
174,1549224000,228,444,216,672,5,0.1777613734972096,-0.11389824366981906
174,1549238400,91,297,206,388,5,0.1351959362857911,-0.7904810377403372
174,1549252800,14,68,54,82,5,-0.5117987093277699,-1.5194751750135012
174,1549267200,612,149,0,761,5,-0.7416520702694298,0.09812946292270248
174,1549281600,886,358,0,1244,5,-0.7416520702694298,1.2487966795989711
174,1549296000,416,412,0,828,5,-0.7416520702694298,0.25774582631257825
174,1549310400,383,1158,775,1541,5,2.5571693136155034,1.956349812834689
174,1549324800,89,467,378,556,6,0.9385701988362037,-0.4406412098607177
174,1549339200,14,97,83,111,6,-0.41189836039972294,-1.4663709660317
174,1549353600,523,137,0,660,6,-0.7918607007949158,-0.2009200983061511
174,1549368000,907,368,0,1275,6,-0.7918607007949158,1.2166614748290265
174,1549382400,433,422,0,855,6,-0.7918607007949158,0.24855698585866132
174,1549396800,382,990,608,1372,6,1.991477889087943,1.4402475115674203
174,1549411200,87,511,424,598,6,1.1491517368865516,-0.3438307609636812
174,1549425600,11,83,72,94,6,-0.46225481515089306,-1.5055561477281194
174,1549440000,634,149,0,783,6,-0.7918607007949158,0.08259621632088442
174,1549454400,963,373,0,1336,6,-0.7918607007949158,1.357267126798532
174,1549468800,402,465,63,867,6,-0.5034555508563959,0.2762171141149575
174,1549483200,420,1151,731,1571,6,2.554554610396482,1.8989446384843314
174,1549497600,83,526,443,609,6,1.236131067820391,-0.31847564339540974
174,1549512000,18,95,77,113,6,-0.4393655175367248,-1.4617609446556505
174,1549526400,609,117,0,726,6,-0.7918607007949158,-0.04878939289652229
174,1549540800,967,351,0,1318,6,-0.7918607007949158,1.3157769344140877
174,1549555200,423,514,91,937,6,-0.3752754842170537,0.437567862276685
174,1549569600,402,1031,629,1433,6,2.0876129390674496,1.5808531635369258
174,1549584000,106,532,426,638,6,1.1583074559322188,-0.25163033344269403
174,1549598400,16,121,105,137,6,-0.31118545089738264,-1.4064406881430582
174,1549612800,565,141,0,706,6,-0.7918607007949158,-0.09488960665701586
174,1549627200,923,340,0,1263,6,-0.7918607007949158,1.1890013465727303
174,1549641600,410,571,161,981,6,-0.05482531761869826,0.5389883325497709
174,1549656000,451,983,532,1434,6,1.6435605653525858,1.5831581742249505
174,1549670400,104,550,446,654,6,1.2498646463888918,-0.21475016243429917
174,1549684800,16,148,132,164,6,-0.1875832437808741,-1.3442053995663918
174,1549699200,126,75,0,201,6,-0.7918607007949158,-1.2589200041094788
174,1549713600,430,270,0,700,6,-0.7918607007949158,-0.10871967078516394
174,1549728000,446,394,0,840,6,-0.7918607007949158,0.21398182553829112
174,1549742400,350,529,179,879,6,0.027576153792307434,0.3038772423712536
174,1549756800,133,429,296,562,6,0.5631857179638444,-0.4268111457325696
174,1549771200,21,133,112,154,6,-0.2791404342375471,-1.3672555064466387
174,1549785600,77,62,0,139,6,-0.7918607007949158,-1.4018306667670088
174,1549800000,334,196,0,530,6,-0.7918607007949158,-0.5005714877493593
174,1549814400,352,328,0,680,6,-0.7918607007949158,-0.1548198845456575
174,1549828800,254,480,226,734,6,0.24273555136548897,-0.030349307392324852
174,1549843200,73,301,228,374,6,0.2518912704111563,-0.8601531550812093
174,1549857600,14,73,59,87,6,-0.5217669889477305,-1.5216912225442922
174,1549872000,585,127,0,712,6,-0.7918607007949158,-0.0810595425288678
174,1549886400,901,357,0,1258,6,-0.7918607007949158,1.177476293132607
174,1549900800,389,485,96,874,6,-0.35238618660288545,0.2923521889311302
174,1549915200,399,1067,668,1466,6,2.266149460457962,1.6569185162417401
174,1549929600,97,499,402,596,7,1.2467035953598307,-0.20445195384722853
174,1549944000,15,95,80,110,7,-0.4062345048701974,-1.4226187359784996
174,1549958400,548,119,0,667,7,-0.8169023558590243,-0.02648931695150785
174,1549972800,814,346,0,1160,7,-0.8169023558590243,1.2092230772680739
174,1549987200,342,488,146,830,7,-0.06743352780441526,0.38207279310486497
174,1550001600,325,1008,683,1333,7,2.689174421958085,1.6428503474506044
174,1550016000,70,455,385,525,7,1.1594366770247049,-0.3824145907429492
174,1550030400,12,78,66,90,7,-0.4781013787932421,-1.4727490562308154
174,1550044800,597,124,0,721,7,-0.8169023558590243,0.1088625477297445
174,1550059200,984,356,0,1340,7,-0.8169023558590243,1.660395959538915
174,1550073600,412,480,68,892,7,-0.46783468251852145,0.5374767858870436
174,1550088000,384,1062,678,1446,7,2.6635076812712835,1.926086656876188
174,1550102400,92,561,469,653,7,1.5906379205629733,-0.06158054112812883
174,1550116800,18,112,94,130,7,-0.3343676309471527,-1.372488415726184
174,1550131200,564,134,0,698,7,-0.8169023558590243,0.051212679439581466
174,1550145600,952,330,0,1282,7,-0.8169023558590243,1.5150180308071994
174,1550160000,406,535,129,941,7,-0.15470044613954098,0.660296070505217
174,1550174400,446,1025,579,1471,7,2.15530621567261,1.9887495571915828
174,1550188800,115,540,425,655,7,1.3647706025191184,-0.05656750910289726
174,1550203200,17,121,104,138,7,-0.2830341495735494,-1.3524362876252578
174,1550217600,556,131,0,687,7,-0.8169023558590243,0.023641003300807834
174,1550232000,849,387,0,1236,7,-0.8169023558590243,1.3997182942268733
174,1550246400,448,586,138,1034,7,-0.10850031290329795,0.893402059678485
174,1550253570,251,395,144,646,7,-0.07770022407913593,-0.07912615321643932
174,1550254642,31,86,55,117,7,-0.5345682083042058,-1.4050731238901892
174,1550260800,388,857,469,1245,7,1.5906379205629733,1.4222769383404155
174,1550275200,111,511,400,622,7,1.23643689908511,-0.13928253751921815
174,1550289600,21,134,113,155,7,-0.23683401633730636,-1.3098255154107894
174,1550304000,99,76,0,175,7,-0.8169023558590243,-1.2596951951584736
174,1550318400,392,269,0,661,7,-0.8169023558590243,-0.04152841302720255
174,1550332800,442,388,0,830,7,-0.8169023558590243,0.38207279310486497
174,1550347200,332,571,239,903,7,0.40996784897009597,0.5650484620258173
174,1550361600,101,398,297,499,7,0.7077020409369954,-0.44758400707095963
174,1550376000,25,147,122,172,7,-0.19063388310106333,-1.267214743196321
174,1550390400,80,47,0,127,7,-0.8169023558590243,-1.3800079637640315
174,1550404800,328,182,0,510,7,-0.8169023558590243,-0.420012330932186
174,1550419200,383,332,0,715,7,-0.8169023558590243,0.0938234516540498
174,1550433600,245,450,205,695,7,0.23543401229984454,0.04369313140173411
174,1550448000,106,321,215,427,7,0.2867674936734479,-0.6280531599792961
174,1550462400,16,90,74,106,7,-0.43703459369435943,-1.4326448000289629
174,1550476800,185,81,0,266,7,-0.8169023558590243,-1.0316022380104373
174,1550491200,490,270,0,760,7,-0.8169023558590243,0.20661667222176008
174,1550505600,402,334,0,736,7,-0.8169023558590243,0.14646028791898127
174,1550520000,294,517,223,811,7,0.32783427877233057,0.3344489888651651
174,1550534400,87,339,252,426,8,0.3102183253762492,-0.8504452901302992
174,1550548800,14,83,69,97,8,-0.49029805832086404,-1.6350131147440208
174,1550563200,474,127,0,601,8,-0.7921321046328904,-0.4331219791655537
174,1550577600,922,364,0,1286,8,-0.7921321046328904,1.2004006951821644
174,1550592000,408,455,47,863,8,-0.5865350006232493,0.1916706349645224
174,1550606400,368,1021,653,1389,8,2.064355319160634,1.4460252724928433
174,1550620800,106,503,397,609,8,0.9445072632783336,-0.41404434209287966
174,1550635200,15,99,84,114,8,-0.4246819612965105,-1.5944731359645885
174,1550649600,474,126,0,600,8,-0.7921321046328904,-0.43550668379963803
174,1550664000,900,323,0,1223,8,-0.7921321046328904,1.050164303234856
174,1550678400,405,448,43,853,8,-0.6040326264964102,0.1678235886236798
174,1550692800,290,892,602,1182,8,1.841260589277832,0.9523914132374014
174,1550707200,85,475,390,560,8,0.9138864180003019,-0.5308948691630084
174,1550721600,16,87,71,103,8,-0.48154924538428356,-1.6207048869395153
174,1550736000,471,129,0,600,8,-0.7921321046328904,-0.43550668379963803
174,1550750400,926,372,0,1298,8,-0.7921321046328904,1.2290171507911756
174,1550764800,385,404,19,789,8,-0.7090183817353759,0.015202492042287158
174,1550779200,404,1025,621,1429,8,1.9243743121753463,1.5414134578562135
174,1550793600,99,582,483,681,8,1.3207062195512937,-0.24234560843881292
174,1550808000,14,114,100,128,8,-0.35469145780386674,-1.5610872710874089
174,1550822400,454,123,0,577,8,-0.7921321046328904,-0.490354890383576
174,1550836800,849,343,0,1192,8,-0.7921321046328904,0.976238459578244
174,1550851200,470,508,38,978,8,-0.6259046588378614,0.46591166788421234
174,1550865600,364,841,477,1205,8,1.2944597807415523,1.0072396198213394
174,1551484800,9284,7165,0,16449,9,-0.7386881931839091,4.107193993923957
174,1551499200,23,147,124,170,9,0.16572872792771196,-0.3496785192877576
174,1551513600,103,95,0,198,9,-0.7386881931839091,-0.3420126657113753
174,1551528000,452,271,0,723,9,-0.7386881931839091,-0.19827791115420654
174,1551542400,449,389,0,838,9,-0.7386881931839091,-0.1667931553940648
174,1551556800,304,529,225,833,9,0.9023908975428226,-0.1681620578184188
174,1551571200,108,381,273,489,9,1.252487770231192,-0.26234254461397316
174,1551585600,26,155,129,181,9,0.20219715216608378,-0.34666693395417886
174,1551600000,82,62,0,144,9,-0.7386881931839091,-0.3567968118943984
174,1551614400,410,184,0,594,9,-0.7386881931839091,-0.23359559370253943
174,1551628800,403,394,0,797,9,-0.7386881931839091,-0.17801815527376752
174,1551643200,214,508,294,722,9,1.4056551520323537,-0.19855169163907732
174,1551657600,73,278,205,351,9,0.7565172005893354,-0.30012425152614325
174,1551672000,15,63,48,78,9,-0.3885913204955396,-0.374866323895871
174,1551686400,371,100,0,471,9,-0.7386881931839091,-0.26727059334164754
174,1551700800,729,300,0,1029,9,-0.7386881931839091,-0.11450108278374246
174,1551715200,359,401,42,760,9,-0.43235342958158585,-0.18814803321398701
174,1551729600,370,853,483,1223,9,2.7841615882428083,-0.06138766871880772
174,1551744000,79,418,339,497,10,0.6526485617781236,-0.5598430771170119
174,1551758400,11,87,76,98,10,-0.4847844148205511,-1.4541845737740482
174,1551772800,594,146,0,740,10,-0.8134722711760617,-0.015168932536410773
174,1551787200,972,376,0,1348,10,-0.8134722711760617,1.3476371576076447
174,1551801600,399,458,59,857,10,-0.5583066984790206,0.2470815815209157
174,1551816000,387,1116,729,1503,10,2.3393362457077176,1.6950630522989747
174,1551830400,81,531,450,612,10,1.1327058256657774,-0.30207547782989613
174,1551844800,16,87,71,103,10,-0.5064086158965716,-1.4429772868485216
174,1551859200,638,112,0,750,10,-0.8134722711760617,0.007245641314642771
174,1551873600,968,335,0,1303,10,-0.8134722711760617,1.2467715752779038
174,1551888000,381,469,88,850,10,-0.4328863322381021,0.2313913798251782
174,1551902400,376,1152,776,1528,10,2.5426037358223095,1.7510994869266086
174,1551916800,78,520,442,598,10,1.0981071039441446,-0.3334558812213711
174,1551931200,14,113,99,127,10,-0.3853130898708571,-1.389182309605993
174,1551945600,606,148,0,754,10,-0.8134722711760617,0.016211470855064188
174,1551945987,30,11,0,41,10,-0.8134722711760617,-1.5819476447250536
174,1551960000,955,357,0,1312,10,-0.8134722711760617,1.2669446917438518
174,1551974400,389,598,209,987,10,0.09041933380159238,0.5384710415846118
174,1551988800,416,1102,686,1518,10,2.1533681164539415,1.7286849130755548
174,1552003200,90,580,490,670,10,1.3056994342739408,-0.17207094949378557
174,1552017600,11,129,118,140,10,-0.3031411257819795,-1.3600433635996234
174,1552032000,564,168,0,732,10,-0.8134722711760617,-0.03310059161725361
174,1552046400,908,427,0,1335,10,-0.8134722711760617,1.3184982116012751
174,1552060800,414,594,180,1008,10,-0.035001032439326125,0.5855416466718242
174,1552075200,391,933,542,1324,10,1.5305911254645532,1.2938421803651161
174,1552089600,124,578,454,702,10,1.1500051865265937,-0.10034431317041424
174,1552104000,18,138,120,156,10,-0.2944914453515713,-1.3241800454379378
174,1552118400,122,93,0,215,10,-0.8134722711760617,-1.1919340597167218
174,1552132800,475,263,0,738,10,-0.8134722711760617,-0.019651847306621482
174,1552147200,462,431,0,893,10,-0.8134722711760617,0.32777404738470844
174,1552161600,357,538,181,895,10,-0.03067619222412204,0.3322569621549192
174,1552176000,120,432,312,552,10,0.5358778759676133,-0.4365629209362174
174,1552194000,30,181,151,211,10,-0.16042139868024463,-1.2008998892571432
174,1552208400,129,80,0,209,10,-0.8134722711760617,-1.205382804027354
174,1552222800,347,190,0,537,10,-0.8134722711760617,-0.4701847817127977
174,1552237200,331,360,29,691,10,-0.6880519049351432,-0.12500034440657312
174,1552251600,164,440,276,604,10,0.3801836282202662,-0.32000713691073895
174,1552266000,58,231,173,289,10,-0.06527491394575473,-1.0260662132189255
174,1552280400,23,47,24,70,10,-0.7096761060111636,-1.5169453805569981
174,1552294800,1019,221,0,1240,10,-0.8134722711760617,1.1055597600162663
174,1552309200,570,348,0,918,10,-0.8134722711760617,0.3838104820123423
174,1552323600,413,758,345,1171,10,0.6785976030693481,0.950899200443997
174,1552338000,308,977,669,1285,10,2.0798458327954723,1.2064253423460074
174,1552352400,60,434,374,494,11,0.7387054134121193,-0.6296804422504743
174,1552366800,20,76,56,96,11,-0.5888173935755374,-1.5626478480879968
174,1552381200,1030,337,0,1367,11,-0.8225949948060681,1.4167530886443929
174,1552395600,595,366,0,961,11,-0.8225949948060681,0.4650325691216941
174,1552410000,408,704,296,1112,11,0.41308661169816574,0.8189975899293973
174,1552424400,301,1037,736,1338,11,2.2499106213666216,1.3487730515356287
174,1552438800,59,395,336,454,11,0.5800706125771162,-0.7234460106763559
174,1552453200,25,88,63,113,11,-0.559595193421721,-1.5227974815069971
174,1552467600,1027,308,0,1335,11,-0.8225949948060681,1.3417406339036877
174,1552482000,627,318,0,945,11,-0.8225949948060681,0.4275263417513414
174,1552496400,412,620,208,1032,11,0.04572180976447459,0.631466453077634
174,1552510800,285,1147,862,1432,11,2.7759102241353157,1.5691221373364506
174,1552525200,67,464,397,531,11,0.8347212139175157,-0.5429472914565338
174,1552539600,31,48,17,79,11,-0.7516267944325141,-1.6024982146689966
174,1552554000,1078,176,0,1254,11,-0.8225949948060681,1.1518653578412772
174,1552568400,635,291,0,926,11,-0.8225949948060681,0.38298769674904765
174,1552582800,401,592,191,993,11,-0.025246390609079378,0.5400450238623994
174,1552597200,325,1128,803,1453,11,2.5296088228388633,1.6183490607600386
174,1552611600,75,438,363,513,11,0.6927848131704079,-0.5851417972481805
174,1552626000,24,102,78,126,11,-0.4969761930921146,-1.4923236717685855
174,1552640400,921,221,0,1142,11,-0.8225949948060681,0.8893217662488087
174,1552654800,616,364,0,980,11,-0.8225949948060681,0.5095712141239879
174,1552669200,421,699,278,1120,11,0.337943811302638,0.8377507036145737
174,1552683600,303,887,584,1190,11,1.6153714180266094,1.0018404483598666
174,1552698000,81,390,309,471,11,0.46735641198382466,-0.6835956440953562
174,1552712400,14,112,98,126,11,-0.41348419265263936,-1.4923236717685855
174,1552726800,190,129,0,319,11,-0.8225949948060681,-1.0399048041137064
174,1552741200,487,331,0,818,11,-0.8225949948060681,0.12982066199916717
174,1552755600,426,511,85,937,11,-0.4677539929382982,0.4087732280661651
174,1552770000,247,508,261,755,11,0.266975610929084,-0.017860108271596443
174,1552784400,99,419,320,518,11,0.513277012225536,-0.5734211011949453
174,1552798800,16,138,122,154,11,-0.31329379212526903,-1.4266877738704684
174,1552813200,166,76,0,242,11,-0.8225949948060681,-1.2204035233335286
174,1552827600,375,216,0,591,11,-0.8225949948060681,-0.4022989388177112
174,1552842000,378,361,0,739,11,-0.8225949948060681,-0.05536633564194911
174,1552856400,187,474,287,661,11,0.37551521150040185,-0.23820919407241833
174,1552870800,61,298,237,359,11,0.1667852104017137,-0.9461392356878249
174,1552885200,25,51,26,76,11,-0.7140553942347503,-1.6095306323009375
174,1552899600,951,233,0,1184,11,-0.8225949948060681,0.9877756130959844
174,1552914000,515,360,0,875,11,-0.8225949948060681,0.26343659700604855
174,1552928400,381,563,182,944,11,-0.06281779080684324,0.4251822025406944
174,1552942800,284,991,707,1275,11,2.1288472207293823,1.2010922812648652
174,1552957200,51,343,292,394,12,0.5444559498719175,-0.7870186538770462
174,1552971600,22,55,33,77,12,-0.6100767831295191,-1.5588065150999248
174,1552986000,1008,258,0,1266,12,-0.7571794093420574,1.3360066299915667
174,1553000400,591,327,0,918,12,-0.7571794093420574,0.4887442460623496
174,1553014800,405,618,213,1023,12,0.19230117802978045,0.7443837584547858
174,1553029200,297,1024,727,1321,12,2.483536022673558,1.4699130412447474
174,1553043600,61,337,276,398,12,0.4731334644355353,-0.7772800057859057
174,1553058000,25,57,32,82,12,-0.614534438469293,-1.5466332049859994
174,1553072400,995,255,0,1250,12,-0.7571794093420574,1.297052037627005
174,1553086800,638,345,0,983,12,-0.7571794093420574,0.6469972775433815
174,1553101200,411,568,157,979,12,-0.0573275209975572,0.6372586294522411
174,1553115600,274,1067,793,1341,12,2.7777412750986343,1.5186062817004498
174,1553130000,77,313,236,390,12,0.29482725084457984,-0.7967573019681866
174,1553144400,20,43,23,63,12,-0.654653336527258,-1.5928917834189165
174,1553158800,898,216,0,1114,12,-0.7571794093420574,0.9659380025282305
174,1553173200,571,319,0,890,12,-0.7571794093420574,0.4205737094243666
174,1553187600,378,608,230,986,12,0.2680813188059365,0.6543012636117369
174,1553202000,280,936,656,1216,12,2.167042493549612,1.2142735288523114
174,1553216400,70,377,307,447,12,0.6113207799685257,-0.6579815666694355
174,1553230800,21,46,25,67,12,-0.6457380258477102,-1.583153135327776
174,1553242549,447,139,0,586,12,-0.7571794093420574,-0.31956354550230576
174,1553245200,884,149,0,1033,12,-0.7571794093420574,0.7687303786826368
174,1553259600,537,320,0,857,12,-0.7571794093420574,0.34022986267245814
174,1553274000,458,641,183,1099,12,0.05857151783656384,0.9294180721864539
174,1553288400,310,898,588,1208,12,1.8639219304449877,1.1947962326700305
174,1553302800,88,415,327,503,12,0.7004738867640035,-0.5216404933934696
174,1553317200,20,115,95,135,12,-0.33370215206353815,-1.4175961177783887
174,1553331600,201,98,0,299,12,-0.7571794093420574,-1.0183115460416312
174,1553346000,459,294,0,753,12,-0.7571794093420574,0.08702501230280704
174,1553360400,428,435,7,863,12,-0.7259758219636402,0.35483783480916875
174,1553374800,249,484,235,733,12,0.29036959550480596,0.038331771847104915
174,1553389200,99,339,240,438,12,0.31265787220367536,-0.6798935248745015
174,1553403600,14,103,89,117,12,-0.3604480841021815,-1.4614200341885206
174,1553418000,138,79,0,217,12,-0.7571794093420574,-1.21795383191001
174,1553432400,392,216,0,608,12,-0.7571794093420574,-0.2660009810010334
174,1553446800,362,423,61,785,12,-0.4852624336158503,0.16493419703193046
174,1553461200,196,463,267,659,12,0.4330145663775703,-0.14183321783899297
174,1553475600,49,259,210,308,12,0.17892821201045878,-0.9963995878365653
174,1553490000,26,48,22,74,12,-0.6591109918670319,-1.5661105011682803
174,1553504400,994,222,0,1216,12,-0.7571794093420574,1.2142735288523114
174,1553518800,546,316,0,862,12,-0.7571794093420574,0.35240317278638367
174,1553533200,384,588,204,972,12,0.15218227997181547,0.6202159952927454
174,1553547600,268,1044,776,1312,12,2.7019611343224783,1.4480010830396817
174,1553562000,62,313,251,375,13,0.34403745467428176,-0.7684914599687956
174,1553576400,24,42,18,66,13,-0.6582563746297072,-1.4788327401194346
174,1553590800,1014,252,0,1266,13,-0.7356867992111312,1.2797741730869299
174,1553605200,584,323,0,907,13,-0.7356867992111312,0.45449093821935926
174,1553619600,421,586,165,1007,13,-0.02590790721474419,0.684374847653223
174,1553634000,272,1089,817,1361,13,2.7787941387346153,1.4981638870491005
174,1553648400,58,408,350,466,13,0.769904789872114,-0.5592971023839797
174,1553662800,22,42,20,64,13,-0.64965299412066,-1.4834304183081117
174,1553677200,1007,217,0,1224,13,-0.7356867992111312,1.1832229311247071
174,1553691600,600,279,0,879,13,-0.7356867992111312,0.3901234435778774
174,1553706000,418,626,208,1044,13,0.1590647737297688,0.7694318941437526
174,1553720400,307,977,670,1284,13,2.1464456713196527,1.3211532767850254
174,1553734800,55,310,255,365,13,0.361244215692376,-0.791479850912182
174,1553749200,28,42,14,70,13,-0.6754631356478014,-1.46963738374208
174,1553763600,1004,268,0,1272,13,-0.7356867992111312,1.2935672076529618
174,1553778000,620,317,0,937,13,-0.7356867992111312,0.5234561110495184
174,1553792400,432,611,179,1043,13,0.03431575634858562,0.7671330550494139
174,1553806800,304,1045,741,1349,13,2.451865679390825,1.4705778179170368
174,1553821200,69,348,279,417,13,0.4644847818009414,-0.6719402180065729
174,1553835600,22,72,50,94,13,-0.5206022864849533,-1.4144652454779527
174,1553850000,935,210,0,1145,13,-0.7356867992111312,1.0016146426719548
174,1553852880,173,89,0,262,13,-0.7356867992111312,-1.0282602776290617
174,1553857255,147,101,0,248,13,-0.7356867992111312,-1.0604440249498026
174,1553864400,603,303,0,906,13,-0.7356867992111312,0.4521920991250206
174,1553878800,437,734,297,1171,13,0.5419152063823655,1.0613844591247594
174,1553893200,297,869,572,1166,13,1.724880026376344,1.0498902636530663
174,1553907600,80,451,371,531,13,0.8602402852171087,-0.40987256125196825
174,1553922000,14,114,100,128,13,-0.3055177737587754,-1.336304716270439
174,1553936400,208,101,0,309,13,-0.7356867992111312,-0.9202148401951457
174,1553950800,483,302,0,785,13,-0.7356867992111312,0.17403256871004555
174,1553965200,414,415,1,829,13,-0.7313851089566077,0.27518148886094557
174,1553979600,249,494,245,743,13,0.3182273131471404,0.07748132674782279
174,1553994000,87,385,298,472,13,0.546216896636889,-0.5455040678179478
174,1554008400,17,82,65,99,13,-0.4560769326671,-1.4029710500062593
174,1554022800,138,63,0,201,13,-0.7356867992111312,-1.1684894623837185
174,1554037200,363,171,0,534,13,-0.7356867992111312,-0.4029760439689523
174,1554051600,320,400,80,720,13,-0.3915515788492466,0.024608027578034142
174,1554066000,166,481,315,647,13,0.6193456309637895,-0.14320722630868635
174,1554080400,50,198,148,248,13,-0.09903664154164467,-1.0604440249498026
174,1554094800,21,27,6,48,13,-0.7098766576839899,-1.5202118438175298
174,1554109200,1089,207,0,1296,13,-0.7356867992111312,1.348739345917089
174,1554123600,529,350,0,879,13,-0.7356867992111312,0.3901234435778774
174,1554138000,418,598,180,1016,13,0.03861744660310918,0.7050643995022707
174,1554152400,253,1083,830,1336,13,2.834716112043422,1.4406929096906345
174,1554166800,55,339,284,394,14,0.4604891149430536,-0.759734259886282
174,1554181200,20,35,15,55,14,-0.6823813326279221,-1.550646893922001
174,1554195600,1063,218,0,1281,14,-0.7461101679943334,1.309703812059685
174,1554210000,594,331,0,925,14,-0.7461101679943334,0.4791288925413487
174,1554224400,383,620,237,1003,14,0.26080543079496493,0.6611087906380628
174,1554238800,283,1142,859,1425,14,2.9034278039888197,1.6456667008536188
174,1554253200,56,378,322,434,14,0.6219354978712955,-0.6664112352213004
174,1554267600,21,38,17,59,14,-0.6738841545790673,-1.5413145914555029
174,1554282000,1031,178,0,1209,14,-0.7461101679943334,1.1417223676627182
174,1554296400,611,312,0,923,14,-0.7461101679943334,0.4744627413080996
174,1554310800,419,617,198,1036,14,0.09511045884229559,0.7381002859866727
174,1554325200,314,1075,761,1389,14,2.4870660795949324,1.5616759786551353
174,1554339600,61,413,352,474,14,0.7493931686041181,-0.5730882105563188
174,1554354000,21,40,19,61,14,-0.6653869765302124,-1.5366484402222538
174,1554364529,408,126,0,534,14,-0.7461101679943334,-0.4331036735588464
174,1554368400,1060,146,0,1206,14,-0.7461101679943334,1.1347231408128444
174,1554382800,592,352,0,944,14,-0.7461101679943334,0.523457329257215
174,1554384287,35,28,0,63,14,-0.7461101679943334,-1.5319822889890047
174,1554397200,381,643,262,1024,14,0.3670201564056504,0.7101033785871782
174,1554411600,331,1003,672,1334,14,2.108941656420892,1.4333568197407855
174,1554426000,74,467,393,541,14,0.9235853186056423,-0.4167721442424746
174,1554440400,19,51,32,70,14,-0.610155319212656,-1.515650759672633
174,1554454800,913,212,0,1125,14,-0.7461101679943334,0.9457440158662567
174,1554469200,556,298,0,854,14,-0.7461101679943334,0.3134805237610064
174,1554483600,423,662,239,1085,14,0.2693026088438198,0.8524209912012751
174,1554498000,300,852,552,1152,14,1.599110973489602,1.0087370575151193
174,1554512400,83,416,333,499,14,0.6686699771399972,-0.5147613201407053
174,1554526800,16,85,69,101,14,-0.4529575253088415,-1.4433254155572721
174,1554541200,221,126,0,347,14,-0.7461101679943334,-0.8693888138676353
174,1554555600,494,316,0,810,14,-0.7461101679943334,0.21082519662952665
174,1554570000,413,460,47,873,14,-0.5464264838462447,0.35780896047687266
174,1554584400,287,517,230,804,14,0.231065307623973,0.1968267429297794
174,1554598800,110,357,247,467,14,0.3032913210392391,-0.5894197398726906
174,1554613200,15,80,65,95,14,-0.46995188140655114,-1.4573238692570194
174,1554627600,154,93,0,247,14,-0.7461101679943334,-1.1026963755300894
174,1554642000,407,223,0,630,14,-0.7461101679943334,-0.20912841436289056
174,1554656400,371,447,76,818,14,-0.42321740213784953,0.22948980156252297
174,1554670800,187,539,352,726,14,0.7493931686041181,0.014846844833065278
174,1554685200,57,225,168,282,14,-0.032347211890526986,-1.0210387289482306
174,1554699600,21,43,22,64,14,-0.6526412094569302,-1.5296492133723802
174,1554714000,989,205,0,1194,14,-0.7461101679943334,1.10672623341335
174,1554728400,550,281,0,831,14,-0.7461101679943334,0.25981978457864197
174,1554742800,422,533,111,955,14,-0.2745167862828899,0.5491211610400849
174,1554757200,264,1057,793,1321,14,2.62302092837661,1.4030268367246665
174,1554771600,50,379,329,429,15,0.5178099798114344,-0.76088752565409
174,1554786000,25,65,40,90,15,-0.6257812747284475,-1.5322857448411402
174,1554800400,1083,210,0,1293,15,-0.7840638013083618,1.2051539533359141
174,1554814800,589,248,0,837,15,-0.7840638013083618,0.1675209505356341
174,1554829200,425,555,130,980,15,-0.2696455899236399,0.4929190193962482
174,1554843600,284,1104,820,1388,15,2.460727993579884,1.4213274955859723
174,1554858000,70,361,291,431,15,0.36744157956051565,-0.7563365037119836
174,1554872400,20,63,43,83,15,-0.6139100852349538,-1.548214321638513
174,1554886800,1030,245,0,1275,15,-0.7840638013083618,1.1641947558569556
174,1554901200,624,375,0,999,15,-0.7840638013083618,0.5361537278462599
174,1554915600,412,597,185,1009,15,-0.05200711587625759,0.5589088375567923
174,1554930000,295,997,702,1292,15,1.9937945401691366,1.2028784423648609
174,1554944400,53,460,407,513,15,0.8264609066422676,-0.5697446040856174
174,1554958800,24,56,32,80,15,-0.6574377800444303,-1.5550408545516727
174,1554973200,1019,228,0,1247,15,-0.7840638013083618,1.1004804486674649
174,1554987600,594,353,0,947,15,-0.7840638013083618,0.4178271573514911
174,1555002000,408,770,362,1178,15,0.6483930642398638,0.9434701916647908
174,1555016400,337,1330,993,1667,15,3.145299921038014,2.0561950565098277
174,1555030800,55,476,421,531,15,0.8818597909452376,-0.5287854066066591
174,1555045200,18,68,50,86,15,-0.5862106430834688,-1.5413877887253533
174,1555059600,960,211,0,1171,15,-0.7840638013083618,0.9275416148674182
174,1555074000,578,340,0,918,15,-0.7840638013083618,0.351837339190947
174,1555088400,431,681,250,1112,15,0.20520198981610338,0.7932864675752767
174,1555102800,343,948,605,1291,15,1.609959413212844,1.2006029313938076
174,1555117200,82,426,344,508,15,0.5771659272789023,-0.5811221589408837
174,1555131600,15,98,83,113,15,-0.4556275586550394,-1.4799489925069156
174,1555146000,214,104,0,318,15,-0.7840638013083618,-1.0134692434410002
174,1555160400,501,285,0,786,15,-0.7840638013083618,0.05146989101191859
174,1555174800,426,478,52,904,15,-0.5782965167544731,0.31998018559620156
174,1555189200,290,526,236,816,15,0.14980310551313333,0.11973522014351595
174,1555203600,103,426,323,529,15,0.49406760082444723,-0.5333364285487655
174,1555218000,15,110,95,125,15,-0.40814280068106507,-1.4526428608542767
174,1555232400,165,74,0,239,15,-0.7840638013083618,-1.1932346101542066
174,1555246800,418,247,0,665,15,-0.7840638013083618,-0.2238669364855241
174,1555261200,384,400,16,784,15,-0.720750790676396,0.046918869069812096
174,1555275600,168,524,356,692,15,0.6246506852528766,-0.1624281402670865
174,1555290000,63,253,190,316,15,-0.032221800053768276,-1.0180202653831067
174,1555304400,16,36,20,52,15,-0.7049225380184047,-1.6187551617411635
174,1555318800,987,231,0,1218,15,-0.7840638013083618,1.0344906305069206
174,1555333200,559,304,0,863,15,-0.7840638013083618,0.2266842357830185
174,1555347600,395,626,231,1021,15,0.130017789690644,0.5862149692094313
174,1555362000,275,991,716,1266,15,2.0491934244721066,1.1437151571174764
174,1555376400,68,376,308,444,16,0.6195048308449406,-0.7345709786969689
174,1555390800,28,46,18,74,16,-0.7312951762605688,-1.6913418284958874
174,1555405200,1092,202,0,1294,16,-0.8151379353222902,1.463416108678925
174,1555419600,612,326,0,938,16,-0.8151379353222902,0.5428473991426683
174,1555434000,419,626,207,1045,16,0.14905379388750448,0.8195351854358691
174,1555448400,311,1078,767,1389,16,2.757495186918833,1.7090734890327015
174,1555462800,55,454,399,509,16,1.0433765572125313,-0.5664896131917535
174,1555477200,19,65,46,84,16,-0.6008731066090025,-1.6654831568797004
174,1555491600,1021,189,0,1210,16,-0.8151379353222902,1.2462032671029544
174,1555506000,592,352,0,944,16,-0.8151379353222902,0.5583626021123805
174,1555520400,436,627,191,1063,16,0.07452689694375224,0.8660807943450056
174,1555534800,316,1118,802,1434,16,2.920522773983291,1.825437511305543
174,1555549200,61,433,372,494,16,0.9176124186199495,-0.605277620616034
174,1555563600,21,74,53,95,16,-0.5682675891961109,-1.6370386181018948
174,1555578000,930,201,0,1131,16,-0.8151379353222902,1.0419197613350772
174,1555592400,593,338,0,931,16,-0.8151379353222902,0.5247463290113374
174,1555606800,445,627,182,1072,16,0.0326055174128916,0.889353598799574
174,1555621200,327,934,607,1261,16,2.0122262174813104,1.378082492345508
174,1555635600,73,441,368,514,16,0.8989806943840114,-0.55356027738366
174,1555650000,23,68,45,91,16,-0.605531037667987,-1.6473820867483695
174,1555664400,568,160,0,728,16,-0.8151379353222902,-0.0001847047972584365
174,1555678800,539,285,0,824,16,-0.8151379353222902,0.24805854271813665
174,1555693200,381,545,164,926,16,-0.051237241648829666,0.5118169932032439
174,1555707600,267,689,422,956,16,1.1505089715691752,0.589393008051805
174,1555722000,86,359,273,445,16,0.4564772437804825,-0.7319851115353502
174,1555736400,22,130,108,152,16,-0.31208138095196253,-1.4896441898896289
174,1555750800,263,131,0,394,16,-0.8151379353222902,-0.8638643367779039
174,1555765200,470,294,0,764,16,-0.8151379353222902,0.09290651302101471
174,1555779600,487,469,0,956,16,-0.8151379353222902,0.589393008051805
174,1555794000,355,564,209,919,16,0.1583696560054735,0.49371592307191303
174,1555808400,135,434,299,569,16,0.5775834513140798,-0.41133758349463156
174,1555822800,18,125,107,143,16,-0.316739312010947,-1.5129169943441971
174,1555837200,182,108,0,290,16,-0.8151379353222902,-1.1327945215862485
174,1555851600,396,275,0,671,16,-0.8151379353222902,-0.14757913300952427
174,1555866000,373,437,64,810,16,-0.5170303475472812,0.21185640245547488
174,1555880400,237,557,320,794,16,0.6754000035527546,0.17048252786957568
174,1555894800,80,313,233,393,16,0.27016000142110186,-0.8664502039395225
174,1555909200,37,59,22,96,16,-0.7126634520246308,-1.634452750940276
174,1555923600,719,185,0,904,16,-0.8151379353222902,0.4549279156476326
174,1555938000,492,318,0,810,16,-0.8151379353222902,0.21185640245547488
174,1555952400,380,555,175,935,16,0.0,0.5350897976578122
174,1555966800,247,836,589,1083,16,1.9283834584195894,0.9177981375773796
174,1555981200,65,314,249,379,17,0.3775080482309146,-0.9168514580688589
174,1555995600,23,63,40,86,17,-0.6251441900053843,-1.7161412032513028
174,1556010000,775,190,0,965,17,-0.8170393552180731,0.681728032296029
174,1556024400,534,298,0,832,17,-0.8170393552180731,0.3189105029128718
174,1556038800,384,516,132,900,17,-0.1837853100162001,0.5044111946275687
174,1556053200,273,902,629,1175,17,2.200512117751458,1.254597815532593
174,1556067600,82,342,260,424,17,0.43027921866440405,-0.7940936473753095
174,1556082000,25,53,28,78,17,-0.682712739569191,-1.7379648140412673
174,1556096400,785,213,0,998,17,-0.8170393552180731,0.7717504268046319
174,1556110800,589,339,0,928,17,-0.8170393552180731,0.5807938323924439
174,1556125200,396,523,127,919,17,-0.2077722056677862,0.556242270253734
174,1556139600,254,938,684,1192,17,2.464367969918905,1.300972988461267
174,1556154000,61,425,364,486,17,0.9292066482173948,-0.6249606637530859
174,1556168400,25,60,35,85,17,-0.6491310856569704,-1.7188691546000485
174,1556182800,763,203,0,966,17,-0.8170393552180731,0.6844559836447746
174,1556197200,560,280,0,840,17,-0.8170393552180731,0.34073411370283613
174,1556211600,394,585,191,979,17,0.09926005867251587,0.7199193511784666
174,1556226000,313,888,575,1201,17,1.9414536447143282,1.325524550599977
174,1556240400,79,443,364,522,17,0.9292066482173948,-0.5267544151982464
174,1556254800,19,95,76,114,17,-0.4524385413139644,-1.6397585654864277
174,1556269200,669,162,0,831,17,-0.8170393552180731,0.3161825515641263
174,1556283600,556,328,0,884,17,-0.8170393552180731,0.46076397304764005
174,1556298000,354,504,150,858,17,-0.09743248567049013,0.38983723798025594
174,1556312400,294,803,509,1097,17,1.6248266221133918,1.0418176103304406
174,1556326800,94,417,323,511,17,0.7325141038743889,-0.5567618800344474
174,1556341200,29,151,122,180,17,-0.2317591013193723,-1.4597137764692218
174,1556355600,321,176,0,497,17,-0.8170393552180731,-0.5949531989168849
174,1556370000,582,412,0,994,17,-0.8170393552180731,0.7608386214096498
174,1556384400,588,537,0,1125,17,-0.8170393552180731,1.1182002480953157
174,1556398800,382,635,253,1017,17,0.3966975647521835,0.8235815024307972
174,1556413200,115,444,329,559,17,0.7612983786562922,-0.4258202152946613
174,1556427600,19,161,142,180,17,-0.1358115187130279,-1.4597137764692218
174,1556442000,201,83,0,284,17,-0.8170393552180731,-1.1760068361996854
174,1556456400,441,244,0,685,17,-0.8170393552180731,-0.08209834535272294
174,1556470800,340,383,43,723,17,-0.6107520526144327,0.021563805899607682
174,1556485200,182,487,305,669,17,0.646161279528679,-0.12574556693265163
174,1556499600,64,286,222,350,17,0.2479788117123497,-0.9959620471824797
174,1556514000,25,55,30,80,17,-0.6731179813085565,-1.7325089113437762
174,1556528400,1045,232,0,1277,17,-0.8170393552180731,1.5328488531046383
174,1556542800,577,336,0,913,17,-0.8170393552180731,0.5398745621612607
174,1556557200,387,585,198,972,17,0.13284171258473643,0.7008236917372478
174,1556571600,253,1026,773,1279,17,2.8913347125171374,1.5383047558021292
174,1556586000,57,345,288,402,18,0.4176501808462032,-0.780679967726639
174,1556600400,21,39,18,60,18,-0.7058249349147837,-1.5654690582583195
174,1556614800,1059,196,0,1255,18,-0.7807232759655162,1.1767033487164122
174,1556629200,547,344,0,891,18,-0.7807232759655162,0.3414307494370797
174,1556643600,392,572,180,964,18,-0.03173986545819153,0.5089442102815612
174,1556658000,296,1042,746,1338,18,2.323396858692618,1.3671638589916446
174,1556672400,54,409,355,463,18,0.6964384503128185,-0.6407029661990585
174,1556686800,22,38,16,60,18,-0.7141469728093095,-1.5654690582583195
174,1556701200,1029,183,0,1212,18,-0.7807232759655162,1.0780310361641834
174,1556715600,617,303,0,920,18,-0.7807232759655162,0.40797719278625727
174,1556730000,412,581,169,993,18,-0.07751107387808359,0.5754906536307388
174,1556744400,310,1085,775,1395,18,2.4440664081632426,1.4979620407469247
174,1556758800,67,412,345,479,18,0.6548282608401893,-0.6039876871098571
174,1556773200,16,38,22,54,18,-0.689180859125732,-1.57923728791677
174,1556787600,1046,227,0,1273,18,-0.7807232759655162,1.2180080376917637
174,1556790250,167,62,0,229,18,-0.7807232759655162,-1.1776639228786294
174,1556802000,629,274,0,903,18,-0.7807232759655162,0.36896720875398076
174,1556816400,448,714,266,1162,18,0.3261077640064191,0.9632957890104289
174,1556830800,330,1149,819,1479,18,2.6271512418428107,1.6907172559652321
174,1556845200,60,409,349,469,18,0.671472336629241,-0.626934736540608
174,1556859600,14,33,19,47,18,-0.7016639159675208,-1.5953002225182957
174,1556874000,962,222,0,1184,18,-0.7807232759655162,1.0137792977580808
174,1556888400,586,319,0,905,18,-0.7807232759655162,0.3735566186401309
174,1556902800,442,661,219,1103,18,0.13053987348506213,0.8279081973689986
174,1556917200,311,910,599,1221,18,1.7117270734449697,1.0986833806518592
174,1556931600,72,460,388,532,18,0.8337520755724946,-0.4823683251268774
174,1556946000,15,113,98,128,18,-0.3729434191337505,-1.4094291221292135
174,1556960400,236,140,0,376,18,-0.7807232759655162,-0.8403422962465913
174,1556974800,498,332,0,830,18,-0.7807232759655162,0.20145374790949921
174,1556989200,435,514,79,949,18,-0.45200277913174586,0.47452363613543486
174,1557003600,275,528,253,803,18,0.2720145176920012,0.13949671444647183
174,1557018000,92,456,364,548,18,0.7338876208381847,-0.44565304603767597
174,1557032400,15,105,90,120,18,-0.40623157071185384,-1.4277867616738142
174,1557046800,163,92,0,255,18,-0.7807232759655162,-1.1180015943586772
174,1557061200,407,222,0,629,18,-0.7807232759655162,-0.25978194564859375
174,1557075600,326,407,81,733,18,-0.44368074123722007,-0.021132631568784435
174,1557090000,188,478,290,666,18,0.42597221874072905,-0.17487786275481543
174,1557104400,55,252,197,307,18,0.03899745664527801,-0.9986769373187725
174,1557118800,20,60,40,80,18,-0.6142825180749996,-1.5195749593968177
174,1557133200,1018,212,0,1230,18,-0.7807232759655162,1.119335725139535
174,1557147600,582,317,0,899,18,-0.7807232759655162,0.35978838898168036
174,1557162000,398,604,206,1002,18,0.07644662717064424,0.5961429981184145
174,1557176400,285,1082,797,1367,18,2.5356088250030266,1.4337103023408222
174,1557190800,48,351,303,399,19,0.5177026427470687,-0.8013958394136131
174,1557205200,19,49,30,68,19,-0.6561115755123519,-1.5643216053198004
174,1557219600,1066,235,0,1301,19,-0.785102148947453,1.2776344954727337
174,1557234000,573,324,0,897,19,-0.785102148947453,0.34645017696487995
174,1557248400,431,649,218,1080,19,0.15222935134761537,0.768249014308784
174,1557262800,297,1063,766,1360,19,2.5084571594287968,1.413624284561752
174,1557277200,72,375,303,447,19,0.5177026427470687,-0.6907600787988186
174,1557291600,16,43,27,59,19,-0.6690106328558619,-1.5850658104350743
174,1557306000,1039,217,0,1256,19,-0.785102148947453,1.1739134698963638
174,1557320400,620,361,0,981,19,-0.785102148947453,0.5400627580407703
174,1557334800,409,569,160,978,19,-0.09715242396024686,0.5331480230023457
174,1557349200,304,1062,758,1366,19,2.474059673179436,1.4274537546386012
174,1557363600,65,463,398,528,19,0.9261727919582223,-0.5040622327613529
174,1557378000,12,54,42,66,19,-0.6045153461383114,-1.5689314286787501
174,1557392400,1055,232,0,1287,19,-0.785102148947453,1.2453657319600853
174,1557406800,618,353,0,971,19,-0.785102148947453,0.5170136412460214
174,1557421200,464,630,166,1094,19,-0.07135430927322661,0.8005177778214324
174,1557435600,330,1049,719,1379,19,2.306371927713805,1.4574176064717748
174,1557450000,72,403,331,475,19,0.6380938446198298,-0.6262225517735218
174,1557464400,15,50,35,65,19,-0.6346131466065017,-1.571236340358225
174,1557478800,887,227,0,1114,19,-0.785102148947453,0.8466160114109301
174,1557493200,593,361,0,954,19,-0.785102148947453,0.4778301426949484
174,1557507600,453,674,221,1127,19,0.1651284086911255,0.8765798632441036
174,1557522000,329,862,533,1191,19,1.5066303724161776,1.0240942107304962
174,1557536400,81,355,274,436,19,0.3930117550931375,-0.7161141072730424
174,1557550800,24,99,75,123,19,-0.4626257153597001,-1.4375514629486816
174,1557565200,208,162,0,370,19,-0.785102148947453,-0.8682382781183848
174,1557579600,494,310,0,804,19,-0.785102148947453,0.13209339077371557
174,1557594000,419,503,84,922,19,-0.4239285433291698,0.4040729689517521
174,1557608400,263,543,280,806,19,0.4188098697801578,0.13670321413266534
174,1557622800,100,404,304,504,19,0.5220023285282387,-0.5593801130687501
174,1557637200,16,101,85,117,19,-0.4196288575479997,-1.451380933025531
174,1557651600,150,76,0,226,19,-0.785102148947453,-1.2001455599627684
174,1557666000,343,208,0,551,19,-0.785102148947453,-0.4510492641334305
174,1557680400,307,319,12,626,19,-0.7335059195734125,-0.27818088817281406
174,1557694800,166,433,267,599,19,0.36291395462494724,-0.340413503518636
174,1557709200,55,261,206,316,19,0.10063312197357492,-0.9927035088100287
174,1557723600,22,34,12,56,19,-0.7335059195734125,-1.591980545473499
174,1557738000,972,228,0,1200,19,-0.785102148947453,1.0448384158457702
174,1557752400,540,358,0,898,19,-0.785102148947453,0.34875508864435484
174,1557766800,413,658,245,1071,19,0.2683208674392064,0.74750480919351
174,1557781200,239,1054,815,1293,19,2.7191417627061285,1.2591952020369346
174,1557795600,54,363,309,417,20,0.4870348254804187,-0.9622725107614406
174,1557810000,20,43,23,63,20,-0.7399497222693274,-1.824559618403744
174,1557824400,1032,224,0,1256,20,-0.8386233047806707,1.0813966511365611
174,1557838800,580,340,0,920,20,-0.8386233047806707,0.2629546506625104
174,1557853200,430,634,204,1064,20,0.036568470537330075,0.6137155080085321
174,1557867600,280,1037,757,1317,20,2.40902460657093,1.2299828476511954
174,1557882000,50,440,390,490,20,0.8345374421508014,-0.7844562428013045
174,1557896400,24,65,41,89,20,-0.6627269185647979,-1.76122779693849
174,1557910800,1009,242,0,1251,20,-0.8386233047806707,1.0692174547009354
174,1557925200,635,331,0,966,20,-0.8386233047806707,0.37500325787026734
174,1557939600,426,622,196,1048,20,0.0022472244464280832,0.5747420794145297
174,1557954000,292,1045,753,1337,20,2.391863983525479,1.2786996333936984
174,1557968400,70,432,362,502,20,0.7144130808326444,-0.7552261713558027
174,1557982800,22,62,40,84,20,-0.6670170743261608,-1.773406993374116
174,1557997200,1054,226,0,1280,20,-0.8386233047806707,1.1398567940275648
174,1558011600,622,367,0,989,20,-0.8386233047806707,0.4310275614741458
174,1558026000,473,600,127,1073,20,-0.2937735230876016,0.6356380615926585
174,1558040400,330,1085,755,1415,20,2.400444295048205,1.4686950977894602
174,1558054800,72,472,400,544,20,0.8774389997644289,-0.6529209212965463
174,1558069200,16,82,66,98,20,-0.5554730245307292,-1.7393052433543637
174,1558083600,910,264,0,1174,20,-0.8386233047806707,0.8816578295922987
174,1558098000,610,353,0,963,20,-0.8386233047806707,0.3676957400088919
174,1558112400,446,651,205,1097,20,0.04085862629869282,0.6940982044836621
174,1558126800,351,821,470,1172,20,1.1777499030598213,0.8767861510180484
174,1558141200,91,471,380,562,20,0.7916358845371738,-0.6090758141282937
174,1558155600,27,182,155,209,20,-0.17364916176944462,-1.468927082483472
174,1558170000,343,161,0,504,20,-0.8386233047806707,-0.7503544927815524
174,1558184400,580,384,0,964,20,-0.8386233047806707,0.37013157929601703
174,1558198800,586,620,34,1206,20,-0.6927580088943373,0.9596046867803035
174,1558213200,369,623,254,992,20,0.2510762586054675,0.43833507933552124
174,1558227600,140,540,400,680,20,0.8774389997644289,-0.32164677824752586
174,1558242000,24,167,143,191,20,-0.2251310309057976,-1.5127721896517246
174,1558256400,228,133,0,361,20,-0.8386233047806707,-1.098679510840449
174,1558270800,570,279,0,849,20,-0.8386233047806707,0.09001006127662466
174,1558285200,481,515,34,996,20,-0.6927580088943373,0.44807843648402185
174,1558299600,259,704,445,963,20,1.0704960090257525,0.3676957400088919
174,1558314000,88,363,275,451,20,0.34116952959408525,-0.8794539749991854
174,1558328400,41,94,53,135,20,-0.611245049428445,-1.649179189730733
174,1558342800,975,175,0,1150,20,-0.8386233047806707,0.8231976867012951
174,1558357200,556,363,0,919,20,-0.8386233047806707,0.26051881137538524
174,1558371600,437,644,207,1081,20,0.04943893782141832,0.6551247758896597
174,1558386000,276,1008,732,1284,20,2.3017707125368614,1.1496001511760654
174,1558400400,67,437,370,504,21,0.9822574314406862,-0.5099076541061573
174,1558414800,22,74,52,96,21,-0.5795318845500049,-1.524748253497924
174,1558429200,1062,240,0,1302,21,-0.8349188167245833,1.4750011652924453
174,1558443600,582,350,0,932,21,-0.8349188167245833,0.5546800334910882
174,1558458000,453,630,177,1083,21,0.03437901010042402,0.9302705494424528
174,1558472400,323,1007,684,1330,21,2.5244015988025637,1.5446470887801156
174,1558486800,79,411,332,490,21,0.7956285194669559,-0.5447306158499924
174,1558501200,23,66,43,89,21,-0.6237334689648357,-1.5421597343698417
174,1558515600,1081,279,0,1360,21,-0.8349188167245833,1.6192677210883337
174,1558530000,621,350,0,971,21,-0.8349188167245833,0.6516868554917717
174,1558544400,429,612,183,1041,21,0.0638467330436446,0.8258016642109475
174,1558558800,313,1048,735,1361,21,2.7748772438199385,1.6217550754986076
174,1558573200,76,444,368,520,21,0.9724348571262794,-0.4701099835417743
174,1558587600,23,97,74,120,21,-0.4714835670915294,-1.4650517476513496
174,1558602000,953,229,0,1182,21,-0.8349188167245833,1.1765186360595727
174,1558616400,605,334,0,939,21,-0.8349188167245833,0.5720915143630058
174,1558630800,455,665,210,1120,21,0.19645148628813724,1.0223026626225886
174,1558645200,314,961,647,1275,21,2.342683973986037,1.407842596215049
174,1558659600,68,454,386,522,21,1.0608380259559411,-0.4651352747212264
174,1558674000,20,84,64,104,21,-0.5205964386635638,-1.5048494182157326
174,1558688400,795,220,0,1015,21,-0.8349188167245833,0.761130449543825
174,1558702800,560,360,0,920,21,-0.8349188167245833,0.5248317805678009
174,1558717200,468,788,320,1256,21,0.7366930735805147,1.3605828624198442
174,1558731600,311,854,543,1165,21,1.83191010963688,1.1342336110849158
174,1558746000,110,409,299,519,21,0.6335560432792426,-0.4725973379520482
174,1558760400,16,124,108,140,21,-0.30449980374661273,-1.4153046594458707
174,1558774800,195,147,0,342,21,-0.8349188167245833,-0.9128590685705352
174,1558789200,448,320,0,768,21,-0.8349188167245833,0.14675391020616235
174,1558803600,393,387,0,780,21,-0.8349188167245833,0.1766021631294496
174,1558818000,276,508,232,784,21,0.30449980374661273,0.18655158077054534
174,1558832400,87,390,303,477,21,0.6532011919080564,-0.5770662231835536
174,1558846800,18,116,98,134,21,-0.35361267531864704,-1.4302287859075145
174,1558861200,140,102,0,242,21,-0.8349188167245833,-1.161594509597929
174,1558875600,453,213,0,666,21,-0.8349188167245833,-0.10695623964177933
174,1558890000,380,409,29,789,21,-0.6924914891656838,0.19898835282191504
174,1558904400,178,471,293,649,21,0.604088320336022,-0.14924126461643628
174,1558918800,66,315,249,381,21,0.3879916854190711,-0.8158522465698517
174,1558933200,20,89,69,109,21,-0.49604000287754657,-1.4924126461643628
174,1558947600,170,105,0,275,21,-0.8349188167245833,-1.079511814058889
174,1558962000,393,217,0,610,21,-0.8349188167245833,-0.24624808661711986
174,1558976400,346,360,14,706,21,-0.7661607965237353,-0.0074620632308218145
174,1558990800,226,484,258,710,21,0.43219326983390194,0.002487354410273938
174,1559005200,65,269,204,334,22,0.053982260396016835,-1.1412012311431143
174,1559019600,19,47,28,66,22,-0.7089945442834403,-1.7957419219837203
174,1559034000,987,220,0,1207,22,-0.8303772177551721,0.9909406461100538
174,1559048400,518,342,0,860,22,-0.8303772177551721,0.14345699043210497
174,1559062800,408,571,163,979,22,-0.12375665433044762,0.43409259569341885
174,1559077200,277,951,674,1228,22,2.091477136528658,1.0422292823326387
174,1559091600,53,398,345,451,22,0.6652307232358092,-0.855450257902999
174,1559106000,20,46,26,66,22,-0.7176647352457068,-1.7957419219837203
174,1559120400,999,254,0,1253,22,-0.8303772177551721,1.1032871825976205
174,1559134800,566,317,0,883,22,-0.8303772177551721,0.19963025867588832
174,1559149200,415,630,215,1045,22,0.10166831068848291,0.595285452392971
174,1559163600,301,1059,758,1360,22,2.4556251569438534,1.364614995731743
174,1559178000,53,391,338,444,22,0.6348850548678763,-0.872546469977194
174,1559192400,17,49,32,66,22,-0.6916541623589072,-1.7957419219837203
174,1559206800,1001,232,0,1233,22,-0.8303772177551721,1.054440862385635
174,1559221200,653,325,0,978,22,-0.8303772177551721,0.43165027968281955
174,1559235600,449,642,193,1091,22,0.006296210103550762,0.7076319888805378
174,1559250000,317,1033,716,1350,22,2.273551146736256,1.3401918356257503
174,1559264400,72,470,398,542,22,0.894990783735873,-0.6331995009384649
174,1559278800,23,68,45,91,22,-0.6352979211041746,-1.7346840217187385
174,1559293200,898,284,0,1182,22,-0.8303772177551721,0.9298827458450719
174,1559307600,555,353,0,908,22,-0.8303772177551721,0.2606881589408702
174,1559322000,416,667,251,1083,22,0.25773174800928095,0.6880934607957435
174,1559336400,365,837,472,1202,22,1.2157878493397356,0.9787290660570575
174,1559350800,110,516,406,626,22,0.9296715475849392,-0.42804495604812565
174,1559365200,43,195,152,238,22,-0.1714427046229137,-1.3756635681606448
174,1559379600,349,186,0,535,22,-0.8303772177551721,-0.6502957130126598
174,1559394000,567,426,0,993,22,-0.8303772177551721,0.4682850198418087
174,1559408400,596,547,0,1143,22,-0.8303772177551721,0.8346324214317001
174,1559422800,355,593,238,948,22,0.20137550675454832,0.3583807993648413
174,1559437200,156,495,339,651,22,0.6392201503490096,-0.3669870557831438
174,1559451600,26,178,152,204,22,-0.1714427046229137,-1.4587023125210201
174,1559466000,225,129,0,354,22,-0.8303772177551721,-1.0923549109311288
174,1559480400,576,323,0,899,22,-0.8303772177551721,0.23870731484547675
174,1559494800,472,541,69,1013,22,-0.5312556295569759,0.5171313400537942
174,1559509200,227,639,412,866,22,0.955682120471739,0.15811088649570063
174,1559523600,91,435,344,526,22,0.6608956277546759,-0.6722765571080532
174,1559538000,29,95,66,124,22,-0.5442609160003757,-1.6540875933689623
174,1559552400,972,240,0,1212,22,-0.8303772177551721,1.00315222616305
174,1559566800,566,342,0,908,22,-0.8303772177551721,0.2606881589408702
174,1559581200,454,633,179,1087,22,-0.05439512663231515,0.6978627248381407
174,1559595600,297,1127,830,1424,22,2.7677520315854496,1.5209232204100969
174,1559610000,68,345,277,413,23,0.46488550784074945,-0.9087867561107617
174,1559624400,20,44,24,64,23,-0.6767538280307097,-1.699444179607411
174,1559638800,920,237,0,1157,23,-0.7850516306430221,0.7767408171886854
174,1559653200,622,324,0,946,23,-0.7850516306430221,0.29872157261048193
174,1559667600,430,555,125,985,23,-0.221000575370562,0.3870758405656949
174,1559682000,278,1039,761,1317,23,2.648891193855715,1.1392198652100718
174,1559696400,63,426,363,489,23,0.852952633868202,-0.7366092083006032
174,1559710800,18,39,21,57,23,-0.6902910533572488,-1.7153026379583465
174,1559725200,1031,263,0,1294,23,-0.7850516306430221,1.0871135020569975
174,1559739600,627,314,0,941,23,-0.7850516306430221,0.2873941023598136
174,1559754000,415,549,134,964,23,-0.18038889939094488,0.33950046551288793
174,1559768400,299,1065,766,1364,23,2.6714532360666134,1.245698085566354
174,1559782800,68,443,375,511,23,0.9071015351743581,-0.6867683391976624
174,1559797200,18,50,32,68,23,-0.6406545604932723,-1.6903822034068763
174,1559811600,960,258,0,1218,23,-0.7850516306430221,0.9149359542468389
174,1559826000,633,325,0,958,23,-0.7850516306430221,0.32590750121208595
174,1559840400,436,607,171,1043,23,-0.013429787030296693,0.5184744954734475
174,1559854800,333,966,633,1299,23,2.071302913256716,1.0984409723076658
174,1559869200,65,464,399,529,23,1.0153993377866706,-0.6459894462952565
174,1559883600,19,64,45,83,23,-0.5819932507449365,-1.6563997926548713
174,1559898000,895,254,0,1149,23,-0.7850516306430221,0.758616864787616
174,1559912400,573,344,0,917,23,-0.7850516306430221,0.23302224515660566
174,1559926800,429,585,156,1014,23,-0.0811159136629919,0.4527751680195712
174,1559941200,441,814,373,1255,23,0.8980767182899988,0.9987592341017846
174,1559955600,183,730,547,913,23,1.6832357872292631,0.223960268956071
174,1559970000,62,179,117,241,23,-0.2570998429079994,-1.2984517327337521
174,1559984400,710,254,0,964,23,-0.7850516306430221,0.33950046551288793
174,1559998800,1168,391,0,1559,23,-0.7850516306430221,1.6874694253424187
174,1560013200,1205,633,0,1838,23,-0.7850516306430221,2.3195422653297113
174,1560027600,522,565,43,1087,23,-0.5910180676292958,0.6181562336793288
174,1560042000,187,550,363,737,23,0.852952633868202,-0.17476668386745411
174,1560056400,44,203,159,247,23,-0.06757868833645286,-1.2848587684329502
174,1560070800,159,100,0,259,23,-0.7850516306430221,-1.2576728398313461
174,1560085200,414,192,0,606,23,-0.7850516306430221,-0.47154640443496426
174,1560099600,316,370,54,686,23,-0.5413815747653193,-0.29030688042427105
174,1560114000,171,477,306,648,23,0.5957453526639602,-0.37639565432935035
174,1560128400,73,268,195,341,23,0.09486801558201564,-1.0719023277203856
174,1560142800,20,51,31,71,23,-0.645166968935452,-1.6835857212564753
174,1560157200,848,223,0,1071,23,-0.7850516306430221,0.5819083288771901
174,1560171600,497,343,0,840,23,-0.7850516306430221,0.05857920329631342
174,1560186000,370,600,230,970,23,0.2528023110583045,0.3530934298136899
174,1560200400,237,844,607,1081,23,1.9539802937600441,0.6045632693785268
174,1560214800,83,409,326,492,24,0.36427489009302877,-0.9671467567767826
174,1560229200,42,66,24,108,24,-0.7937358131500732,-1.9181950400092656
174,1560243600,983,234,0,1217,24,-0.8857631538051541,0.8284522154720456
174,1560258000,583,331,0,914,24,-0.8857631538051541,0.07801567948391461
174,1560272400,427,606,179,1033,24,-0.19939257141934205,0.3727415797564809
174,1560286800,297,1020,723,1317,24,1.8865604834291596,1.0761210392305047
174,1560301200,89,627,538,716,24,1.1771830658795772,-0.41236859155783434
174,1560315600,40,71,31,111,24,-0.766894505459008,-1.9107649752965117
174,1560330000,1013,237,0,1250,24,-0.8857631538051541,0.9101829273123371
174,1560344400,620,370,0,990,24,-0.8857631538051541,0.2662439855403435
174,1560358800,417,625,208,1042,24,-0.08819286812778591,0.3950317738947422
174,1560373200,316,1036,720,1352,24,1.8750570658472745,1.1628051275459654
174,1560387600,99,545,446,644,24,0.8244115933684335,-0.5906901446639249
174,1560402000,36,104,68,140,24,-0.6250190219490914,-1.8389410164065585
174,1560416400,986,211,0,1197,24,-0.8857631538051541,0.7789184507203538
174,1560430800,593,325,0,918,24,-0.8857631538051541,0.08792243243425298
174,1560445200,428,613,185,1041,24,-0.17638573625557183,0.39255508565715763
174,1560459600,307,1068,761,1375,24,2.032270439466371,1.2197689570104109
174,1560474000,92,563,471,655,24,0.9202734065508096,-0.5634465740504944
174,1560488400,41,121,80,162,24,-0.579005351621551,-1.7844538751796977
174,1560502800,922,266,0,1188,24,-0.8857631538051541,0.7566282565820924
174,1560517200,625,367,0,992,24,-0.8857631538051541,0.2711973620155127
174,1560531600,425,664,239,1089,24,0.03067578021836032,0.5114361210612179
174,1560546000,346,891,545,1237,24,1.2040243735706424,0.8779859802237374
174,1561165200,9219,8067,0,17286,25,-0.7330808628539754,4.107102850020874
174,1561179600,29,181,152,210,25,0.017558823062370606,-0.38117858238859187
174,1561194000,328,177,0,505,25,-0.7330808628539754,-0.30364034026158365
174,1561208400,553,365,0,918,25,-0.7330808628539754,-0.19508680128377212
174,1561222800,525,461,0,986,25,-0.7330808628539754,-0.17721357936974988
174,1561237200,366,678,312,1044,25,0.8077058608690507,-0.16196877244308386
174,1561251600,151,550,399,701,25,1.2373483126764329,-0.2521234065094019
174,1561266000,32,217,185,249,25,0.18052664960999837,-0.37092776393790267
174,1561280400,218,98,0,316,25,-0.7330808628539754,-0.35331738352261605
174,1561294800,514,253,0,767,25,-0.7330808628539754,-0.2347758675928509
174,1561309200,468,473,5,941,25,-0.7083887679225167,-0.18904144681285281
174,1561323600,260,642,382,902,25,1.1533951899094732,-0.19929226526354205
174,1561338000,110,431,321,541,25,0.8521516317456764,-0.29417804630710126
174,1561352400,41,105,64,146,25,-0.4170220477313034,-0.3980004383076716
174,1561366800,881,234,0,1115,25,-0.7330808628539754,-0.14330702603285475
174,1561381200,579,354,0,933,25,-0.7330808628539754,-0.1911441788027378
174,1561395600,427,533,106,960,25,-0.20960845030704991,-0.18404745833687602
174,1561410000,309,1055,746,1364,25,2.9509797009196705,-0.07785949284768509
174,1561424400,86,521,435,607,26,1.1179092411659992,-0.42527809823653884
174,1561438800,39,101,62,140,26,-0.5458914592051336,-1.7127305783741325
174,1561453200,941,211,0,1152,26,-0.822448143985322,1.077209271517184
174,1561467600,589,329,0,918,26,-0.822448143985322,0.4321046026687966
174,1561482000,422,547,125,969,26,-0.26487418273494223,0.5727043381870349
174,1561496400,278,935,657,1213,26,2.1081605963466736,1.2453775826272337
174,1561510800,104,551,447,655,26,1.1714363414460356,-0.292948935395844
174,1561525200,39,103,64,142,26,-0.5369702758251276,-1.7072168632557703
174,1561539600,977,252,0,1229,26,-0.822448143985322,1.289487303574132
174,1561554000,641,367,0,1008,26,-0.822448143985322,0.6802217829950995
174,1561568400,418,547,129,965,26,-0.2470318159749301,0.5616769079503103
174,1561582800,307,1043,736,1350,26,2.4605473398569133,1.6230670682350503
174,1561597200,89,606,517,695,26,1.4836777597462483,-0.18267463302859827
174,1561611600,36,119,83,155,26,-0.45221903371506983,-1.6713777149864153
174,1561626000,883,226,0,1109,26,-0.822448143985322,0.9586643964723949
174,1561640400,627,319,0,946,26,-0.822448143985322,0.5092966143258686
174,1561654800,420,495,75,915,26,-0.4879037672350941,0.4238340299912532
174,1561669200,335,1005,670,1340,26,2.166148288316713,1.595498492643239
174,1561683600,114,606,492,720,26,1.3721629674961724,-0.11375319404906968
174,1561698000,38,140,102,178,26,-0.36746779160501214,-1.6079699911252492
174,1561712400,761,196,0,957,26,-0.822448143985322,0.5396220474768612
174,1561726800,580,355,0,935,26,-0.822448143985322,0.478971181174876
174,1561741200,437,624,187,1061,26,0.011682502045246056,0.8263352336317
174,1561755600,345,759,414,1104,26,1.0242368156759356,0.9448801086764892
174,1561770000,107,524,417,631,26,1.0376185907459445,-0.3591135168161914
174,1561784400,26,148,122,174,26,-0.2782559578049514,-1.6189974213619738
174,1561798800,210,147,0,357,26,-0.822448143985322,-1.1144924880318245
174,1561813200,478,357,0,835,26,-0.822448143985322,0.20328542525676174
174,1561827600,425,476,51,901,26,-0.594957967795167,0.3852380241627172
174,1561842000,272,493,221,765,26,0.1633426195053493,0.010305396114081742
174,1561856400,109,381,272,490,26,0.3908327956955042,-0.7478304326607326
174,1561870800,17,120,103,137,26,-0.36300719991500907,-1.721001151051676
174,1561885200,174,107,0,281,26,-0.822448143985322,-1.3240136625295913
174,1561899600,530,215,0,745,26,-0.822448143985322,-0.04483175506954112
174,1561914000,438,390,0,828,26,-0.822448143985322,0.18398742234249374
174,1561928400,221,500,279,721,26,0.4220569375255255,-0.11099633648988855
174,1561942800,61,331,270,392,26,0.38191161231549814,-1.0180024734604844
174,1561957200,21,117,96,138,26,-0.39423134174503033,-1.7182442934924949
174,1561971600,781,226,0,1007,26,-0.822448143985322,0.6774649254359183
174,1561986000,583,361,0,944,26,-0.822448143985322,0.5037828992075063
174,1562000400,442,480,38,922,26,-0.6529456597652065,0.44313203290552117
174,1562014800,281,961,680,1242,26,2.2107542052167433,1.3253264518434869
174,1562029200,74,387,313,461,27,0.8844299720780874,-0.5404207706570797
174,1562043600,24,37,13,61,27,-0.699293881309937,-1.7322706559374708
174,1562058000,851,234,0,1085,27,-0.7679219149567513,1.3188650503803303
174,1562072400,595,352,0,947,27,-0.7679219149567513,0.9076768399585954
174,1562086800,382,493,111,875,27,-0.18194408920318236,0.693143860608125
174,1562101200,281,970,689,1251,27,2.869363868324411,1.8134827527716926
174,1562115600,77,385,308,462,27,0.8580345745216202,-0.5374411459438787
174,1562130000,22,36,14,58,27,-0.6940148017986436,-1.7412095300770738
174,1562144400,778,213,0,991,27,-0.7679219149567513,1.0387803273394385
174,1562158800,599,351,0,950,27,-0.7679219149567513,0.9166157140981983
174,1562173200,419,609,190,1028,27,0.23510319218899736,1.1490264417278746
174,1562187600,308,814,506,1122,27,1.9032923177577163,1.4291111647687664
174,1562202000,83,400,317,483,27,0.905546290123261,-0.4748690269666582
174,1562216400,16,70,54,86,27,-0.482851621346907,-1.6577800381074463
174,1562230800,191,118,0,309,27,-0.7679219149567513,-0.9933237270636284
174,1562245200,335,211,0,546,27,-0.7679219149567513,-0.2871526700349966
174,1562259600,342,349,7,691,27,-0.7309683583776975,0.14489291337914512
174,1562274000,228,374,146,602,27,0.002823693692087133,-0.12029368609574188
174,1562288400,85,366,281,451,27,0.715499427716698,-0.5702170177890895
174,1562302800,13,117,104,130,27,-0.21889764578223628,-1.5266765507266034
174,1562315443,305,83,0,388,27,-0.7679219149567513,-0.7579333747207511
174,1562317200,298,203,0,501,27,-0.7679219149567513,-0.4212357821290406
174,1562331600,439,313,0,752,27,-0.7679219149567513,0.32665002088440476
174,1562346000,405,477,72,882,27,-0.3878281901436255,0.7140012336005319
174,1562360400,268,548,280,816,27,0.7102203482054047,0.5173460025292673
174,1562374800,79,441,362,520,27,1.1431048681314646,-0.36462291257822205
174,1562389200,23,125,102,148,27,-0.2294558048048231,-1.4730433058889858
174,1562403600,256,179,0,435,27,-0.7679219149567513,-0.6178910132003052
174,1562418000,455,409,0,864,27,-0.7679219149567513,0.6603679887629142
174,1562432400,453,498,45,951,27,-0.5303633369485478,0.9195953388113993
174,1562446800,244,491,247,735,27,0.536010724332722,0.27599640075998816
174,1562461200,116,413,297,529,27,0.7999646998973927,-0.33780629015941327
174,1562475600,23,130,107,153,27,-0.20306040724835603,-1.458145182322981
174,1562490000,196,121,0,317,27,-0.7679219149567513,-0.9694867293580205
174,1562504400,460,277,0,737,27,-0.7679219149567513,0.2819556501863901
174,1562518800,424,409,0,833,27,-0.7679219149567513,0.567999622653684
174,1562533200,209,560,351,769,27,1.085034993507237,0.3773036410088214
174,1562547600,79,415,336,494,27,1.005848800837836,-0.4420931551214475
174,1562562000,36,97,61,133,27,-0.4458980647678531,-1.5177376765870003
174,1562576400,867,252,0,1119,27,-0.7679219149567513,1.4201722906291636
174,1562590800,501,322,0,823,27,-0.7679219149567513,0.5382033755216742
174,1562605200,360,519,159,879,27,0.07145172733890152,0.7050623594609289
174,1562619600,236,1019,783,1255,27,3.365597342385992,1.8254012516244966
174,1562634000,63,361,298,424,28,0.5824249811813865,-0.6846956110736617
174,1562648400,23,43,20,66,28,-0.6518477786610806,-1.58071000549356
174,1562662800,903,238,0,1141,28,-0.7406443800885961,1.1098360112701013
174,1562677200,565,351,0,916,28,-0.7406443800885961,0.546698472877707
174,1562691600,413,542,129,955,28,-0.1679063008811204,0.6443089795323887
174,1562706000,301,1078,777,1379,28,2.7091035853703858,1.705510385214056
174,1562720400,72,452,380,524,28,0.9464910470342006,-0.43441226067704203
174,1562734800,26,51,25,77,28,-0.6296486283042017,-1.553178836949932
174,1562749200,935,195,0,1130,28,-0.7406443800885961,1.0823048427264732
174,1562763600,581,331,0,912,28,-0.7406443800885961,0.5366871388618423
174,1562778000,370,520,150,890,28,-0.07466986938222901,0.48162480177458594
174,1562792400,253,994,741,1247,28,2.5492697028008577,1.3751363626905182
174,1562797801,37,230,193,267,28,0.11624282368692956,-1.0776404711963545
174,1562797884,37,249,212,286,28,0.2005995950430694,-1.030086634620997
174,1562806800,29,211,182,240,28,0.06740469290179597,-1.1452169758034418
174,1562821200,29,76,47,105,28,-0.5319723667339344,-1.4830994988388784
174,1562835600,891,231,0,1122,28,-0.7406443800885961,1.0622821746947435
174,1562850000,573,312,0,885,28,-0.7406443800885961,0.46911063425475497
174,1562864400,418,542,124,960,28,-0.19010545123799932,0.6568231470522197
174,1562878800,273,959,686,1232,28,2.3050790488751898,1.3375938601310253
174,1562893200,59,375,316,434,28,0.6623419224661506,-0.6596672760339998
174,1562907600,28,76,48,104,28,-0.5275325366625586,-1.4856023323428447
174,1562922000,776,225,0,1001,28,-0.7406443800885961,0.7594393207148338
174,1562936400,572,351,0,923,28,-0.7406443800885961,0.5642183074054704
174,1562950800,452,571,119,1023,28,-0.21230460159487824,0.8145016578020902
174,1562965200,359,856,497,1215,28,1.465951165385167,1.2950456905635999
174,1562979600,104,460,356,564,28,0.8399351253211819,-0.33429892051839416
174,1562994000,29,167,138,196,28,-0.1279478302387384,-1.2553416499779546
174,1563008400,240,135,0,375,28,-0.7406443800885961,-0.8073344527680053
174,1563022800,508,299,0,807,28,-0.7406443800885961,0.2738896209453916
174,1563037200,459,429,0,888,28,-0.7406443800885961,0.4766191347666536
174,1563051600,252,410,158,662,28,-0.03915122881122277,-0.0890212371297069
174,1563066000,49,75,26,124,28,-0.6252087982328258,-1.4355456622635208
174,1563080400,27,104,77,131,28,-0.398777464592661,-1.4180258277357574
174,1563094800,208,94,0,302,28,-0.7406443800885961,-0.9900412985575378
174,1563109200,481,245,0,726,28,-0.7406443800885961,0.07116010712412969
174,1563123600,439,440,1,879,28,-0.7362045500172204,0.4540936332309578
174,1563138000,228,607,379,835,28,0.9420512169628248,0.34396895905644514
174,1563152400,69,386,317,455,28,0.6667817525375264,-0.6071077724507096
174,1563166800,33,61,28,94,28,-0.6163291380900743,-1.5106306673825067
174,1563181200,884,237,0,1121,28,-0.7406443800885961,1.0597793411907774
174,1563195600,564,322,0,886,28,-0.7406443800885961,0.47161346775872115
174,1563210000,358,483,125,841,28,-0.18566562116662355,0.3589859600802423
174,1563224400,279,1070,791,1349,28,2.7712612063696467,1.6304253800950703
174,1563238800,69,368,299,437,29,0.5113550936394383,-0.780201513007363
174,1563253200,38,94,56,132,29,-0.5741045747640782,-1.611058723218047
174,1563267600,937,178,0,1115,29,-0.8242516588406087,1.0667532034609775
174,1563282000,605,360,0,965,29,-0.8242516588406087,0.6581349033573622
174,1563296400,379,529,150,908,29,-0.15421482649275903,0.5028599493179885
174,1563310800,286,973,687,1259,29,2.2445170333125426,1.459026771560448
174,1563325200,68,512,444,580,29,1.1590573649090263,-0.39065206690858323
174,1563339600,34,101,67,135,29,-0.5249685403919024,-1.6028863572159746
174,1563354000,933,243,0,1176,29,-0.8242516588406087,1.2329246455031142
174,1563368400,576,355,0,931,29,-0.8242516588406087,0.5655147553338762
174,1563382800,402,555,153,957,29,-0.14081408984580202,0.6363419273518361
174,1563397200,293,989,696,1282,29,2.284719243253414,1.5216815775763355
174,1563411600,54,460,406,514,29,0.9893147007142377,-0.5704441189541739
174,1563426000,27,83,56,110,29,-0.5741045747640782,-1.6709894072332439
174,1563440400,876,206,0,1082,29,-0.8242516588406087,0.976857177438182
174,1563454800,591,329,0,920,29,-0.8242516588406087,0.5355494133262777
174,1563469200,376,535,159,911,29,-0.11401261655188805,0.5110323153200608
174,1563483600,273,938,665,1211,29,2.1462449645681914,1.328268915527291
174,1563498000,64,440,376,504,29,0.8553073342446678,-0.5976853389610816
174,1563512400,26,117,91,143,29,-0.41776264721624656,-1.5810933812104486
174,1563526800,785,201,0,986,29,-0.8242516588406087,0.7153414653718684
174,1563541200,561,355,0,916,29,-0.8242516588406087,0.5246529253235146
174,1563555600,420,595,175,1015,29,-0.04254202110145074,0.7943410033919006
174,1563570000,344,950,606,1294,29,1.8826971438447038,1.5543710415846248
174,1563584400,97,451,354,548,29,0.7570352655003165,-0.47782397093068774
174,1563598800,21,158,137,179,29,-0.2122846852962393,-1.483024989185581
174,1563613200,262,128,0,390,29,-0.8242516588406087,-0.908235247039829
174,1563627600,435,313,0,748,29,-0.8242516588406087,0.06700042920746573
174,1563642000,363,422,59,785,29,-0.5607038381171211,0.16779294323302413
174,1563656400,244,429,185,673,29,0.0021271010550725626,-0.13730872084434184
174,1563670800,99,380,281,479,29,0.4309506737576963,-0.6657883889783507
174,1563685200,16,142,126,158,29,-0.26142071966841496,-1.540231551200087
174,1563699600,192,91,0,283,29,-0.8242516588406087,-1.199716301113741
174,1563714000,397,250,0,647,29,-0.8242516588406087,-0.2081358928623018
174,1563728400,388,396,8,784,29,-0.78851636111539,0.16506882123233335
174,1563742800,215,475,260,690,29,0.3371455172289974,-0.09099864683259878
174,1563757200,68,323,255,391,29,0.31481095615073573,-0.9055111250391382
174,1563771600,24,77,53,101,29,-0.5875053114110351,-1.695506505239461
174,1563786000,844,212,0,1056,29,-0.8242516588406087,0.906030005420222
174,1563800400,526,330,0,856,29,-0.8242516588406087,0.3612056052820686
174,1563814800,365,525,160,890,29,-0.10954570433623571,0.4538257533055547
174,1563829200,228,1014,786,1242,29,2.6867413426621236,1.4127166975487049
174,1563843600,62,323,261,385,30,0.41690126550883455,-0.8636796088964586
174,1563858000,25,61,36,86,30,-0.615962230121161,-1.6681662227906677
174,1563872400,903,227,0,1130,30,-0.7812203894219603,1.140810449134263
174,1563879160,379,129,0,508,30,-0.7812203894219603,-0.5327369550202454
174,1563886800,480,338,0,818,30,-0.7812203894219603,0.3013461563750883
174,1563888277,37,35,0,72,30,-0.7812203894219603,-1.7058344923375537
174,1563901200,365,509,144,874,30,-0.12018775221876314,0.45201923456263254
174,1563915600,274,1030,756,1304,30,2.689200955894824,1.6089732277884181
174,1563930000,63,387,324,450,30,0.7061030442852333,-0.6887912145716305
174,1563944400,29,79,50,108,30,-0.5516951681708502,-1.6089732277884181
174,1563958800,895,245,0,1140,30,-0.7812203894219603,1.1677163559534673
174,1563973200,578,316,0,894,30,-0.7812203894219603,0.5058310482010412
174,1563987600,378,517,139,895,30,-0.14314027434387416,0.5085216388829616
174,1564002000,296,992,696,1288,30,2.413770690393492,1.5659237768776912
174,1564016400,70,448,378,518,30,0.9539902832364322,-0.5058310482010412
174,1564030800,28,78,50,106,30,-0.5516951681708502,-1.614354409152259
174,1564045200,881,256,0,1137,30,-0.7812203894219603,1.159644583907706
174,1564059600,610,371,0,981,30,-0.7812203894219603,0.7399124375281187
174,1564074000,416,539,123,955,30,-0.2165883451442294,0.6699570797981875
174,1564088400,309,910,601,1219,30,1.9776727700163834,1.3802730198251816
174,1564102800,75,431,356,506,30,0.8529991858859438,-0.5381181363840863
174,1564117200,24,82,58,106,30,-0.5149711327706725,-1.614354409152259
174,1564131600,762,231,0,993,30,-0.7812203894219603,0.7721995257111639
174,1564146000,561,337,0,898,30,-0.7812203894219603,0.5165934109287229
174,1564160400,421,622,201,1043,30,0.1414710000075024,0.9067290598071855
174,1564174800,326,819,493,1145,30,1.4818982921139854,1.1811693093630695
174,1564189200,93,448,355,541,30,0.8484086814609215,-0.4439474625168712
174,1564203600,25,155,130,180,30,-0.18445481416907397,-1.4152506986901472
174,1564218000,245,159,0,404,30,-0.7812203894219603,-0.8125583859399704
174,1564232400,459,358,0,817,30,-0.7812203894219603,0.2986555656931679
174,1564246800,403,426,23,829,30,-0.6756387876464496,0.3309426538762131
174,1564261200,268,515,247,783,30,0.3526342035585237,0.20717548250787324
174,1564275600,107,464,357,571,30,0.857589690310966,-0.3632297420592583
174,1564290000,26,147,121,173,30,-0.22576935399427378,-1.43408483346359
174,1564304400,184,120,0,304,30,-0.7812203894219603,-1.0816174541320136
174,1564318800,468,254,0,722,30,-0.7812203894219603,0.04304945091072691
174,1564333200,400,398,0,798,30,-0.7812203894219603,0.2475343427366797
174,1564347600,193,621,428,814,30,1.1835155044875423,0.2905837936474066
174,1564362000,92,384,292,476,30,0.5592069026845228,-0.6188358568416993
174,1564376400,35,76,41,111,30,-0.59300970799605,-1.6009014557426569
174,1564390800,844,241,0,1085,30,-0.7812203894219603,1.0197338684478436
174,1564405200,528,321,0,849,30,-0.7812203894219603,0.3847544675146217
174,1564419600,377,479,102,856,30,-0.31298893806969563,0.40358860228806476
174,1564434000,233,959,726,1192,30,2.551485823144158,1.3076270714133298
174,1564448400,62,340,278,402,31,0.3324427014952781,-0.9841796292379732
174,1564462800,30,63,33,93,31,-0.7018234809344761,-1.8025086045074887
174,1564477200,862,193,0,1055,31,-0.8411328034658307,0.7451693055548865
174,1564491600,561,305,0,866,31,-0.8411328034658307,0.24463799058421196
174,1564506000,358,540,182,898,31,-0.07282078223229901,0.32938403333056954
174,1564520400,255,915,660,1170,31,1.9450536471612623,1.0497253966746092
174,1564534800,61,444,383,505,31,0.7756996368223157,-0.7114033041481347
174,1564549200,25,76,51,101,31,-0.6258365777355553,-1.7813220938208993
174,1564563600,902,226,0,1128,31,-0.8411328034658307,0.9384962155700148
174,1564578000,579,328,0,907,31,-0.8411328034658307,0.3532188578529826
174,1564592400,391,570,179,961,31,-0.0854852660987858,0.4962278049874611
174,1564606800,255,975,720,1230,31,2.198343324490998,1.2086242268240297
174,1564621200,52,435,383,487,31,0.7756996368223157,-0.7590729531929609
174,1564635600,24,62,38,86,31,-0.6807160078236647,-1.8210468013582544
174,1564650000,859,196,0,1055,31,-0.8411328034658307,0.7451693055548865
174,1564664400,577,345,0,922,31,-0.8411328034658307,0.39294356539033776
174,1564678800,391,505,114,896,31,-0.35988241653933284,0.3240874056589222
174,1564693200,301,1015,714,1316,31,2.1730143567580242,1.4363792167048657
174,1564707600,60,428,368,488,31,0.7123772174898817,-0.7564246393571371
174,1564722000,25,91,66,116,31,-0.5625141584031214,-1.741597386283544
174,1564736400,729,230,0,959,31,-0.8411328034658307,0.4909311773158137
174,1564750800,556,351,0,907,31,-0.8411328034658307,0.3532188578529826
174,1564765200,406,548,142,954,31,-0.2416805671187895,0.47768960813669537
174,1564779600,297,768,471,1065,31,1.1471911635725947,0.7716524439131233
174,1565398800,9388,7314,0,16702,32,-0.7197110848600852,4.104041063355659
174,1565413200,20,149,129,169,32,0.03340704900432125,-0.3768150760600611
174,1565427600,205,139,0,344,32,-0.7197110848600852,-0.3293857030244504
174,1565442000,536,376,0,912,32,-0.7197110848600852,-0.17544350940029696
174,1565456400,508,477,0,985,32,-0.7197110848600852,-0.15565868521972792
174,1565470800,319,490,171,809,32,0.2786083018904071,-0.2033590832441135
174,1565485200,110,408,298,518,32,1.020050185617381,-0.28222735497761464
174,1565499600,19,141,122,160,32,-0.00745982647669305,-0.37925430095903534
174,1565514000,154,103,0,257,32,-0.7197110848600852,-0.3529648770478683
174,1565528400,388,260,0,648,32,-0.7197110848600852,-0.2469941064368753
174,1565542800,390,419,29,809,32,-0.5504054578673117,-0.2033590832441135
174,1565557200,217,540,323,757,32,1.166003312335289,-0.21745238266040925
174,1565571600,69,409,340,478,32,1.2652514385034666,-0.2930683545286114
174,1565586000,23,71,48,94,32,-0.4394810815617014,-0.39714195021817994
174,1565600400,768,229,0,997,32,-0.7197110848600852,-0.1524063853544289
174,1565614800,626,376,0,1002,32,-0.7197110848600852,-0.15105126041055433
174,1565629200,457,571,114,1028,32,-0.05416482702642368,-0.14400461070240644
174,1565643600,377,1022,645,1399,32,3.0458795844619466,-0.04345433986691184
174,1565658000,57,466,409,523,33,1.0536250362750985,-0.7235321912113338
174,1565672400,20,78,58,98,33,-0.5669153359352409,-1.867054702184881
174,1565686800,810,202,0,1012,33,-0.8346969359016219,0.592191356708818
174,1565701200,718,364,0,1082,33,-0.8346969359016219,0.7805362408691668
174,1565715600,416,529,113,945,33,-0.31298450838091424,0.41191839615534115
174,1565730000,341,924,583,1265,33,1.856969836174241,1.2729235808883648
174,1565744400,64,467,403,531,33,1.02592349145099,-0.7020070615930082
174,1565758800,30,73,43,103,33,-0.6361691979955119,-1.8536014961734273
174,1565772521,568,116,0,684,33,-0.8346969359016219,-0.2903389576425313
174,1565773200,742,237,0,979,33,-0.8346969359016219,0.5034001970332249
174,1565787600,722,366,0,1088,33,-0.8346969359016219,0.7966800880829111
174,1565802000,467,536,69,1003,33,-0.5161291704243757,0.5679755858882016
174,1565816400,333,1011,678,1344,33,2.2955776292226235,1.48548423586933
174,1565830800,73,491,418,564,33,1.095177353511261,-0.6132159019174152
174,1565845200,20,91,71,111,33,-0.5068953221496728,-1.8320763665551019
174,1565859600,797,235,0,1032,33,-0.8346969359016219,0.646004180754632
174,1565874000,630,389,0,1019,33,-0.8346969359016219,0.6110258451248528
174,1565888400,502,644,142,1146,33,-0.17909370839772382,0.9527372778157717
174,1565902800,327,1012,685,1339,33,2.3278960981840835,1.4720310298578765
174,1565917200,81,603,522,684,33,1.5753374637958062,-0.2903389576425313
174,1565931600,20,109,89,129,33,-0.42379068767734773,-1.7836448249138692
174,1565946000,704,234,0,938,33,-0.8346969359016219,0.39308390773930624
174,1565960400,607,404,0,1011,33,-0.8346969359016219,0.5895007155065273
174,1565974800,524,640,116,1164,33,-0.29913373596886006,1.0011688194570043
174,1565989200,396,895,499,1291,33,1.469148208636724,1.342880252147923
174,1566003600,109,576,467,685,33,1.3214066362414794,-0.2876483164402406
174,1566018000,30,180,150,210,33,-0.14215831529891265,-1.5657028875283225
174,1566032400,272,159,0,431,33,-0.8346969359016219,-0.9710711818220781
174,1566046800,531,409,0,940,33,-0.8346969359016219,0.39846519014388765
174,1566061200,500,548,48,1048,33,-0.6130845773087549,0.6890544399912831
174,1566075600,379,608,229,987,33,0.2225786915518475,0.5249253266515505
174,1566090000,138,490,352,628,33,0.790460360446069,-0.44101486497081044
174,1566104400,20,183,163,203,33,-0.08213830151334453,-1.5845373759443575
174,1566118800,191,140,0,331,33,-0.8346969359016219,-1.240135302051148
174,1566133200,506,327,0,833,33,-0.8346969359016219,0.11056658149878285
174,1566147600,494,497,3,991,33,-0.8208461634895676,0.5356878914607133
174,1566162000,237,639,402,876,33,1.0213065673136388,0.2262641531972829
174,1566176400,89,427,338,516,33,0.7258234225231495,-0.7423666796273687
174,1566190800,41,106,65,147,33,-0.5345968669737812,-1.7352132832726366
174,1566205200,662,251,0,913,33,-0.8346969359016219,0.3258178776820388
174,1566219600,605,392,0,997,33,-0.8346969359016219,0.5518317386744575
174,1566234000,459,548,89,1007,33,-0.42379068767734773,0.5787381506973645
174,1566248400,327,897,570,1224,33,1.796949822388673,1.162607291594446
174,1566262800,65,409,344,474,34,0.7108595159419919,-0.8472494634391173
174,1566277200,24,68,44,92,34,-0.628579679641842,-1.858804039374316
174,1566291600,756,218,0,974,34,-0.8250307616608044,0.47677485061218966
174,1566306000,605,411,0,1016,34,-0.8250307616608044,0.5879928929924995
174,1566320400,426,452,26,878,34,-0.7089460313768721,0.22256218231433872
174,1566334800,350,1058,708,1408,34,2.336045739917044,1.6260279552087242
174,1566349200,65,530,465,595,34,1.2510999914941383,-0.5268355794387011
174,1566363600,27,73,46,100,34,-0.6196500850046165,-1.837619650349495
174,1566378000,799,225,0,1024,34,-0.8250307616608044,0.6091772820173204
174,1566392400,666,395,0,1061,34,-0.8250307616608044,0.7071550812571171
174,1566406800,467,615,148,1082,34,-0.16424075850611294,0.762764102447272
174,1566421200,326,982,656,1308,34,2.1038762793491794,1.3612230923984627
174,1566435600,64,519,455,583,34,1.2064520183080105,-0.5586121629759324
174,1566450000,23,84,61,107,34,-0.5526781252254248,-1.8190833099527768
174,1566464400,749,230,0,979,34,-0.8250307616608044,0.49001509375270275
174,1566478800,676,401,0,1077,34,-0.8250307616608044,0.7495238593067589
174,1566493200,446,535,89,981,34,-0.42766380030426693,0.49531119100890797
174,1566507600,364,973,609,1337,34,1.8940308053743786,1.4380165026134386
174,1566522000,78,554,476,632,34,1.3002127619988788,-0.4288577801989043
174,1566536400,19,125,106,144,34,-0.3517622458878497,-1.72110551071298
174,1566550800,676,221,0,897,34,-0.8250307616608044,0.27287510624828837
174,1566565200,611,362,0,973,34,-0.8250307616608044,0.4741268019840871
174,1566579600,471,617,146,1088,34,-0.1731703531433385,0.7786523942158876
174,1566594000,420,834,414,1254,34,1.0233953282448864,1.2182284664809215
174,1566608400,94,541,447,635,34,1.1707336397591082,-0.4209136343145965
174,1566622800,24,201,177,225,34,-0.03476163626634232,-1.5066135718366682
174,1566637200,300,162,0,462,34,-0.8250307616608044,-0.8790260469763487
174,1566651600,578,425,0,1003,34,-0.8250307616608044,0.5535682608271655
174,1566666000,575,528,0,1103,34,-0.8250307616608044,0.8183731236374269
174,1566680400,378,584,206,962,34,0.0947174859734283,0.4449982670749583
174,1566694800,125,568,443,693,34,1.152874450484657,-0.26732681388464485
174,1566709200,24,176,152,200,34,-0.14638156923166182,-1.5728147875392335
174,1566723600,189,129,0,318,34,-0.8250307616608044,-1.2603450494231252
174,1566738000,533,341,0,874,34,-0.8250307616608044,0.21196998780192827
174,1566752400,481,503,22,984,34,-0.7268052206513232,0.5032553368932158
174,1566766800,282,621,339,903,34,0.688535529348928,0.2887633980169041
174,1566781200,85,458,373,543,34,0.8403386381817626,-0.664534108100037
174,1566795600,36,92,56,128,34,-0.5750021118184887,-1.7634742887626218
174,1566810000,696,242,0,938,34,-0.8250307616608044,0.3814451000004956
174,1566824400,558,404,0,962,34,-0.8250307616608044,0.4449982670749583
174,1566838800,461,526,65,987,34,-0.5348189359509736,0.5111994827775237
174,1566853200,337,1025,688,1362,34,2.2467497935447884,1.504217718316004
174,1566867600,90,562,472,652,35,1.2944448336297922,-0.27582099293170775
174,1566882000,40,103,63,143,35,-0.5517834420338221,-1.5686298477648692
174,1566896400,818,298,0,1116,35,-0.8361657925639143,0.9026923835763216
174,1566910800,669,407,0,1076,35,-0.8361657925639143,0.8010964028428708
174,1566925200,516,604,88,1120,35,-0.4389333029345792,0.9128519816496667
174,1566939600,329,1037,708,1366,35,2.359750146726646,1.5376672631603892
174,1566954000,87,670,583,757,35,1.795499451230431,-0.009131543506399394
174,1566968400,37,98,61,135,35,-0.5608114531617616,-1.5889490439115594
174,1566982800,808,273,0,1081,35,-0.8361657925639143,0.8137959004345522
174,1566997200,683,398,0,1081,35,-0.8361657925639143,0.8137959004345522
174,1567011600,476,671,195,1147,35,0.04406529241018056,0.981429268644746
174,1567026000,327,1073,746,1400,35,2.5312823581574952,1.6240238467838224
174,1567040400,78,612,534,690,35,1.5743131785959148,-0.1793048112349295
174,1567054800,40,119,79,159,35,-0.47955935301030667,-1.527991455471489
174,1567069200,793,272,0,1065,35,-0.8361657925639143,0.7731575081411718
174,1567083600,739,376,0,1115,35,-0.8361657925639143,0.9001524840579853
174,1567098000,472,638,166,1110,35,-0.08684086894494124,0.887452986466304
174,1567112400,365,1104,739,1469,35,2.4996843192097074,1.799276913549025
174,1567126800,99,552,453,651,35,1.2086787279143676,-0.27836089245004403
174,1567141200,42,169,127,211,35,-0.26288708593976023,-1.395916680518003
174,1567155600,562,261,0,823,35,-0.8361657925639143,0.15850182470379445
174,1567170000,652,447,0,1099,35,-0.8361657925639143,0.859514091764605
174,1567184400,505,734,229,1239,35,0.19754148158515095,1.215100024331683
174,1567198800,457,763,306,1220,35,0.5451199100108192,1.1668419334832938
174,1567213200,97,556,459,653,35,1.235762761298186,-0.2732810934133715
174,1567227600,29,148,119,177,35,-0.298999130451518,-1.4822732641414362
174,1567242000,208,152,0,360,35,-0.8361657925639143,-1.0174716522858986
174,1567256400,520,352,0,872,35,-0.8361657925639143,0.2829569011022717
174,1567270800,496,594,98,1090,35,-0.393793247294882,0.8366549960995786
174,1567285200,269,487,218,756,35,0.14788742038148406,-0.011671443024735663
174,1567299600,105,427,322,532,35,0.6173439990343347,-0.5806089351320602
174,1567314000,20,118,98,138,35,-0.393793247294882,-1.5813293453565507
174,1567328400,132,100,0,232,35,-0.8361657925639143,-1.3425787906329412
174,1567342800,455,282,0,737,35,-0.8361657925639143,-0.059929533873124795
174,1567357200,438,408,0,846,35,-0.8361657925639143,0.21691951362552866
174,1567371600,235,478,243,713,35,0.260737559480727,-0.12088712231319529
174,1567386000,106,377,271,483,35,0.3871297152718791,-0.7050640115305374
174,1567400400,17,86,69,103,35,-0.5246994086500039,-1.67022582849832
174,1567414800,146,100,0,246,35,-0.8361657925639143,-1.3070201973762334
174,1567429200,351,267,0,618,35,-0.8361657925639143,-0.36217757655514093
174,1567443600,319,424,105,743,35,-0.362195208347094,-0.04469013676310717
174,1567458000,246,475,229,721,35,0.19754148158515095,-0.10056792616650512
174,1567472400,70,245,175,315,36,-0.09474539656158275,-1.1812486988177961
174,1567486800,26,48,22,74,36,-0.7141084874107495,-1.7142640041598847
174,1567501200,878,270,0,1148,36,-0.8031672325001722,0.6610822113480124
174,1567515600,637,444,0,1081,36,-0.8031672325001722,0.512899533099382
174,1567530000,508,626,118,1134,36,-0.3254885088387233,0.6301186666393433
174,1567544400,327,1177,850,1504,36,2.6377388277729765,1.448440919654168
174,1567558800,66,477,411,543,36,0.860612050761315,-0.6769852564194715
174,1567573200,60,92,32,152,36,-0.6736272396428301,-1.5417528264973
174,1567587600,957,272,0,1229,36,-0.8031672325001722,0.8402284343053119
174,1567602000,746,429,0,1175,36,-0.8031672325001722,0.7207976190004455
174,1567616400,487,664,177,1151,36,-0.08664914700799888,0.6677172566427272
174,1567630800,332,1052,720,1384,36,2.111482606790024,1.1830391078655764
174,1567645200,64,487,423,551,36,0.9091895480828183,-0.6592918023002321
174,1567659600,25,82,57,107,36,-0.5724241202230317,-1.641278505918022
174,1567674000,995,305,0,1300,36,-0.8031672325001722,0.9972578396135621
174,1567688400,748,441,0,1189,36,-0.8031672325001722,0.7517611637091146
174,1567702800,522,625,103,1147,36,-0.3862103804906024,0.6588705295831074
174,1567717200,377,1084,707,1461,36,2.058856984691729,1.3533386037632562
174,1567731600,79,518,439,597,36,0.9739595445114894,-0.5575544411146052
174,1567746000,22,100,78,122,36,-0.4874134999104009,-1.6081032794444479
174,1567760400,972,312,0,1284,36,-0.8031672325001722,0.9618709313750832
174,1567774800,683,446,0,1129,36,-0.8031672325001722,0.6190602578148187
174,1567789200,513,774,261,1287,36,0.2533933342425241,0.9685059766697979
174,1567803600,352,1030,678,1382,36,1.9414613661647628,1.1786157443357665
174,1567818000,88,519,431,607,36,0.9415745462971539,-0.5354376234655559
174,1567832400,16,146,130,162,36,-0.27691101151722003,-1.5196360088482506
174,1567846800,243,141,0,384,36,-0.8031672325001722,-1.0286426570393556
174,1567861200,585,439,0,1024,36,-0.8031672325001722,0.3868336724998008
174,1567875600,504,465,0,969,36,-0.8031672325001722,0.2651911754300295
174,1567890000,362,646,284,1008,36,0.34650020410873866,0.3514467642613219
174,1567904400,117,472,355,589,36,0.6339170632609664,-0.5752478952338447
174,1567918800,16,160,144,176,36,-0.2202372646421329,-1.4886724641395817
174,1567933200,164,106,0,270,36,-0.8031672325001722,-1.280774378238518
174,1567947600,519,302,0,821,36,-0.8031672325001722,-0.062137725775900425
174,1567962000,483,512,29,995,36,-0.685771613973206,0.32269490131755774
174,1567976400,231,583,352,814,36,0.6217726889305906,-0.07761949813023494
174,1567990800,62,345,283,407,36,0.3424520793319467,-0.9777739764465423
174,1568005200,27,57,30,84,36,-0.681723489196414,-1.6921471865108353
174,1568019600,968,259,0,1227,36,-0.8031672325001722,0.835805070775502
174,1568034000,653,424,0,1077,36,-0.8031672325001722,0.5040528060397622
174,1568048400,501,769,268,1270,36,0.2817302076800676,0.930907386666414
174,1568062800,278,1054,776,1332,36,2.338177594290373,1.0680316560905199
174,1568077200,53,512,459,565,37,0.9920920350762078,-0.7875668729811433
174,1568091600,27,94,67,121,37,-0.5766558774761055,-1.8021815221937416
174,1568106000,944,263,0,1207,37,-0.8447837094684651,0.6795110657451814
174,1568120400,770,418,0,1188,37,-0.8447837094684651,0.6360928712968945
174,1568134800,506,664,158,1170,37,-0.21248225491931846,0.5949598449774649
174,1568149200,358,1112,754,1470,37,2.1726548774306274,1.280510283634626
174,1568163600,73,518,445,591,37,0.9360653239136252,-0.728152501630856
174,1568178000,23,88,65,111,37,-0.5846596933564744,-1.8250332034823138
174,1568192400,1090,324,0,1414,37,-0.8447837094684651,1.1525408684186225
174,1568206800,715,417,0,1132,37,-0.8447837094684651,0.5081234560808912
174,1568221200,532,788,256,1320,37,0.17970472321875985,0.9377350643060454
174,1568235600,311,1131,820,1442,37,2.4367808014828025,1.2165255760266243
174,1568250000,78,604,526,682,37,1.2602198670685676,-0.5202022019048504
174,1568264400,19,77,58,96,37,-0.6126730489377658,-1.8593107254151717
174,1568278800,1038,207,0,1245,37,-0.8447837094684651,0.7663474546417551
174,1568293200,726,450,0,1176,37,-0.8447837094684651,0.608670853750608
174,1568307600,510,747,237,1257,37,0.10366847235525488,0.7937694721880416
174,1568322000,375,941,566,1316,37,1.4202961846759465,0.9285943917906165
174,1568336400,79,614,535,693,37,1.2962370385302278,-0.49506535248742123
174,1568350800,25,95,70,120,37,-0.564650153655552,-1.804466690322599
174,1568365200,905,287,0,1192,37,-0.8447837094684651,0.6452335438123233
174,1568379600,633,404,0,1037,37,-0.8447837094684651,0.2910324838394568
174,1568394000,542,614,72,1156,37,-0.5566463377751831,0.562967491173464
174,1568408400,446,966,520,1412,37,1.2362084194274607,1.1479705321609082
174,1568422800,99,609,510,708,37,1.196189340025616,-0.4607878305545632
174,1568437200,24,230,206,254,37,-0.02039067379046377,-1.4982541610557336
174,1568451600,301,229,0,530,37,-0.8447837094684651,-0.8675477574911454
174,1568466000,689,499,0,1188,37,-0.8447837094684651,0.6360928712968945
174,1568480400,672,633,0,1305,37,-0.8447837094684651,0.9034575423731873
174,1568494800,432,695,263,1127,37,0.20771807880005116,0.4966976154366051
174,1568509200,147,506,359,653,37,0.5919012410577605,-0.5864720776417094
174,1568523600,47,198,151,245,37,-0.24049561050060975,-1.5188206742154484
174,1568538000,270,118,0,388,37,-0.8447837094684651,-1.1920416317888682
174,1568552400,539,388,0,927,37,-0.8447837094684651,0.03966398966516439
174,1568566800,549,572,23,1121,37,-0.7527398268442222,0.4829866066634619
174,1568581200,300,643,343,943,37,0.527870714014809,0.07622667972687965
174,1568595600,91,446,355,537,37,0.5758936092970226,-0.851551580589145
174,1568610000,48,104,56,152,37,-0.6206768648181347,-1.7313413101991684
174,1568624400,998,265,0,1263,37,-0.8447837094684651,0.8074804809611847
174,1568638800,669,444,0,1113,37,-0.8447837094684651,0.4647052616326043
174,1568653200,504,640,136,1144,37,-0.3005242296033768,0.5355454736271775
174,1568667600,319,1175,856,1494,37,2.5808494873294436,1.3353543187271988
174,1568682000,76,520,444,596,38,0.8665509669322542,-0.6432270023073449
174,1568696400,37,98,61,135,38,-0.5982807747735298,-1.6362234317982405
174,1568710800,971,288,0,1259,38,-0.8315829581783674,0.7848784917327067
174,1568725200,674,414,0,1088,38,-0.8315829581783674,0.4165435905549558
174,1568739600,528,645,117,1173,38,-0.3841017211559739,0.5996340385088086
174,1568754000,403,1116,713,1519,38,1.8953753494880135,1.3449198619444915
174,1568768400,67,539,472,606,38,0.9736404937410321,-0.6216869496068916
174,1568782800,41,117,76,158,38,-0.5409113854116845,-1.586681310587198
174,1568797200,995,299,0,1294,38,-0.8315829581783674,0.8602686761842931
174,1568811600,716,397,0,1113,38,-0.8315829581783674,0.470393722306089
174,1568826000,515,758,243,1273,38,0.09780114948352683,0.8150345655133413
174,1568840400,379,1050,671,1429,38,1.7347410592748467,1.1510593876404123
174,1568854800,83,625,542,708,38,1.2413643107629768,-0.40197841206226825
174,1568869200,32,106,74,138,38,-0.5485606373265971,-1.6297614159881044
174,1568883600,1011,252,0,1263,38,-0.8315829581783674,0.793494512812888
174,1568898000,728,422,0,1150,38,-0.8315829581783674,0.5500919172977661
174,1568912400,538,702,164,1240,38,-0.2043443011555252,0.7439523916018455
174,1568926800,402,1268,866,1670,38,2.480543120978836,1.6701746577213359
174,1568941200,81,622,541,703,38,1.2375396848055205,-0.4127484384124949
174,1568955600,42,107,65,149,38,-0.5829822709437044,-1.606067358017606
174,1568970000,943,280,0,1223,38,-0.8315829581783674,0.707334302011075
174,1568984400,747,451,0,1198,38,-0.8315829581783674,0.6534841702599418
174,1568998800,569,827,258,1396,38,0.15517053884537216,1.0799772137289165
174,1569013200,426,1035,609,1461,38,1.4976142499125527,1.2199875562818627
174,1569027600,98,604,506,702,38,1.103677776294548,-0.41490244368254026
174,1569042000,15,154,139,169,38,-0.2999599500919341,-1.5629872526166992
174,1569056400,231,144,0,375,38,-0.8315829581783674,-1.1192621669873621
174,1569070800,668,455,0,1123,38,-0.8315829581783674,0.4919337750065423
174,1569085200,565,587,22,1152,38,-0.7474411871143276,0.5543999278378567
174,1569099600,438,561,123,999,38,-0.36115396541123573,0.22483712152092178
174,1569114000,95,427,332,522,38,0.43819285969714244,-0.802623392290699
174,1569128400,23,176,153,199,38,-0.2464151866875451,-1.4983670945153396
174,1569142800,158,118,0,276,38,-0.8315829581783674,-1.3325086887218494
174,1569157200,455,322,0,777,38,-0.8315829581783674,-0.2533520484291407
174,1569171600,413,480,67,893,38,-0.5753330190287916,-0.0034874371038828515
174,1569186000,252,580,328,832,38,0.422894355867317,-0.13488175857664778
174,1569200400,76,345,269,421,38,0.19724142437739206,-1.0201779245652771
174,1569214800,28,62,34,90,38,-0.7015456756248514,-1.7331536689502802
174,1569229200,905,270,0,1175,38,-0.8315829581783674,0.6039420490488993
174,1569243600,667,431,0,1098,38,-0.8315829581783674,0.4380836432554091
174,1569258000,459,762,303,1221,38,0.32727870693090816,0.7030262914709843
174,1569272400,334,1274,940,1608,38,2.763565441830606,1.5366263309785257
174,1569286800,85,441,356,526,39,0.6126461613640802,-0.7702421267055715
174,1569301200,26,63,37,89,39,-0.670090714703422,-1.7111422261101679
174,1569315600,1038,290,0,1328,39,-0.8188721078523172,0.9565356300964567
174,1569330000,733,403,0,1136,39,-0.8188721078523172,0.5431424514106844
174,1569344400,554,792,238,1346,39,0.13815415078111704,0.9952912405982478
174,1569358800,362,1159,797,1521,39,2.3859595229495616,1.3720818982545508
174,1569373200,71,581,510,652,39,1.231898446362185,-0.4989528531930334
174,1569387600,37,81,44,118,39,-0.6419428835671445,-1.6487026314128377
174,1569402000,1081,337,0,1418,39,-0.8188721078523172,1.1503136826054126
174,1569416400,761,418,0,1179,39,-0.8188721078523172,0.6357252987205187
174,1569430800,486,668,182,1154,39,-0.0870284983091028,0.5818980619124755
174,1569445200,398,1149,751,1547,39,2.2009880611968806,1.4280622245349157
174,1569459600,64,551,487,615,39,1.1394127154858444,-0.5786171636689375
174,1569474000,28,74,46,102,39,-0.6339006460996366,-1.6831520629699854
174,1569488400,974,292,0,1266,39,-0.8188721078523172,0.8230440828125094
174,1569502800,757,479,0,1236,39,-0.8188721078523172,0.7584513986428575
174,1569517200,559,699,140,1258,39,-0.25591548512676765,0.8058193670339355
174,1569531600,414,1175,761,1589,39,2.24119924853442,1.5184919823724286
174,1569546000,95,545,450,640,39,0.9906313223369492,-0.5247899268608941
174,1569560400,30,102,72,132,39,-0.5293515590220346,-1.6185593788003334
174,1569574800,949,326,0,1275,39,-0.8188721078523172,0.842421888063405
174,1569589200,716,440,0,1156,39,-0.8188721078523172,0.586204240857119
174,1569603600,532,746,214,1278,39,0.04164730117102281,0.8488811564803701
174,1569618000,403,1094,691,1497,39,1.9597209371716453,1.3204077509188292
174,1569632400,112,527,415,639,39,0.8498921666555618,-0.5269430163332158
174,1569646800,26,140,114,166,39,-0.3604645722043697,-1.5453543367413947
174,1569661200,252,157,0,409,39,-0.8188721078523172,-1.022153594967214
174,1569675600,630,421,0,1051,39,-0.8188721078523172,0.36012984626333727
174,1569690000,538,493,0,1031,39,-0.8188721078523172,0.31706805681690264
174,1569704400,402,697,295,1099,39,0.36735791860509076,0.46347814093478035
174,1569718800,99,482,383,581,39,0.7212163671754362,-0.6518222057278763
174,1569733200,22,193,171,215,39,-0.13126080438039597,-1.4398529525976298
174,1569747600,155,123,0,278,39,-0.8188721078523172,-1.3042083158413607
174,1569762000,498,354,0,852,39,-0.8188721078523172,-0.0683349587286872
174,1569776400,483,495,12,978,39,-0.7706186830472701,0.2029543147838509
174,1569790800,267,530,263,797,39,0.23868211912496515,-0.1867548797063824
174,1569805200,87,331,244,418,39,0.16228086318364057,-1.0027757897163183
174,1569819600,27,76,49,103,39,-0.6218372898983748,-1.6809989734976636
174,1569834000,667,263,0,930,39,-0.8188721078523172,0.09960602011240781
174,1569848400,668,461,0,1129,39,-0.8188721078523172,0.5280708251044323
174,1569862800,480,607,127,1087,39,-0.3081900286655687,0.43764106726691954
174,1569877200,296,1000,704,1296,39,2.0119954807104463,0.8876367669821613
174,1569891600,88,419,331,507,40,0.4471565319769049,-0.7774598374454553
174,1569906000,33,60,27,93,40,-0.7082556415755958,-1.6496219161022074
174,1569920400,780,273,0,1053,40,-0.8108744859371666,0.3727829039714204
174,1569934800,709,417,0,1126,40,-0.8108744859371666,0.5265699371645192
174,1569940554,221,211,0,432,40,-0.8108744859371666,-0.9354602140137075
174,1569949200,303,441,138,744,40,-0.28637817031136037,-0.2781786474897785
174,1569963600,345,1113,768,1458,40,2.108061531458625,1.225984937439982
174,1569978000,66,535,469,601,40,0.9716528476027112,-0.579432698813246
174,1569992400,30,69,39,99,40,-0.6626472663037866,-1.636981885976747
174,1570006800,1042,302,0,1344,40,-0.8108744859371666,0.9858243650562388
174,1570021200,719,423,0,1142,40,-0.8108744859371666,0.5602766841657463
174,1570035600,495,805,310,1300,40,0.36734187525123874,0.8931308108028642
174,1570050000,382,1238,856,1620,40,2.4425229501185592,1.5672657508274068
174,1570064400,61,608,547,669,40,1.2681072868694712,-0.4361790240580307
174,1570078800,26,65,39,91,40,-0.6626472663037866,-1.6538352594773607
174,1570093200,1061,284,0,1345,40,-0.8108744859371666,0.9879310367438155
174,1570107600,724,413,0,1137,40,-0.8108744859371666,0.5497433257278629
174,1570122000,564,782,218,1346,40,0.017677664834034566,0.9900377084313922
174,1570136400,397,1182,785,1579,40,2.172673396427021,1.4808922116367622
174,1570150800,79,620,541,699,40,1.2453030992335665,-0.37297887343072983
174,1570165200,26,84,58,110,40,-0.5904340054567553,-1.6138084974134035
174,1570179600,968,324,0,1292,40,-0.8108744859371666,0.8762774373022506
174,1570194000,765,480,0,1245,40,-0.8108744859371666,0.777263867986146
174,1570208400,582,769,187,1351,40,-0.10014397128480597,1.0005710668692758
174,1570222800,408,1013,605,1421,40,1.4885477673498826,1.1480380849996443
174,1570237200,100,585,485,685,40,1.03246401463179,-0.40247227705680355
174,1570251600,19,142,123,161,40,-0.3433886394011219,-1.506368241346992
174,1570266000,279,155,0,434,40,-0.8108744859371666,-0.9312468706385542
174,1570280400,615,438,0,1053,40,-0.8108744859371666,0.3727829039714204
174,1570294800,564,589,25,1153,40,-0.7158570374542307,0.58345007272909
174,1570309200,391,578,187,969,40,-0.10014397128480597,0.19582248221497797
174,1570323600,110,512,402,622,40,0.7170060856684429,-0.5351925933741354
174,1570338000,19,154,135,173,40,-0.2977802641293127,-1.4810881810960717
174,1570352400,167,115,0,282,40,-0.8108744859371666,-1.251460967150212
174,1570366800,482,300,0,782,40,-0.8108744859371666,-0.19812512336186408
174,1570381200,407,547,140,954,40,-0.2787767744327255,0.16422240690132756
174,1570395600,273,570,297,843,40,0.3179328020401121,-0.06961815041968566
174,1570410000,67,341,274,408,40,0.23051674943581102,-0.9860203345155483
174,1570424400,23,71,48,94,40,-0.6284409848499297,-1.6475152444146306
174,1570438800,1010,280,0,1290,40,-0.8108744859371666,0.8720640939270973
174,1570453200,708,437,0,1145,40,-0.8108744859371666,0.5665966992284764
174,1570467600,501,753,252,1254,40,0.14690139477082742,0.7962239131743363
174,1570482000,338,1226,888,1564,40,2.564145284176717,1.449292136323112
174,1570496400,61,530,469,591,41,0.9697545100476638,-0.8576552338340193
174,1570510800,29,78,49,107,41,-0.6698955960810422,-1.8266645487171864
174,1570525200,999,260,0,1259,41,-0.8611881084627245,0.4797377875336577
174,1570539600,732,443,0,1175,41,-0.8611881084627245,0.31156261718203365
174,1570554000,511,778,267,1289,41,0.18116088757623852,0.5398003483735234
174,1570568400,359,1229,870,1588,41,2.5352299685181663,1.1384238714108519
174,1570582800,91,535,444,626,41,0.8721562894447645,-0.7875822461875093
174,1570597200,21,83,62,104,41,-0.6191445213675346,-1.832670804801173
174,1570611600,737,284,0,1021,41,-0.8611881084627245,0.003241471537389525
174,1570626000,698,433,0,1131,41,-0.8611881084627245,0.2234708612835639
174,1570640400,486,614,128,1100,41,-0.3614852189758808,0.1614062150823693
174,1570654800,364,958,594,1322,41,1.4577456130621596,0.6058691652973757
174,1570669200,89,521,432,610,41,0.825309143555373,-0.819615611968771
174,1570683600,21,74,53,95,41,-0.6542798807845783,-1.8506895730531328
174,1570698000,1049,313,0,1362,41,-0.8611881084627245,0.68595257975053
174,1570712400,732,448,0,1180,41,-0.8611881084627245,0.3215730439886779
174,1570726800,585,706,121,1291,41,-0.3888127207446926,0.5438045190961811
174,1570741200,394,1132,738,1526,41,2.0199113637348587,1.0142945790084628
174,1570755600,67,634,567,701,41,1.3523395348110285,-0.637425844087845
174,1570770000,27,76,49,103,41,-0.6698955960810422,-1.834672890162502
174,1570784400,994,268,0,1262,41,-0.8611881084627245,0.48574404361764423
174,1570798800,758,478,0,1236,41,-0.8611881084627245,0.43368982422309393
174,1570813200,526,725,199,1251,41,-0.0843062724636472,0.4637211046430268
174,1570827600,434,1073,639,1507,41,1.6334224101473782,0.9762549571432144
174,1570842000,138,616,478,754,41,1.0048898694647075,-0.5313153199374155
174,1570856400,33,304,271,337,41,0.19677660287270238,-1.3661849156115493
174,1570870800,605,326,0,931,41,-0.8611881084627245,-0.17694621098220767
174,1570885200,1205,580,0,1785,41,-0.8611881084627245,1.5328346875926369
174,1570899600,1076,895,0,1971,41,-0.8611881084627245,1.9052225647998045
174,1570914000,835,1027,192,1862,41,-0.11163377423245897,1.686995260414959
174,1570928400,185,795,610,980,41,1.520208474248015,-0.07884402827709365
174,1570942800,39,324,285,363,41,0.2514316064103259,-1.314130696216999
174,1570957200,373,233,0,606,41,-0.8611881084627245,-0.8276239534140865
174,1570971600,949,497,0,1446,41,-0.8611881084627245,0.8541277501021541
174,1570986000,935,836,0,1771,41,-0.8611881084627245,1.5048054925340328
174,1571000400,497,912,415,1409,41,0.7589423535454015,0.7800505917329863
174,1571014800,142,692,550,834,41,1.2859727448010572,-0.37114849103110686
174,1571029200,38,192,154,230,41,-0.2599830695488657,-1.580408049273737
174,1571043600,566,191,0,757,41,-0.8611881084627245,-0.5253090638534289
174,1571058000,632,392,0,1024,41,-0.8611881084627245,0.009247727621376099
174,1571072400,502,525,23,1027,41,-0.7713977455080573,0.015253983705362672
174,1571086800,342,948,606,1290,41,1.5045927589515513,0.5418024337348523
174,1571101200,65,436,371,501,42,0.8176856547702974,-0.725758363425051
174,1571115600,22,69,47,91,42,-0.6066700019263497,-1.6078956007372676
174,1571130000,945,264,0,1209,42,-0.8132894953360486,0.7975420366165327
174,1571144400,709,419,0,1128,42,-0.8132894953360486,0.6232661433914363
174,1571158800,542,700,158,1242,42,-0.11869630472472059,0.8685433264489794
174,1571173200,391,1071,680,1462,42,2.176098919953211,1.3418852586652907
174,1571187600,70,500,430,570,42,1.0770590613909832,-0.5773011210481169
174,1571202000,21,67,46,88,42,-0.6110661613605987,-1.614350263449308
174,1571216400,1028,271,0,1299,42,-0.8132894953360486,0.9911819179777509
174,1571230800,719,365,0,1084,42,-0.8132894953360486,0.528597756948174
174,1571245200,491,748,257,1239,42,0.3165234792659216,0.8620886637369387
174,1571259600,317,1074,757,1391,42,2.514603196390377,1.189124907813663
174,1571274000,62,487,425,549,42,1.0550782642197387,-0.6224837600324012
174,1571288400,24,78,54,102,42,-0.5758968858866074,-1.5842285041264519
174,1571302800,1025,315,0,1340,42,-0.8132894953360486,1.0793956417089725
174,1571317200,734,409,0,1143,42,-0.8132894953360486,0.6555394569516393
174,1571331600,495,756,261,1251,42,0.3341081170029172,0.8879073145851012
174,1571346000,423,1128,705,1551,42,2.2860029058094335,1.533373585789162
174,1571360400,91,590,499,681,42,1.380394062354158,-0.33847860070261443
174,1571374800,24,89,65,113,42,-0.5275391321098694,-1.5605614075156364
174,1571388294,603,140,0,743,42,-0.8132894953360486,-0.20508223798710853
174,1571388378,7,1,0,8,42,-0.8132894953360486,-1.7864746024370577
174,1571389200,978,323,0,1301,42,-0.8132894953360486,0.9954850264524446
174,1571403600,747,401,0,1148,42,-0.8132894953360486,0.6662972281383737
174,1571418000,503,602,99,1105,42,-0.37806971134540635,0.5737803959324582
174,1571432400,471,939,468,1410,42,1.2441131198924418,1.2300044383232533
174,1571446800,114,553,439,667,42,1.1166244962992233,-0.36860036002547064
174,1571461200,16,130,114,146,42,-0.3121273198316727,-1.4895601176831896
174,1571475600,255,138,0,393,42,-0.8132894953360486,-0.9581262210585129
174,1571490000,632,435,0,1067,42,-0.8132894953360486,0.4920213349132772
174,1571504400,545,523,0,1068,42,-0.8132894953360486,0.4941728891506241
174,1571518800,414,619,205,1033,42,0.08792318868497821,0.4188684908434836
174,1571533200,106,536,430,642,42,1.0770590613909832,-0.42238921595914236
174,1571547600,17,175,158,192,42,-0.11869630472472059,-1.3905886227652338
174,1571562000,161,121,0,282,42,-0.8132894953360486,-1.1969487414040154
174,1571576400,513,320,0,833,42,-0.8132894953360486,-0.011442356625890281
174,1571590800,404,456,52,860,42,-0.5846892047551051,0.0466496077824752
174,1571605200,219,464,245,683,42,0.2637695660549347,-0.3341754922279207
174,1571619600,71,246,175,317,42,-0.043961594342489106,-1.121644343096875
174,1571634000,18,71,53,89,42,-0.5802930453208562,-1.6121987092119612
174,1571648400,944,248,0,1192,42,-0.8132894953360486,0.7609656145816359
174,1571662800,691,469,0,1160,42,-0.8132894953360486,0.692115878986536
174,1571677200,442,696,254,1138,42,0.30333500096317484,0.6447816857649049
174,1571691600,341,1034,693,1375,42,2.2332489925984467,1.154700040016113
174,1571706000,62,515,453,577,43,1.1440833140891842,-0.6369546867348965
174,1571720400,27,73,46,100,43,-0.7161811366899002,-1.669628490574576
174,1571734800,1014,310,0,1324,43,-0.926432155696873,0.9802514589008279
174,1571749200,703,403,0,1106,43,-0.926432155696873,0.5082957162655027
174,1571763600,496,702,206,1198,43,0.01512675550826557,0.7074696993960069
174,1571778000,377,1061,684,1438,43,2.199909083450286,1.2270540032147135
174,1571792400,71,444,373,515,43,0.7784293679901012,-0.7711806318880624
174,1571806800,27,81,54,108,43,-0.679615742079992,-1.6523090137806191
174,1571821200,1044,257,0,1301,43,-0.926432155696873,0.9304579631182018
174,1571835600,743,431,0,1174,43,-0.926432155696873,0.6555112690141363
174,1571850000,525,725,200,1250,43,-0.012297290449165648,0.8200462985567267
174,1571864400,391,1110,719,1501,43,2.359882684868635,1.363444882967124
174,1571878800,76,463,387,539,43,0.8424188085574407,-0.7192222015061918
174,1571893200,24,72,48,96,43,-0.7070397880374232,-1.6782882289715544
174,1571907600,1007,264,0,1271,43,-0.926432155696873,0.8655099251408636
174,1571922000,794,441,0,1235,43,-0.926432155696873,0.7875722795680575
174,1571936400,498,757,259,1255,43,0.257372494798908,0.8308709715529498
174,1571950800,393,1079,686,1472,43,2.2090504321027633,1.3006617795890303
174,1571965200,79,583,504,662,43,1.3771877047273495,-0.4529352457991046
174,1571979600,21,105,84,126,43,-0.5424955122928359,-1.613340190994216
174,1571994000,939,265,0,1204,43,-0.926432155696873,0.7204593069914746
174,1572008400,700,468,0,1168,43,-0.926432155696873,0.6425216614186686
174,1572022800,527,836,309,1363,43,0.4859062111108349,1.0646839082713677
174,1572037200,468,863,395,1331,43,0.878984203167349,0.9954060010955402
174,1572051600,110,577,467,687,43,1.2080727546565235,-0.3988118808179893
174,1572066000,22,135,113,157,43,-0.4099459568319183,-1.546227218417633
174,1572080400,276,184,0,460,43,-0.926432155696873,-0.890252034846516
174,1572094800,665,384,0,1049,43,-0.926432155696873,0.3848944441085599
174,1572109200,493,652,159,1145,43,-0.19969493782494566,0.5927281656360426
174,1572123600,392,709,317,1101,43,0.5224716057207431,0.49747104326927966
174,1572138000,106,437,331,543,43,0.5864610462880826,-0.7105624631092133
174,1572152400,25,181,156,206,43,-0.21340696080366126,-1.4401454230546473
174,1572166800,159,108,0,267,43,-0.926432155696873,-1.308084412500726
174,1572181200,398,303,0,701,43,-0.926432155696873,-0.36850279642856476
174,1572195600,352,444,92,796,43,-0.5059301176829276,-0.1628340095003267
174,1572210000,221,492,271,713,43,0.31222058671377045,-0.34252358123762944
174,1572224400,79,293,214,372,43,0.051692150118173866,-1.080766279580042
174,1572238800,19,77,58,96,43,-0.6613330447750378,-1.6782882289715544
174,1572253200,994,263,0,1257,43,-0.926432155696873,0.835200840751439
174,1572267600,685,398,0,1083,43,-0.926432155696873,0.45850222048287664
174,1572282000,494,778,284,1272,43,0.37163935295487144,0.8676748597401082
174,1572296400,364,1008,644,1372,43,2.017082110400745,1.0841683196645693
174,1572310800,83,515,432,598,44,0.9018312413587506,-0.6239384130608254
174,1572325200,21,78,57,99,44,-0.632889671812543,-1.6680538123684572
174,1572339600,982,321,0,1303,44,-0.8661672506145796,0.8512146060010591
174,1572354000,673,451,0,1124,44,-0.8661672506145796,0.47667220825343176
174,1572368400,535,738,203,1273,44,-0.03537166295118599,0.7884421371048088
174,1572382800,347,1101,754,1448,44,2.2196449321351683,1.1546148723329361
174,1572397200,60,521,461,581,44,1.020516325310664,-0.6595094787687006
174,1572411600,25,83,58,108,44,-0.6287970827107529,-1.649222071699582
174,1572426000,975,301,0,1276,44,-0.8661672506145796,0.7947193839944339
174,1572440400,785,417,0,1202,44,-0.8661672506145796,0.6398806273836828
174,1572454800,515,679,164,1194,44,-0.1949826379210005,0.6231413023446827
174,1572469200,395,1093,698,1488,44,1.9904599424349216,1.2383114975279368
174,1572483600,74,567,493,641,44,1.1514791765679477,-0.5339645409761998
174,1572498000,24,98,74,122,44,-0.563315657082111,-1.619928252881332
174,1572512400,990,269,0,1259,44,-0.8661672506145796,0.7591483182865586
174,1572526800,690,402,0,1092,44,-0.8661672506145796,0.40971490809743133
174,1572541200,487,857,370,1344,44,0.6480907170477634,0.9370036468259347
174,1572555600,381,944,563,1325,44,1.437960413693256,0.8972477498583095
174,1572570000,97,514,417,611,44,0.8404424048318989,-0.5967370098724503
174,1572584400,20,141,121,161,44,-0.37096396929797554,-1.5383240433162064
174,1572598800,917,318,0,1235,44,-0.8661672506145796,0.7089303431695583
174,1572613200,740,488,0,1228,44,-0.8661672506145796,0.6942834337604332
174,1572627600,610,749,139,1359,44,-0.2972973654657534,0.9683898812740599
174,1572642000,482,1163,681,1645,44,1.9208859277044896,1.566820751418314
174,1572656400,112,569,457,681,44,1.0041459689035035,-0.45026791578119923
174,1572670800,17,126,109,143,44,-0.42007503851945693,-1.5759875246539565
174,1572685200,248,153,0,401,44,-0.8661672506145796,-1.036144292146203
174,1572699600,664,465,0,1129,44,-0.8661672506145796,0.4871342864028068
174,1572714000,569,578,9,1147,44,-0.8293339486984685,0.5247977677405571
174,1572728400,370,626,256,996,44,0.18153555944369018,0.20884300762943
174,1572742800,102,488,386,590,44,0.7135721426764052,-0.6406777380998255
174,1572753600,17,139,122,156,44,-0.3668713801961854,-1.5487861214655814
174,1572768000,106,59,0,165,44,-0.8661672506145796,-1.5299543807967062
174,1572782400,527,313,0,840,44,-0.8661672506145796,-0.1175738306310721
174,1572796800,572,451,0,1023,44,-0.8661672506145796,0.2653382296360554
174,1572811200,332,813,481,1145,44,1.1023681073464664,0.5206129364808071
174,1572825600,79,430,351,509,44,0.5703315241137512,-0.8101634041197016
174,1572840000,18,88,70,106,44,-0.5796860134892714,-1.6534069029593321
174,1572854400,569,157,0,726,44,-0.8661672506145796,-0.35610921243682364
174,1572868800,918,462,0,1380,44,-0.8661672506145796,1.0123306095014353
174,1572883200,464,620,156,1084,44,-0.22772335073532146,0.3929755830584312
174,1572897600,448,1255,807,1703,44,2.436552154530044,1.6881808579510647
174,1572912000,95,640,545,735,45,1.4317610570006416,-0.2424499512502469
174,1572926400,14,131,117,145,45,-0.3258935739249566,-1.3929497199176382
174,1572940800,515,176,0,691,45,-0.8063739286405991,-0.32824993399832353
174,1572955200,996,456,0,1452,45,-0.8063739286405991,1.15569976762182
174,1572969600,509,602,93,1111,45,-0.42445364668713964,0.4907499013242261
174,1572984000,457,1206,749,1663,45,2.2695216754791976,1.5671496848910056
174,1572998400,96,631,535,727,45,1.3906943600163986,-0.2580499481135336
174,1573012800,17,124,107,141,45,-0.3669602709091995,-1.4007497183492814
174,1573027200,622,166,0,788,45,-0.8063739286405991,-0.1390999720309728
174,1573041600,1081,419,0,1500,45,-0.8063739286405991,1.24929974880154
174,1573056000,491,571,80,1062,45,-0.4778403527666555,0.3951999205365953
174,1573070400,477,1285,808,1762,45,2.5118151876862314,1.760199646074178
174,1573084800,87,492,405,579,45,0.8568272992212405,-0.5466498900843367
174,1573099200,6,22,16,28,45,-0.7406672134658104,-1.6210996740432055
174,1573113600,626,193,0,819,45,-0.8063739286405991,-0.07864998418573699
174,1573128000,1053,457,0,1510,45,-0.8063739286405991,1.2687997448806483
174,1573142400,502,602,100,1104,45,-0.3957069587981696,0.4770999040688503
174,1573156800,423,1125,702,1548,45,2.0765081996532557,1.34289972998126
174,1573171200,67,425,358,492,45,0.6638138233952985,-0.7162998559725792
174,1573185600,6,17,11,23,45,-0.7612005619579318,-1.6308496720827597
174,1573200000,550,148,0,698,45,-0.8063739286405991,-0.31459993674294773
174,1573214400,1018,485,0,1503,45,-0.8063739286405991,1.2551497476252724
174,1573228800,550,711,161,1261,45,-0.14520010719428758,0.783249842510851
174,1573243200,573,1128,555,1701,45,1.4728277539848846,1.6412496699916173
174,1573257600,109,541,432,650,45,0.9677073810786964,-0.4081999179226677
174,1573272000,12,151,139,163,45,-0.23554684055962208,-1.3578497269752432
174,1573286400,118,107,0,225,45,-0.8063739286405991,-1.2369497512847716
174,1573300800,605,381,0,986,45,-0.8063739286405991,0.24699995033537203
174,1573315200,625,547,0,1172,45,-0.8063739286405991,0.6096998774067869
174,1573329600,460,725,265,1185,45,0.2818935414418391,0.6350498723096277
174,1573344000,123,517,394,640,45,0.8116539325385732,-0.427699914001776
174,1573358400,18,185,167,203,45,-0.12056008900374182,-1.2798497426588098
174,1573372800,87,65,0,152,45,-0.8063739286405991,-1.3792997226622623
174,1573387200,528,270,0,798,45,-0.8063739286405991,-0.11959997595186447
174,1573401600,525,460,0,985,45,-0.8063739286405991,0.24504995072746122
174,1573416000,319,605,286,924,45,0.3681336051087493,0.12609997464490041
174,1573430400,94,338,244,432,45,0.1956534777749289,-0.8332998324472292
174,1573444800,15,101,86,116,45,-0.4532003345761097,-1.4494997085470522
174,1573459200,363,148,0,511,45,-0.8063739286405991,-0.6792498634222733
174,1573473600,920,421,0,1341,45,-0.8063739286405991,0.9392498111437175
174,1573488000,412,596,184,1008,45,-0.05074670413052881,0.28989994170941036
174,1573502400,425,1133,708,1558,45,2.101148217843802,1.3623997260603682
174,1573516800,76,362,286,438,46,0.40518006187256644,-0.7611247826883604
174,1573531200,4,17,13,21,46,-0.6785135675724642,-1.536099461137517
174,1573545600,582,156,0,738,46,-0.7301180261174657,-0.20358904279688075
174,1573560000,1002,455,0,1457,46,-0.7301180261174657,1.1326382804763653
174,1573574400,482,648,166,1130,46,-0.07116878623513934,0.5249243239946526
174,1573588800,453,1230,777,1683,46,2.354240765379929,1.55264853786128
174,1573603200,61,339,278,400,46,0.3734234719987194,-0.8317459764079478
174,1573617600,3,22,19,25,46,-0.654696125167079,-1.5286656512722974
174,1573632000,559,162,0,721,46,-0.7301180261174657,-0.2351827347240646
174,1573646400,1081,454,0,1535,46,-0.7301180261174657,1.2775975728481501
174,1573660800,485,545,60,1030,46,-0.49194360206361276,0.3390790773641594
174,1573675200,440,1329,889,1769,46,2.798833023613788,1.7124754499635042
174,1573689600,74,435,361,509,46,0.7028980919398826,-0.6291746575807101
174,1573704000,2,6,4,8,46,-0.7142397311805422,-1.5602593431994811
174,1573718400,585,165,0,750,46,-0.7301180261174657,-0.18128761320122155
174,1573732800,1148,495,0,1643,46,-0.7301180261174657,1.4783104392090827
174,1573747200,532,545,13,1077,46,-0.6785135675724642,0.4264263432804912
174,1573761600,474,1179,705,1653,46,2.068431456515306,1.496894963872132
174,1573776000,59,472,413,531,46,0.9093159261198884,-0.5882887033220017
174,1573790400,2,4,2,6,46,-0.7221788786490039,-1.563976248132091
174,1573804800,605,169,0,774,46,-0.7301180261174657,-0.13668475400990318
174,1573819200,967,504,0,1471,46,-0.7301180261174657,1.1586566150046345
174,1573833600,514,610,96,1124,46,-0.34903894763130106,0.513773609196823
174,1573848000,502,1115,613,1617,46,1.7032306729660647,1.4299906750851545
174,1573862400,107,593,486,700,46,1.1990948087187427,-0.27421023651646814
174,1573876800,19,154,135,173,46,-0.19422557199629667,-1.2536146862591673
174,1573891200,131,86,0,217,46,-0.7301180261174657,-1.1718427777417504
174,1573905600,532,426,0,958,46,-0.7301180261174657,0.20527049979020429
174,1573920000,622,635,13,1257,46,-0.6785135675724642,0.7609477872153789
174,1573934400,479,820,341,1299,46,0.6235066172552649,0.8390027908001861
174,1573948800,134,413,279,547,46,0.3773930457329503,-0.5585534638611227
174,1573963200,19,189,170,208,46,-0.0552904912982158,-1.1885688499384948
174,1573977600,79,65,0,144,46,-0.7301180261174657,-1.3075098077820104
174,1573992000,480,284,0,764,46,-0.7301180261174657,-0.1552692786729525
174,1574006400,533,445,0,978,46,-0.7301180261174657,0.24243954911630294
174,1574020800,275,668,393,943,46,0.8299244514352708,0.17739371279563032
174,1574035200,73,381,308,454,46,0.49251068402564585,-0.7313895432274814
174,1574049600,10,98,88,108,46,-0.3807955375051481,-1.374414096568988
174,1574064000,543,222,0,765,46,-0.7301180261174657,-0.1534108262066476
174,1574078400,952,465,0,1417,46,-0.7301180261174657,1.0583001818241682
174,1574092800,462,517,55,979,46,-0.5117914707347672,0.24429800158260787
174,1574107200,407,1169,762,1576,46,2.294697159366466,1.3537941239666522
174,1574121600,70,443,373,513,47,0.5773781324070002,-0.6237205051185469
174,1574136000,3,9,6,12,47,-0.6400919815357496,-1.5165318567310955
174,1574150400,596,181,0,777,47,-0.6599961250879471,-0.15325703840055724
174,1574164800,1073,451,0,1524,47,-0.6599961250879471,1.1779407253810272
174,1574179200,508,572,64,1080,47,-0.44768526053117336,0.3867067131734991
174,1574193600,458,1259,801,1717,47,1.997207039130425,1.5218780324892545
174,1574208000,61,450,389,511,47,0.6304558485461936,-0.6272846222906528
174,1574222400,8,16,8,24,47,-0.6334572670183505,-1.4951471536984595
174,1574236800,574,192,0,766,47,-0.6599961250879471,-0.17285968284714015
174,1574251200,1114,416,0,1530,47,-0.6599961250879471,1.1886330768973452
174,1574265600,509,636,127,1145,47,-0.23869175323309916,0.5025405212669435
174,1574280000,452,1188,736,1640,47,1.7815788173149516,1.3846595213631743
174,1574294400,58,474,416,532,47,0.7200244945310825,-0.58986139198354
174,1574308800,2,8,6,10,47,-0.6400919815357496,-1.5200959739032014
174,1574323200,618,186,0,804,47,-0.6599961250879471,-0.10514145657712648
174,1574337600,1048,477,0,1525,47,-0.6599961250879471,1.17972278396708
174,1574352000,536,529,0,1065,47,-0.6599961250879471,0.3599758343827042
174,1574366400,382,1890,1508,2272,47,4.342578621031036,2.5109205477486647
174,1574380800,66,426,360,492,47,0.5342524880439055,-0.6611437354256597
174,1574395200,4,13,9,17,47,-0.6301399097596508,-1.5076215638008306
174,1574409600,505,181,0,686,47,-0.6599961250879471,-0.31542436973137944
174,1574424000,1021,445,0,1466,47,-0.6599961250879471,1.0745813273899536
174,1574438400,511,788,277,1299,47,0.25891183557183944,0.7769775435191042
174,1574452800,540,1057,517,1597,47,1.0550775776597412,1.3080310021628956
174,1574467200,106,552,446,658,47,0.8195452122920703,-0.3653220101408632
174,1574481600,17,184,167,201,47,-0.10599746288511552,-1.17972278396708
174,1574496000,113,101,0,214,47,-0.6599961250879471,-1.1565560223483913
174,1574510400,567,366,0,933,47,-0.6599961250879471,0.12474410102370938
174,1574524800,583,482,0,1065,47,-0.6599961250879471,0.3599758343827042
174,1574539200,432,616,184,1048,47,-0.04960238948722249,0.3296808384198034
174,1574553600,140,538,398,678,47,0.6603120638744899,-0.3296808384198034
174,1574568000,23,201,178,224,47,-0.06950653303942003,-1.1387354364878615
174,1574582400,102,54,0,156,47,-0.6599961250879471,-1.2599154203394647
174,1574596800,436,254,0,690,47,-0.6599961250879471,-0.3082961353871675
174,1574611200,444,394,0,838,47,-0.6599961250879471,-0.04455146465132478
174,1574625600,269,567,298,836,47,0.32857633800453084,-0.048115581823430766
174,1574640000,82,331,249,413,47,0.1660258323282509,-0.8019263637238461
174,1574654400,21,91,70,112,47,-0.4277811169789758,-1.3383259981257964
174,1574668800,559,273,0,832,47,-0.6599961250879471,-0.05524381616764273
174,1574683200,1026,491,0,1517,47,-0.6599961250879471,1.1654663152786562
174,1574697600,518,618,100,1136,47,-0.3282603992179881,0.4865019939924666
174,1574712000,511,1180,669,1691,47,1.559315880982079,1.4755445092518766
174,1574726400,114,536,422,650,48,1.3409184569604298,-0.15968261525021388
174,1574740800,13,98,85,111,48,-0.37558329214130876,-1.3759999248176227
174,1574755200,540,182,0,722,48,-0.8085288371669698,0.002793908476786929
174,1574769600,1055,429,0,1484,48,-0.8085288371669698,1.7223371179208788
174,1574784000,590,557,0,1147,48,-0.8085288371669698,0.9618567221431111
174,1574798400,492,1124,632,1616,48,2.4105486270238274,2.0202107447537134
174,1574812800,95,654,559,749,48,2.038724806001789,0.06372260487441223
174,1574827200,20,147,127,167,48,-0.1616572581286292,-1.2496292952521777
174,1574841600,494,181,0,675,48,-0.8085288371669698,-0.10326715562278305
174,1574856000,924,488,0,1412,48,-0.8085288371669698,1.559860594193878
174,1574870400,545,777,232,1322,48,0.3731578269030697,1.356764939535127
174,1574884800,503,941,438,1444,48,1.42241408896526,1.6320723825169894
174,1574899200,121,510,389,631,48,1.1728337159504671,-0.2025583645670613
174,1574913600,24,132,108,156,48,-0.2584333211343652,-1.2744520974882472
174,1574928000,104,75,0,179,48,-0.8085288371669698,-1.2225498746310108
174,1574942400,285,267,0,552,48,-0.8085288371669698,-0.38083121698974276
174,1574956800,359,426,67,785,48,-0.46726587814674286,0.14496086673791264
174,1574971200,240,419,179,659,48,0.10320354588706933,-0.1393730497843388
174,1574985600,144,353,209,497,48,0.2560078558961262,-0.5049452281700906
174,1575000000,26,117,91,143,48,-0.3450224301394974,-1.3037881364945112
174,1575014400,159,85,0,244,48,-0.8085288371669698,-1.0758696795996907
174,1575028800,438,325,0,763,48,-0.8085288371669698,0.0953152622657735
174,1575043200,486,493,7,979,48,-0.7728744981648565,0.582744833446776
174,1575057600,399,798,399,1197,48,1.223768485953486,1.074687641397973
174,1575072000,120,482,362,602,48,1.035309836942316,-0.2680002977348811
174,1575086400,13,148,135,161,48,-0.12090944212621403,-1.263169005562761
174,1575100800,95,100,5,195,48,-0.7830614521654603,-1.186443980469455
174,1575115200,432,313,0,745,48,-0.8085288371669698,0.0546961313340233
174,1575129600,522,403,0,925,48,-0.8085288371669698,0.4608874406515253
174,1575144000,413,639,226,1052,48,0.34259696490125835,0.747477975558874
174,1575158400,147,424,277,571,48,0.602364291916655,-0.3379554676728953
174,1575172800,27,184,157,211,48,-0.008852948119572355,-1.1503380863078994
174,1575187200,85,73,0,158,48,-0.8085288371669698,-1.2699388607180526
174,1575201600,409,254,0,663,48,-0.8085288371669698,-0.13034657624394985
174,1575216000,432,388,0,820,48,-0.8085288371669698,0.2239425102163158
174,1575230400,192,526,334,718,48,0.892692480933863,-0.0062325650636020045
174,1575244800,80,295,215,375,48,0.28656871789793753,-0.7802526711519531
174,1575259200,14,79,65,93,48,-0.47745283214734663,-1.416619055749373
174,1575273600,576,152,0,728,48,-0.8085288371669698,0.01633361878737033
174,1575288000,866,428,0,1294,48,-0.8085288371669698,1.2935796247524045
174,1575302400,479,640,161,1119,48,0.011520959881635224,0.8986714073603886
174,1575316800,386,1172,786,1558,48,3.1949440850703197,1.8893268784180741
174,1575331200,79,457,378,536,49,0.6196120213907975,-0.7170754318108749
174,1575345600,7,51,44,58,49,-0.6286886300626146,-1.6669306950092861
174,1575360000,590,185,0,775,49,-0.7931354224696509,-0.24214780021166918
174,1575374400,1041,427,0,1468,49,-0.7931354224696509,1.1349436169358185
174,1575388800,498,588,90,1086,49,-0.45676698345525835,0.3758542643379248
174,1575403200,427,1146,719,1573,49,1.8940746625453289,1.3435938316551346
174,1575417600,89,674,585,763,49,1.3932594311239002,-0.2659935390367339
174,1575432000,7,63,56,70,49,-0.5838395048606955,-1.6430849561842213
174,1575446400,590,186,0,776,49,-0.7931354224696509,-0.24016065530958045
174,1575460800,1089,468,0,1557,49,-0.7931354224696509,1.311799513221715
174,1575475200,529,639,110,1168,49,-0.38201844145206004,0.5388001463092004
174,1575489600,452,1245,793,1697,49,2.1706442679571625,1.5899997995141368
174,1575504000,100,753,653,853,49,1.6474044739347744,-0.08715049784874851
174,1575518400,12,62,50,74,49,-0.606264067461655,-1.6351363765758666
174,1575532800,571,210,0,781,49,-0.7931354224696509,-0.23022493079913683
174,1575547200,985,409,0,1394,49,-0.7931354224696509,0.9878948941812526
174,1575561600,516,646,130,1162,49,-0.3072698994488617,0.5268772768966681
174,1575576000,458,1299,841,1757,49,2.3500407687648384,1.7092284936394604
174,1575590400,117,744,627,861,49,1.5502313693306167,-0.07125333863203868
174,1575604800,12,94,82,106,49,-0.4866664002565377,-1.5715477397090274
174,1575619200,553,208,0,761,49,-0.7931354224696509,-0.26996782884091136
174,1575633600,1059,482,0,1541,49,-0.7931354224696509,1.2800051947882953
174,1575648000,542,675,133,1217,49,-0.29605761814838194,0.636170246511548
174,1575662400,553,1050,497,1603,49,1.0643658463098276,1.4032081787177966
174,1575676800,154,756,602,910,49,1.4567956918266187,0.026116761570308913
174,1575691200,32,197,165,229,49,-0.17645995094326464,-1.3271289167521139
174,1575705600,139,106,0,245,49,-0.7931354224696509,-1.2953345983186944
174,1575720000,608,311,0,919,49,-0.7931354224696509,0.04400106568910745
174,1575734400,604,578,0,1182,49,-0.7931354224696509,0.5666201749384425
174,1575748800,487,675,188,1162,49,-0.09049912763958658,0.5268772768966681
174,1575763200,187,614,427,801,49,0.8027459492986334,-0.19048203275736228
174,1575777600,25,227,202,252,49,-0.038175148237347745,-1.2814245840040732
174,1575792000,82,70,0,152,49,-0.7931354224696509,-1.4801390742129459
174,1575806400,437,305,0,742,49,-0.7931354224696509,-0.3077235819805972
174,1575820800,607,456,0,1063,49,-0.7931354224696509,0.3301499315898841
174,1575835200,308,655,347,963,49,0.5037517812858401,0.13143544138101143
174,1575849600,80,378,298,458,49,0.3206178533780042,-0.8720727341737955
174,1575864000,15,109,94,124,49,-0.4418172750546187,-1.5357791314714302
174,1575878400,570,168,0,738,49,-0.7931354224696509,-0.31567216158895206
174,1575892800,955,500,0,1455,49,-0.7931354224696509,1.109110733208665
174,1575907200,493,550,57,1043,49,-0.5801020777605356,0.29040703354810954
174,1575921600,424,1169,745,1593,49,1.9912477671494866,1.3833367296969092
174,1575936000,80,425,345,505,50,0.5891414791158464,-0.8022736892428292
174,1575950400,17,58,41,75,50,-0.6442014304350843,-1.6777457634256385
174,1575964800,609,152,0,761,50,-0.8105404412626769,-0.28106240786887754
174,1575979200,1099,470,0,1569,50,-0.8105404412626769,1.3640106989676573
174,1575993600,532,570,38,1102,50,-0.6563725775688105,0.413207306773769
174,1576008000,428,1154,726,1582,50,2.134877165099085,1.3904784593499282
174,1576022400,99,687,588,786,50,1.5750043969476757,-0.23016286867220256
174,1576036800,20,148,128,168,50,-0.29123816355702187,-1.4883994776140077
174,1576051200,585,156,0,741,50,-0.8105404412626769,-0.3217820392262175
174,1576065600,1073,449,0,1522,50,-0.8105404412626769,1.2683195652779085
174,1576080000,566,651,85,1217,50,-0.46569127247376535,0.6473451870784738
174,1576094400,474,1047,573,1521,50,1.5141486612790442,1.2662835837100415
174,1576108800,108,793,685,901,50,1.9685381542714924,0.003975011632502258
174,1576123200,15,146,131,161,50,-0.27906701642329557,-1.5026513485890767
174,1576137600,554,188,0,742,50,-0.8105404412626769,-0.3197460576583505
174,1576152000,1051,467,0,1518,50,-0.8105404412626769,1.2601756390064405
174,1576166400,570,537,0,1107,50,-0.8105404412626769,0.42338721461310397
174,1576180800,533,1034,501,1567,50,1.2220411300696132,1.3599387358319233
174,1576195200,93,675,582,768,50,1.5506621026802232,-0.26681053689380857
174,1576209600,25,175,150,200,50,-0.2019830845763624,-1.4232480674422638
174,1576224000,512,150,0,662,50,-0.8105404412626769,-0.4826245830877104
174,1576238400,1035,483,0,1518,50,-0.8105404412626769,1.2601756390064405
174,1576252800,543,576,33,1119,50,-0.6766578227916876,0.4478189934275079
174,1576267200,528,1129,601,1657,50,1.6277460345271562,1.543177076939953
174,1576281600,134,679,545,813,50,1.400551288030932,-0.17519136633979362
174,1576296000,26,274,248,300,50,0.19560772179202968,-1.2196499106555638
174,1576310400,120,102,0,222,50,-0.8105404412626769,-1.3784564729491897
174,1576324800,579,327,0,906,50,-0.8105404412626769,0.01415491947183725
174,1576339200,643,435,0,1078,50,-0.8105404412626769,0.364343749144961
174,1576353600,538,721,183,1259,50,-0.06810046610537325,0.7328564129288877
174,1576368000,167,519,352,686,50,0.6175408224278743,-0.43376102545890244
174,1576382400,40,259,219,299,50,0.07795329949934221,-1.2216858922234308
174,1576396800,82,61,0,143,50,-0.8105404412626769,-1.5392990168106826
174,1576411200,489,261,0,750,50,-0.8105404412626769,-0.30345820511541455
174,1576425600,610,451,0,1061,50,-0.8105404412626769,0.329732062491222
174,1576440000,328,722,394,1050,50,0.7879368823000423,0.30733626524468505
174,1576454400,104,376,272,480,50,0.29297689886184,-0.8531732284395042
174,1576468800,21,133,112,154,50,-0.35615094827022875,-1.5169032195641456
174,1576483200,559,192,0,751,50,-0.8105404412626769,-0.30142222354754755
174,1576497600,1004,456,0,1460,50,-0.8105404412626769,1.1420887080701545
174,1576512000,531,610,79,1141,50,-0.4900335667412179,0.49261058792058193
174,1576526400,479,1259,780,1738,50,2.3539578135061583,1.70809158393718
174,1576540800,100,588,488,688,51,1.3610601395263298,-0.34190895223010154
174,1576555200,10,118,108,128,51,-0.36871528863422315,-1.5510051116725894
174,1576569600,548,157,0,705,51,-0.860335673479854,-0.30520424738988317
174,1576584000,991,443,0,1434,51,-0.860335673479854,1.2687798601700697
174,1576598400,483,574,91,1057,51,-0.4460999788414058,0.4547990528311092
174,1576612800,449,1151,702,1600,51,2.3351968280167466,1.6271905074333786
174,1576627200,103,642,539,745,51,1.5932142101478777,-0.21884023600113403
174,1576641600,12,144,132,156,51,-0.25946631422408295,-1.490550303700465
174,1576656000,531,173,0,704,51,-0.860335673479854,-0.3073633476746019
174,1576670400,1046,484,0,1530,51,-0.860335673479854,1.4760534875030678
174,1576684800,529,609,80,1138,51,-0.49617242544605333,0.6296861758933262
174,1576699200,509,1039,530,1548,51,1.5522458447440752,1.5149172926280048
174,1576713600,96,691,595,787,51,1.8481284837715382,-0.12815802404294743
174,1576728000,12,136,124,148,51,-0.29588263902746303,-1.5078231059782148
174,1576742400,552,187,0,739,51,-0.860335673479854,-0.2317948377094464
174,1576756800,969,445,0,1414,51,-0.860335673479854,1.2255978544756951
174,1576771200,567,541,0,1108,51,-0.860335673479854,0.5649131673517643
174,1576785600,444,1059,615,1503,51,1.9391692957799884,1.417757779815662
174,1576800000,114,701,587,815,51,1.8117121589681582,-0.06770321607082305
174,1576814400,15,182,167,197,51,-0.10014489320929518,-1.402027192026997
174,1576828800,494,175,0,669,51,-0.860335673479854,-0.3829318576397574
174,1576843200,950,518,0,1468,51,-0.860335673479854,1.3421892698505065
174,1576857600,561,688,127,1249,51,-0.28222651722619546,0.8693463074971051
174,1576872000,520,945,425,1465,51,1.0742815816997118,1.3357119689963504
174,1576886400,126,486,360,612,51,0.7783989426722489,-0.5060005738687249
174,1576900800,20,237,217,257,51,0.1274571368118302,-1.2724811749438734
174,1576915200,101,114,13,215,51,-0.8011591456743614,-1.36316338690206
174,1576929600,523,295,0,818,51,-0.860335673479854,-0.061225915216666864
174,1576944000,558,510,0,1068,51,-0.860335673479854,0.4785491559630152
174,1576958400,459,660,201,1119,51,0.05462448720507009,0.5886632704836704
174,1576972800,128,468,340,596,51,0.6873581306637987,-0.5405461784242246
174,1576987200,26,217,191,243,51,0.009104081200845016,-1.3027085789299355
174,1577001600,81,78,0,159,51,-0.860335673479854,-1.4840730028463087
174,1577016000,403,238,0,641,51,-0.860335673479854,-0.4433866656118818
174,1577030400,555,440,0,995,51,-0.860335673479854,0.32093483517854804
174,1577044800,309,656,347,965,51,0.7192224148667562,0.25616182663698617
174,1577059200,113,442,329,555,51,0.6372856840591511,-0.6290692900976924
174,1577073600,17,107,90,124,51,-0.45065201944182826,-1.5596415128114642
174,1577088000,266,142,0,408,51,-0.860335673479854,-0.9464570319513455
174,1577102400,777,444,0,1221,51,-0.860335673479854,0.8088914995249806
174,1577116800,580,613,33,1193,51,-0.7101183336659113,0.7484366915528562
174,1577131200,428,935,507,1363,51,1.4475489109343576,1.1154837399550401
174,1577145600,115,461,346,576,52,1.5909881000665727,0.02455122943783052
174,1577160000,11,143,132,154,52,0.1309904439162873,-1.1215349235228464
174,1577174400,201,112,0,313,52,-0.7695688580081879,-0.6897157331893213
174,1577188800,549,308,0,857,52,-0.7695688580081879,0.7877033834234947
174,1577203200,451,546,95,997,52,-0.12143905738072466,1.1679215384341457
174,1577217600,311,633,322,944,52,1.4272500451712136,1.0239818083229708
174,1577232000,114,262,148,376,52,0.24014914717986005,-0.5186175634345283
174,1577246400,27,114,87,141,52,-0.17601840901251103,-1.15684089505955
174,1577260800,58,45,0,103,52,-0.7695688580081879,-1.260042965705298
174,1577275200,176,163,0,339,52,-0.7695688580081879,-0.6191037901159147
174,1577289600,291,315,24,606,52,-0.6058308031128288,0.10602654836868435
174,1577304000,210,306,96,516,52,-0.11461663842675136,-0.13839940842387713
174,1577318400,84,302,218,386,52,0.7177184739579908,-0.49145912379091033
174,1577332800,15,88,73,103,52,-0.2715322743681372,-1.260042965705298
174,1577347200,195,105,0,300,52,-0.7695688580081879,-0.7250217047260247
174,1577361600,501,334,0,835,52,-0.7695688580081879,0.7279548162075352
174,1577376000,451,382,0,833,52,-0.7695688580081879,0.7225231282788116
174,1577390400,358,928,570,1286,52,3.119209945756591,1.9528004441347042
174,1577404800,115,418,303,533,52,1.297624085045721,-0.09223006102972663
174,1577419200,12,131,119,143,52,0.04229899751463446,-1.1514092071308262
174,1577433600,194,129,0,323,52,-0.7695688580081879,-0.6625572935457034
174,1577437094,153,42,0,195,52,-0.7695688580081879,-1.010185320984013
174,1577448000,631,361,0,992,52,-0.7695688580081879,1.1543423186123367
174,1577462400,553,543,0,1096,52,-0.7695688580081879,1.4367900909059634
174,1577476800,470,757,287,1227,52,1.1884653817821482,1.7925656502373584
