remote_unit_id,time_stamp,entries,exits,num_people_exited,sum_exit_entry,week_num,z_score_num_people_exited,z_score_sum_exit_entry
186,1546311600,75,127,52,202,1,-0.5242603545091016,-0.7374829856627024
186,1546326000,12,25,13,37,1,-0.9308600044550809,-1.0962836800352471
186,1546340400,48,105,57,153,1,-0.47213219425961706,-0.8440359191430339
186,1546354800,188,424,236,612,1,1.394055942671929,0.15408237611149983
186,1546369200,291,343,52,634,1,-0.5242603545091016,0.2019224686945058
186,1546383600,84,153,69,237,1,-0.3470246096608542,-0.6613737474624656
186,1546398000,20,21,1,41,1,-1.0559675890538436,-1.0875854813837915
186,1546412400,47,68,21,115,1,-0.8474549480559056,-0.9266688063318624
186,1546426800,423,679,256,1102,1,1.602568583669867,1.2196117109148148
186,1546441200,369,660,291,1029,1,1.9674657054162588,1.0608695855257495
186,1546455600,652,637,0,1289,1,-1.0663932211037406,1.6262524978703654
186,1546470000,192,278,86,470,1,-0.1697888648126068,-0.1547036760151751
186,1546484400,29,43,14,72,1,-0.9204343724051839,-1.0201744418350105
186,1546498800,32,48,16,80,1,-0.8995831083053901,-1.002778044532099
186,1546513200,597,793,196,1390,1,0.9770306606760527,1.8458820138196201
186,1546527600,425,631,206,1056,1,1.0812869811750219,1.119582426423075
186,1546542000,608,692,84,1300,1,-0.1906401289124006,1.6501725441618684
186,1546556400,204,308,104,512,1,0.017872512085537487,-0.06337259017489096
186,1546570800,16,31,15,47,1,-0.910008740355287,-1.0745381834066081
186,1546585200,36,62,26,98,1,-0.7953267878064211,-0.9636361506005489
186,1546599600,417,699,282,1116,1,1.8736350169671867,1.2500554061949094
186,1546614000,353,671,318,1024,1,2.248957770763475,1.04999683721143
186,1546628400,588,698,110,1286,1,0.08042630438491892,1.6197288488817738
186,1546642800,218,302,84,520,1,-0.1906401289124006,-0.045976192871979696
186,1546657200,42,54,12,96,1,-0.9412856365049778,-0.9679852499262767
186,1546671600,6,18,12,24,1,-0.9412856365049778,-1.124552825652478
186,1546686000,103,281,178,384,1,0.7893692837779084,-0.34171494702147115
186,1546700400,260,495,235,755,1,1.3836303106220322,0.46504297790103866
186,1546714800,381,405,24,786,1,-0.8161780519062148,0.5324540174498198
186,1546729200,162,207,45,369,1,-0.5972397788583799,-0.37433319196442977
186,1546743600,36,44,8,80,1,-0.9829881647045654,-1.002778044532099
186,1546758000,8,22,14,30,1,-0.9204343724051839,-1.1115055276752945
186,1546772400,75,223,148,298,1,0.4766003222810013,-0.5287262180277672
186,1546786800,142,264,122,406,1,0.20553388898368177,-0.29387485443846517
186,1546801200,290,352,62,642,1,-0.42000403401013253,0.21931886599741707
186,1546815600,98,123,25,221,1,-0.805752419856318,-0.6961665420682882
186,1546830000,26,21,0,47,1,-1.0663932211037406,-1.0745381834066081
186,1546844400,41,77,36,118,1,-0.691070467307452,-0.9201451573432706
186,1546858800,523,806,283,1329,1,1.8840606490170835,1.7132344843849219
186,1546873200,334,503,169,837,1,0.6955385953288363,0.643356050255879
186,1546887600,600,795,195,1395,1,0.9666050286261558,1.8567547621339398
186,1546902000,175,314,139,489,1,0.38276963383192913,-0.11338723242076085
186,1546916400,27,31,4,58,2,-0.9709220571683906,-1.1418565312915292
186,1546930800,42,67,25,109,2,-0.7118136594611226,-1.0412412575235233
186,1546945200,555,772,217,1327,2,1.657177405291041,1.3616882218770883
186,1546959600,337,611,274,948,2,2.3604716276393396,0.6139786383854364
186,1546974000,578,684,106,1262,2,0.2876044459811965,1.233453069035512
186,1546988400,238,344,106,582,2,0.2876044459811965,-0.10808391453789999
186,1547002800,24,33,9,57,2,-0.909229581523803,-1.1438293797967842
186,1547017200,49,64,15,113,2,-0.8351986107502979,-1.0333498635025034
186,1547031600,627,801,174,1428,2,1.1266221147475879,1.560945920907845
186,1547046000,383,536,153,919,2,0.86751371704032,0.556766031733041
186,1547060400,683,664,0,1347,2,-1.0202760376840607,1.4011451919821885
186,1547074800,204,360,156,564,2,0.9045292024270726,-0.14359518763249032
186,1547089200,34,33,0,67,2,-1.0202760376840607,-1.1241008947442341
186,1547103600,58,59,1,117,2,-1.0079375425551431,-1.0254584694814832
186,1547118000,842,730,0,1572,2,-1.0202760376840607,1.8450361056645674
186,1547132400,455,571,116,1026,2,0.4109893972703717,0.7678608217953279
186,1547146800,931,668,0,1599,2,-1.0202760376840607,1.898303015306453
186,1547161200,221,371,150,592,2,0.8304982316535674,-0.08835542948534982
186,1547175600,31,44,13,75,2,-0.8598756010081329,-1.1083181067021939
186,1547190000,40,67,27,107,2,-0.6871366692032876,-1.0451869545340333
186,1547204400,666,774,108,1440,2,0.31228143623903154,1.584620102970905
186,1547218800,328,538,210,866,2,1.5708079393886187,0.452205060954525
186,1547233200,589,673,84,1262,2,0.016157553145011046,1.233453069035512
186,1547247600,218,317,99,535,2,0.20123498007877386,-0.20080779428488582
186,1547262000,69,55,0,124,2,-1.0202760376840607,-1.011648529944698
186,1547276400,13,16,3,29,2,-0.9832605522973081,-1.1990691379439247
186,1547290800,91,256,165,347,2,1.0155756585873301,-0.5717033132728292
186,1547305200,301,457,156,758,2,0.9045292024270726,0.23913742238698313
186,1547319600,369,543,174,912,2,1.1266221147475879,0.5429560921962558
186,1547334000,231,218,0,449,2,-1.0202760376840607,-0.37047276573681737
186,1547348400,62,72,10,134,2,-0.8968910863948855,-0.9919200448921479
186,1547362800,14,20,6,34,2,-0.9462450669105555,-1.1892048954176497
186,1547377200,143,213,70,356,2,-0.15658137865983424,-0.553947676725534
186,1547391600,309,410,101,719,2,0.2259119703366089,0.16219633068203743
186,1547406000,369,348,0,717,2,-1.0202760376840607,0.1582506336715274
186,1547420400,103,121,18,224,2,-0.7981831253635453,-0.8143636794191963
186,1547434800,30,21,0,51,2,-1.0202760376840607,-1.1556664708283144
186,1547449200,40,69,29,109,2,-0.6624596789454525,-1.0412412575235233
186,1547463600,499,745,246,1244,2,2.0149937640296494,1.1979417959409218
186,1547478000,270,473,203,743,2,1.484438473486196,0.20954469480815785
186,1547492400,577,700,123,1277,2,0.4973588631727944,1.2630457966143374
186,1547506800,212,334,122,546,2,0.4850203680438768,-0.17910646072708064
186,1547521200,28,23,0,51,3,-1.005996032613332,-1.0726641308662188
186,1547535600,52,69,17,121,3,-0.8224801493006291,-0.9218808392216249
186,1547550000,711,901,190,1612,3,1.0450638397051117,2.2898032728082276
186,1547564400,293,491,198,784,3,1.1314242553816778,0.5062523373550297
186,1547578800,720,699,0,1419,3,-1.005996032613332,1.8740721972738466
186,1547593200,198,363,165,561,3,0.7751875407158428,0.025899851115823106
186,1547607600,24,31,7,55,3,-0.9304306688963366,-1.064047942772242
186,1547622000,44,66,22,110,3,-0.7685048895027753,-0.9455753564800611
186,1547636400,507,784,277,1291,3,1.9842333601877675,1.598354178266589
186,1547650800,320,545,225,865,3,1.4228906582900882,0.6807301462580598
186,1547665200,580,653,73,1233,3,-0.2179572395646667,1.4734194509039253
186,1547679600,210,312,102,522,3,0.09509926726288524,-0.05810798280045069
186,1547694000,22,35,13,57,3,-0.8656603571389121,-1.0597398487252536
186,1547708400,39,65,26,104,3,-0.7253246816644923,-0.9584996386210263
186,1547722800,542,801,259,1343,3,1.789922424915494,1.7103646234882874
186,1547737200,445,516,71,961,3,-0.2395473434838082,0.887518660513503
186,1547751600,641,621,0,1262,3,-1.005996032613332,1.5358868145852573
186,1547766000,212,321,109,533,3,0.17066463097988052,-0.03441346554201449
186,1547780400,17,37,20,54,3,-0.7900949934219168,-1.0662019897957362
186,1547794800,40,63,23,103,3,-0.7577098375432045,-0.9606536856445205
186,1547809200,464,721,257,1185,3,1.7683323209963524,1.3700251937762038
186,1547823600,402,526,124,928,3,0.3325904103734419,0.8164351087381945
186,1547838000,562,635,73,1197,3,-0.2179572395646667,1.3958737580581342
186,1547852400,205,325,120,530,3,0.28941020253515887,-0.04087560661249709
186,1547866800,47,46,0,93,3,-1.005996032613332,-0.9821941558794625
186,1547881200,10,24,14,34,3,-0.8548653051793413,-1.1092829302656202
186,1547895600,105,261,156,366,3,0.678032073079706,-0.3941393184655459
186,1547910000,249,495,246,744,3,1.649586749441074,0.4200904564152617
186,1547924400,307,402,95,709,3,0.019533903545889946,0.3446988105929647
186,1547938800,140,170,30,310,3,-0.6821444738262092,-0.5147659517812211
186,1547953200,33,35,2,68,3,-0.9844059286941904,-1.0360453314668174
186,1547967600,10,18,8,28,3,-0.9196356169367659,-1.1222072124065854
186,1547982000,58,197,139,255,3,0.49451618976700323,-0.633238538073402
186,1547996400,194,415,221,609,3,1.3797104504518052,0.1292941082435447
186,1548010800,243,209,0,452,3,-1.005996032613332,-0.20889127444504468
186,1548025200,99,146,47,245,3,-0.49862859051350633,-0.654779008308344
186,1548039600,23,23,0,46,3,-1.005996032613332,-1.0834343659836898
186,1548054000,20,38,18,58,3,-0.8116850973410583,-1.0575858017017594
186,1548068400,156,395,239,551,3,1.5740213857240788,0.004359380880881107
186,1548082800,208,465,257,673,3,1.7683323209963524,0.2671531177471735
186,1548097200,330,379,49,709,3,-0.4770384865943648,0.3446988105929647
186,1548111600,102,124,22,226,3,-0.7685048895027753,-0.6957059017547339
186,1548126000,18,11,0,29,4,-1.1391756078197086,-1.1756914616034957
186,1548140400,41,63,22,104,4,-0.8740033329679753,-1.008040021752449
186,1548154800,492,620,128,1112,4,0.4036449004085582,1.2451953298456195
186,1548169200,312,501,189,813,4,1.1388952988610916,0.5768249229727799
186,1548183600,585,622,37,1207,4,-0.6932040546599753,1.4575538203236122
186,1548198000,199,305,106,504,4,0.13847262555682485,-0.11389900921353288
186,1548212400,13,9,0,22,4,-1.1391756078197086,-1.1913389293229268
186,1548226800,37,60,23,97,4,-0.8619500477474419,-1.02368748947188
186,1548241200,532,701,169,1233,4,0.897829594450425,1.5156729861386418
186,1548255600,303,579,276,882,4,2.1875311130474917,0.7310642476357428
186,1548270000,551,747,196,1298,4,1.223268295404825,1.6609709006762157
186,1548284400,215,313,98,528,4,0.04204634379255818,-0.06025054846119792
186,1548298800,15,16,1,31,4,-1.1271223225991753,-1.1712207565408013
186,1548313200,37,74,37,111,4,-0.6932040546599753,-0.992392554033018
186,1548327600,546,788,242,1334,4,1.7777194155493583,1.741443591804718
186,1548342000,261,513,252,774,4,1.8982522677546918,0.4896461742502355
186,1548356400,590,692,102,1282,4,0.09025948467469151,1.625205260174659
186,1548370800,194,301,107,495,4,0.1505259107773582,-0.13401718199565849
186,1548385200,23,15,0,38,4,-1.1391756078197086,-1.1555732888213701
186,1548399600,42,71,29,113,4,-0.789630336424242,-0.9879218489703234
186,1548414000,494,731,237,1225,4,1.7174529894466917,1.4977901658878634
186,1548428400,324,552,228,876,4,1.6089734224618917,0.7176521324476591
186,1548442800,572,602,30,1174,4,-0.7775770512037086,1.3837871867891516
186,1548457200,220,306,86,526,4,-0.10259307885384183,-0.0647212535238925
186,1548471600,36,40,4,76,4,-1.0909624669375753,-1.0706298926301732
186,1548486000,10,15,5,25,4,-1.078909181717042,-1.184632871728885
186,1548500400,94,282,188,376,4,1.1268420136405584,-0.40002413322598607
186,1548514800,250,451,201,701,4,1.2835347215074917,0.3264654394618833
186,1548529200,325,376,51,701,4,-0.5244580615725085,0.3264654394618833
186,1548543600,170,226,56,396,4,-0.4641916354698419,-0.3553170825990402
186,1548558000,37,45,8,82,4,-1.042749326055442,-1.0572177774420894
186,1548572400,8,17,9,25,4,-1.0306960408349086,-1.184632871728885
186,1548586800,65,211,146,276,4,0.6206040343781583,-0.6235593863607151
186,1548601200,244,394,150,638,4,0.6688171752602916,0.18563822998700402
186,1548615600,282,311,29,593,4,-0.789630336424242,0.08504736607637595
186,1548630000,114,139,25,253,4,-0.8378434773063753,-0.6749724945817027
186,1548644400,33,21,0,54,4,-1.1391756078197086,-1.1198076483198136
186,1548658800,41,73,32,114,4,-0.7534704807626419,-0.9856864964389761
186,1548661331,57,114,57,171,4,-0.45213835024930854,-0.8582714021521806
186,1548673200,449,612,163,1061,4,0.825509883127225,1.1311923507469077
186,1548687600,304,451,147,755,4,0.6326573195986915,0.44717447615463696
186,1548702000,571,668,97,1239,4,0.02999305857202484,1.5290851013267255
186,1548716400,209,310,101,519,4,0.07820619945415819,-0.08036872124332353
186,1548730800,22,14,0,36,5,-1.0306817327626066,-1.057208361399664
186,1548745200,40,74,34,114,5,-0.6256646925175686,-0.8828360480430872
186,1548759600,543,681,138,1224,5,0.6132109599966652,1.5986161035697335
186,1548774000,287,504,217,791,5,1.5542799652719006,0.6306262101928405
186,1548788400,577,715,138,1292,5,0.6132109599966652,1.7506329921370054
186,1548802800,219,332,113,551,5,0.31540431275766667,0.09409601524952788
186,1548817200,23,17,0,40,5,-1.0306817327626066,-1.048266191483942
186,1548831600,46,75,29,121,5,-0.6852260219653683,-0.8671872506905739
186,1548842624,453,601,148,1054,5,0.7323336188922646,1.2185738821515537
186,1548846000,79,132,53,211,5,-0.39933164061592974,-0.6659884275868316
186,1548860400,359,550,191,909,5,1.2445610521433421,0.8944202227066359
186,1548874800,586,626,40,1212,5,-0.554191097180209,1.5717895938225679
186,1548889200,154,364,210,518,5,1.470894104044981,0.02032311344482239
186,1548903600,15,23,8,38,5,-0.9353836056461271,-1.0527372764418028
186,1548918000,40,51,11,91,5,-0.8996468079774472,-0.934253525058488
186,1548932400,487,767,280,1254,5,2.304752716314177,1.6656823779376477
186,1548946800,257,479,222,736,5,1.6138412947197005,0.5076713738516647
186,1548961200,497,664,167,1161,5,0.9586666707939034,1.457776927397114
186,1548975600,188,295,107,483,5,0.24393071742030706,-0.05792087331774404
186,1548990000,25,28,3,53,5,-0.9949449350939268,-1.019204139257846
186,1549004400,31,69,38,100,5,-0.5780156289593289,-0.9141336427481138
186,1549017899,470,636,166,1106,5,0.9467544049043436,1.3348220910559383
186,1549018800,13,40,27,53,5,-0.7090505537444882,-1.019204139257846
186,1549033200,308,487,179,795,5,1.1016138614686228,0.6395683801085624
186,1549047600,577,679,102,1256,5,0.18436938797250735,1.6701534628955086
186,1549062000,229,301,72,530,5,-0.17299858871429089,0.047149623191988024
186,1549076400,31,45,14,76,5,-0.8639100103087675,-0.967786662242445
186,1549090800,7,20,13,27,5,-0.8758222761983274,-1.077328243710038
186,1549105200,62,208,146,270,5,0.7085090871131448,-0.534091421329934
186,1549119600,183,285,102,468,5,0.18436938797250735,-0.09145401050170107
186,1549134000,242,224,0,466,5,-1.0306817327626066,-0.09592509545956202
186,1549148400,119,124,5,243,5,-0.9711204033148069,-0.5944510682610566
186,1549162800,35,31,0,66,5,-1.0306817327626066,-0.9901420870317498
186,1549177200,9,15,6,24,5,-0.959208137425247,-1.0840348711468295
186,1549191600,58,152,94,210,5,0.08907126085602782,-0.6682239700657622
186,1549206000,150,221,71,371,5,-0.18491085460385082,-0.3083016309579566
186,1549220400,164,206,42,370,5,-0.5303665654010891,-0.3105371734368871
186,1549234800,79,60,0,139,5,-1.0306817327626066,-0.8269474860698255
186,1549249200,28,29,1,57,5,-1.0187694668730467,-1.010261969342124
186,1549263600,37,61,24,98,5,-0.744787351413168,-0.9186047277059747
186,1549278000,498,803,305,1301,5,2.6025593635531754,1.7707528744473797
186,1549292400,284,476,192,760,5,1.256473318032902,0.5613243933459959
186,1549306800,628,580,0,1208,5,-1.0306817327626066,1.5628474239068462
186,1549321200,205,304,99,509,5,0.14863259030382753,0.00020323113444816672
186,1549335600,13,15,2,28,6,-1.0456405309930643,-1.0990243115873768
186,1549350000,41,66,25,107,6,-0.7958486263669434,-0.9365831339142132
186,1549364400,523,743,220,1266,6,1.3219523041588646,1.4465728777718199
186,1549378800,301,518,217,819,6,1.2893707513815444,0.52744368258316
186,1549393200,650,713,63,1363,6,-0.38314895785422187,1.646025969345198
186,1549407600,229,296,67,525,6,-0.3397068874844617,-0.0770842444536767
186,1549422000,17,11,0,28,6,-1.0673615661779445,-1.0990243115873768
186,1549436400,41,68,27,109,6,-0.7741275911820633,-0.9324706990364116
186,1549450800,578,838,260,1416,6,1.7563730078564663,1.7550054936069406
186,1549465200,307,567,260,874,6,1.7563730078564663,0.6405356417227043
186,1549479600,601,693,92,1294,6,-0.06819394767346065,1.5041469660610425
186,1549494000,197,341,144,538,6,0.4965529671334215,-0.050353417747966235
186,1549508400,23,11,0,34,6,-1.0673615661779445,-1.086687006953972
186,1549522800,43,71,28,114,6,-0.7632670735896233,-0.9221896118419076
186,1549537200,642,895,253,1537,6,1.680349384709386,2.003807803713938
186,1549551600,295,576,281,871,6,1.984443877297707,0.6343669894060019
186,1549566000,622,723,101,1345,6,0.029550710658499717,1.6090140554449834
186,1549580400,191,344,153,535,6,0.5942976254653819,-0.056522070064668646
186,1549594800,12,10,0,22,6,-1.0673615661779445,-1.1113616162207816
186,1549609200,41,61,20,102,6,-0.8501512143291436,-0.9468642211087173
186,1549623600,527,824,297,1351,6,2.158212158776748,1.6213513600783882
186,1549638000,325,575,250,900,6,1.6477678319320659,0.6939972951341252
186,1549652400,555,671,116,1226,6,0.19245847454510034,1.3643241802157877
186,1549666800,195,331,136,526,6,0.4096688263939012,-0.07502802701477589
186,1549681200,29,44,15,73,6,-0.9044538022913439,-1.0064945268368406
186,1549695600,7,12,5,19,6,-1.0130589782157442,-1.1175302685374842
186,1549710000,85,215,130,300,6,0.3445057208392609,-0.5397331682063579
186,1549724400,196,270,74,466,6,-0.2636832643373814,-0.1984010733488242
186,1549738800,270,314,44,584,6,-0.5894987921105826,0.0442325844414708
186,1549753200,146,160,14,306,6,-0.9153143198837839,-0.527395863572953
186,1549767600,31,33,2,64,6,-1.0456405309930643,-1.0250004837869477
186,1549782000,10,15,5,25,6,-1.0130589782157442,-1.1051929639040792
186,1549796400,72,186,114,258,6,0.17073743936022026,-0.6260943006401917
186,1549810800,186,293,107,479,6,0.09471381621313997,-0.17167024664311373
186,1549825200,216,235,19,451,6,-0.8610117319215836,-0.22924433493233629
186,1549839600,80,116,36,196,6,-0.676382932850103,-0.7535797818520416
186,1549854000,21,16,0,37,6,-1.0673615661779445,-1.0805183546372696
186,1549868400,51,59,8,110,6,-0.9804774254384241,-0.9304144815975108
186,1549871628,92,161,69,253,6,-0.3179858522995816,-0.6363753878346957
186,1549882800,421,629,208,1050,6,1.1916260930495841,1.002429910969246
186,1549897200,302,481,179,783,6,0.8766710828688229,0.453419854782731
186,1549911600,594,658,64,1252,6,-0.3722884402617818,1.4177858336272087
186,1549926000,215,336,121,551,6,0.24676106250730054,-0.023622591042255767
186,1549940400,25,26,1,51,7,-0.9392416289248128,-0.9902733174189408
186,1549954800,52,75,23,127,7,-0.7173394900532896,-0.8257860181942304
186,1549969200,545,798,253,1343,7,1.6025465072399068,1.8060107694011354
186,1549983600,271,559,288,830,7,1.9555726372627844,0.6957214996343404
186,1549998000,551,736,185,1287,7,0.9166671689097443,1.6848096015513487
186,1550012400,191,290,99,481,7,0.04923153513924484,-0.059621492858079515
186,1550026800,22,20,0,42,7,-0.9493280897826092,-1.0097520765376564
186,1550041200,51,75,24,126,7,-0.707253029195493,-0.8279503247629766
186,1550055600,560,848,288,1408,7,1.9555726372627844,1.9466906963696375
186,1550070000,299,532,233,831,7,1.4008172900839766,0.6978858062030866
186,1550084400,590,661,71,1251,7,-0.23318936887905733,1.6068945650764859
186,1550098800,239,415,176,654,7,0.8258890211895757,0.31480354353501117
186,1550113200,25,23,0,48,7,-0.9493280897826092,-0.9967662371251793
186,1550127600,42,76,34,118,7,-0.6063884206175281,-0.8452647773129461
186,1550142000,558,854,296,1412,7,2.0362643241251566,1.9553479226446224
186,1550156400,282,572,290,854,7,1.9757455589783774,0.7476648572842489
186,1550170800,612,714,102,1326,7,0.07949091771263435,1.76921755773245
186,1550185200,194,319,125,513,7,0.311479517441954,0.00963631734179853
186,1550199600,30,40,10,70,7,-0.8484634812046442,-0.9491514926127632
186,1550214000,45,79,34,124,7,-0.6063884206175281,-0.8322789379004689
186,1550228400,496,710,214,1206,7,1.209174533785843,1.5095007694829075
186,1550242800,345,543,198,888,7,1.047791160061099,0.8212512806216193
186,1550257200,623,637,14,1260,7,-0.8081176377734581,1.6263733241952016
186,1550271600,208,220,12,428,7,-0.8282905594890512,-0.17432974100162751
186,1550286000,25,16,0,41,7,-0.9493280897826092,-1.0119163831064026
186,1550300400,4,10,6,14,7,-0.8888093246358302,-1.0703526604625497
186,1550314800,66,177,111,243,7,0.1702690654328029,-0.5747264562196724
186,1550329200,208,313,105,521,7,0.10975030028602387,0.026950769891768044
186,1550343600,272,275,3,547,7,-0.9190687072092197,0.08322274067916896
186,1550358000,116,97,0,213,7,-0.9493280897826092,-0.6396556532820582
186,1550372400,19,27,8,46,7,-0.8686364029202371,-1.0010948502626718
186,1550386800,8,10,2,18,7,-0.9291551680670163,-1.061695434187565
186,1550401200,64,171,107,235,7,0.12992322200161688,-0.592040908769642
186,1550415600,161,312,151,473,7,0.5737274997446631,-0.07693594540804903
186,1550430000,197,214,17,411,7,-0.7778582552000687,-0.21112295267031275
186,1550444400,56,90,34,146,7,-0.6063884206175281,-0.7846641933880528
186,1550458800,16,18,2,34,7,-0.9291551680670163,-1.027066529087626
186,1550473200,11,33,22,44,7,-0.7274259509110861,-1.005423463400164
186,1550487600,145,341,196,486,7,1.027618238345506,-0.04879996001434857
186,1550502000,160,347,187,507,7,0.9368400906253374,-0.0033495220706786025
186,1550516400,300,224,0,524,7,-0.9493280897826092,0.03344368959800661
186,1550530800,73,105,32,178,7,-0.626561342333121,-0.7154063831881747
186,1550545200,12,12,0,24,8,-1.1770868226377456,-1.2292571935715009
186,1550559600,51,74,23,125,8,-0.9934932076306062,-1.0286463309576943
186,1550574000,481,786,305,1267,8,1.257524158978666,1.239646788893465
186,1550588400,287,629,342,916,8,1.5528704092075423,0.5424743851563749
186,1550602800,521,733,212,1254,8,0.5151673678628422,1.2138255887550544
186,1550617200,166,431,265,597,8,0.9382309154879892,-0.09113814131693491
186,1550631600,24,27,3,51,8,-1.1531398293759447,-1.1756285471301864
186,1550646000,48,84,36,132,8,-0.8897229034961363,-1.0147426078062425
186,1550660400,521,868,347,1389,8,1.5927820646438768,1.4819688209616275
186,1550669999,177,266,89,443,8,-0.4666593558709893,-0.39702005064887763
186,1550670098,3,6,3,9,8,-1.1531398293759447,-1.259050886038898
186,1550674800,106,213,107,319,8,-0.3229773963001847,-0.6433145750460263
186,1550689200,527,701,174,1228,8,0.2118387865466992,1.1621831884782328
186,1550703600,164,399,235,563,8,0.6987609828699815,-0.1586705109097015
186,1550718000,29,35,6,64,8,-1.129192836114144,-1.1498073469917756
186,1550732400,44,77,33,121,8,-0.913669896757937,-1.036591315615667
186,1550746800,516,785,269,1301,8,0.9701602398370569,1.3071791584862316
186,1550761200,290,688,398,978,8,1.99988095009449,0.6656216473549492
186,1550775600,585,746,161,1331,8,0.10806848241222919,1.3667665434210257
186,1550790000,203,415,212,618,8,0.5151673678628422,-0.0494269718625791
186,1550804400,35,32,0,67,8,-1.1770868226377456,-1.1438486084982962
186,1550818800,46,74,28,120,8,-0.9535815521942717,-1.03857756178016
186,1550833200,465,759,294,1224,8,1.16971851701873,1.1542382038202603
186,1550847600,367,502,135,869,8,-0.09947212585671082,0.4491208154251976
186,1550862000,598,659,61,1257,8,-0.6901646263144632,1.2197843272485338
186,1550876400,176,272,96,448,8,-0.4107830382601208,-0.38708881982641197
186,1551495600,8371,6384,0,14755,9,-1.031786850542937,4.10604612381018
186,1551510000,7,18,11,25,9,-0.8935637135960482,-0.3471490169919238
186,1551524400,42,215,173,257,9,1.1420861214399491,-0.2770104377206348
186,1551538800,158,330,172,488,9,1.1295203817175046,-0.20717417991172193
186,1551553200,233,307,74,540,9,-0.1019221110820493,-0.19145346386815712
186,1551567600,123,162,39,285,9,-0.5417230013676043,-0.26854543677409987
186,1551582000,45,56,11,101,9,-0.8935637135960482,-0.32417258585132913
186,1551596400,12,21,9,33,9,-0.9186951930409372,-0.34473044529291386
186,1551610800,82,142,60,224,9,-0.27784246719627126,-0.28698704597905084
186,1551625200,161,321,160,482,9,0.9787315050481715,-0.2089881086859794
186,1551639600,204,224,20,428,9,-0.7804720560940485,-0.2253134676542967
186,1551654000,90,82,0,172,9,-1.031786850542937,-0.3027077620226157
186,1551668400,24,18,0,42,9,-1.031786850542937,-0.3420095521315276
186,1551682800,36,58,22,94,9,-0.7553405766491595,-0.32628883608796283
186,1551697200,343,523,180,866,9,1.23004629949706,-0.09289666713350093
186,1551711600,236,462,226,698,9,1.8080703267295037,-0.14368667281271028
186,1551726000,483,685,202,1168,9,1.5064925733908374,-0.001595585495874647
186,1551740400,171,290,119,461,9,0.46353617642795,-0.21533685939588057
186,1551754800,25,20,0,45,10,-1.1921168136017055,-1.0899272036397187
186,1551769200,46,90,44,136,10,-0.7279297357390945,-0.908215849388868
186,1551783600,589,809,220,1398,10,1.1288185757113494,1.6117811732987555
186,1551798000,283,552,269,835,10,1.645754185149257,0.4875669706259092
186,1551812400,611,764,153,1375,10,0.4219882526023736,1.5658541277188702
186,1551826800,212,365,153,577,10,0.4219882526023736,-0.02761467109628323
186,1551841200,27,30,3,57,10,-1.1604676946565273,-1.065965266815431
186,1551855600,48,69,21,117,10,-0.9705729809854593,-0.9461555826939907
186,1551870000,585,785,200,1370,10,0.9178244494101626,1.555869987375417
186,1551884400,286,584,298,870,10,1.9516956682859778,0.5574559530300827
186,1551898800,563,692,129,1255,10,0.16879530104094945,1.32623475947599
186,1551913200,210,319,109,529,10,-0.04219882526023736,-0.12346241839343532
186,1551927600,27,31,4,58,10,-1.149917988341468,-1.06396843874674
186,1551942000,39,72,33,111,10,-0.8439765052047472,-0.9581365511061347
186,1551956400,580,770,190,1350,10,0.8123273862595692,1.5159334260016035
186,1551970800,283,607,324,890,10,2.2259880324775208,0.597392514403896
186,1551985200,585,698,113,1283,10,0.0,1.3821459453993288
186,1551999600,217,360,143,577,10,0.31649118945178023,-0.02761467109628323
186,1552014000,33,33,0,66,10,-1.1921168136017055,-1.0479938141972147
186,1552028400,40,96,56,136,10,-0.6013332599583824,-0.908215849388868
186,1552042800,528,795,267,1323,10,1.6246547725191385,1.4620190681469554
186,1552057200,313,602,289,915,10,1.856748311450444,0.6473132161211627
186,1552071600,560,656,96,1216,10,-0.17934500735600878,1.2483584647970538
186,1552086000,200,268,68,468,10,-0.4747367841776703,-0.24526893058356608
186,1552100400,25,50,25,75,10,-0.928374155725222,-1.0300223615789987
186,1552114800,8,19,11,27,10,-1.0760700441360527,-1.125870108876151
186,1552129200,40,186,146,226,10,0.34814030839695825,-0.7285013232067079
186,1552143600,142,358,216,500,10,1.0866197504511121,-0.18137043238546469
186,1552158000,198,340,142,538,10,0.30594148313672087,-0.1054909657752193
186,1552172400,106,195,89,301,10,-0.2531929515614242,-0.5787392180549077
186,1552190400,32,45,13,77,10,-1.054970631505934,-1.0260287054416175
186,1552204800,8,20,12,28,10,-1.0655203378209934,-1.1238732808074603
186,1552219200,44,222,178,266,10,0.6857309104788571,-0.6486282004590811
186,1552233600,149,358,209,507,10,1.0127718062456967,-0.16739263590463002
186,1552248000,177,220,43,397,10,-0.7384794420541538,-0.38704372346060356
186,1552262400,60,81,21,141,10,-0.9705729809854593,-0.8982317090454147
186,1552276800,10,5,0,15,10,-1.1921168136017055,-1.149832045700439
186,1552291200,135,281,146,416,10,0.34814030839695825,-0.3491039901554808
186,1552305600,831,766,0,1597,10,-1.1921168136017055,2.0091499589681985
186,1552320000,416,542,126,958,10,0.13714618209577142,0.7331768230748614
186,1552334400,562,636,74,1198,10,-0.41143854628731424,1.2124155595606219
186,1552348800,151,203,52,354,11,-0.8268323540256638,-0.579982061891258
186,1552363200,14,11,0,25,11,-1.3051616652799543,-1.3347982380971244
186,1552377600,138,318,180,456,11,0.35059364290797435,-0.3459661045265213
186,1552392000,488,717,229,1205,11,0.8013270323591327,1.3724451902400256
186,1552406400,337,654,317,991,11,1.6108074052510089,0.8814705345924408
186,1552420800,551,682,131,1233,11,-0.10013974654318397,1.4366848648107378
186,1552435200,165,238,73,403,11,-0.6336609014037388,-0.467562631392512
186,1552449600,15,12,0,27,11,-1.3051616652799543,-1.3302096899135023
186,1552464000,171,240,69,411,11,-0.670455463807915,-0.4492084386580228
186,1552464278,13,20,7,33,11,-1.2407711810726458,-1.3164440453626354
186,1552478400,474,744,270,1218,11,1.1784712970019386,1.4022707534335705
186,1552492800,375,591,216,966,11,0.6817447045455601,0.8241136822971623
186,1552507200,507,758,251,1265,11,1.0036971255821017,1.5101016357486945
186,1552521600,141,169,28,310,11,-1.0475997284507208,-0.6809301219309484
186,1552536000,151,206,55,357,11,-0.7992364322225316,-0.5730992396158247
186,1552550400,144,316,172,460,11,0.277004518099622,-0.33678900815927676
186,1552551743,83,92,9,175,11,-1.2223738998705578,-0.9906571243254528
186,1552564800,438,719,281,1157,11,1.2796563436134232,1.2623200338330909
186,1552579200,377,570,193,947,11,0.470175970721547,0.7805224745527505
186,1552593600,538,747,209,1285,11,0.6173542203382517,1.5559871175849174
186,1552608000,150,242,92,392,11,-0.45888672998390184,-0.49279964640243457
186,1552622400,17,20,3,37,11,-1.2775657434768222,-1.3072669489953908
186,1552636800,152,297,145,449,11,0.028641221871432698,-0.36202602316919935
186,1552651200,496,811,315,1307,11,1.5924101240489208,1.6064611476047626
186,1552665600,394,695,301,1089,11,1.4636291556343042,1.106309395589933
186,1552680000,521,603,82,1124,11,-0.5508731359943423,1.186608988803323
186,1552694400,130,236,106,366,11,-0.33010576156928517,-0.5524507727895243
186,1552708800,23,40,17,63,11,-1.1487847750622053,-1.247615822608301
186,1552723200,15,47,32,62,11,-1.0108051660465447,-1.2499100967001122
186,1552737600,126,341,215,467,11,0.672546063944516,-0.32072908951659873
186,1552752000,247,566,319,813,11,1.6292046864530971,0.4730897462500572
186,1552766400,340,478,138,818,11,-0.03574926233587564,0.4845611167091129
186,1552780800,123,243,120,366,11,-0.2013247931546685,-0.5524507727895243
186,1552795200,16,36,20,52,11,-1.1211888532590732,-1.2728528376182235
186,1552809600,24,38,14,62,11,-1.1763806968653376,-1.2499100967001122
186,1552824000,113,412,299,525,11,1.4452318744322161,-0.18766119219155236
186,1552838400,266,545,279,811,11,1.2612590624113351,0.4685011980664349
186,1552852800,268,381,113,649,11,-0.2657152773619768,0.09682879519302952
186,1552867200,107,177,70,284,11,-0.6612568232068708,-0.7405812483180382
186,1552881600,14,16,2,30,11,-1.2867643840778662,-1.3233268676380687
186,1552896000,131,237,106,368,11,-0.33010576156928517,-0.5478622246059021
186,1552910400,448,780,332,1228,11,1.7487870142666697,1.425213494351682
186,1552924800,320,597,277,917,11,1.242861781209247,0.7116942517984162
186,1552939200,519,623,104,1142,11,-0.3485030427713733,1.2279059224559237
186,1552953600,119,171,52,290,12,-0.8909199219641963,-0.7202236096906123
186,1552968000,16,8,0,24,12,-1.371831713751098,-1.3532452576698053
186,1552982400,140,273,133,413,12,-0.14180732321921471,-0.4275105920160231
186,1552996800,452,761,309,1213,12,1.4858941259056837,1.4763139131845573
186,1553011200,329,544,215,873,12,0.6165535792139766,0.6671884984743106
186,1553025600,475,658,183,1133,12,0.3206078611912678,1.2859314626644993
186,1553040000,143,191,48,334,12,-0.9279131367170349,-0.6155132619045804
186,1553054400,13,13,0,26,12,-1.371831713751098,-1.348485696406804
186,1553068800,149,304,155,453,12,0.06165535792139758,-0.3323193667559941
186,1553083200,471,712,241,1183,12,0.8570094751074274,1.4049204942395355
186,1553097600,343,590,247,933,12,0.9124992972366853,0.8099753363643541
186,1553112000,512,669,157,1181,12,0.08015196529781687,1.400160932976534
186,1553126400,121,194,73,315,12,-0.6967055445117937,-0.6607290939030942
186,1553140800,11,31,20,42,12,-1.186865639986905,-1.3104092063027923
186,1553155200,143,274,131,417,12,-0.16030393059563403,-0.4179914694900202
186,1553169600,465,748,283,1213,12,1.2454382300122326,1.4763139131845573
186,1553184000,332,642,310,974,12,1.4951424295938933,0.9075463422558838
186,1553198400,460,748,288,1208,12,1.291679748453281,1.4644150100270537
186,1553212800,150,179,29,329,12,-1.1036309067930183,-0.6274121650620841
186,1553227200,14,12,0,26,12,-1.371831713751098,-1.348485696406804
186,1553241600,120,232,112,352,12,-0.33602170067161735,-0.5726772105375674
186,1553256000,404,730,326,1134,12,1.6431152886052476,1.288311243296
186,1553270400,329,677,348,1006,12,1.84657796974586,0.9836993224639071
186,1553284800,457,589,132,1046,12,-0.15105562690742436,1.078890547723936
186,1553299200,119,253,134,372,12,-0.13255901953100507,-0.5250815979075528
186,1553313600,18,35,17,53,12,-1.2146105510515341,-1.2842316193562842
186,1553328000,15,59,44,74,12,-0.9649063514698735,-1.234256226094769
186,1553342400,134,367,233,501,12,0.7830230456017503,-0.21808989644395926
186,1553356800,308,569,261,877,12,1.0419755488716205,0.6767076210003135
186,1553371200,294,481,187,775,12,0.35760107594410634,0.4339699965872395
186,1553385600,146,219,73,365,12,-0.6967055445117937,-0.5417400623280579
186,1553400000,18,40,22,58,12,-1.1683690326104859,-1.2723327161987805
186,1553414400,14,54,40,68,12,-1.0018995662227121,-1.2485349098837735
186,1553428800,98,389,291,487,12,1.31942465951791,-0.25140682528496944
186,1553443200,269,550,281,819,12,1.2269416226358134,0.5386803443732714
186,1553457600,282,333,51,615,12,-0.900168225652406,0.05320509554712344
186,1553472000,76,110,34,186,12,-1.05738938835197,-0.9677207953666878
186,1553486400,16,13,0,29,12,-1.371831713751098,-1.3413463545123017
186,1553500800,137,270,133,407,12,-0.14180732321921471,-0.44178927580502747
186,1553515200,427,682,255,1109,12,0.9864857267423626,1.2288167275084818
186,1553529600,331,497,166,828,12,0.16338669849170373,0.560098370056778
186,1553544000,467,683,216,1150,12,0.6258018829021862,1.3263877334000116
186,1553558400,110,176,66,286,13,-0.5957125124460715,-0.6960053582562891
186,1553572800,11,15,4,26,13,-1.2296460565447924,-1.2940365575763517
186,1553587200,132,254,122,386,13,-0.023127375840775122,-0.4659933585178034
186,1553601600,463,506,43,969,13,-0.8308814078375325,0.8749765999575679
186,1553616000,366,602,236,968,13,1.1424923665342925,0.8726764799601832
186,1553630400,524,636,112,1160,13,-0.12537472166314947,1.3142995194580755
186,1553644800,167,204,37,371,13,-0.892229815330957,-0.5004951584785763
186,1553659200,12,13,1,25,13,-1.2603202602915047,-1.2963366775737366
186,1553673600,147,245,98,392,13,-0.2685210058144736,-0.45219263853349423
186,1553688000,474,724,250,1198,13,1.2856386506856166,1.4017040793587001
186,1553702400,344,590,246,934,13,1.2447397123566668,0.794472400049098
186,1553716800,539,674,135,1213,13,0.10979417372831153,1.436205879319473
186,1553731200,126,188,62,314,13,-0.6366114507750212,-0.631601998329513
186,1553745600,10,19,9,29,13,-1.1785223836336052,-1.2871361975841973
186,1553760000,126,248,122,374,13,-0.023127375840775122,-0.4935947984864217
186,1553774400,471,822,351,1293,13,2.3183368434915974,1.6202154791102614
186,1553788800,378,634,256,1012,13,1.346987058179041,0.9738817598451168
186,1553803200,560,695,135,1255,13,0.10979417372831153,1.5328109192096369
186,1553817600,151,205,54,356,13,-0.7184093274329206,-0.5349969584393491
186,1553832000,12,14,2,26,13,-1.2500955257092672,-1.2940365575763517
186,1553846400,129,255,126,384,13,0.017771562488174616,-0.4705935985125731
186,1553860800,442,764,322,1206,13,2.0218195406067117,1.420105039337779
186,1553875200,376,650,274,1026,13,1.5310322806593148,1.0060834398085048
186,1553889600,504,657,153,1161,13,0.29383939620858535,1.3165996394554604
186,1553904000,141,221,80,362,13,-0.45256622829474735,-0.5211962384550399
186,1553918400,24,29,5,53,13,-1.219421321962555,-1.2319333176469607
186,1553932800,18,58,40,76,13,-0.8615556115842448,-1.179030557707109
186,1553947200,121,330,209,451,13,0.8664245328138817,-0.3164855586877877
186,1553961600,283,472,189,755,13,0.661929841169133,0.38275092051720866
186,1553976000,363,414,51,777,13,-0.749083531179633,0.43335356045967555
186,1553990400,115,188,73,303,13,-0.5241393703704095,-0.6569033183007464
186,1554004800,20,32,12,52,13,-1.147848179886893,-1.2342334376443456
186,1554019200,10,36,26,46,13,-1.004701895735569,-1.2480341576286547
186,1554033600,106,366,260,472,13,1.3878859965079908,-0.2681830387427057
186,1554048000,185,430,245,615,13,1.2345149777744293,0.06073412088332876
186,1554062400,196,254,58,450,13,-0.677510389103971,-0.31878567868517255
186,1554076800,75,122,47,197,13,-0.7899824695085828,-0.9007160380235413
186,1554091200,7,9,2,16,13,-1.2500955257092672,-1.3170377575502004
186,1554105600,160,273,113,433,13,-0.11514998708091204,-0.3578877186407151
186,1554120000,476,671,195,1147,13,0.7232782486625576,1.2843979594920725
186,1554134400,341,576,235,917,13,1.132267631952055,0.7553703600935554
186,1554148800,536,699,163,1235,13,0.3960867420309597,1.4868085192619398
186,1554163200,127,198,71,325,14,-0.5154027053965193,-0.6536910174985123
186,1554177600,13,11,0,24,14,-1.2390048087357004,-1.2992626012197992
186,1554192000,148,271,123,419,14,0.014559398457528815,-0.4520839448413663
186,1554206400,480,795,315,1275,14,1.971342551149399,1.383827269993921
186,1554220800,376,563,187,939,14,0.6668204493548188,0.6631892230492288
186,1554235200,551,739,188,1290,14,0.6770120282750889,1.4159986113753804
186,1554249600,163,229,66,392,14,-0.56636059999787,-0.5099923593279934
186,1554264000,13,11,0,24,14,-1.2390048087357004,-1.2992626012197992
186,1554278400,149,271,122,420,14,0.004367819537258659,-0.449939188749269
186,1554292800,561,747,186,1308,14,0.6566288704345487,1.4546042210331318
186,1554307200,401,626,225,1027,14,1.0541004483250846,0.851927759153791
186,1554321600,553,682,129,1235,14,0.07570887197914974,1.2980370263100292
186,1554336000,149,230,81,379,14,-0.4134869161938177,-0.5378741885252583
186,1554350400,6,16,10,22,14,-1.1370890195329988,-1.3035521134039938
186,1554364800,158,284,126,442,14,0.04513413521833928,-0.4027545547231285
186,1554379200,525,758,233,1283,14,1.135633079687246,1.4009853187306993
186,1554393600,391,566,175,957,14,0.5445215023115769,0.7017948327069802
186,1554408000,577,655,78,1232,14,-0.4440616529546282,1.2916027580337373
186,1554422400,162,212,50,374,14,-0.7294258627221926,-0.5485979689857448
186,1554436800,13,19,6,32,14,-1.1778553352140795,-1.2821045524830208
186,1554451200,137,245,108,382,14,-0.1383142853465235,-0.5314399202489664
186,1554465600,526,793,267,1319,14,1.4821467629764313,1.478196538046202
186,1554480000,384,636,252,1020,14,1.329273079172379,0.8369144665091099
186,1554494400,269,365,96,634,14,-0.2606132323897654,0.009038614959552795
186,1554508800,605,901,296,1506,14,1.777702551664266,1.879265927268397
186,1554523200,17,25,8,42,14,-1.157472177373539,-1.2606569915620478
186,1554537600,21,48,27,69,14,-0.9638321778884061,-1.2027485770754207
186,1554552000,145,409,264,554,14,1.4515720262156209,-0.16254187240823106
186,1554566400,282,414,132,696,14,0.10628360873996022,0.1420134926695853
186,1554580800,392,377,0,769,14,-1.2390048087357004,0.29858068739268806
186,1554595200,129,146,17,275,14,-1.0657479670911076,-0.7609288221033773
186,1554609600,23,34,11,57,14,-1.1268974406127286,-1.2284856501805883
186,1554624000,19,30,11,49,14,-1.1268974406127286,-1.2456436989173667
186,1554638400,120,313,193,433,14,0.7279699228764397,-0.42205735955200413
186,1554652800,275,423,148,698,14,0.2693488714642827,0.1463030048537799
186,1554667200,248,301,53,549,14,-0.6988511259613821,-0.17326565286871756
186,1554681600,83,87,4,170,14,-1.1982384930546197,-0.9861282117735936
186,1554696000,13,9,0,22,14,-1.2390048087357004,-1.3035521134039938
186,1554710400,130,260,130,390,14,0.0859004508994199,-0.514281871512188
186,1554724800,463,774,311,1237,14,1.9305762354683182,1.3023265384942238
186,1554739200,360,627,267,987,14,1.4821467629764313,0.766137515469899
186,1554753600,527,667,140,1194,14,0.18781624010212147,1.2101020265340399
186,1554768000,140,176,36,316,15,-0.8205285303443604,-0.5847510475644491
186,1554782400,12,13,1,25,15,-1.2034418445050619,-1.2339571123150268
186,1554796800,144,269,125,413,15,0.1531653256642806,-0.3683490259809232
186,1554811200,545,763,218,1308,15,1.1706207032912874,1.6283500391454244
186,1554825600,349,548,199,897,15,0.9627534756040494,0.7114301332605877
186,1554840000,559,721,162,1280,15,0.557959400634165,1.5658834762140972
186,1554854400,157,200,43,357,15,-0.74394586751222,-0.4932821518435773
186,1554868800,16,10,0,26,15,-1.2143822249096532,-1.231726163638908
186,1554883200,153,312,159,465,15,0.5251382594203906,-0.2523396948227443
186,1554883412,11,20,9,31,15,-1.11591880126833,-1.220571420258314
186,1554885668,176,210,34,386,15,-0.8424092911535432,-0.4285846402361314
186,1554887451,108,108,0,216,15,-1.2143822249096532,-0.8078459151763315
186,1554894690,202,304,102,506,15,-0.09846342364132324,-0.16087079910187252
186,1554897600,58,109,51,167,15,-0.6564228242754883,-0.9171624003061538
186,1554912000,423,600,177,1023,15,0.722065106703037,0.9925296664515595
186,1554926400,570,699,129,1269,15,0.19692684728264648,1.5413430407767903
186,1554940800,144,225,81,369,15,-0.32821141213774413,-0.46651076773015143
186,1554955200,11,11,0,22,15,-1.2143822249096532,-1.2406499583433834
186,1554969600,153,283,130,436,15,0.20786722768723795,-0.3170372064301902
186,1554984000,525,823,298,1348,15,2.045851135658605,1.7175879861901773
186,1554998400,388,591,203,979,15,1.0065149972224152,0.8943679247023313
186,1555012800,590,707,117,1297,15,0.06564228242754883,1.6038096037081173
186,1555027200,157,216,59,373,15,-0.5688997810387565,-0.45758697302567614
186,1555041600,16,13,0,29,15,-1.2143822249096532,-1.2250333176105517
186,1555056000,144,305,161,449,15,0.5470190202295735,-0.2880348736406455
186,1555070400,476,814,338,1290,15,2.4834663518422637,1.5881929629752856
186,1555084800,392,579,187,971,15,0.8314689107489518,0.8765203352933807
186,1555099200,634,657,23,1291,15,-0.9627534756040494,1.5904239116514043
186,1555113600,158,234,76,392,15,-0.38291331416070146,-0.41519894817941844
186,1555128000,16,30,14,46,15,-1.0612168992453728,-1.1871071901165315
186,1555142400,17,89,72,106,15,-0.42667483577906734,-1.0532502695494022
186,1555156800,120,332,212,452,15,1.1049784208637385,-0.281342027612289
186,1555171200,314,535,221,849,15,1.2034418445050619,0.6043445968068841
186,1555185600,368,436,68,804,15,-0.4704363573974332,0.5039519063815371
186,1555200000,135,216,81,351,15,-0.32821141213774413,-0.5066678439002903
186,1555214400,18,44,26,62,15,-0.929932334390275,-1.1514120112986304
186,1555228800,18,34,16,52,15,-1.0393361384361897,-1.1737214980598185
186,1555243200,117,332,215,449,15,1.137799562077513,-0.2880348736406455
186,1555257600,280,463,183,743,15,0.7877073891305859,0.3678640371382888
186,1555272000,294,318,24,612,15,-0.951813095199458,0.07560976056672283
186,1555286400,83,107,24,190,15,-0.951813095199458,-0.8658505807554209
186,1555300800,8,15,7,23,15,-1.137799562077513,-1.2384190096672645
186,1555315200,154,289,135,443,15,0.2625691297101953,-0.3014205656973584
186,1555329600,477,765,288,1242,15,1.9364473316126902,1.481107426521582
186,1555344000,369,621,252,990,15,1.5425936370473974,0.9189083601396383
186,1555358400,549,699,150,1248,15,0.42667483577906734,1.4944931185782948
186,1555372800,152,208,56,360,16,-0.7553758098429585,-0.6026071370469754
186,1555387200,12,11,0,23,16,-1.2605347250407515,-1.3375749455573493
186,1555401600,159,295,136,454,16,-0.03372021670325407,-0.39760127948028356
186,1555416000,507,777,270,1284,16,1.1750529018057507,1.4125568245660378
186,1555430400,389,656,267,1045,16,1.147990817063012,0.891318527135832
186,1555444800,614,786,172,1400,16,0.2910248002096129,1.665542776456849
186,1555459200,149,250,101,399,16,-0.34944453870187475,-0.517551515290582
186,1555473600,17,11,0,28,16,-1.2605347250407515,-1.3266703786655039
186,1555488000,148,296,148,444,16,0.0745281222677016,-0.4194104132639742
186,1555502400,533,789,256,1322,16,1.0487631730063025,1.4954315329440622
186,1555516800,384,706,322,1090,16,1.6441290373465587,0.9894596291624398
186,1555531200,619,755,136,1374,16,-0.03372021670325407,1.6088390286192533
186,1555545600,156,260,104,416,16,-0.32238245395913584,-0.4804759878583079
186,1555560000,16,10,0,26,16,-1.2605347250407515,-1.331032205422242
186,1555574400,154,264,110,418,16,-0.268258284473658,-0.47611416110156984
186,1555588800,521,797,276,1318,16,1.2291770712912287,1.486707879430586
186,1555603200,399,668,269,1067,16,1.1660322068915046,0.9392986214599514
186,1555617600,633,654,21,1287,16,-1.0711001318415792,1.419099564701145
186,1555632000,144,243,99,387,16,-0.3674859285303674,-0.5437224758310107
186,1555646400,14,17,3,31,16,-1.2334726402980127,-1.3201276385303968
186,1555660800,92,216,124,308,16,-0.14196855567420974,-0.7160146327221666
186,1555675200,382,659,277,1041,16,1.238197766205475,0.8825948736223558
186,1555689600,422,724,302,1146,16,1.4637151390616325,1.1115907783511072
186,1555704000,476,640,164,1116,16,0.2188592408956425,1.0461633770000354
186,1555718400,155,220,65,375,16,-0.6741895556147417,-0.5698934363714395
186,1555732800,27,23,0,50,16,-1.2605347250407515,-1.2786902843413845
186,1555747200,16,83,67,99,16,-0.6561481657862491,-1.1718255288013006
186,1555761600,131,447,316,578,16,1.590004867861081,-0.1271680205625199
186,1555776000,314,541,227,855,16,0.7871630204931597,0.4769449852457102
186,1555790400,354,430,76,784,16,-0.5749619115580323,0.32210013538150684
186,1555804800,166,157,0,323,16,-1.2605347250407515,-0.6833009320466307
186,1555819200,33,29,0,62,16,-1.2605347250407515,-1.2525193238009558
186,1555833600,17,66,49,83,16,-0.8185206742426826,-1.2067201428552055
186,1555848000,90,354,264,444,16,1.120928732320273,-0.4194104132639742
186,1555862400,283,475,192,758,16,0.471438698494539,0.2653963875439112
186,1555876800,358,328,0,686,16,-1.2605347250407515,0.10837062430133877
186,1555891200,94,129,35,223,16,-0.9448104030421309,-0.9013922698835369
186,1555905600,16,18,2,34,16,-1.242493335212259,-1.3135848983952896
186,1555920000,111,249,138,360,16,-0.01567882687476146,-0.6026071370469754
186,1555934400,393,737,344,1130,16,1.8425843254599774,1.0766961642972022
186,1555948800,383,625,242,1008,16,0.9224734442068543,0.8106247321361767
186,1555963200,425,664,239,1089,16,0.8954113594641153,0.9872787157840707
186,1555977600,131,173,42,304,17,-0.8604960275686773,-0.7290084933032853
186,1555992000,11,15,4,26,17,-1.209594060105436,-1.3680402626583275
186,1556006400,130,220,90,350,17,-0.41953009173277145,-0.6232694235538899
186,1556020800,435,725,290,1160,17,1.4178279742501696,1.238657674207204
186,1556035200,391,607,216,998,17,0.7380054898364814,0.8662722546549851
186,1556049600,606,668,62,1274,17,-0.6767602209703832,1.5007066731513579
186,1556064000,188,228,40,416,17,-0.8788696082285067,-0.4715568452178008
186,1556078400,9,17,8,26,17,-1.1728468987857772,-1.3680402626583275
186,1556092800,148,262,114,410,17,-0.19904712381481854,-0.48534889779380885
186,1556107200,427,666,239,1093,17,0.9493016674245196,1.08464642044178
186,1556121600,378,620,242,998,17,0.9768620384142638,0.8662722546549851
186,1556136000,596,671,75,1267,17,-0.557331946681492,1.484615945146015
186,1556150400,177,255,78,432,17,-0.5297715756917479,-0.4347780383484458
186,1556164800,14,16,2,30,17,-1.2279676407652655,-1.3588455609409886
186,1556179200,142,270,128,412,17,-0.07043205919601266,-0.4807515469351395
186,1556193600,465,746,281,1211,17,1.3351468612809372,1.3558901211032728
186,1556208000,392,612,220,1004,17,0.7747526511561402,0.8800643072309933
186,1556222400,576,695,119,1271,17,-0.153113172165245,1.4938106468633539
186,1556236800,138,251,113,389,17,-0.20823391414473325,-0.5336210818098372
186,1556251200,16,25,9,41,17,-1.1636601084558627,-1.3335601312183072
186,1556265600,138,242,104,380,17,-0.2909150271139656,-0.5543091606738494
186,1556280000,419,720,301,1139,17,1.5188826678792313,1.1903854901911757
186,1556294400,346,666,320,1012,17,1.6934316841476107,0.8984537106656707
186,1556308800,495,595,100,1090,17,-0.3276621884336244,1.077750394153776
186,1556323200,134,258,124,392,17,-0.10717922051567147,-0.5267250555218331
186,1556337600,22,47,25,69,17,-1.0166714631772273,-1.269197219196936
186,1556352000,22,87,65,109,17,-0.6491998499806391,-1.1772502020235487
186,1556366400,158,440,282,598,17,1.344333651610852,-0.05319791707888832
186,1556380800,309,585,276,894,17,1.2892129096313638,0.6272100100041781
186,1556395200,384,441,57,825,17,-0.7226941726199567,0.4686014053800849
186,1556409600,151,233,82,384,17,-0.4930244143720891,-0.5451144589565107
186,1556424000,21,41,20,62,17,-1.062605414826801,-1.2852879472022787
186,1556438400,18,51,33,69,17,-0.9431771405379097,-1.269197219196936
186,1556452800,91,396,305,487,17,1.5556298291988901,-0.3083508897350382
186,1556467200,232,558,326,790,17,1.748552426127099,0.388147765353371
186,1556481600,273,329,56,602,17,-0.7318809629498715,-0.04400321536154959
186,1556496000,103,117,14,220,17,-1.117726156806289,-0.9220972293673988
186,1556510400,11,12,1,23,17,-1.2371544310951803,-1.3749362889463315
186,1556524800,140,262,122,402,17,-0.12555280117550088,-0.5037383012284863
186,1556539200,451,816,365,1267,17,2.1068372489937723,1.484615945146015
186,1556553600,372,567,195,939,17,0.5450828929082726,0.7306504043242388
186,1556568000,535,688,153,1223,17,0.15923769905185498,1.383474226255289
186,1556582400,150,229,79,379,18,-0.670931094082571,-0.5952962419514197
186,1556596800,18,15,0,33,18,-1.357422939443563,-1.351190881172485
186,1556611200,184,316,132,500,18,-0.21037327377709536,-0.33095158488278126
186,1556625600,515,859,344,1374,18,1.6318580074448072,1.578447012455979
186,1556640000,365,638,273,1003,18,1.0148843236393588,0.7679357085513108
186,1556654400,578,731,153,1309,18,-0.027888099693793692,1.4364436842786112
186,1556668800,159,241,82,400,18,-0.6448617834992423,-0.5494182436171932
186,1556683200,16,15,0,31,18,-1.357422939443563,-1.3555602143471732
186,1556697600,159,324,165,483,18,0.07638914263952155,-0.3680909168676313
186,1556700306,196,222,26,418,18,-1.1314889143880467,-0.510094245044999
186,1556712000,338,589,251,927,18,0.8237093793616141,0.6019010479131577
186,1556726400,380,581,201,961,18,0.3892208696394673,0.6761797118828577
186,1556740800,553,744,191,1297,18,0.3023231676950379,1.4102276852304818
186,1556755200,144,253,109,397,18,-0.4102379882492829,-0.5559722433792256
186,1556769600,11,10,0,21,18,-1.357422939443563,-1.3774068802206145
186,1556784000,153,324,171,477,18,0.12852776380617917,-0.381198916391696
186,1556798400,551,833,282,1384,18,1.0930922553893452,1.6002936783294204
186,1556812800,404,627,223,1031,18,0.580395813917212,0.8291063729969461
186,1556827200,554,706,152,1260,18,-0.03657786988823663,1.3293950214987496
186,1556841600,176,272,96,448,18,-0.5232050007770411,-0.4445542474246755
186,1556856000,14,23,9,37,18,-1.2792150076935767,-1.3424522148231086
186,1556870400,133,242,109,375,18,-0.4102379882492829,-0.6040349083007962
186,1556884800,478,899,421,1377,18,2.3009703124169136,1.5850010122180114
186,1556899200,454,673,219,1127,18,0.5456367331394402,1.0388343653819816
186,1556913600,532,698,166,1230,18,0.08507891283396449,1.2638550238784259
186,1556928000,160,243,83,403,18,-0.6361720133047993,-0.5428642438551609
186,1556942400,19,52,33,71,18,-1.0706605230269461,-1.2681735508534084
186,1556956800,27,54,27,81,18,-1.1227991441936038,-1.2463268849799674
186,1556971200,148,524,376,672,18,1.9099306536669813,0.04481106814040728
186,1556985600,268,592,324,860,18,1.4580626035559485,0.45552838656110173
186,1557000000,348,529,181,877,18,0.21542546575060856,0.49266771854595176
186,1557014400,158,243,85,401,18,-0.6187924729159134,-0.5472335770298491
186,1557028800,16,40,24,56,18,-1.1488684547769326,-1.3009435496635702
186,1557043200,21,53,32,74,18,-1.0793502932213892,-1.2616195510913761
186,1557057600,103,471,368,574,18,1.8404124921114378,-0.1692862574193164
186,1557072000,227,525,298,752,18,1.2321285785004321,0.21958439512793684
186,1557086400,257,344,87,601,18,-0.6014129325270275,-0.1103002595610252
186,1557100800,84,142,58,226,18,-0.8534162681658727,-0.92955022981507
186,1557115200,13,22,9,35,18,-1.2792150076935767,-1.3468215479977967
186,1557129600,132,274,142,406,18,-0.123475571832666,-0.5363102440931284
186,1557144000,484,714,230,1198,18,0.6412242052783125,1.193945693083414
186,1557158400,391,688,297,1079,18,1.2234388083059893,0.9339703691894639
186,1557172800,580,789,209,1369,18,0.4587390311950108,1.5675236795192584
186,1557187200,179,257,78,436,19,-0.5769285176075066,-0.4660785925710954
186,1557201600,16,16,0,32,19,-1.1939764522082874,-1.3113566557120044
186,1557216000,147,280,133,427,19,-0.14183061500439184,-0.48490904447274935
186,1557230400,506,777,271,1283,19,0.9498695769816051,1.3060761586178897
186,1557244800,378,632,254,1010,19,0.8153847707224606,0.7348857842677209
186,1557259200,630,684,54,1314,19,-0.766789420561593,1.3709366040569197
186,1557273600,184,230,46,414,19,-0.8300763882129552,-0.5121085861084717
186,1557288000,15,13,0,28,19,-1.1939764522082874,-1.319725745446073
186,1557302400,153,302,149,455,19,-0.015256679701667563,-0.4263254163342705
186,1557316800,519,818,299,1337,19,1.1713739637613727,1.419058870027813
186,1557331200,405,592,187,997,19,0.2853564166423026,0.7076862426319986
186,1557345600,553,795,242,1348,19,0.7204543192454174,1.4420738667965012
186,1557360000,185,224,39,409,19,-0.8854524849078971,-0.5225699482760572
186,1557374400,12,23,11,35,19,-1.1069568716876645,-1.3050798384114533
186,1557388800,153,294,141,447,19,-0.07854364735302971,-0.4430635958024073
186,1557403200,528,872,344,1400,19,1.5273631568002848,1.5508720333393906
186,1557417600,373,681,308,1054,19,1.242571802369155,0.8269457713424734
186,1557432000,589,751,162,1340,19,0.08758464273179592,1.4253356873283645
186,1557446400,171,246,75,417,19,-0.6006611304767674,-0.5058317688079204
186,1557460800,14,11,0,25,19,-1.1939764522082874,-1.326002562746624
186,1557475200,143,312,169,455,19,0.1429607394267378,-0.4263254163342705
186,1557489600,485,868,383,1353,19,1.8358871241006751,1.4525352289640867
186,1557504000,417,705,288,1122,19,1.0843543832407496,0.9692202968216364
186,1557518400,518,680,162,1198,19,0.08758464273179592,1.128233001768936
186,1557532800,170,208,38,378,19,-0.8933633558643174,-0.5874303937150873
186,1557547200,25,23,0,48,19,-1.1939764522082874,-1.2778802967757308
186,1557561600,24,60,36,84,19,-0.9091850977771578,-1.2025584891691152
186,1557576000,160,463,303,623,19,1.2030174475870536,-0.07482364750339741
186,1557590400,297,552,255,849,19,0.8232956416788808,0.39802992247146757
186,1557604800,393,406,13,799,19,-1.091135129774824,0.2934163007956125
186,1557619200,176,196,20,372,19,-1.035759033079882,-0.5999840283161899
186,1557633600,13,33,20,46,19,-1.035759033079882,-1.2820648416427651
186,1557648000,14,49,35,63,19,-0.9170959687335781,-1.2464962102729744
186,1557662400,112,409,297,521,19,1.1555522218485321,-0.2882354357221418
186,1557676800,211,512,301,723,19,1.1871957056742133,0.13440359584831274
186,1557691200,204,257,53,461,19,-0.7747002915180133,-0.41377178173316786
186,1557705600,88,122,34,210,19,-0.9250068396899984,-0.9389321625459603
186,1557720000,9,14,5,23,19,-1.154422097426186,-1.3301871076136584
186,1557734400,149,275,126,424,19,-0.19720671169933374,-0.49118586177330065
186,1557748800,510,903,393,1413,19,1.9149958336648778,1.5780715749751129
186,1557763200,369,655,286,1024,19,1.0685326413279093,0.7641775983369603
186,1557777600,471,800,329,1271,19,1.4087000924539808,1.2809688894156845
186,1557792000,134,201,67,335,20,-0.6674863167272626,-0.7474137902937144
186,1557806400,11,19,8,30,20,-1.1842095572302793,-1.3839652598544139
186,1557820800,217,294,77,511,20,-0.579906106472514,-0.38009228654721233
186,1557835200,644,878,234,1522,20,0.7951031945270389,1.7299193059966147
186,1557849600,473,724,251,1197,20,0.9439895519601116,1.0516267564647217
186,1557864000,564,811,247,1375,20,0.9089574678582121,1.4231223682083431
186,1557878400,151,223,72,374,20,-0.6236962115998883,-0.6660186843498872
186,1557892800,13,11,0,24,20,-1.2542737254340781,-1.396487583845772
186,1557907200,173,322,149,495,20,0.0506714073616759,-0.41348515052416707
186,1557921600,545,779,234,1324,20,0.7951031945270389,1.3166826142817998
186,1557936000,430,640,210,1070,20,0.5849106899156423,0.7865708986476435
186,1557950400,651,742,91,1393,20,-0.45729381211586595,1.460689340182417
186,1557964800,195,257,62,452,20,-0.7112764218546369,-0.5032284724622329
186,1557979200,13,20,7,33,20,-1.192967578255754,-1.377704097858735
186,1557993600,143,313,170,456,20,0.23458984889664794,-0.4948802564679942
186,1558008000,531,799,268,1330,20,1.0928759093931841,1.3292049382731579
186,1558022400,426,622,196,1048,20,0.46229839555899427,0.7406557106793308
186,1558036800,580,628,48,1208,20,-0.8338887162112849,1.0745843504488781
186,1558051200,195,235,40,430,20,-0.9039528844150838,-0.5491436604305456
186,1558065600,15,22,7,37,20,-1.192967578255754,-1.3693558818644962
186,1558080000,130,327,197,457,20,0.4710564165844692,-0.49279320246943453
186,1558094400,490,831,341,1321,20,1.732211444252849,1.3104214522861208
186,1558108800,372,670,298,1042,20,1.35561654015743,0.7281333866879728
186,1558123200,536,684,148,1220,20,0.04191338633620104,1.0996289984315941
186,1558137600,202,247,45,449,20,-0.8601627792877095,-0.509489634457912
186,1558152000,27,39,12,66,20,-1.14917747312838,-1.3088313159062657
186,1558166400,29,91,62,120,20,-0.7112764218546369,-1.1961303999840436
186,1558180800,164,468,304,632,20,1.4081646663102791,-0.1275587527214922
186,1558195200,338,606,268,944,20,1.0928759093931841,0.523602094829125
186,1558209600,395,605,210,1000,20,0.5849106899156423,0.6404771187484666
186,1558224000,186,212,26,398,20,-1.0265651787717318,-0.6159293883844551
186,1558238400,27,40,13,67,20,-1.140419452102905,-1.306744261907706
186,1558252800,27,53,26,80,20,-1.0265651787717318,-1.2796125599264303
186,1558267200,123,484,361,607,20,1.907371864762346,-0.17973510268548396
186,1558281600,301,590,289,891,20,1.2767943509281563,0.4129882329054625
186,1558296000,372,414,42,786,20,-0.8864368423641341,0.1938475630566971
186,1558310400,148,167,19,315,20,-1.0878713259500559,-0.7891548702649077
186,1558324800,8,19,11,27,20,-1.1579354941538547,-1.3902264218500928
186,1558339200,146,284,138,430,20,-0.04566682391854755,-0.5491436604305456
186,1558353600,480,816,336,1296,20,1.6884213391254745,1.258245102322129
186,1558368000,386,690,304,1076,20,1.4081646663102791,0.7990932226390015
186,1558382400,558,685,127,1243,20,-0.14200505519877102,1.1476312403984665
186,1558396800,149,200,51,349,21,-0.7101995606770996,-0.5581983167810414
186,1558411200,16,16,0,32,21,-1.0947413854926575,-1.2481855407735012
186,1558425600,157,292,135,449,21,-0.07683655509853361,-0.3405367319253758
186,1558440000,494,898,404,1392,21,1.951433069909017,1.7120120132635503
186,1558454400,383,697,314,1080,21,1.2728298496462678,1.0329078685138737
186,1558468800,636,706,70,1342,21,-0.5669388808438525,1.6031812208357175
186,1558483200,167,258,91,425,21,-0.40859812944921103,-0.39277551229073554
186,1558497600,18,27,9,45,21,-1.0268810634663825,-1.2198895347422647
186,1558512000,153,318,165,471,21,0.1493645183223828,-0.2926511832571294
186,1558526400,503,809,306,1312,21,1.21250956340069,1.5378827453790178
186,1558540800,435,690,255,1125,21,0.8279677385851321,1.1308555816989234
186,1558555200,598,696,98,1294,21,-0.35581787898433054,1.4987036601049981
186,1558569600,197,234,37,431,21,-0.8157600616068605,-0.3797158171993956
186,1558584000,13,18,5,31,21,-1.0570412065891714,-1.2503621566220577
186,1558598400,139,284,145,423,21,-0.001436197291561476,-0.39712874398784886
186,1558612800,532,948,416,1480,21,2.0419134992773835,1.903554207936536
186,1558627200,399,735,336,1134,21,1.4387106368216063,1.1504451243359333
186,1558641600,515,785,270,1300,21,0.9410682752955902,1.511763355196338
186,1558656000,177,258,81,435,21,-0.48399848725618316,-0.371009353805169
186,1558670400,24,23,0,47,21,-1.0947413854926575,-1.2155363030451514
186,1558684800,118,250,132,368,21,-0.09945666244062526,-0.5168426156584649
186,1558699200,405,834,429,1239,21,2.1399339644264472,1.378989788434382
186,1558713600,438,713,275,1151,21,0.9787684541990763,1.1874475937613964
186,1558728000,494,573,79,1067,21,-0.49907855881757757,1.0046118624826372
186,1558742400,157,195,38,352,21,-0.8082200258261634,-0.5516684692353714
186,1558756800,19,37,18,56,21,-0.9590207414401076,-1.1959467604081415
186,1558771200,19,61,42,80,21,-0.7780598827033746,-1.1437079800427816
186,1558785600,121,411,290,532,21,1.0918689909095345,-0.1598776164951734
186,1558800000,264,532,268,796,21,0.9259882037341959,0.41474896752378365
186,1558814400,357,408,51,765,21,-0.7101995606770996,0.34727387621852734
186,1558828800,146,187,41,333,21,-0.7855999184840717,-0.5930241703579479
186,1558843200,22,30,8,52,21,-1.0344210992470797,-1.2046532238023682
186,1558857600,14,51,37,65,21,-0.8157600616068605,-1.1763572177711314
186,1558872000,113,369,256,482,21,0.8355077743658292,-0.2687084089230062
186,1558886400,239,478,239,717,21,0.7073271660939766,0.24279631548780786
186,1558900800,300,304,4,604,21,-1.0645812423698686,-0.0031612753990942137
186,1558915200,78,136,58,214,21,-0.6574193102122191,-0.8520414563361899
186,1558929600,22,22,0,44,21,-1.0947413854926575,-1.2220661505908212
186,1558944000,18,48,30,66,21,-0.8685403120717411,-1.174180601922575
186,1558958400,100,366,266,466,21,0.9109081321728014,-0.30353426249991267
186,1558972800,238,550,312,788,21,1.2577497780848732,0.3973360407353304
186,1558987200,279,316,37,595,21,-0.8157600616068605,-0.022750818036104112
186,1559001600,106,129,23,235,22,-1.0449080024948139,-0.9001592584416002
186,1559016000,9,12,3,21,22,-1.2052812387629745,-1.3501888176179881
186,1559030400,146,260,114,406,22,-0.3152097774746825,-0.5405561994735518
186,1559044800,492,648,156,1140,22,0.021574018688455064,1.0030031296641526
186,1559059200,343,546,203,889,22,0.3984511239186328,0.47516472147128636
186,1559073600,581,744,163,1325,22,0.07770465138231132,1.392047374746544
186,1559088000,142,213,71,355,22,-0.6600122354512281,-0.6478062346043733
186,1559102400,12,16,4,28,22,-1.1972625769495666,-1.3354682245608165
186,1559116800,159,224,65,383,22,-0.7081242063316763,-0.5889238623756871
186,1559131200,534,881,347,1415,22,1.55313842504939,1.5813121426244643
186,1559145600,411,662,251,1073,22,0.7833468909622185,0.8621060246883676
186,1559160000,534,795,261,1329,22,0.863533509096299,1.400459142207785
186,1559174400,153,228,75,381,22,-0.6279375881975959,-0.5931297461063074
186,1559188800,9,11,2,20,22,-1.2132999005763827,-1.3522917594832984
186,1559203200,141,306,165,447,22,0.0937419750091274,-0.45433558299583265
186,1559217600,512,793,281,1305,22,1.0239067453644597,1.3499885374403395
186,1559232000,397,702,305,1099,22,1.2163546288862526,0.9167825131864334
186,1559246400,542,787,245,1329,22,0.7352349200817704,1.400459142207785
186,1559260800,142,192,50,334,22,-0.8284041335327968,-0.691968013775888
186,1559275200,10,16,6,26,22,-1.1812252533227505,-1.339674108291437
186,1559289600,134,277,143,411,22,-0.08266858488584941,-0.5300414901470007
186,1559304000,507,772,265,1279,22,0.8956081563499311,1.2953120489422738
186,1559318400,418,721,303,1139,22,1.2003173052594365,1.0009001877988424
186,1559332800,543,733,190,1276,22,0.2942085203443283,1.289003223346343
186,1559347200,189,212,23,401,22,-1.0449080024948139,-0.551070908800103
186,1559361600,29,30,1,59,22,-1.2213185623897906,-1.2702770267361996
186,1559376000,21,83,62,104,22,-0.7321801917719004,-1.1756446427972396
186,1559390400,163,507,344,670,22,1.529082439609166,0.014620452968347296
186,1559404800,286,565,279,851,22,1.0078694217376436,0.39525293058949784
186,1559419200,405,538,133,943,22,-0.16285520301992978,0.5887235821980384
186,1559433600,193,202,9,395,22,-1.1571692678825263,-0.5636885599919643
186,1559448000,34,47,13,81,22,-1.1250946206288943,-1.2240123056993748
186,1559462400,17,75,58,92,22,-0.7642548390255326,-1.2008799451809622
186,1559476800,117,478,361,595,22,1.6653996904371027,-0.14310018692991952
186,1559491200,292,601,309,893,22,1.2484292761398847,0.48357648893252725
186,1559505600,363,357,0,720,22,-1.2293372242031988,0.1197675462338585
186,1559520000,109,159,50,268,22,-0.8284041335327968,-0.8307621768863628
186,1559534400,17,12,0,29,22,-1.2293372242031988,-1.3333652826955062
186,1559548800,154,299,145,453,22,-0.06663126125903335,-0.44171793180397134
186,1559563200,452,836,384,1288,22,1.8498289121454876,1.3142385257300657
186,1559577600,361,687,326,1048,22,1.3847465269678214,0.809532478055612
186,1559592000,531,782,251,1313,22,0.7833468909622185,1.3668120723628214
186,1559606400,146,257,111,403,23,-0.35661419552556417,-0.5418048798781926
186,1559620800,18,17,0,35,23,-1.2586952479076479,-1.3318177311420931
186,1559635200,148,304,156,452,23,0.009094339223929212,-0.4366129513131624
186,1559649600,484,847,363,1331,23,1.6913535990715987,1.4504014407003387
186,1559664000,374,592,218,966,23,0.5129594315454534,0.6668289115934811
186,1559678400,529,661,132,1190,23,-0.18595021264246725,1.1477062993193334
186,1559692800,178,253,75,431,23,-0.6491810233251588,-0.48169520641246105
186,1559707200,18,22,4,40,23,-1.2261878225965817,-1.3210838608803552
186,1559721600,243,370,127,613,23,-0.22658449428129984,-0.09098232888520598
186,1559736000,536,847,311,1383,23,1.2687570700277397,1.5620336914224118
186,1559750400,378,665,287,1043,23,1.0737125181613432,0.8321305136242428
186,1559764800,564,718,154,1282,23,-0.0071593734316038275,1.3452095121353087
186,1559779200,149,228,79,377,23,-0.6166735980140927,-0.597621005239229
186,1559793600,13,25,12,38,23,-1.1611729719744495,-1.3253774089850503
186,1559808000,146,280,134,426,23,-0.1696964999869342,-0.49242907667419883
186,1559822400,511,949,438,1460,23,2.3008678236540874,1.7273352934531734
186,1559836800,405,605,200,1010,23,0.36667601764565605,0.7612869698967736
186,1559851200,599,742,143,1341,23,-0.09655479303703554,1.4718691812238143
186,1559865600,195,230,35,425,23,-0.9742552764358197,-0.4945758507265464
186,1559880000,16,24,8,40,23,-1.1936803972855157,-1.3210838608803552
186,1559894400,123,261,138,384,23,-0.13718907467586813,-0.5825935868727962
186,1559908800,481,878,397,1359,23,1.9676667142156603,1.5105111141660703
186,1559923200,401,689,288,1090,23,1.0818393744891097,0.933028894084578
186,1559937600,502,712,210,1214,23,0.44794458092332123,1.199228876575675
186,1559952000,198,231,33,429,23,-0.9905089890913527,-0.4859887545171562
186,1559966400,17,36,19,53,23,-1.1042849776800838,-1.293175798199837
186,1559980800,28,68,40,96,23,-0.933620994796987,-1.200864513948892
186,1559995200,163,455,292,618,23,1.114346799800176,-0.0802484586234682
186,1560009600,283,522,239,805,23,0.6836234144285503,0.3211982891655247
186,1560024000,302,419,117,721,23,-0.307853057558965,0.14086926876833
186,1560038400,131,182,51,313,23,-0.8442255751915553,-0.7350145445894726
186,1560052800,18,41,23,59,23,-1.0717775523690178,-1.2802951538857517
186,1560067200,15,59,44,74,23,-0.9011135694859209,-1.2480935431005384
186,1560081600,97,340,243,437,23,0.7161308397396163,-0.46881456209837574
186,1560096000,282,453,171,735,23,0.130997184140427,0.17092410550119577
186,1560110400,304,373,69,677,23,-0.697942161291758,0.046411210465037565
186,1560124800,105,126,21,231,23,-1.088031265024551,-0.9110500168819722
186,1560139200,10,19,9,29,23,-1.1855535409577491,-1.3446983754561783
186,1560153600,152,280,128,432,23,-0.21845763795353332,-0.4795484323601135
186,1560168000,456,764,308,1220,23,1.24437650104444,1.21210952088976
186,1560182400,337,726,389,1063,23,1.9026518635935281,0.875065994671194
186,1560196800,456,745,289,1201,23,1.0899662308168763,1.1713208138951565
186,1560211200,139,186,47,325,24,-0.7925209240540457,-0.9222679843607144
186,1560225600,19,15,0,34,24,-1.0413972053271425,-1.456091919614753
186,1560240000,164,278,114,442,24,-0.4377398422392056,-0.7076377423513587
186,1560254400,514,849,335,1363,24,0.7325082037470579,0.9818874960299799
186,1560268800,394,603,209,997,24,0.06530796033407509,0.3104800723084056
186,1560283200,501,904,403,1405,24,1.0925845255889852,1.0589342495718
186,1560297600,232,286,54,518,24,-0.7554542438644355,-0.5682198073709225
186,1560312000,27,17,0,44,24,-1.0413972053271425,-1.4377474544857483
186,1560326400,145,279,134,424,24,-0.3318350416974623,-0.7406577795835673
186,1560340800,555,812,257,1367,24,0.31947948163425904,0.9892252820815818
186,1560355200,423,737,314,1160,24,0.6213081631782275,0.6094948539111832
186,1560369600,533,1397,864,1930,24,3.5336901780761685,2.02201866884455
186,1560384000,805,470,0,1275,24,-1.0413972053271425,0.820456202894738
186,1560398400,21,18,0,39,24,-1.0413972053271425,-1.4469196870502505
186,1560412800,137,280,143,417,24,-0.28417788145367784,-0.7534989051738706
186,1560427200,542,901,359,1443,24,0.8595939643971499,1.128643217062018
186,1560441600,396,701,305,1097,24,0.5736510029344429,0.49392472359845324
186,1560456000,549,668,119,1217,24,-0.41126364210376976,0.7140583051465104
186,1560470400,160,281,121,441,24,-0.40067316204959547,-0.7094721888642592
186,1560484800,20,28,8,48,24,-0.9990352851104451,-1.4304096684341463
186,1560499200,121,224,103,345,24,-0.4959874825371644,-0.8855790541027049
186,1560513600,446,778,332,1224,24,0.7166224836657964,0.7268994307368137
186,1560528000,408,690,282,1098,24,0.45186048231143816,0.4957591701113537
186,1560542400,498,715,217,1213,24,0.10766988055077241,0.7067205190949084
186,1561161600,9386,6779,0,16165,25,-1.103699370428742,4.216746345265991
186,1561176000,35,46,11,81,25,-1.0076255809995014,-0.35758377833017724
186,1561190400,24,96,72,120,25,-0.4748527487100752,-0.34649208006977866
186,1561204800,153,406,253,559,25,1.1059977864437958,-0.22163937401042044
186,1561219200,266,615,349,881,25,1.9444599487353518,-0.13006176273225795
186,1561233600,371,439,68,810,25,-0.50978867213889,-0.15025434161657328
186,1561248000,188,240,52,428,25,-0.6495323658541493,-0.25889610406457975
186,1561262400,28,48,20,76,25,-0.929019753284668,-0.3590057909276642
186,1561276800,24,66,42,90,25,-0.7368721744261865,-0.35502415565470063
186,1561291200,130,400,270,530,25,1.254475461016259,-0.22988704707584504
186,1561305600,256,549,293,805,25,1.4553570207319442,-0.15167635421406025
186,1561320000,316,424,108,740,25,-0.16042943785074174,-0.1701625179813912
186,1561334400,144,176,32,320,25,-0.8242119829982235,-0.28961157617029887
186,1561348800,17,30,13,47,25,-0.9901576192850939,-0.3672534639930888
186,1561362928,106,225,119,331,25,-0.06435564842150097,-0.28648314845582745
186,1561363200,14,15,1,29,25,-1.0949653895715383,-0.372372709344042
186,1561377600,483,760,277,1243,25,1.315613327016685,-0.02710805067419945
186,1561392000,338,568,230,906,25,0.9051162267281105,-0.12295169974482295
186,1561406400,538,729,191,1267,25,0.5644909732971659,-0.020282390206261873
186,1561420800,166,215,49,381,26,-0.8361935084437812,-0.576708562061723
186,1561435200,15,15,0,30,26,-1.2400626096822935,-1.3494623906305214
186,1561449600,135,219,84,354,26,-0.5477155789877008,-0.6361511642593229
186,1561464000,510,900,390,1410,26,1.9744057471140297,1.6887150550245835
186,1561478400,366,631,265,997,26,0.9441274276280287,0.7794633991872224
186,1561492800,516,754,238,1270,26,0.7215873106190525,1.3804941547407323
186,1561507200,174,268,94,442,26,-0.4652933134288208,-0.4424123126523307
186,1561521600,20,13,0,33,26,-1.2400626096822935,-1.3428576570530104
186,1561536000,145,226,81,371,26,-0.5724422586553649,-0.5987243406534267
186,1561550400,538,801,263,1339,26,0.9276429745162527,1.5324030270234876
186,1561564800,358,673,315,1031,26,1.356238755422429,0.8543170463990148
186,1561579200,520,715,195,1235,26,0.3671715687158681,1.3034389296697695
186,1561593600,212,224,12,436,26,-1.1411558910116375,-0.4556217798073529
186,1561608000,16,28,12,44,26,-1.1411558910116375,-1.3186403006021363
186,1561622400,128,250,122,378,26,-0.23451096986395653,-0.5833132956392342
186,1561636800,472,745,273,1217,26,1.0100652400751329,1.263810528204703
186,1561651200,365,661,296,1026,26,1.199636450860557,0.843309157103163
186,1561665600,559,720,161,1279,26,0.0869358658156758,1.4003083554732656
186,1561680000,206,251,45,457,26,-0.8691624146673332,-0.4093886447647752
186,1561694400,18,27,9,45,26,-1.1658825706793015,-1.316438722742966
186,1561708800,88,198,110,286,26,-0.3334176885346126,-0.7858584586829078
186,1561723200,419,770,351,1189,26,1.6529589114343974,1.2021663481479328
186,1561737600,415,679,264,1094,26,0.9358852010721407,0.9930164515267479
186,1561752000,517,647,130,1164,26,-0.16857315741685247,1.1471269016686736
186,1561766400,179,248,69,427,26,-0.671348977326021,-0.4754359805398862
186,1561780800,21,42,21,63,26,-1.0669758520086454,-1.2768103212778994
186,1561795200,18,74,56,92,26,-0.7784979225525651,-1.2129645633619588
186,1561809600,146,436,290,582,26,1.150183091525229,-0.13419141236847948
186,1561824000,244,648,404,892,26,2.089796918896462,0.548297723974334
186,1561838400,350,412,62,762,26,-0.7290445632172371,0.2620926022821864
186,1561852800,143,220,77,363,26,-0.6054111648789169,-0.6163369635267897
186,1561867200,25,41,16,66,26,-1.1081869847880854,-1.2702055877003884
186,1561881600,14,54,40,68,26,-0.9103735474467732,-1.2658024319820476
186,1561896000,129,363,234,492,26,0.6886184043955005,-0.3323334196938124
186,1561910400,383,640,257,1023,26,0.8781896151809246,0.8367044235256519
186,1561924800,324,393,69,717,26,-0.671348977326021,0.16302159861951993
186,1561939200,116,182,66,298,26,-0.696075656993685,-0.7594395243728634
186,1561953600,10,24,14,34,26,-1.1246714378998615,-1.34065607919384
186,1561968000,101,228,127,329,26,-0.19329983708451648,-0.6911906107385821
186,1561982400,395,717,322,1112,26,1.4139343413136451,1.0326448529918144
186,1561996800,327,643,316,970,26,1.3644809819783172,0.7200207969896225
186,1562011200,543,663,120,1206,26,-0.2509954229757325,1.2395931717538289
186,1562025600,145,244,99,389,27,-0.19795465111546076,-0.24469410174257494
186,1562040000,17,21,4,38,27,-0.9965785721980577,-1.17106298923334
186,1562054400,113,237,124,350,27,0.012209538643117367,-0.3476239781304377
186,1562068800,437,754,317,1191,27,1.6346770835793407,1.871966433207834
186,1562083200,363,648,285,1011,27,1.3656669206883607,1.396905465263852
186,1562097600,487,632,145,1119,27,0.188747458040323,1.6819420460302412
186,1562112000,161,269,108,430,27,-0.12229554280237263,-0.13648577015533456
186,1562126400,22,23,1,45,27,-1.021798274969087,-1.1525883960355185
186,1562140800,106,223,117,329,27,-0.04663643448928451,-0.4030477577239023
186,1562155200,376,751,375,1127,27,2.122258003819242,1.7030558668277516
186,1562169600,353,678,325,1031,27,1.7019296243020856,1.4496900172576277
186,1562184000,501,559,58,1060,27,-0.5426239223195289,1.5262276176486027
186,1562198400,147,181,34,328,27,-0.744381544487764,-0.4056869853235911
186,1562212800,12,26,14,38,27,-0.9125128962946264,-1.17106298923334
186,1562227200,19,61,42,80,27,-0.6771290037650189,-1.0602154300464108
186,1562241600,92,327,235,419,27,0.9453385411712043,-0.16551727375191125
186,1562256000,252,428,176,680,27,0.44935105334095987,0.5233211297668628
186,1562270400,262,289,27,551,27,-0.8032275176201658,0.18286076940700896
186,1562284800,104,192,88,296,27,-0.29042689460923515,-0.49014226851363235
186,1562299200,14,34,20,48,27,-0.8620734907525677,-1.1446707132364522
186,1562313600,56,149,93,205,27,-0.2483940566575195,-0.7303119800853122
186,1562328000,170,611,441,781,27,2.6770914647818884,0.7898831173354305
186,1562342400,310,618,308,928,27,1.5590179752662525,1.1778495744896826
186,1562356800,370,435,65,805,27,-0.483777949187127,0.8532245797279615
186,1562371200,129,144,15,273,27,-0.9041063287042833,-0.5508445033064745
186,1562385600,22,26,4,48,27,-0.9965785721980577,-1.1446707132364522
186,1562400000,11,38,27,49,27,-0.8032275176201658,-1.1420314856367633
186,1562414400,73,261,188,334,27,0.5502298644250774,-0.38985161972545834
186,1562428800,174,389,215,563,27,0.7772071893643417,0.21453150060327444
186,1562443200,234,303,69,537,27,-0.4501516788257545,0.14591158301136592
186,1562457600,96,98,2,194,27,-1.013391707378744,-0.7593434836818889
186,1562472000,26,26,0,52,27,-1.0302048425594301,-1.134113802837697
186,1562486400,13,24,11,37,27,-0.9377325990656558,-1.1737022168330289
186,1562500800,53,206,153,259,27,0.255999998763068,-0.5877936897021175
186,1562515200,169,342,173,511,27,0.4241313505699305,0.07729166541945738
186,1562529600,212,212,0,424,27,-1.0302048425594301,-0.15232113575346728
186,1562544000,110,103,0,213,27,-1.0302048425594301,-0.7091981592878018
186,1562558400,14,12,0,26,27,-1.0302048425594301,-1.2027337204296056
186,1562572800,116,216,100,332,27,-0.18954808352511765,-0.39513007492483593
186,1562587200,424,708,284,1132,27,1.3572603530980176,1.7162520048261956
186,1562601600,302,569,267,871,27,1.2143487040621845,1.0274136013074215
186,1562616000,480,618,138,1098,27,0.1299014849079211,1.6265182664367765
186,1562630400,152,187,35,339,28,-0.9853521396513354,-0.5835131205188329
186,1562644800,13,23,10,36,28,-1.2057653792410037,-1.2703229588209664
186,1562659200,131,232,101,363,28,-0.40346118713461154,-0.5291123412473768
186,1562673600,482,714,232,1196,28,0.7515041883152495,1.3590480392994126
186,1562688000,335,580,245,915,28,0.866119072901877,0.7221055819961139
186,1562702400,529,788,259,1317,28,0.989550487072091,1.6333186347930038
186,1562716800,154,244,90,398,28,-0.5004430125540655,-0.4497778714765033
186,1562731200,23,20,0,43,28,-1.2939306750768709,-1.2544560648667917
186,1562745600,134,240,106,374,28,-0.35937853921667795,-0.5041786507479594
186,1562760000,508,742,234,1250,28,0.769137247482423,1.4814497926601888
186,1562774400,304,579,275,883,28,1.1306149604094786,0.6495712096341724
186,1562788800,519,685,166,1204,28,0.1696132357985256,1.377181632389898
186,1562803200,193,257,64,450,28,-0.7296727817273204,-0.33190951638834837
186,1562817600,24,19,0,43,28,-1.2939306750768709,-1.2544560648667917
186,1562832000,115,228,113,343,28,-0.29766283213157085,-0.5744463239735902
186,1562846400,487,714,227,1201,28,0.7074215403973159,1.370381534980966
186,1562860800,352,707,355,1059,28,1.8359373270964168,1.0485102576248506
186,1562875200,471,731,260,1202,28,0.9983670166556778,1.3726482341172765
186,1562889600,136,234,98,370,28,-0.42991077588537174,-0.5132454472932021
186,1562904000,12,20,8,32,28,-1.223398438408177,-1.279389755366209
186,1562918400,102,218,116,320,28,-0.27121324338081065,-0.6265804041087356
186,1562932800,430,788,358,1218,28,1.8623869158471769,1.4089154202982475
186,1562947200,345,633,288,978,28,1.2452298449961061,0.8649076275836862
186,1562961600,510,618,108,1128,28,-0.3417454800495045,1.204912498030287
186,1562976000,191,228,37,419,28,-0.967719080484162,-0.4021771896139792
186,1562990400,33,46,13,79,28,-1.1793157904902434,-1.1728548959596075
186,1563004800,19,58,39,77,28,-0.9500860213169885,-1.177388294232229
186,1563019200,126,437,311,563,28,1.4480100254186008,-0.07577251398524248
186,1563033600,257,462,205,719,28,0.5134578895584079,0.2778325512792223
186,1563048000,235,457,222,692,28,0.6633388924793823,0.21663167459883415
186,1563062400,0,11,11,11,28,-1.1969488496574168,-1.326990437228733
186,1563076800,22,32,10,54,28,-1.2057653792410037,-1.2295223743673742
186,1563091200,18,28,10,46,28,-1.2057653792410037,-1.2476559674578596
186,1563105600,106,406,300,512,28,1.351028199999147,-0.19137416993708672
186,1563120000,207,453,246,660,28,0.8749356024854636,0.14409730223689265
186,1563134400,227,336,109,563,28,-0.33292895046591775,-0.07577251398524248
186,1563148800,112,141,29,253,28,-1.0382513171528558,-0.7784492462415507
186,1563163200,16,29,13,45,28,-1.1793157904902434,-1.2499226665941703
186,1563177600,120,235,115,355,28,-0.2800297729643974,-0.5472459343378622
186,1563192000,422,748,326,1170,28,1.5802579691724017,1.3001138617553352
186,1563206400,331,590,259,921,28,0.989550487072091,0.7357057768139779
186,1563220800,544,705,161,1249,28,0.12553058788059196,1.4791830935238781
186,1563235200,132,243,111,375,29,-0.40904070649985125,-0.459696028621725
186,1563249600,22,18,0,40,29,-1.290871239555665,-1.0369955580282708
186,1563264000,135,253,118,388,29,-0.35342977198281794,-0.4372933603163963
186,1563278400,496,771,275,1267,29,0.8938440450420717,1.0774716735592869
186,1563292800,340,629,289,969,29,1.0050659140761382,0.563933584714061
186,1563307200,569,683,114,1252,29,-0.38520744884969416,1.0516224408992922
186,1563321600,175,278,103,453,29,-0.4725960602336036,-0.3252800187897531
186,1563336000,21,20,0,41,29,-1.290871239555665,-1.0352722758509378
186,1563350400,127,262,135,389,29,-0.21837464529859424,-0.43557007813906334
186,1563364800,475,783,308,1258,29,1.1560098791938,1.06196213396329
186,1563379200,352,628,276,980,29,0.9017884642587907,0.5828896886647236
186,1563393600,519,770,251,1289,29,0.7031779838408146,1.1153838814606123
186,1563408000,143,276,133,419,29,-0.23426348373203235,-0.38387161281907417
186,1563422400,15,21,6,36,29,-1.2432047242553508,-1.0438886867376027
186,1563436800,128,280,152,408,29,-0.08331951861437054,-0.4028277167697369
186,1563451200,485,841,356,1326,29,1.5373420015963142,1.1791453220219323
186,1563465600,366,651,285,1017,29,0.973288237209262,0.6466511292260436
186,1563480000,556,679,123,1235,29,-0.31370767589922277,1.0223266438846317
186,1563494400,157,200,43,357,29,-0.9492612132367462,-0.49071510781371847
186,1563508800,19,31,12,50,29,-1.1955382089550364,-1.019762736254941
186,1563523200,108,241,133,349,29,-0.23426348373203235,-0.5045013652323823
186,1563537600,416,802,386,1218,29,1.7756745780978853,0.9930308468699711
186,1563580800,1287,1755,468,3042,29,2.427116953868847,4.136297538325313
186,1563595200,25,51,26,76,29,-1.0843163399209699,-0.9749573996442839
186,1563609600,18,78,60,96,29,-0.8142060865525225,-0.9404917560976244
186,1563624000,108,406,298,514,29,1.0765656870266096,-0.22015980597244175
186,1563627083,33,103,70,136,29,-0.734761894385332,-0.8715604690043055
186,1563638400,158,386,228,544,29,0.5204563418562766,-0.16846134065245255
186,1563652800,241,414,173,655,29,0.08351328493672935,0.02282298103150743
186,1563667200,169,174,5,343,29,-1.2511491434720698,-0.5148410582963802
186,1563681600,28,36,8,64,29,-1.2273158858219126,-0.9956367857722795
186,1563696000,25,56,31,81,29,-1.0445942438373745,-0.966340988757619
186,1563710400,81,377,296,458,29,1.0606768485931715,-0.31666360790308823
186,1563724800,161,455,294,616,29,1.0447880101597335,-0.044385023884478514
186,1563739200,219,339,120,558,29,-0.33754093354937986,-0.14433539016979094
186,1563753600,124,145,21,269,29,-1.124038436004565,-0.6423639394190201
186,1563768000,16,11,0,27,29,-1.290871239555665,-1.0593982263335995
186,1563782400,112,225,113,337,29,-0.39315186806641317,-0.5251807513603779
186,1563796800,446,730,284,1176,29,0.9653438179925431,0.9206529954219863
186,1563811200,362,629,267,991,29,0.8302886913083193,0.6018457926153863
186,1563825600,461,752,291,1213,29,1.0209547525095763,0.9844144359833064
186,1563840000,111,174,63,285,30,-0.6714771860913421,-0.6714024489404697
186,1563854400,12,12,0,24,30,-1.2200195245901662,-1.2579432239871249
186,1563868800,132,222,90,354,30,-0.43638761244898894,-0.5163399451925035
186,1563883200,471,774,303,1245,30,1.4182079129517973,1.4859889075529742
186,1563897600,339,632,293,971,30,1.3311377004916665,0.8702334578871371
186,1563912000,516,680,164,1196,30,0.20793195975597903,1.375872057065288
186,1563926400,159,188,29,347,30,-0.9675159084557868,-0.5320709238336014
186,1563940800,21,14,0,35,30,-1.2200195245901662,-1.2332231146939707
186,1563955200,134,236,102,370,30,-0.331903357496832,-0.4803834225842794
186,1563969600,470,717,247,1187,30,0.9306147231750647,1.355646513098162
186,1563984000,350,648,298,998,30,1.3746728067217318,0.9309100897885152
186,1563998400,523,726,203,1249,30,0.5475057883504891,1.4949780382050302
186,1564012800,162,242,80,404,30,-0.5234578249091197,-0.4039758120418033
186,1564027200,12,13,1,25,30,-1.2113125033441532,-1.2556959413241109
186,1564041600,117,214,97,331,30,-0.3754384637268974,-0.5680274464418256
186,1564056000,487,774,287,1261,30,1.278895573015588,1.5219454301611983
186,1564070400,334,671,337,1005,30,1.714246635316242,0.9466410684296133
186,1564084800,516,709,193,1225,30,0.4604355758903584,1.441043254292694
186,1564099200,198,200,2,398,30,-1.20260548209814,-0.4174595080198873
186,1564113600,22,24,2,46,30,-1.20260548209814,-1.2085030054008168
186,1564128000,99,236,137,335,30,-0.027157613886374145,-0.5590383157897696
186,1564142400,389,730,341,1119,30,1.7490747203002943,1.2028312920132098
186,1564156800,371,684,313,1055,30,1.505278125411928,1.0590052015803135
186,1564171200,513,680,167,1193,30,0.23405302349401827,1.369130209076246
186,1564185600,187,193,6,380,30,-1.1677773971140877,-0.45791059595413935
186,1564200000,26,34,8,60,30,-1.1503633546220615,-1.1770410481186206
186,1564214400,13,54,41,67,30,-0.8630316535036299,-1.1613100694775227
186,1564228800,80,326,246,406,30,0.9219077019290516,-0.39948124671577523
186,1564243200,150,388,238,538,30,0.8522515319609469,-0.1028399351979267
186,1564257600,188,360,172,548,30,0.2775881297240837,-0.08036710856778666
186,1564272000,146,161,15,307,30,-1.08941420589997,-0.6219622303541616
186,1564286400,29,32,3,61,30,-1.193898460852127,-1.1747937654556067
186,1564300800,13,32,19,45,30,-1.0545861209159177,-1.2107502880638308
186,1564315200,66,243,177,309,30,0.3211232359541491,-0.6174676650281337
186,1564329600,160,365,205,525,30,0.5649198308425153,-0.13205460981710876
186,1564344000,228,287,59,515,30,-0.7063052710753944,-0.15452743644724878
186,1564358400,103,154,51,257,30,-0.7759614410434991,-0.7343263635048619
186,1564372800,7,16,9,23,30,-1.1416563333760485,-1.2601905066501389
186,1564387200,126,250,124,376,30,-0.14034889008454418,-0.4668997266061954
186,1564401600,457,759,302,1216,30,1.409500891705784,1.4208177103255681
186,1564416000,348,643,295,991,30,1.3485517429836926,0.9151791111474172
186,1564430400,535,701,166,1236,30,0.2253460022480052,1.4657633635858482
186,1564444800,117,156,39,273,31,-1.006202079206808,-0.8713224871669041
186,1564459200,8,13,5,21,31,-1.2972552151985683,-1.4022805125961673
186,1564473600,130,245,115,375,31,-0.3556127164016971,-0.6564109054455357
186,1564488000,449,774,325,1223,31,1.442068417665057,1.1303049896497626
186,1564502400,421,640,219,1061,31,0.5346674642789812,0.7889748304452362
186,1564516800,520,734,214,1254,31,0.491865532515487,1.1956212546827274
186,1564531200,171,207,36,378,31,-1.0318832382649046,-0.6500899765713778
186,1564545600,10,10,0,20,31,-1.3400571469620624,-1.4043874888875532
186,1564560000,139,252,113,391,31,-0.37273348910709475,-0.6226992847833602
186,1564574400,509,793,284,1302,31,1.091092577204405,1.2967561166692536
186,1564588800,329,557,228,886,31,0.6117109414532705,0.42025397945269233
186,1564603200,481,723,242,1204,31,0.7315563503910542,1.0902724401134292
186,1564617600,117,160,43,277,31,-0.9719605337960128,-0.8628945820013603
186,1564632000,7,9,2,16,31,-1.3229363742566647,-1.412815394053097
186,1564646400,114,246,132,360,31,-0.21008614840581702,-0.6880155498163252
186,1564660800,457,782,325,1239,31,1.442068417665057,1.1640166103119378
186,1564675200,355,650,295,1005,31,1.1852568270840922,0.6709841581276221
186,1564689600,532,691,159,1223,31,0.02104428311705137,1.1303049896497626
186,1564704000,137,175,38,312,31,-1.0147624655595069,-0.7891504118028515
186,1564718400,7,16,9,23,31,-1.263013669787773,-1.3980665600133952
186,1564732800,103,239,136,342,31,-0.1758446029950217,-0.7259411230612726
186,1564747200,370,761,391,1131,31,2.0070539169431796,0.9364631708422537
186,1564761600,390,634,244,1024,31,0.7486771230964518,0.7110167076639554
186,1564776000,487,650,163,1137,31,0.055285828527846685,0.9491050285905694
186,1565395200,7638,6240,0,13878,32,-1.018333622140982,4.094361436641112
186,1565409600,20,40,20,60,32,-0.8451639934349106,-0.38187404814877807
186,1565424000,21,71,50,92,32,-0.5854095503758031,-0.3715078927345881
186,1565438400,137,384,247,521,32,1.120311292379002,-0.23253662171310435
186,1565452800,247,537,290,784,32,1.4926259940970559,-0.14733978190273084
186,1565467200,360,403,43,763,32,-0.6460189204229282,-0.154142571393293
186,1565481600,170,195,25,365,32,-0.8018715862583926,-0.2830716293572803
186,1565496000,22,33,11,55,32,-0.9230903263526428,-0.38349375993224527
186,1565510400,15,49,34,64,32,-0.7239452533406604,-0.38057827872200434
186,1565524800,106,390,284,496,32,1.4406751054852345,-0.24063518063044023
186,1565539200,238,489,251,727,32,1.1549452181202162,-0.16580449623425667
186,1565553600,318,338,20,656,32,-0.8451639934349106,-0.18880440355949057
186,1565568000,89,153,64,242,32,-0.464190810281553,-0.32291653923057284
186,1565582400,11,17,6,28,32,-0.9663827335291606,-0.392240203562968
186,1565596800,106,197,91,303,32,-0.23041181152835638,-0.30315605547227326
186,1565611200,422,707,285,1129,32,1.449333586920538,-0.03557966884349563
186,1565625600,331,632,301,963,32,1.5878692898853952,-0.08935410005460591
186,1565640000,539,634,95,1173,32,-0.19577788578714206,-0.02132620514898447
186,1565654400,133,224,91,357,33,-0.6302656096375767,-0.7339173510115383
186,1565668800,17,13,0,30,33,-1.2290414386295774,-1.470139752501018
186,1565683200,111,238,127,349,33,-0.3933872597066754,-0.7519289082345225
186,1565697600,463,858,395,1321,33,1.3700404564455901,1.4364752943580594
186,1565712000,336,662,326,998,33,0.9160236190780292,0.7092586714800718
186,1565726400,544,670,126,1214,33,-0.39996721387142264,1.1955707165006457
186,1565740800,145,213,68,358,33,-0.7816045554267637,-0.7316659063586654
186,1565755200,13,20,7,33,33,-1.1829817594763465,-1.4633854185423991
186,1565769600,120,257,137,377,33,-0.3275877180592028,-0.6888884579540778
186,1565784000,450,741,291,1191,33,0.6857252233118751,1.143787489484566
186,1565798400,358,588,230,946,33,0.2843480192622923,0.5921835495306744
186,1565812800,468,682,214,1150,33,0.17906875262633618,1.051478258716772
186,1565827200,162,245,83,407,33,-0.6829052429555548,-0.621345118367887
186,1565841600,22,22,0,44,33,-1.2290414386295774,-1.4386195273607958
186,1565856000,117,260,143,377,33,-0.2881079930707192,-0.6888884579540778
186,1565870400,435,694,259,1129,33,0.4751666900399628,1.0041979210064385
186,1565884800,358,590,232,948,33,0.29750792759178685,0.5966864388364205
186,1565899200,565,632,67,1197,33,-0.7881845095915109,1.1572961574018041
186,1565913600,144,267,123,411,33,-0.4197070763656644,-0.6123393397563949
186,1565928000,11,23,12,34,33,-1.1500819886526101,-1.461133973889526
186,1565942400,87,243,156,330,33,-0.20256858892900487,-0.79470635663911
186,1565956800,376,704,328,1080,33,0.9291835274075237,0.8938771330156601
186,1565971200,362,580,218,942,33,0.2053885692853252,0.5831777709191823
186,1565985600,492,592,100,1084,33,-0.5710460221548513,0.9028829116271522
186,1566000000,166,217,51,383,33,-0.8934637762274671,-0.6753797900368397
186,1566014400,33,70,37,103,33,-0.9855831345339287,-1.3057842928412873
186,1566028800,37,180,143,217,33,-0.2881079930707192,-1.0491196024137621
186,1566043200,228,839,611,1067,33,2.791310556030998,0.8646083525283107
186,1566057600,420,968,548,1388,33,2.3767734436519206,1.5873220861005524
186,1566072000,484,824,340,1308,33,1.0081429773844908,1.4072065138707102
186,1566086400,240,411,171,651,33,-0.10386927645779596,-0.07199262306686846
186,1566100800,38,79,41,117,33,-0.9592633178749397,-1.2742640677010648
186,1566115200,36,114,78,150,33,-0.7158050137792911,-1.1999663941562548
186,1566129600,195,690,495,885,33,2.028035872920316,0.4548454257054198
186,1566144000,367,857,490,1224,33,1.9951361020965797,1.2180851630293759
186,1566158400,404,658,254,1062,33,0.4422669192162265,0.8533511292639455
186,1566172800,192,297,105,489,33,-0.538146251331115,-0.43672665683229883
186,1566187200,32,43,11,75,33,-1.1566619428173575,-1.368824743121732
186,1566201600,101,238,137,339,33,-0.3275877180592028,-0.7744433547632529
186,1566216000,385,673,288,1058,33,0.6659853608176334,0.8443453506524534
186,1566230400,310,524,214,834,33,0.17906875262633618,0.34002174840889543
186,1566244800,465,563,98,1028,33,-0.5842059304843459,0.7768020110662627
186,1566259200,151,207,56,358,34,-0.8725705633337674,-0.7434162325073849
186,1566273600,13,16,3,29,34,-1.2295531169049796,-1.50103298158822
186,1566288000,111,220,109,331,34,-0.515588009762555,-0.8055914672343835
186,1566302400,427,714,287,1141,34,0.6833345286464223,1.0596655745755752
186,1566316800,332,542,210,874,34,0.16469949798635905,0.44482158671969996
186,1566331200,509,646,137,1155,34,-0.32699345315889566,1.0919045851747597
186,1566345600,153,184,31,337,34,-1.0409585603013203,-0.7917747484061616
186,1566360000,14,17,3,31,34,-1.2295531169049796,-1.4964274086454794
186,1566374400,107,249,142,356,34,-0.2933158537653851,-0.7480218054501255
186,1566388800,416,754,338,1170,34,1.0268460424602304,1.1264463822453146
186,1566403200,356,546,190,902,34,0.029989100412316654,0.5092996079180689
186,1566417600,455,706,251,1161,34,0.44085581301314597,1.1057213040029816
186,1566432000,145,221,76,366,34,-0.737860165759725,-0.7249939407364223
186,1566446400,15,15,0,30,34,-1.249759676541086,-1.4987301951168497
186,1566460800,109,247,138,356,34,-0.3202579332801936,-0.7480218054501255
186,1566475200,412,696,284,1108,34,0.6631279690103159,0.9836736210203547
186,1566489600,326,578,252,904,34,0.44759133289184805,0.5139051808608095
186,1566504000,512,618,106,1130,34,-0.5357945693986614,1.0343349233905017
186,1566518400,153,238,85,391,34,-0.6772404868514059,-0.6674242789521644
186,1566532800,15,16,1,31,34,-1.2430241566623839,-1.4964274086454794
186,1566547200,91,226,135,317,34,-0.34046449291629993,-0.837830477833568
186,1566561600,361,718,357,1079,34,1.1548209201555706,0.9168928133506155
186,1566576000,393,592,199,985,34,0.09060877932063573,0.7004308850418054
186,1566590400,474,578,104,1052,34,-0.5492656091560656,0.8547175786236169
186,1566604800,182,231,49,413,34,-0.9197192024846822,-0.6167629765820173
186,1566619200,57,94,37,151,34,-1.0005454410291077,-1.220093032081041
186,1566633600,70,197,127,267,34,-0.3943486519459169,-0.952969801402084
186,1566648000,256,803,547,1059,34,2.4345696971089734,0.870837083923209
186,1566662400,416,962,546,1378,34,2.427834177230271,1.605425968290341
186,1566676800,470,838,368,1308,34,1.228911638821294,1.4442309152944186
186,1566691200,299,498,199,797,34,0.09060877932063573,0.26750702842418533
186,1566705600,42,103,61,145,34,-0.8388929639402568,-1.233909750909263
186,1566720000,42,115,73,157,34,-0.7580667253958313,-1.2062763132528191
186,1566734400,207,713,506,920,34,2.1584133820821862,0.5507497644027346
186,1566748800,386,856,470,1242,34,1.91593466644891,1.2922470081839774
186,1566763200,423,698,275,1121,34,0.6025082901019968,1.0136098451481688
186,1566777600,190,398,208,588,34,0.1512284582289548,-0.2137753440922114
186,1566792000,30,46,16,76,34,-1.1419913584818522,-1.392802017433815
186,1566806400,111,228,117,339,34,-0.46170385073293807,-0.7871691754634209
186,1566820800,372,706,334,1078,34,0.9999039629454218,0.9145900268792451
186,1566835200,322,549,227,871,34,0.2792033359242951,0.437913227305589
186,1566849600,476,615,139,1091,34,-0.31352241340149145,0.9445262510070592
186,1566864000,168,196,28,364,35,-0.918384869591386,-0.4855627292542914
186,1566878400,19,27,8,46,35,-1.0998582383179831,-1.3200982860578323
186,1566892800,127,282,155,409,35,0.23397102182250545,-0.3674680749896394
186,1566907200,417,802,385,1219,35,2.3209147621783717,1.7582357017740968
186,1566921600,355,562,207,917,35,0.7058017805116579,0.9656893553757655
186,1566936000,502,701,199,1203,35,0.633212433021019,1.7162464913688873
186,1566950400,180,222,42,402,35,-0.791353511482768,-0.3858383545419186
186,1566964800,20,21,1,41,35,-1.1633739173722921,-1.3332199143094603
186,1566979200,118,303,185,421,35,0.506181074912401,-0.3359761671857322
186,1566993600,430,687,257,1117,35,1.1594852023281506,1.4905544854408856
186,1567008000,299,502,203,801,35,0.6695071067663384,0.6612675799379959
186,1567022400,496,659,163,1155,35,0.3065603693131443,1.5902788601532585
186,1567036800,178,229,51,407,35,-0.7096904955557993,-0.37271672629029057
186,1567051200,12,23,11,35,35,-1.0726372330089935,-1.3489658682114138
186,1567065600,126,275,149,401,35,0.17952901120452633,-0.38846268019224417
186,1567080000,443,707,264,1150,35,1.2230008813824595,1.5771572319016305
186,1567094400,399,519,120,918,35,-0.08360737344903944,0.9683136810260912
186,1567108800,561,576,15,1137,35,-1.0363425592636741,1.5430409984473976
186,1567123200,156,244,88,400,35,-0.3739647634115948,-0.3910870058425698
186,1567137600,17,27,10,44,35,-1.0817109014453234,-1.3253469373584834
186,1567152000,103,279,176,382,35,0.4245180589854324,-0.4383248675484306
186,1567166400,340,705,365,1045,35,2.139441393451775,1.3016030386174424
186,1567180800,354,617,263,971,35,1.2139272129461296,1.1074029404933479
186,1567195200,446,510,64,956,35,-0.5917328058835113,1.0680380557384639
186,1567209600,178,208,30,386,35,-0.9002375327187263,-0.4278275649471282
186,1567224000,19,44,25,63,35,-0.9456058749003755,-1.275484750002297
186,1567238400,26,91,65,117,35,-0.5826591374471815,-1.1337711648847146
186,1567252800,151,346,195,497,35,0.5969177592756996,-0.13652741776098656
186,1567267200,252,524,272,776,35,1.2955902288730983,0.5956594386798559
186,1567281600,338,405,67,743,35,-0.5645118005745217,0.5090566922191111
186,1567296000,168,175,7,343,35,-1.1089319067543129,-0.540673567911129
186,1567310400,22,55,33,77,35,-0.8730165274097367,-1.2387441908977386
186,1567324800,15,58,43,73,35,-0.7822798430464382,-1.249241493499041
186,1567339200,110,409,299,519,35,1.5405792766540043,-0.07879225345382336
186,1567353600,260,483,223,743,35,0.8509804754929355,0.5090566922191111
186,1567368000,318,387,69,705,35,-0.546364463701862,0.40933231750673826
186,1567382400,91,139,48,230,35,-0.736911500864789,-0.8372223663979218
186,1567396800,17,27,10,44,35,-1.0817109014453234,-1.3253469373584834
186,1567411200,18,70,52,88,35,-0.7006168271194695,-1.209876608744157
186,1567425600,123,386,263,509,35,1.2139272129461296,-0.10503550995707937
186,1567440000,194,490,296,684,35,1.5133582713450149,0.3542214788499007
186,1567454400,250,271,21,521,35,-0.981900548645695,-0.07354360215317217
186,1567468800,99,97,0,196,36,-1.294124521555012,-0.9716566779302881
186,1567483200,10,12,2,22,36,-1.2762715966394886,-1.3489008474205153
186,1567497600,138,262,124,400,36,-0.18724317679257113,-0.5293704102520908
186,1567512000,451,763,312,1214,36,1.4909317652666132,1.2354385205815008
186,1567526400,361,587,226,948,36,0.723255993899114,0.658731916648165
186,1567540800,557,678,121,1235,36,-0.214022564165856,1.2809679893130799
186,1567555200,164,214,50,378,36,-0.8478013986669309,-0.5770679489232688
186,1567569600,17,24,7,41,36,-1.2316392843506805,-1.3077075185681342
186,1567584000,164,329,165,493,36,0.1787417839756552,-0.3277399058693831
186,1567598400,486,784,298,1270,36,1.3659612908579506,1.356850437199045
186,1567612800,390,611,221,1001,36,0.6786236816103058,0.7736396234469123
186,1567627200,576,726,150,1302,36,0.044844847109230944,1.4262286752662134
186,1567641600,143,224,81,367,36,-0.5710810624763207,-0.600916718258858
186,1567656000,12,23,11,35,36,-1.195933434519634,-1.3207159382057283
186,1567670400,172,396,224,568,36,0.7054030689835907,-0.1651346603994576
186,1567684800,518,834,316,1352,36,1.5266376150976597,1.5346321722461638
186,1567699200,407,622,215,1029,36,0.6250649068637362,0.8343455817556845
186,1567713600,572,666,94,1238,36,-0.4550370505254197,1.287472199131877
186,1567728000,168,236,68,404,36,-0.6871250744272218,-0.5206981304936947
186,1567742400,18,21,3,39,36,-1.267345134181727,-1.312043658447332
186,1567756800,145,327,182,472,36,0.33049164575760276,-0.37326937460096227
186,1567771200,480,849,369,1329,36,1.9997401253590255,1.4847665636353866
186,1567785600,420,647,227,1067,36,0.7321824563568756,0.9167322394604468
186,1567800000,484,801,317,1285,36,1.5355640775554213,1.3893714862930302
186,1567814400,165,210,45,375,36,-0.892433710955739,-0.5835721587420659
186,1567828800,23,33,10,56,36,-1.2048598969773956,-1.275186469474149
186,1567843200,22,53,31,75,36,-1.0174041853644016,-1.233993140621768
186,1567857600,146,449,303,595,36,1.4105936031467585,-0.10659677203028442
186,1567872000,295,560,265,855,36,1.071388029751817,0.45710141226545736
186,1567886400,316,443,127,759,36,-0.1604637894192863,0.2489666980639527
186,1567900800,155,203,48,358,36,-0.8656543235824542,-0.620429347715249
186,1567915200,20,38,18,58,36,-1.1334481973153028,-1.2708503295949511
186,1567929600,25,63,38,88,36,-0.9549189481600704,-1.205808231406981
186,1567944000,133,360,227,493,36,0.7321824563568756,-0.3277399058693831
186,1567958400,238,455,217,693,36,0.6429178317792594,0.10587408205041825
186,1567972800,292,327,35,619,36,-0.9816983355333552,-0.05456309347990825
186,1567987200,85,133,48,218,36,-0.8656543235824542,-0.92395913925911
186,1568001600,12,19,7,31,36,-1.2316392843506805,-1.3293882179641243
186,1568016000,175,313,138,488,36,-0.06227270238390848,-0.33858025556737814
186,1568030400,508,829,321,1337,36,1.5712699273864676,1.5021111231521787
186,1568044800,376,626,250,1002,36,0.9374910928853928,0.7758076933865113
186,1568059200,546,724,178,1270,36,0.29478579592655624,1.356850437199045
186,1568073600,151,203,52,354,37,-0.7542894224753707,-0.6677114236933137
186,1568088000,14,18,4,32,37,-1.1832928305737904,-1.3495561299738374
186,1568102400,194,349,155,543,37,0.16628039073582163,-0.2674982265286585
186,1568116800,567,852,285,1419,37,1.328164621002375,1.5874581793773623
186,1568131200,387,593,206,980,37,0.6220965118403926,0.6578624462806236
186,1568145600,598,696,98,1294,37,-0.34316115638105177,1.3227669114113205
186,1568160000,164,245,81,409,37,-0.4950998634159087,-0.5512472657882553
186,1568174400,21,17,0,38,37,-1.219043114581992,-1.3368509491114673
186,1568188800,173,334,161,507,37,0.2199058167481241,-0.34372931170287857
186,1568203200,523,808,285,1331,37,1.328164621002375,1.401115526729269
186,1568217600,414,735,321,1149,37,1.6499171770761898,1.0157250405707121
186,1568232000,621,700,79,1321,37,-0.5129750054200095,1.3799402252919857
186,1568246400,167,227,60,394,37,-0.6827888544589673,-0.5830102179441803
186,1568260800,19,17,0,36,37,-1.219043114581992,-1.341086009398924
186,1568275200,186,337,151,523,37,0.13053010672762,-0.3098488294032252
186,1568275738,25,40,15,65,37,-1.0849795495512358,-1.2796776352308024
186,1568289600,537,813,276,1350,37,1.2477264819839213,1.4413485994601074
186,1568304000,425,659,234,1084,37,0.872348499897804,0.8780855812283704
186,1568318400,609,672,63,1281,37,-0.6559761414528161,1.2952390195428523
186,1568332800,169,231,62,400,37,-0.6649137124548665,-0.5703050370818104
186,1568347200,18,25,7,43,37,-1.1564801175676391,-1.3262632983928258
186,1568361600,171,319,148,490,37,0.10371739372146875,-0.37972732414626026
186,1568376000,490,813,323,1303,37,1.6677923190802906,1.3418246827048756
186,1568390400,444,658,214,1102,37,0.6935970798567959,0.9162011238154805
186,1568404800,538,674,136,1212,37,-0.0035334583031361674,1.149129439625597
186,1568419200,179,256,77,435,37,-0.5308501474241104,-0.49619148205131863
186,1568433600,27,39,12,66,37,-1.111792262557387,-1.277560105087074
186,1568448000,23,87,64,110,37,-0.6470385704507657,-1.1843887787630274
186,1568462400,157,485,328,642,37,1.7124801740905427,-0.057862742299553405
186,1568476800,296,598,302,894,37,1.480103328037232,0.47575485391998684
186,1568491200,367,466,99,833,37,-0.3342235853790014,0.3465855151525585
186,1568505600,165,197,32,362,37,-0.9330408425163789,-0.6507711825434871
186,1568520000,33,49,16,82,37,-1.0760419785491855,-1.2436796227874207
186,1568534400,22,58,36,80,37,-0.8972905585081772,-1.2479146830748773
186,1568548800,153,424,271,577,37,1.2030386269736693,-0.19550220164189513
186,1568563200,253,611,358,864,37,1.9806073041520549,0.41222894960813683
186,1568577600,344,349,5,693,37,-1.17435525957174,0.05013129503059165
186,1568592000,120,155,35,275,37,-0.9062281295102276,-0.8349963050478522
186,1568606400,15,21,6,36,37,-1.1654176885696894,-1.341086009398924
186,1568620800,180,334,154,514,37,0.1573428197337712,-0.32890660069678024
186,1568635200,514,794,280,1308,37,1.283476765992123,1.3524123334235174
186,1568649600,406,632,226,1038,37,0.8008479318814008,0.780679194616867
186,1568664000,582,730,148,1312,37,0.10371739372146875,1.3608824539984306
186,1568678400,165,226,61,391,38,-0.6394418012856423,-0.6224364587992959
186,1568692800,11,16,5,27,38,-1.1756154614010899,-1.3719487919848372
186,1568707200,193,302,109,495,38,-0.17986437832954436,-0.4082900778891412
186,1568721600,530,818,288,1348,38,1.5339764281109043,1.348122065537416
186,1568736000,385,688,303,1073,38,1.677594372784685,0.7818696160153724
186,1568750400,593,796,203,1389,38,0.7201414082928141,1.4325451580116115
186,1568764800,162,276,114,438,38,-0.1319917301049508,-0.5256587674264375
186,1568779200,17,14,0,31,38,-1.2234881096256833,-1.3637123927190622
186,1568793600,180,348,168,528,38,0.3850328707206594,-0.34033978394649594
186,1568808000,570,832,262,1402,38,1.285038657343018,1.459313455625381
186,1568822400,424,657,233,1081,38,1.0073772976403754,0.7983424145469228
186,1568836800,623,719,96,1342,38,-0.3043332637134875,1.3357674666387533
186,1568851200,176,249,73,425,38,-0.5245474455466178,-0.5524270650402069
186,1568865600,18,11,0,29,38,-1.2234881096256833,-1.3678305923519498
186,1568880000,178,315,137,493,38,0.08822245172817945,-0.4124082775220288
186,1568894400,544,781,237,1325,38,1.0456754162200501,1.3007627697592088
186,1568908800,424,574,150,998,38,0.21269133711212265,0.6274371297820878
186,1568923200,642,770,128,1412,38,0.0020516849239110933,1.479904453789819
186,1568937600,191,254,63,445,38,-0.6202927419958049,-0.5112450687113309
186,1568952000,16,14,0,30,38,-1.2234881096256833,-1.365771492535506
186,1568966400,184,351,167,535,38,0.37545834107574066,-0.3259260852313894
186,1568980800,645,818,173,1463,38,0.4329055189452529,1.5849185444284524
186,1568995200,440,668,228,1108,38,0.9595046494157818,0.8539381095909052
186,1569009600,556,666,110,1222,38,-0.17028984868462563,1.088675488665498
186,1569024000,185,240,55,425,38,-0.6968889791551546,-0.5524270650402069
186,1569038400,26,40,14,66,38,-1.0894446945968215,-1.2916438991435293
186,1569052800,26,68,42,94,38,-0.8213578645390978,-1.233989104283103
186,1569067200,197,457,260,654,38,1.2658895980531806,-0.08089320707457777
186,1569081600,376,531,155,907,38,0.2605639853367162,0.4400590464857024
186,1569096000,419,474,55,893,38,-0.6968889791551546,0.41123164905548926
186,1569110400,159,173,14,332,38,-1.0894446945968215,-0.7439233479694798
186,1569124800,22,41,19,63,38,-1.041572046372228,-1.2978211985928607
186,1569139200,21,54,33,75,38,-0.907528631343366,-1.2731120007955352
186,1569153600,141,412,271,553,38,1.3712094241472863,-0.2888622885354011
186,1569168000,328,455,127,783,38,-0.007522844721007614,0.1847306692466718
186,1569182400,356,321,0,677,38,-1.2234881096256833,-0.033533911296370476
186,1569196800,112,116,4,228,38,-1.1851899910460086,-0.9580697288796345
186,1569211200,12,23,11,35,38,-1.1181682835315776,-1.355475993453287
186,1569225600,171,340,169,511,38,0.39460740036557806,-0.37534448082604044
186,1569240000,446,893,447,1339,38,3.0563266416529786,1.329590167189422
186,1569254400,456,673,217,1129,38,0.854184823321676,0.8971792057362249
186,1569268800,579,745,166,1324,38,0.365883811430822,1.298703669942765
186,1569283200,170,228,58,398,39,-0.770115437731839,-0.6626870255117326
186,1569297600,24,17,0,41,39,-1.2515116928806098,-1.4029335620924464
186,1569312000,224,355,131,579,39,-0.1642201510790757,-0.2873799579456005
186,1569326400,672,924,252,1596,39,0.8400720363864634,1.821389587439794
186,1569340800,398,694,296,1092,39,1.2052691954648413,0.7763356534434923
186,1569355200,627,750,123,1377,39,-0.23061963454787168,1.367288770881877
186,1569369600,180,263,83,443,39,-0.5626170518918515,-0.5693786385477771
186,1569384000,28,16,0,44,39,-1.2515116928806098,-1.396713002961516
186,1569398400,199,382,183,581,39,0.26737649146809817,-0.2832329185249802
186,1569412800,598,809,211,1407,39,0.49977468360888405,1.4294943621911809
186,1569427200,394,648,254,1042,39,0.8566719072536625,0.6726596679279861
186,1569441600,605,748,143,1353,39,-0.06462092587588174,1.3175242978344341
186,1569456000,154,269,115,423,39,-0.29701911801666764,-0.6108490327539796
186,1569470400,18,19,1,37,39,-1.2432117574470103,-1.4112276409336868
186,1569484800,196,389,193,585,39,0.35037584580409314,-0.2749388396837398
186,1569499200,580,899,319,1479,39,1.3961677104376298,1.5787877813335096
186,1569513600,438,672,234,1110,39,0.6906731985816725,0.8136590082290744
186,1569528000,615,803,188,1418,39,0.3088761686360956,1.452303079004592
186,1569542400,190,255,65,445,39,-0.7120158896966425,-0.5652315991271569
186,1569556800,19,25,6,44,39,-1.2017120802790129,-1.396713002961516
186,1569571200,160,359,199,519,39,0.4001754584056901,-0.41179114056420785
186,1569585600,514,938,424,1452,39,2.267660930965577,1.5228027491551364
186,1569600000,422,718,296,1140,39,1.2052691954648413,0.8758645995383781
186,1569614400,579,672,93,1251,39,-0.4796176975558566,1.1060252873828018
186,1569628800,210,240,30,450,39,-1.002513629872625,-0.5548640005756063
186,1569643200,33,32,0,65,39,-1.2515116928806098,-1.3531690890450034
186,1569657600,35,102,67,137,39,-0.6954160188294435,-1.2038756699026745
186,1569672000,205,510,305,715,39,1.2799686143672369,-0.005381277343423844
186,1569686400,345,728,383,1073,39,1.9273635781879976,0.7369387789476
186,1569700800,417,621,204,1038,39,0.4416751355736876,0.6643655890867457
186,1569715200,481,211,0,692,39,-1.2515116928806098,-0.05307223068055666
186,1569729600,48,40,0,88,39,-1.2515116928806098,-1.3054781357078706
186,1569744000,49,67,18,116,39,-1.1021128550758188,-1.247419583819187
186,1569758400,140,410,270,550,39,0.9894708741912543,-0.34751202954459404
186,1569772800,291,540,249,831,39,0.815172230085665,0.23514700905255034
186,1569787200,299,376,77,675,39,-0.6124166644934486,-0.08832206575582874
186,1569801600,141,149,8,290,39,-1.1851122094118138,-0.8866271542252259
186,1569816000,17,23,6,40,39,-1.2017120802790129,-1.4050070818027565
186,1569830400,110,280,170,390,39,0.1594773308313047,-0.6792751831942136
186,1569844800,376,738,362,1114,39,1.753064934082408,0.821953087070315
186,1569859200,365,585,220,950,39,0.5744741025112795,0.4818958545794549
186,1569873600,486,583,97,1069,39,-0.4464179558214586,0.7286447001063595
186,1569888000,151,194,43,345,40,-0.9890388766038795,-0.6891742384217743
186,1569902400,14,13,0,27,40,-1.3557406239137966,-1.3409665573823477
186,1569916800,140,292,152,432,40,-0.05949258691129889,-0.5108536983287872
186,1569931200,467,775,308,1242,40,1.270867240538633,1.149372019778334
186,1569945600,358,598,240,956,40,0.6909668029322523,0.5631688649898936
186,1569960000,568,653,85,1221,40,-0.6308650769058208,1.1063291307903715
186,1569974400,175,220,45,395,40,-0.9719829813801624,-0.5866911694028162
186,1569988800,18,15,0,33,40,-1.3557406239137966,-1.328668589100073
186,1570003200,173,364,191,537,40,0.27309736995118405,-0.2956392533889752
186,1570017600,558,810,252,1368,40,0.7933021742745548,1.4076293537061084
186,1570032000,401,662,261,1063,40,0.8700537027812817,0.782482632690464
186,1570046400,609,796,187,1405,40,0.2389855795037499,1.4834668247801372
186,1570060800,163,262,99,425,40,-0.5114738103398013,-0.5252013279914414
186,1570075200,16,13,0,29,40,-1.3557406239137966,-1.3368672346215895
186,1570089600,192,349,157,541,40,-0.016852848852006202,-0.28744060786745856
186,1570104000,570,954,384,1524,40,1.9189912590398817,1.7273765290452576
186,1570118400,411,785,374,1196,40,1.8337117829212963,1.0550875962808925
186,1570132800,557,801,244,1358,40,0.7250785933796865,1.3871327399023168
186,1570147200,168,269,101,437,40,-0.4944179151160843,-0.5006053914268914
186,1570161600,13,32,19,45,40,-1.1937096192884844,-1.3040726525355228
186,1570176000,160,340,180,500,40,0.17928994622074015,-0.37147672446300417
186,1570190400,504,907,403,1411,40,2.081022263665194,1.4957647930624123
186,1570204800,422,663,241,1085,40,0.6994947505441109,0.8275751830588055
186,1570219200,566,731,165,1297,40,0.05137073204286209,1.2621033956991878
186,1570233600,163,262,99,425,40,-0.5114738103398013,-0.5252013279914414
186,1570248000,26,43,17,69,40,-1.2107655145122014,-1.254880779406423
186,1570262400,22,69,47,91,40,-0.9549270861564453,-1.2097882290380815
186,1570276800,169,469,300,638,40,1.2026436596437646,-0.08862345397067985
186,1570291200,292,500,208,792,40,0.4180724793527792,0.2270243986077111
186,1570305600,372,451,79,823,40,-0.6820327625769721,0.29056390139946514
186,1570320000,147,234,87,381,40,-0.6138091816821037,-0.6153864287281244
186,1570334400,19,36,17,55,40,-1.2107655145122014,-1.2835760387317312
186,1570348800,14,54,40,68,40,-1.014622719439455,-1.256930440786802
186,1570363200,129,334,205,463,40,0.39248863651720356,-0.44731419553703317
186,1570377600,273,497,224,770,40,0.5545196411425157,0.18193184823936953
186,1570392000,251,371,120,622,40,-0.33238691049077207,-0.12141803605674643
186,1570406400,95,113,18,208,40,-1.202237566900343,-0.9699778475337195
186,1570420800,12,18,6,30,40,-1.3045729382426452,-1.3348175732412102
186,1570435200,162,345,183,507,40,0.20487378905631576,-0.35712909480035004
186,1570449600,516,877,361,1393,40,1.7228484639671353,1.4588708882155874
186,1570464000,362,662,300,1024,40,1.2026436596437646,0.7025458388556767
186,1570478400,573,808,235,1381,40,0.6483270648729597,1.4342749516510376
186,1570492800,124,187,63,311,41,-0.6537879198706205,-0.7140373612529431
186,1570507200,8,9,1,17,41,-1.1542181795246758,-1.3333344980620563
186,1570521600,187,340,153,527,41,0.07264310220784673,-0.2590435464544112
186,1570536000,565,829,264,1394,41,0.968574696104623,1.5672510712785854
186,1570550400,414,672,258,1086,41,0.9201459612993919,0.9184635946214195
186,1570564800,592,729,137,1321,41,-0.05650019060610301,1.413480013499452
186,1570579200,192,171,0,363,41,-1.1622896353255476,-0.6045018132458891
186,1570593600,10,9,0,19,41,-1.1622896353255476,-1.3291215923694772
186,1570608000,123,271,148,394,41,0.03228582320348743,-0.5392017750109147
186,1570622400,410,850,440,1260,41,2.38915091705807,1.2849863898757925
186,1570636800,297,703,406,1000,41,2.114721419828427,0.7373086498405225
186,1570651200,461,662,201,1123,41,0.46007298064969593,0.9964023499341309
186,1570665600,128,154,26,282,41,-0.9524317845028792,-0.7751244937953387
186,1570680000,7,9,2,16,41,-1.1461467237238039,-1.3354409509083458
186,1570694400,186,310,124,496,41,-0.16142911601743717,-0.3243435846893857
186,1570708800,599,869,270,1468,41,1.0170034309098541,1.7231285819040085
186,1570723200,407,648,241,1055,41,0.7829312126845702,0.8531635563864449
186,1570737600,659,770,111,1429,41,-0.26635804142877134,1.640976920898718
186,1570752000,161,198,37,359,41,-0.8636457706932889,-0.6129276246310472
186,1570766400,10,12,2,22,41,-1.1461467237238039,-1.3228022338306087
186,1570780800,145,323,178,468,41,0.27442949722964316,-0.38332426438549166
186,1570795200,502,873,371,1375,41,1.8322204667979118,1.527228467199085
186,1570809600,458,737,279,1195,41,1.0896465331177008,1.1480669548669749
186,1570824000,541,711,170,1252,41,0.2098578508226683,1.2681347671054766
186,1570838400,175,210,35,385,41,-0.8797886822950325,-0.5581598506275202
186,1570852800,22,31,9,53,41,-1.0896465331177008,-1.2575021955956343
186,1570867200,29,63,34,92,41,-0.8878601380959044,-1.1753505345903437
186,1570881600,156,471,315,627,41,1.3802189419490878,-0.04839826182546115
186,1570896000,316,516,200,832,41,0.45200152484882405,0.3834245716638864
186,1570910400,381,491,110,872,41,-0.27442949722964316,0.4676826855154664
186,1570924800,151,205,54,356,41,-0.7264310220784672,-0.6192469831699157
186,1570939200,40,37,0,77,41,-1.1622896353255476,-1.2069473272846862
186,1570953600,18,43,25,61,41,-0.9605032403037511,-1.2406505728253183
186,1570968000,138,416,278,554,41,1.081575077316829,-0.20216931960459467
186,1570982400,317,514,197,831,41,0.4277871574462085,0.38131811881759686
186,1570996800,319,368,49,687,41,-0.7667883010828265,0.07798890895190887
186,1571011200,105,149,44,254,41,-0.8071455800871858,-0.8341051734914448
186,1571025600,13,17,4,30,41,-1.1300038121220601,-1.3059506110602928
186,1571040000,86,166,80,252,41,-0.5165731712557989,-0.8383180791840237
186,1571054400,355,670,315,1025,41,1.3802189419490878,0.7899699709977599
186,1571068800,357,617,260,974,41,0.9362888729011356,0.6825408758369954
186,1571083200,474,631,157,1105,41,0.10492892541133415,0.9584861987009199
186,1571097600,117,187,70,304,42,-0.6906388086457641,-0.7774650044452355
186,1571112000,13,15,2,28,42,-1.3125753274262428,-1.3516019388460851
186,1571126400,176,317,141,493,42,-0.04126391403673488,-0.3843060167576971
186,1571140800,527,845,318,1372,42,1.5776002598477463,1.4441953069319657
186,1571155200,389,669,280,1058,42,1.230047499352773,0.7910105337367961
186,1571169600,630,765,135,1395,42,-0.09614066569383593,1.4920400514653698
186,1571184000,163,246,83,409,42,-0.5717391800553785,-0.5590433446188252
186,1571198400,14,15,1,29,42,-1.3217214527024261,-1.3495217325620241
186,1571212800,171,302,131,473,42,-0.13272516679856997,-0.42591014243891806
186,1571227200,570,861,291,1431,42,1.3306548773907916,1.5669274776915676
186,1571241600,428,630,202,1058,42,0.5166497278104593,0.7910105337367961
186,1571256000,494,821,327,1315,42,1.6599153873333978,1.325623548740486
186,1571270400,129,242,113,371,42,-0.2973554217698732,-0.6380911834131452
186,1571284800,10,15,5,25,42,-1.2851369515976923,-1.3578425576982684
186,1571299200,178,284,106,462,42,-0.36137829870315774,-0.4487924115635896
186,1571313600,585,901,316,1486,42,1.5593080092953793,1.6813388233149253
186,1571328000,424,699,275,1123,42,1.1843168729718554,0.9262239422007643
186,1571342400,600,771,171,1371,42,0.2331198442487704,1.4421151006479047
186,1571356800,159,233,74,392,42,-0.65405430754103,-0.5944068514478631
186,1571371200,19,47,28,66,42,-1.0747760702454714,-1.2725541000517653
186,1571385600,148,318,170,466,42,0.2239737189725869,-0.4404715864273454
186,1571388470,213,240,27,453,42,-1.083922195521655,-0.4675142681201391
186,1571400000,335,628,293,963,42,1.3489471279431586,0.5933909367509963
186,1571414400,433,639,206,1072,42,0.5532342289151932,0.8201334217136508
186,1571428800,565,702,137,1267,42,-0.07784841514146892,1.2257736471055554
186,1571443200,168,271,103,439,42,-0.38881667453170826,-0.49663715609699377
186,1571457600,29,34,5,63,42,-1.2851369515976923,-1.2787947189039486
186,1571472000,29,74,45,103,42,-0.9192919405503518,-1.1955864675415064
186,1571486400,171,483,312,654,42,1.5227235081906452,-0.049392805023868065
186,1571500800,345,683,338,1028,42,1.7605227653714166,0.7286043452149645
186,1571515200,417,497,80,914,42,-0.599177555883929,0.49146082883200487
186,1571529600,151,225,74,376,42,-0.65405430754103,-0.62769015199284
186,1571544000,33,38,5,71,42,-1.2851369515976923,-1.2621530686314602
186,1571558400,19,49,30,68,42,-1.0564838196931043,-1.2683936874836432
186,1571572800,189,434,245,623,42,0.9099331146863501,-0.11387919982976061
186,1571587200,318,566,248,884,42,0.9373714905149007,0.4290546403101734
186,1571601600,250,359,109,609,42,-0.33393992287460716,-0.1430020878066153
186,1571616000,111,145,34,256,42,-1.0198993185883705,-0.8773149060801658
186,1571630400,12,14,2,26,42,-1.3125753274262428,-1.3557623514142074
186,1571644800,154,283,129,437,42,-0.151017417350937,-0.5007975686651158
186,1571659200,515,812,297,1327,42,1.3855316290478927,1.3505860241492185
186,1571673600,383,612,229,995,42,0.763595110267414,0.6599575378409499
186,1571688000,659,729,70,1388,42,-0.6906388086457641,1.4774786074769424
186,1571702400,149,194,45,343,43,-0.7650959824096137,-0.6604023662857963
186,1571716800,13,17,4,30,43,-1.1375854598507658,-1.298243047146356
186,1571731200,168,304,136,472,43,0.06164895532562613,-0.397522341266588
186,1571745600,534,906,372,1440,43,2.2057347279137205,1.5750967612031304
186,1571760000,408,714,306,1122,43,1.6061175203255247,0.9270669320860121
186,1571774400,565,698,133,1263,43,0.03439362770798086,1.2144009129209608
186,1571788800,140,280,140,420,43,0.09798939214915316,-0.5034894831347959
186,1571803200,11,12,1,23,43,-1.164840787468411,-1.3125078547055378
186,1571817600,177,316,139,493,43,0.08890428294327139,-0.3547279185890424
186,1571832000,611,836,225,1447,43,0.8702236746491024,1.5893615687623122
186,1571846400,392,679,287,1071,43,1.4335004454137714,0.8231376198691158
186,1571860800,644,663,19,1307,43,-1.0013088217625394,1.3040654175786752
186,1571875200,185,225,40,410,43,-0.8105215284390225,-0.5238677796479129
186,1571889600,17,13,0,30,43,-1.1739258966742927,-1.298243047146356
186,1571904000,174,345,171,519,43,0.3796277775314876,-0.3017443476549384
186,1571918400,571,838,267,1409,43,1.2517982612961362,1.5119240420124678
186,1571932800,419,716,297,1135,43,1.524351537472589,0.9535587175530641
186,1571947200,621,773,152,1394,43,0.20701070261973423,1.4813565972427924
186,1571961600,148,279,131,427,43,0.016223409296217347,-0.4892246755756141
186,1571976000,17,22,5,39,43,-1.1285003506448839,-1.2799025802845507
186,1571990400,151,305,154,456,43,0.22518092103149775,-0.430127615687575
186,1572004800,546,884,338,1430,43,1.896841014913741,1.5547184646900134
186,1572019200,403,688,285,1091,43,1.4153302270020078,0.8638942128953496
186,1572033600,517,715,198,1232,43,0.6249257260902951,1.1512281937302982
186,1572048000,178,225,47,403,43,-0.7469257639978502,-0.5381325872070948
186,1572062400,32,23,0,55,43,-1.1739258966742927,-1.2472973058635637
186,1572076800,21,60,39,81,43,-0.8196066376449043,-1.1943137349294597
186,1572091200,160,424,264,584,43,1.224542933678491,-0.16928542031967841
186,1572105600,342,442,100,784,43,-0.2654149760861171,0.23828050994266006
186,1572120000,374,373,0,747,43,-1.1739258966742927,0.16288081284412745
186,1572134400,120,190,70,310,43,-0.5379682522625698,-0.7276507447790821
186,1572148800,27,50,23,77,43,-0.9649683849390124,-1.2024650535347063
186,1572163200,16,39,23,55,43,-0.9649683849390124,-1.2472973058635637
186,1572177600,120,377,257,497,43,1.1609471692373186,-0.34657659998379564
186,1572192000,222,381,159,603,43,0.2706064670609065,-0.13056665694475625
186,1572206400,277,221,0,498,43,-1.1739258966742927,-0.344538770332484
186,1572220800,82,99,17,181,43,-1.0194790401743028,-0.9905307697982905
186,1572235200,15,17,2,32,43,-1.1557556782625291,-1.2941673878437325
186,1572249600,167,296,129,463,43,-0.0019468091155461645,-0.4158628081283932
186,1572264000,515,752,237,1267,43,0.9792449851196835,1.2225522315262074
186,1572278400,458,594,136,1052,43,0.06164895532562613,0.7844188564941936
186,1572292800,623,702,79,1325,43,-0.456202269409634,1.3407463513022857
186,1572307200,145,236,91,381,44,-0.3147499238571098,-0.611277996689809
186,1572321600,11,15,4,26,44,-1.192156380749396,-1.3108175888233973
186,1572336000,157,334,177,491,44,0.5525714013467593,-0.394519249831514
186,1572350400,597,899,302,1496,44,1.8132128623988943,1.585867482828363
186,1572364800,406,650,244,1056,44,1.2282752244707038,0.718832495395183
186,1572379200,600,719,119,1319,44,-0.032366236581431514,1.2370829537927428
186,1572393600,159,219,60,378,44,-0.6273890061980394,-0.6171895988768534
186,1572408000,13,14,1,27,44,-1.2224117758146473,-1.3088470547610491
186,1572422400,166,336,170,502,44,0.4819754795278397,-0.3728433751456845
186,1572436800,603,767,164,1370,44,0.42146468939733717,1.3375801909724978
186,1572451200,383,726,343,1109,44,2.2267032616239946,0.8232708006996342
186,1572465600,616,738,122,1354,44,-0.0021108415161802696,1.3060516459749276
186,1572480000,168,246,78,414,44,-0.4458566358065319,-0.5462503726323205
186,1572494400,15,17,2,32,44,-1.2123266441262301,-1.2989943844493086
186,1572508800,150,296,146,446,44,0.2399323190058297,-0.4831932826371801
186,1572523200,560,854,294,1414,44,1.7325318088915578,1.4242836897158158
186,1572537600,427,682,255,1109,44,1.3392116730432915,0.8232708006996342
186,1572552000,567,683,116,1250,44,-0.06262163164668276,1.1011161034907215
186,1572566400,157,232,75,389,44,-0.47611203087178317,-0.5955137241910239
186,1572580800,21,33,12,54,44,-1.1114753272420592,-1.2556426350776495
186,1572595200,138,297,159,435,44,0.37103903095525176,-0.5048691573230096
186,1572609600,571,819,248,1390,44,1.268615751224372,1.3769908722194606
186,1572624000,448,593,145,1041,44,0.22984718731741263,0.689274484459961
186,1572638400,588,713,125,1301,44,0.02814455354907098,1.2016133406704763
186,1572652800,172,221,49,393,44,-0.7383254547706273,-0.5876315879416313
186,1572667200,23,36,13,59,44,-1.1013901955536423,-1.2457899647659088
186,1572681600,20,74,54,94,44,-0.6878997963285418,-1.1768212725837242
186,1572696000,172,378,206,550,44,0.8450402203108547,-0.27825774015297394
186,1572710400,283,517,234,800,44,1.1274239075865329,0.21437577543406014
186,1572724800,402,404,2,806,44,-1.2123266441262301,0.22619897980814893
186,1572739200,170,213,43,383,44,-0.7988362449011298,-0.6073369285651127
186,1572750000,23,39,16,62,44,-1.071134800488391,-1.2398783625788645
186,1572764400,11,31,20,42,44,-1.0307942737347227,-1.279289043825827
186,1572778800,121,322,201,443,44,0.7946145618687692,-0.48910488482422454
186,1572793200,573,619,46,1192,44,-0.7685808498358785,0.9868251278745296
186,1572807600,754,391,0,1145,44,-1.2324969075030643,0.8942100269441672
186,1572822000,108,166,58,274,44,-0.6475592695748735,-0.8221251413610595
186,1572836400,25,30,5,55,44,-1.1820712490609788,-1.2536721010153014
186,1572850800,42,90,48,132,44,-0.7484105864590443,-1.1019409782144949
186,1572865200,617,916,299,1533,44,1.7829574673336432,1.658777243135244
186,1572879600,367,641,274,1008,44,1.5308291751232161,0.6242468604024725
186,1572894000,629,774,145,1403,44,0.22984718731741263,1.4026078150299863
186,1572908400,237,327,90,564,44,-0.3248350555455269,-0.2506702632801
186,1572922800,37,28,0,65,45,-1.149117244182526,-1.0390404685998547
186,1572937200,44,107,63,151,45,-0.6315743968451704,-0.8895418160909845
186,1572951600,575,891,316,1466,45,1.4468119583350032,1.3963968821551107
186,1572966000,370,660,290,1030,45,1.2332228467354596,0.6384734810636298
186,1572980400,658,714,56,1372,45,-0.689079157660432,1.2329913782500668
186,1572994800,210,384,174,594,45,0.28028681036826547,-0.11944992002785128
186,1573009200,35,39,4,74,45,-1.116257380859519,-1.023395260779159
186,1573023600,44,87,43,131,45,-0.7958737134602039,-0.9243089445814194
186,1573038000,675,946,271,1621,45,1.0771384959511778,1.6658421279559812
186,1573052400,334,641,307,975,45,1.3728772658582382,0.5428638777149337
186,1573066800,598,756,158,1354,45,0.14884735707623867,1.2017009626086752
186,1573081200,190,324,134,514,45,-0.0483118228618015,-0.2585184339895909
186,1573095600,0,6,6,6,45,-1.0998274491980158,-1.1416034976466376
186,1573110000,39,64,25,103,45,-0.9437430984137339,-0.9729829244680283
186,1573124400,635,952,317,1587,45,1.4550269241657547,1.6067380095222419
186,1573138800,348,606,258,954,45,0.9703439401514061,0.5063583927999771
186,1573153200,682,810,128,1492,45,-0.09760161784631155,1.441594149192676
186,1573167600,172,316,144,488,45,0.03383783544571524,-0.3037157010271563
186,1573182000,0,4,4,4,45,-1.116257380859519,-1.145080210495681
186,1573196400,38,74,36,112,45,-0.8533784742754655,-0.9573377166473326
186,1573210800,587,860,273,1447,45,1.0935684276126811,1.3633681100891977
186,1573225200,378,696,318,1074,45,1.4632418899965065,0.7149611637425866
186,1573239600,595,749,154,1344,45,0.11598749375323197,1.1843173983634578
186,1573254000,230,308,78,538,45,-0.5083499093838952,-0.21679787980106902
186,1573268400,31,52,21,83,45,-0.9766029617367407,-1.007750052958463
186,1573282800,11,30,19,41,45,-0.993032893398244,-1.0807610227883766
186,1573297200,131,343,212,474,45,0.5924555119368291,-0.32805269097046075
186,1573311600,289,584,295,873,45,1.274297675889218,0.3655515224137157
186,1573326000,366,424,58,790,45,-0.6726492259989287,0.22126793917841084
186,1573340400,146,227,81,373,45,-0.4837050118916402,-0.503626689847157
186,1573354800,32,60,28,92,45,-0.919098200921479,-0.9921048451377675
186,1573369200,12,33,21,45,45,-0.9766029617367407,-1.0738075970902896
186,1573383600,87,287,200,374,45,0.493875921967809,-0.5018883334226353
186,1573398000,262,552,290,814,45,1.2332228467354596,0.2629884933669327
186,1573412400,309,374,65,683,45,-0.615144465183667,0.035263801754584066
186,1573426800,92,161,69,253,45,-0.5822846018606603,-0.7122294607897665
186,1573441200,15,30,15,45,45,-1.0258927567212508,-1.0738075970902896
186,1573455600,32,71,39,103,45,-0.8287335767832106,-0.9729829244680283
186,1573470000,479,756,277,1235,45,1.126428290935688,0.9948365480905875
186,1573484400,184,217,33,401,45,-0.8780233717677206,-0.45495270996054815
186,1573498800,870,1348,478,2218,45,2.7776364229167743,2.7036409133954633
186,1573513200,162,279,117,441,45,-0.18796624198457995,-0.38541845297967836
186,1573527600,0,6,6,6,46,-1.2355648291341794,-1.2108932714687797
186,1573542000,39,84,45,123,46,-0.9053551391159405,-0.9947926890828133
186,1573556400,679,925,246,1604,46,0.7964948017472905,1.740634340948094
186,1573570800,307,640,333,947,46,1.5331164179418233,0.527146455242283
186,1573585200,611,845,234,1456,46,0.694891820203217,1.46727633929747
186,1573599600,198,315,117,513,46,-0.2957372498514995,-0.2744574144629255
186,1573614000,0,3,3,3,46,-1.2609655745201978,-1.2164343120427787
186,1573628400,43,81,38,124,46,-0.96462354501665,-0.992945675558147
186,1573642800,679,909,230,1588,46,0.6610241596885259,1.711082124553432
186,1573657200,300,595,295,895,46,1.2113736430522573,0.43110175195963135
186,1573671600,613,727,114,1340,46,-0.3211379952375179,1.25302277043617
186,1573686000,191,332,141,523,46,-0.09253128676335254,-0.2559872792162617
186,1573700400,0,1,1,1,46,-1.2778994047775434,-1.2201283390921116
186,1573714800,46,86,40,132,46,-0.9476897147593044,-0.978169567360816
186,1573729200,631,857,226,1488,46,0.6271564991738346,1.5263807720867941
186,1573743600,327,598,271,925,46,1.0081676799641104,0.4865121576996227
186,1573758000,621,819,198,1440,46,0.3900828755709965,1.437724122902808
186,1573772400,184,322,138,506,46,-0.11793203214937091,-0.2873865091355901
186,1573786800,0,5,5,5,46,-1.2440317442628521,-1.212740284993446
186,1573801200,36,71,35,107,46,-0.9900242904026684,-1.0243449054774754
186,1573815600,518,903,385,1421,46,1.9733960046328085,1.4026308659341467
186,1573830000,373,643,270,1016,46,0.9997007648354375,0.6545903884442632
186,1573844400,564,771,207,1335,46,0.4662851117290517,1.2437877028128381
186,1573858800,235,301,66,536,46,-0.7275499214138119,-0.23197610339559877
186,1573873200,36,84,48,120,46,-0.8799543937299221,-1.0003337296568124
186,1573887600,17,35,18,52,46,-1.1339618475901059,-1.1259306493341261
186,1573902000,133,427,294,560,46,1.2029067279235846,-0.18764777880360567
186,1573916400,292,690,398,982,46,2.0834659013055545,0.5917919286056063
186,1573930800,367,602,235,969,46,0.7033587353318899,0.5677807527849433
186,1573945200,195,340,145,535,46,-0.05866362624866138,-0.23382311692026514
186,1573959600,39,61,22,100,46,-1.1000941870754146,-1.03727400015014
186,1573974000,8,27,19,35,46,-1.125494932461433,-1.1573298792534548
186,1573988400,85,299,214,384,46,0.5255535176297612,-0.5127221591448884
186,1574002800,227,548,321,775,46,1.4315134363977498,0.20946012899966585
186,1574017200,284,332,48,616,46,-0.8799543937299221,-0.08421502142228843
186,1574031600,80,155,75,235,46,-0.6513476852557567,-0.7879271743201789
186,1574046000,18,19,1,37,46,-1.2778994047775434,-1.153635852204122
186,1574060400,42,74,32,116,46,-1.0154250357886867,-1.007721783755478
186,1574074800,604,851,247,1455,46,0.8049617168759633,1.4654293257728035
186,1574089200,309,591,282,900,46,1.101303746379511,0.4403368195829632
186,1574103600,596,816,220,1412,46,0.576355008401798,1.3860077442121492
186,1574118000,176,294,118,470,46,-0.28727033472282676,-0.35387899602357975
186,1574132400,0,16,16,16,47,-1.017521718677656,-1.1334852595485512
186,1574146800,45,78,33,123,47,-0.861651624891806,-0.938794739887521
186,1574161200,635,888,253,1523,47,1.155490765278016,1.6085578538081984
186,1574175600,306,625,319,931,47,1.7606334823289624,0.5313916141882941
186,1574190000,627,818,191,1445,47,0.5870233644119752,1.4666339235880081
186,1574204400,182,258,76,440,47,-0.46739197590406806,-0.3620013311721332
186,1574218800,0,4,4,4,47,-1.1275476672323734,-1.1553197103516573
186,1574233200,40,86,46,126,47,-0.742456847290862,-0.9333361271867445
186,1574247600,664,900,236,1564,47,0.999620671492166,1.6831588940521442
186,1574262000,311,558,247,869,47,1.1004777910006571,0.41858028503891226
186,1574276400,635,804,169,1439,47,0.38530912539499296,1.455716698186455
186,1574290800,176,307,131,483,47,0.036893621638387386,-0.2837612157943361
186,1574305200,0,4,4,4,47,-1.1275476672323734,-1.1553197103516573
186,1574319600,34,83,49,117,47,-0.7149503601521826,-0.9497119652890742
186,1574334000,670,966,296,1636,47,1.5497504142657539,1.8141655988707814
186,1574348400,327,648,321,975,47,1.7789711404214155,0.6114512671330167
186,1574362800,656,812,156,1468,47,0.26611434779404897,1.508483287627295
186,1574377200,210,274,64,484,47,-0.5774179244587856,-0.2819416782274106
186,1574391600,0,2,2,2,47,-1.1458853253248265,-1.1589587854855083
186,1574406000,36,84,48,120,47,-0.724119189198409,-0.9442533525882977
186,1574420400,593,816,223,1409,47,0.880425893891222,1.4011305711786897
186,1574434800,388,635,247,1023,47,1.1004777910006571,0.6987890703454414
186,1574449200,565,823,258,1388,47,1.2013349105091482,1.362920282273254
186,1574463600,199,373,174,572,47,0.4311532706261253,-0.12182237233796538
186,1574478000,38,59,21,97,47,-0.9716775734465235,-0.9861027166275844
186,1574492400,6,25,19,31,47,-0.9900152315389765,-1.1061921960446683
186,1574506800,111,277,166,388,47,0.3578026382563136,-0.4566172846522599
186,1574521200,278,439,161,717,47,0.3119584930251813,0.14201057486623414
186,1574535600,361,337,0,698,47,-1.1642229834172793,0.10743936109464937
186,1574550000,157,202,45,359,47,-0.7516256763370884,-0.5093838740930998
186,1574564400,43,60,17,103,47,-1.0083528896314293,-0.9751854912260314
186,1574578800,8,22,14,30,47,-1.0358593767701088,-1.1080117336115938
186,1574593200,79,289,210,368,47,0.761231116290278,-0.4930080359907702
186,1574607600,186,464,278,650,47,1.3847114914336776,0.020101557882224706
186,1574622000,283,270,0,553,47,-1.1642229834172793,-0.15639358610955015
186,1574636400,83,123,40,206,47,-0.7974698215682208,-0.7877731218327034
186,1574650800,21,23,2,44,47,-1.1458853253248265,-1.0825382076746366
186,1574665200,36,75,39,111,47,-0.8066386506144472,-0.9606291906906272
186,1574679600,602,909,307,1511,47,1.650607533774245,1.586723403005092
186,1574694000,337,607,270,944,47,1.3113608590638657,0.5550456025583258
186,1574708400,605,753,148,1358,47,0.19276371542423726,1.3083341552654886
186,1574722800,237,270,33,507,47,-0.861651624891806,-0.24009231418812377
186,1574737200,30,35,5,65,48,-0.850258466308756,-0.9467890058922215
186,1574751600,39,74,35,113,48,-0.5796533469480506,-0.8511038928042568
186,1574766000,589,875,286,1464,48,1.6844094850365177,1.8420333526507477
186,1574780400,361,606,245,967,48,1.314582488576887,0.8512937442191139
186,1574794800,697,716,19,1413,48,-0.7239760772737601,1.7403679199947852
186,1574809200,223,301,78,524,48,-0.19178600919770625,-0.0318001119885597
186,1574823600,30,43,13,73,48,-0.7780971011459012,-0.9308414870442274
186,1574838000,32,77,45,109,48,-0.48945164049448214,-0.8590776522282539
186,1574852400,401,862,461,1263,48,3.262939347973966,1.4413519415948957
186,1574866800,675,702,27,1377,48,-0.6518147121109054,1.6686040851788118
186,1574881200,1361,640,0,2001,48,-0.8953593195355403,2.912510555322352
186,1574895600,650,236,0,886,48,-0.8953593195355403,0.6898251158831735
186,1574910000,74,38,0,112,48,-0.8953593195355403,-0.8530973326602561
186,1574924400,26,39,13,65,48,-0.7780971011459012,-0.9467890058922215
186,1574938800,149,215,66,364,48,-0.3000280569419884,-0.3507504889484418
186,1574953200,218,373,155,591,48,0.5027671304947708,0.10176035836339094
186,1574967600,130,275,145,405,48,0.41256542404120244,-0.26901945485247203
186,1574982000,91,137,46,228,48,-0.4804314698491253,-0.6218583093643416
186,1574996400,24,36,12,60,48,-0.7871172717912581,-0.9567562051722178
186,1575010800,12,48,36,60,48,-0.5706331763026938,-0.9567562051722178
186,1575025200,129,457,328,586,48,2.063256652141505,0.09179315908339462
186,1575039600,272,570,298,842,48,1.7926515327808,0.602113762219206
186,1575054000,392,521,129,913,48,0.2682426937154929,0.7436479919951536
186,1575068400,145,235,90,380,48,-0.0835439614534241,-0.31885545125245357
186,1575082800,38,46,8,84,48,-0.8231979543726855,-0.9089136486282354
186,1575097200,9,25,16,34,48,-0.7510365892098307,-1.0085856414281986
186,1575111600,93,245,152,338,48,0.47570661855870033,-0.40257992520442265
186,1575126000,244,335,91,579,48,-0.07452379080806724,0.07783908009139978
186,1575140400,256,347,91,603,48,-0.07452379080806724,0.1256816366353821
186,1575154800,163,163,0,326,48,-0.8953593195355403,-0.4265012034764138
186,1575169200,33,49,16,82,48,-0.7510365892098307,-0.912900528340234
186,1575183600,9,14,5,23,48,-0.850258466308756,-1.0305134798441906
186,1575198000,73,221,148,294,48,0.43962593597727295,-0.4902912788683902
186,1575212400,205,356,151,561,48,0.4666864479133435,0.04195716268341304
186,1575226800,192,225,33,417,48,-0.5976936882387643,-0.24509817658048086
186,1575241200,84,106,22,190,48,-0.6969155653376896,-0.6976090238923136
186,1575255600,20,22,2,42,48,-0.8773189782448265,-0.9926381225802046
186,1575270000,43,77,34,120,48,-0.5886735175934075,-0.837149813812262
186,1575284400,610,813,203,1423,48,0.9357353214718995,1.760302318554778
186,1575298800,275,584,309,859,48,1.8918734098797252,0.6360022397711934
186,1575313200,569,786,217,1355,48,1.0620177105068953,1.624748408346828
186,1575327600,174,313,139,487,48,0.3584444001690614,-0.10555738666053244
186,1575342000,19,24,5,43,49,-1.2889320487589964,-1.1645976158207976
186,1575356400,47,74,27,121,49,-1.0763341885209898,-1.0164911798957614
186,1575370800,653,881,228,1534,49,0.8660371709262518,1.6665138709000868
186,1575385200,317,569,252,886,49,1.0979621093677134,0.43609117244593987
186,1575399600,607,745,138,1352,49,-0.0036813482292295373,1.3209321870750024
186,1575414000,225,314,89,539,49,-0.47719476421388046,-0.22279258737441351
186,1575428400,25,26,1,51,49,-1.3275862051659066,-1.1494072121361785
186,1575442800,40,81,41,121,49,-0.9410446410968039,-1.0164911798957614
186,1575457200,653,839,186,1492,49,0.46016852865369384,1.5867642515558367
186,1575471600,312,569,257,881,49,1.1462798048763514,0.42659717014305293
186,1575486000,597,790,193,1387,49,0.5278133023657868,1.387390203195211
186,1575500400,230,372,142,602,49,0.034972808177680746,-0.10316815835803812
186,1575514800,17,18,1,35,49,-1.3275862051659066,-1.1797880195054167
186,1575529200,40,87,47,127,49,-0.8830634064864384,-1.0050983771322972
186,1575543600,643,911,268,1554,49,1.2525787349953545,1.7044898801116346
186,1575558000,321,620,299,941,49,1.5521484471489093,0.5405251977776961
186,1575572400,653,771,118,1424,49,-0.19695213026378094,1.4576458202365743
186,1575586800,208,382,174,590,49,0.344206059432963,-0.12595376388496676
186,1575601200,20,23,3,43,49,-1.3082591269624515,-1.1645976158207976
186,1575615600,34,79,45,113,49,-0.9023904846898936,-1.0316815835803805
186,1575630000,601,891,290,1492,49,1.465176595233361,1.5867642515558367
186,1575644400,353,607,254,960,49,1.1172891875711686,0.5766024065286666
186,1575658800,581,785,204,1366,49,0.6341122324847901,1.347515393523086
186,1575673200,253,313,60,566,49,-0.75743739816398,-0.17152497493882407
186,1575687600,45,81,36,126,49,-0.9893623366054417,-1.0069971775928745
186,1575702000,11,37,26,48,49,-1.0859977276227175,-1.1551036135179107
186,1575716400,127,313,186,440,49,0.46016852865369384,-0.4107738329715749
186,1575730800,251,493,242,744,49,1.0013267183504377,0.16646150704395088
186,1575745200,336,432,96,768,49,-0.4095499905017875,0.2120327180978082
186,1575759600,154,281,127,435,49,-0.1099802783482328,-0.4202678352744618
186,1575774000,39,67,28,106,49,-1.0666706494192624,-1.0449731868044223
186,1575788400,9,21,12,30,49,-1.2212872750469035,-1.1892820218083038
186,1575802800,96,286,190,382,49,0.4988226850606041,-0.5209042596850634
186,1575817200,243,516,273,759,49,1.3008964305039925,0.1949435139526117
186,1575831600,284,411,127,695,49,-0.1099802783482328,0.0734202844756589
186,1575846000,120,177,57,297,49,-0.7864280154691627,-0.6823022988341413
186,1575860400,17,26,9,43,49,-1.250277892352086,-1.1645976158207976
186,1575874800,41,83,42,124,49,-0.9313811019950763,-1.0107947785140292
186,1575889200,624,846,222,1470,49,0.8080559363158863,1.544990641423134
186,1575903600,300,671,371,971,49,2.2479232624732943,0.5974892115950178
186,1575918000,537,823,286,1360,49,1.4265224388264508,1.3361225907596215
186,1575932400,194,354,160,548,49,0.208916512008777,-0.20570338322921702
186,1575946800,22,26,4,48,50,-1.4163124648968615,-1.175576031505706
186,1575961200,37,85,48,122,50,-0.9820424408169875,-1.036148811283621
186,1575975600,636,912,276,1548,50,1.2682658657787227,1.6506514054284467
186,1575990000,325,622,297,947,50,1.475531104544117,0.5182762790301629
186,1576004400,613,798,185,1411,50,0.37011649779534705,1.3925226328551275
186,1576018800,227,374,147,601,50,-0.004934886637271294,-0.13364018308931497
186,1576033200,32,36,4,68,50,-1.4163124648968615,-1.1378929990132505
186,1576047600,45,93,48,138,50,-0.9820424408169875,-1.0060023852896567
186,1576062000,695,948,253,1643,50,1.041261080464243,1.8296458097676098
186,1576076400,333,599,266,932,50,1.1695681330332968,0.4900140046608214
186,1576090800,589,771,182,1360,50,0.3405071779717193,1.2964308999993663
186,1576105200,231,461,230,692,50,0.8142562951497636,0.03781761475135696
186,1576119600,27,47,20,74,50,-1.2583960925041802,-1.126588089265514
186,1576134000,38,94,56,132,50,-0.9030842546206469,-1.0173072950373934
186,1576148400,652,911,259,1563,50,1.1004797201114986,1.6789136797977884
186,1576162800,333,592,259,925,50,1.1004797201114986,0.47682494328846203
186,1576177200,594,784,190,1378,50,0.41946536416806,1.3303456292425762
186,1576191600,260,373,113,633,50,-0.3405071779717193,-0.07334733110138637
186,1576206000,30,54,24,84,50,-1.2189169994060096,-1.1077465730192864
186,1576220400,33,83,50,116,50,-0.9623028942679024,-1.0474537210313577
186,1576234800,581,876,295,1457,50,1.4557915579950318,1.4791936075877747
186,1576249200,379,600,221,979,50,0.7254283356788803,0.5785691310180915
186,1576263600,538,825,287,1363,50,1.3768333717986911,1.3020833548732347
186,1576278000,215,353,138,568,50,-0.0937628461081546,-0.19581718670186632
186,1576292400,54,72,18,126,50,-1.2781356390532652,-1.02861220478513
186,1576306800,6,34,28,40,50,-1.1794379063078393,-1.1906492445026882
186,1576321200,116,307,191,423,50,0.4293351374426026,-0.4690191722721678
186,1576335600,273,489,216,762,50,0.6760794693061674,0.16970822847495076
186,1576350000,321,517,196,838,50,0.47868400381531556,0.3129037519462812
186,1576364400,195,272,77,467,50,-0.6958190158552525,-0.3861165007887659
186,1576378800,53,77,24,130,50,-1.2189169994060096,-1.0210755982866389
186,1576393200,4,24,20,28,50,-1.2583960925041802,-1.2132590639981613
186,1576407600,88,274,186,362,50,0.37998627106988964,-0.5839524213741566
186,1576422000,288,477,189,765,50,0.40959559089351744,0.17536068334881907
186,1576436400,275,434,159,709,50,0.11350239265723977,0.06984819236994402
186,1576450800,113,182,69,295,50,-0.7747772020515932,-0.7101905802238822
186,1576465200,18,24,6,42,50,-1.3965729183477762,-1.1868809412534425
186,1576479600,41,81,40,122,50,-1.0610006270133283,-1.036148811283621
186,1576494000,586,895,309,1481,50,1.593968383838628,1.5244132465787212
186,1576508400,295,600,305,895,50,1.5544892907404577,0.42030039454977897
186,1576522800,602,803,201,1405,50,0.5280328701880285,1.381217723107391
186,1576537200,220,329,109,549,50,-0.37998627106988964,-0.23161606756969894
186,1576551600,25,33,8,58,51,-1.0893972622677917,-1.1004901071252533
186,1576566000,35,88,53,123,51,-0.7050793584413236,-0.9704761647203549
186,1576580400,629,972,343,1601,51,1.7716360217736926,1.9858408641171776
186,1576594800,294,655,361,949,51,1.9253631833042797,0.6817010110711214
186,1576609200,640,720,80,1360,51,-0.47448861614544285,1.5037891699697856
186,1576623600,238,348,110,586,51,-0.2182766802611308,-0.044376851897771984
186,1576638000,34,42,8,76,51,-1.0893972622677917,-1.0644862461515892
186,1576652400,45,73,28,118,51,-0.9185893050115836,-0.9804772372130395
186,1576666800,658,902,244,1560,51,0.9261366333554628,1.903832069677165
186,1576681200,346,689,343,1035,51,1.7716360217736926,0.8537194579452945
186,1576695600,623,828,205,1451,51,0.5930611167058573,1.6858086893366433
186,1576710000,208,396,188,604,51,0.44787435303808043,-0.008372990924107853
186,1576724400,33,36,3,69,51,-1.1320992515818438,-1.0784877476413472
186,1576738800,38,90,52,128,51,-0.7136197563041341,-0.9604750922276705
186,1576753200,589,833,244,1422,51,0.9261366333554628,1.6278024688790733
186,1576767600,306,683,377,989,51,2.0620095491092463,0.7617095910125972
186,1576782000,606,763,157,1369,51,0.183122019290958,1.5217911004566178
186,1576796400,235,364,129,599,51,-0.056009120867733214,-0.018374063416792336
186,1576810800,37,53,16,90,51,-1.0210740793653086,-1.0364832431720725
186,1576825200,36,83,47,119,51,-0.7563217456181861,-0.9784770227145025
186,1576839600,493,872,379,1365,51,2.0790903448348668,1.5137902424624703
186,1576854000,412,628,216,1040,51,0.6870054931967716,0.8637205304379789
186,1576868400,480,758,278,1238,51,1.2165101606910165,1.2597630011482843
186,1576882800,226,370,144,596,51,0.07209684707442279,-0.024374706912403024
186,1576897200,43,60,17,103,51,-1.0125336815024981,-1.0104804546910928
186,1576911600,9,35,26,44,51,-0.9356701007372045,-1.1284931101047697
186,1576926000,82,252,170,334,51,0.2941471915074932,-0.5484309055290698
186,1576940400,235,440,205,675,51,0.5930611167058573,0.1336422384720118
186,1576954800,337,422,85,759,51,-0.43178662683139085,0.3016602563491111
186,1576969200,155,197,42,352,51,-0.7990237349322381,-0.5124270445554057
186,1576983600,40,47,7,87,51,-1.0979376601306021,-1.0424838866676833
186,1576998000,10,13,3,23,51,-1.1320992515818438,-1.1704976145740447
186,1577012400,74,183,109,257,51,-0.22681707812394122,-0.7024474219164109
186,1577026800,222,414,192,636,51,0.482035944489322,0.05563387302907283
186,1577041200,273,346,73,619,51,-0.5342714011851156,0.02163022655394559
186,1577055600,87,167,80,254,51,-0.47448861614544285,-0.7084480654120215
186,1577070000,17,26,9,43,51,-1.0808568644049812,-1.1304933246033066
186,1577084400,21,51,30,72,51,-0.9015085092859628,-1.0724871041457367
186,1577089689,93,213,120,306,51,-0.1328727016330268,-0.604436911488103
186,1577098800,187,433,246,620,51,0.9432174290810836,0.023630441052482486
186,1577113200,345,647,302,992,51,1.4214797093984661,0.7677102345082079
186,1577127600,519,492,0,1011,51,-1.157720445170275,0.8057143099804089
186,1577142000,160,260,100,420,51,-0.30368065888923484,-0.37641245865489675
186,1577156400,34,36,2,70,52,-0.8450907408873561,-1.018237513077613
186,1577170800,18,58,40,76,52,-0.5799642339423032,-1.0012806260782865
186,1577185200,185,478,293,663,52,1.1852201412444965,0.6576681520224896
186,1577199600,294,547,253,841,52,0.9061396076181248,1.1607224663358424
186,1577214000,304,330,26,634,52,-0.6776424207115332,0.5757098648590782
186,1577228400,88,175,87,263,52,-0.25204460693131675,-0.4727909812659438
186,1577242800,29,15,0,44,52,-0.8590447675686748,-1.0917173567413612
186,1577257200,13,18,5,31,52,-0.8241597008653783,-1.1284572785732352
186,1577271600,45,138,93,183,52,-0.21018252688736103,-0.6988828079236304
186,1577286000,196,280,84,476,52,-0.2729756469532946,0.12917850721014698
186,1577300400,197,221,24,418,52,-0.6915964473928519,-0.034738067116675875
186,1577314800,54,128,74,182,52,-0.34274578035988745,-0.7017089557568515
186,1577329200,12,28,16,40,52,-0.7474125541181261,-1.1030219480742454
186,1577343600,19,47,28,66,52,-0.6636883940302146,-1.0295421044104973
186,1577358000,184,559,375,743,52,1.7573352351785578,0.8837599786801763
186,1577372400,246,663,417,909,52,2.050369795486248,1.3529005189948762
186,1577386800,425,456,31,881,52,-0.6427573540082369,1.2737683796646857
186,1577401200,139,199,60,338,52,-0.44042396712911747,-0.26082989377436255
186,1577415600,24,24,0,48,52,-0.8590447675686748,-1.0804127654084767
186,1577430000,16,59,43,75,52,-0.5590331939203254,-1.0041067739115075
186,1577444400,214,567,353,781,52,1.6038409416840536,0.9911535963425775
186,1577458800,306,760,454,1066,52,2.3085192890906416,1.7966057288105861
186,1577473200,462,601,139,1063,52,0.11076008678296619,1.788127285310923
186,1577487600,189,247,58,436,52,-0.4543779938104361,0.01613259388130363
