remote_unit_id,time_stamp,entries,exits,num_people_exited,sum_exit_entry,week_num,z_score_num_people_exited,z_score_sum_exit_entry
194,1546311600,264,69,0,333,1,-0.3166906620089908,-0.5500860584483875
194,1546326000,63,41,0,104,1,-0.3166906620089908,-1.199733370599246
194,1546340400,75,104,29,179,1,0.7314865834446798,-0.9869667836502749
194,1546354800,205,135,0,340,1,-0.3166906620089908,-0.5302278436664836
194,1546369200,375,173,0,548,1,-0.3166906620089908,0.05984482413866292
194,1546383600,223,80,0,303,1,-0.3166906620089908,-0.635192693227976
194,1546398000,75,26,0,101,1,-0.3166906620089908,-1.2082440340772047
194,1546412400,40,67,27,107,1,0.6591984975513232,-1.191222707121287
194,1546426800,477,425,0,902,1,-0.3166906620089908,1.0641031145378064
194,1546441200,391,220,0,611,1,-0.3166906620089908,0.23856875717579865
194,1546455600,828,312,0,1140,1,-0.3166906620089908,1.7392824171225414
194,1546470000,467,138,0,605,1,-0.3166906620089908,0.22154743021988094
194,1546484400,106,46,0,152,1,-0.3166906620089908,-1.0635627549519044
194,1546498800,44,75,31,119,1,0.8037746693380363,-1.1571800532094518
194,1546513200,581,433,0,1014,1,-0.3166906620089908,1.38183455104827
194,1546527600,402,238,0,640,1,-0.3166906620089908,0.3208385041294008
194,1546542000,847,360,0,1207,1,-0.3166906620089908,1.9293539014636223
194,1546556400,565,153,0,718,1,-0.3166906620089908,0.5421157545563308
194,1546570800,121,53,0,174,1,-0.3166906620089908,-1.0011512227802062
194,1546585200,49,67,18,116,1,0.33390211103121853,-1.1656907166874106
194,1546599600,597,443,0,1040,1,-0.3166906620089908,1.4555936345239133
194,1546614000,410,281,0,691,1,-0.3166906620089908,0.4655197832547011
194,1546628400,861,355,0,1216,1,-0.3166906620089908,1.9548858918974987
194,1546642800,543,199,0,742,1,-0.3166906620089908,0.6102010623800015
194,1546657200,218,84,0,302,1,-0.3166906620089908,-0.6380295810539622
194,1546671600,43,58,15,101,1,0.22546998219118364,-1.2082440340772047
194,1546686000,137,302,165,439,1,5.647076424192928,-0.24937594889384174
194,1546700400,382,251,0,633,1,-0.3166906620089908,0.3009802893474968
194,1546714800,567,299,0,866,1,-0.3166906620089908,0.9619751528023004
194,1546729200,374,180,0,554,1,-0.3166906620089908,0.0768661510945806
194,1546743600,258,65,0,323,1,-0.3166906620089908,-0.5784549367082503
194,1546758000,52,50,0,102,1,-0.3166906620089908,-1.2054071462512186
194,1546772400,107,177,70,284,1,2.21339234425849,-0.6890935619217153
194,1546786800,300,240,0,540,1,-0.3166906620089908,0.037149721530772666
194,1546801200,522,243,0,765,1,-0.3166906620089908,0.675449482377686
194,1546815600,282,108,0,390,1,-0.3166906620089908,-0.38838345236716953
194,1546830000,103,47,0,150,1,-0.3166906620089908,-1.069236530603877
194,1546844400,50,63,13,113,1,0.15318189629782702,-1.1742013801653695
194,1546858800,662,439,0,1101,1,-0.3166906620089908,1.6286437919090764
194,1546873200,381,205,0,586,1,-0.3166906620089908,0.1676465615261416
194,1546887600,783,346,0,1129,1,-0.3166906620089908,1.7080766510366923
194,1546902000,498,152,0,650,1,-0.3166906620089908,0.3492073823892636
194,1546916400,117,28,0,145,2,-0.37532954148069575,-1.1341166827093796
194,1546930800,49,63,14,112,2,1.4336357895901986,-1.2190329877299186
194,1546945200,669,494,0,1163,2,-0.37532954148069575,1.4854226661060403
194,1546959600,403,206,0,609,2,-0.37532954148069575,0.05985803030668611
194,1546974000,831,344,0,1175,2,-0.37532954148069575,1.5163013224771456
194,1546988400,491,181,0,672,2,-0.37532954148069575,0.22197097625498813
194,1547002800,115,33,0,148,2,-0.37532954148069575,-1.1263970186166032
194,1547017200,50,82,32,132,2,3.75944835810992,-1.1675685604447434
194,1547031600,671,463,0,1134,2,-0.37532954148069575,1.4107992465425363
194,1547046000,448,238,0,686,2,-0.37532954148069575,0.2579960753546108
194,1547060400,808,356,0,1164,2,-0.37532954148069575,1.4879958874702992
194,1547074800,549,180,0,729,2,-0.37532954148069575,0.3686445940177376
194,1547089200,132,28,0,160,2,-0.37532954148069575,-1.095518362245498
194,1547103600,47,63,16,110,2,1.692059408314612,-1.2241794304584364
194,1547118000,677,416,0,1093,2,-0.37532954148069575,1.305297170607927
194,1547132400,416,265,0,681,2,-0.37532954148069575,0.24512996853331698
194,1547146800,802,357,0,1159,2,-0.37532954148069575,1.4751297806490054
194,1547161200,572,210,0,782,2,-0.37532954148069575,0.505025326323452
194,1547175600,143,47,0,190,2,-0.37532954148069575,-1.0183217213177354
194,1547190000,56,65,9,121,2,0.7875767427791649,-1.1958739954515898
194,1547204400,655,404,0,1059,2,-0.37532954148069575,1.2178076442231291
194,1547218800,422,269,0,691,2,-0.37532954148069575,0.27086218217590463
194,1547233200,883,396,0,1279,2,-0.37532954148069575,1.7839163443600567
194,1547247600,587,184,0,771,2,-0.37532954148069575,0.4767198913166056
194,1547262000,254,50,0,304,2,-0.37532954148069575,-0.7249744857922363
194,1547276400,42,35,0,77,2,-0.37532954148069575,-1.3090957354789754
194,1547290800,158,186,28,344,2,3.242601120661093,-0.6220456312218858
194,1547305200,385,249,0,634,2,-0.37532954148069575,0.12418856441315516
194,1547319600,584,299,0,883,2,-0.37532954148069575,0.7649206841135869
194,1547334000,386,119,0,505,2,-0.37532954148069575,-0.20775699157622515
194,1547348400,293,46,0,339,2,-0.37532954148069575,-0.6349117380431797
194,1547362800,42,32,0,74,2,-0.37532954148069575,-1.3168153995717518
194,1547377200,105,128,23,233,2,2.5965420738500593,-0.9076732026546085
194,1547391600,331,197,0,528,2,-0.37532954148069575,-0.14857290019827363
194,1547406000,495,174,0,669,2,-0.37532954148069575,0.21425131216221185
194,1547420400,256,77,0,333,2,-0.37532954148069575,-0.6503510662287323
194,1547434800,91,29,0,120,2,-0.37532954148069575,-1.1984472168158486
194,1547449200,61,55,0,116,2,-0.37532954148069575,-1.2087401022728836
194,1547463600,589,436,0,1025,2,-0.37532954148069575,1.1303181178383312
194,1547478000,377,236,0,613,2,-0.37532954148069575,0.07015091576372116
194,1547492400,847,337,0,1184,2,-0.37532954148069575,1.5394603147554744
194,1547506800,496,159,0,655,2,-0.37532954148069575,0.17822621306258918
194,1547521200,94,28,0,122,3,-0.41003956488484183,-1.0880875247146717
194,1547535600,59,74,15,133,3,1.067477302996292,-1.0586191365560664
194,1547550000,649,409,0,1058,3,-0.41003956488484183,1.419404413144825
194,1547564400,368,245,0,613,3,-0.41003956488484183,0.22727416491034208
194,1547578800,829,363,0,1192,3,-0.41003956488484183,1.7783829598041974
194,1547593200,567,173,0,740,3,-0.41003956488484183,0.5675001009233294
194,1547607600,125,29,0,154,3,-0.41003956488484183,-1.002361304616911
194,1547622000,52,66,14,118,3,0.968976178470883,-1.0988033022268917
194,1547636400,645,462,0,1107,3,-0.41003956488484183,1.5506726876695207
194,1547650800,430,279,0,709,3,-0.41003956488484183,0.48445282520362376
194,1547665200,855,374,0,1229,3,-0.41003956488484183,1.877503901792233
194,1547679600,589,167,0,756,3,-0.41003956488484183,0.6103632109722096
194,1547694000,124,35,0,159,3,-0.41003956488484183,-0.988966582726636
194,1547708400,52,79,27,131,3,2.249490797301199,-1.0639770253121765
194,1547722800,637,433,0,1070,3,-0.41003956488484183,1.4515517456814853
194,1547737200,392,262,0,654,3,-0.41003956488484183,0.3371108844105978
194,1547751600,897,363,0,1260,3,-0.41003956488484183,1.9605511775119384
194,1547766000,588,151,0,739,3,-0.41003956488484183,0.5648211565452743
194,1547780400,139,33,0,172,3,-0.41003956488484183,-0.9541403058119208
194,1547794800,56,68,12,124,3,0.7719739294200653,-1.0827296359585616
194,1547797727,84,48,0,132,3,-0.41003956488484183,-1.0612980809341215
194,1547809200,535,398,0,933,3,-0.41003956488484183,1.0845363658879477
194,1547823600,464,268,0,732,3,-0.41003956488484183,0.5460685458988892
194,1547838000,839,391,0,1230,3,-0.41003956488484183,1.880182846170288
194,1547852400,546,179,0,725,3,-0.41003956488484183,0.5273159352525041
194,1547866800,211,42,0,253,3,-0.41003956488484183,-0.7371458111894643
194,1547881200,36,41,5,77,3,0.08246605774220278,-1.2086400217271474
194,1547895600,143,185,42,328,3,3.727007665182333,-0.5362249828353379
194,1547910000,405,246,0,651,3,-0.41003956488484183,0.32907405127643274
194,1547924400,594,239,0,833,3,-0.41003956488484183,0.816641928082446
194,1547938800,351,127,0,478,3,-0.41003956488484183,-0.1343833261270853
194,1547953200,188,34,0,222,3,-0.41003956488484183,-0.8201930869091698
194,1547967600,37,28,0,65,3,-0.41003956488484183,-1.2407873542638077
194,1547982000,95,138,43,233,3,3.825508789707742,-0.7907246987505646
194,1547996400,283,246,0,529,3,-0.41003956488484183,0.002242837153720579
194,1548010800,441,205,0,646,3,-0.41003956488484183,0.31567932938615767
194,1548025200,258,97,0,355,3,-0.41003956488484183,-0.4638934846278525
194,1548039600,87,34,0,121,3,-0.41003956488484183,-1.0907664690927266
194,1548054000,33,40,7,73,3,0.27946830679302065,-1.2193557992393675
194,1548068400,190,204,14,394,3,0.968976178470883,-0.3594146538837068
194,1548082800,326,154,0,480,3,-0.41003956488484183,-0.1290254373709753
194,1548097200,444,197,0,641,3,-0.41003956488484183,0.30228460749588254
194,1548111600,268,72,0,340,3,-0.41003956488484183,-0.5040776502986778
194,1548126000,75,21,0,96,4,-0.39295540070425816,-1.2743352161454506
194,1548140400,43,60,17,103,4,1.8162584268771618,-1.2555074080371655
194,1548154800,590,415,0,1005,4,-0.39295540070425816,1.1705901510589822
194,1548169200,370,226,0,596,4,-0.39295540070425816,0.07050822016061804
194,1548183600,749,328,0,1077,4,-0.39295540070425816,1.364247605887056
194,1548198000,533,145,0,678,4,-0.39295540070425816,0.29106254371481327
194,1548212400,100,28,0,128,4,-0.39295540070425816,-1.1882652362218622
194,1548226800,52,89,37,141,4,4.41533351814942,-1.1532993068779045
194,1548241200,659,419,0,1078,4,-0.39295540070425816,1.3669372927596681
194,1548255600,353,243,0,596,4,-0.39295540070425816,0.07050822016061804
194,1548270000,833,351,0,1184,4,-0.39295540070425816,1.6520441012565548
194,1548284400,584,199,0,783,4,-0.39295540070425816,0.5734796653390877
194,1548298800,122,26,0,148,4,-0.39295540070425816,-1.1344714987696194
194,1548313200,48,56,8,104,4,0.6466746358046453,-1.2528177211645535
194,1548327600,670,423,0,1093,4,-0.39295540070425816,1.4072825958488502
194,1548342000,394,206,0,600,4,-0.39295540070425816,0.08126696765106659
194,1548356400,766,343,0,1109,4,-0.39295540070425816,1.4503175858106445
194,1548370800,637,158,0,795,4,-0.39295540070425816,0.6057559078104333
194,1548385200,136,31,0,167,4,-0.39295540070425816,-1.0833674481899889
194,1548399600,52,60,8,112,4,0.6466746358046453,-1.2313002261836563
194,1548414000,635,314,0,949,4,-0.39295540070425816,1.0199676861927025
194,1548428400,453,251,0,704,4,-0.39295540070425816,0.36099440240272884
194,1548442800,820,370,0,1190,4,-0.39295540070425816,1.6681822224922276
194,1548457200,563,137,0,700,4,-0.39295540070425816,0.3502356549122803
194,1548471600,222,61,0,283,4,-0.39295540070425816,-0.7713637709669809
194,1548486000,39,42,3,81,4,-0.0030941370134193445,-1.3146805192346327
194,1548500400,162,182,20,344,4,2.2061196905680003,-0.6072928717376406
194,1548514800,407,253,0,660,4,-0.39295540070425816,0.24264818000779484
194,1548529200,646,229,0,875,4,-0.39295540070425816,0.8209308576194043
194,1548543600,428,136,0,564,4,-0.39295540070425816,-0.015561759762970353
194,1548558000,240,52,0,292,4,-0.39295540070425816,-0.7471565891134717
194,1548572400,41,37,0,78,4,-0.39295540070425816,-1.322749579852469
194,1548586800,110,134,24,244,4,2.725934708822452,-0.8762615589988543
194,1548601200,318,207,0,525,4,-0.39295540070425816,-0.1204595477948437
194,1548615600,556,176,0,732,4,-0.39295540070425816,0.4363056348358687
194,1548630000,327,95,0,422,4,-0.39295540070425816,-0.39749729567389386
194,1548644400,92,35,0,127,4,-0.39295540070425816,-1.1909549230944743
194,1548658800,48,58,10,106,4,0.9065821449318712,-1.2474383474193291
194,1548673200,630,440,0,1070,4,-0.39295540070425816,1.3454197977787712
194,1548687600,391,232,0,623,4,-0.39295540070425816,0.14312976572114575
194,1548702000,753,339,0,1092,4,-0.39295540070425816,1.4045929089762381
194,1548716400,500,177,0,677,4,-0.39295540070425816,0.28837285684220115
194,1548730800,96,22,0,118,5,-0.254621308623876,-1.243149591094766
194,1548745200,58,52,0,110,5,-0.254621308623876,-1.2642817504900834
194,1548759600,672,499,0,1171,5,-0.254621308623876,1.5383708893138714
194,1548774000,430,224,0,654,5,-0.254621308623876,0.17270508839149193
194,1548788400,783,356,0,1139,5,-0.254621308623876,1.4538422517326022
194,1548802800,509,175,0,684,5,-0.254621308623876,0.25195068612393173
194,1548817200,106,20,0,126,5,-0.254621308623876,-1.2220174316994488
194,1548831600,58,71,13,129,5,1.1935373841744188,-1.2140928719262047
194,1548846000,702,444,0,1146,5,-0.254621308623876,1.4723328912035047
194,1548860400,377,268,0,645,5,-0.254621308623876,0.14893140907175997
194,1548862337,76,39,0,115,5,-0.254621308623876,-1.25107415086801
194,1548874800,744,369,0,1113,5,-0.254621308623876,1.385162733697821
194,1548889200,533,165,0,698,5,-0.254621308623876,0.288931965065737
194,1548903600,207,31,0,238,5,-0.254621308623876,-0.9261672001650068
194,1548918000,50,67,17,117,5,1.6391246742662018,-1.2457911110191806
194,1548932400,646,450,0,1096,5,-0.254621308623876,1.3402568949827718
194,1548946800,389,220,0,609,5,-0.254621308623876,0.053836691792832195
194,1548961200,727,369,0,1096,5,-0.254621308623876,1.3402568949827718
194,1548975600,503,186,0,689,5,-0.254621308623876,0.26515828574600503
194,1548990000,133,24,0,157,5,-0.254621308623876,-1.1401303140425942
194,1549004400,51,62,11,113,5,0.9707437391285273,-1.2563571907168394
194,1549018800,632,452,0,1084,5,-0.254621308623876,1.308558655889796
194,1549033200,469,265,0,734,5,-0.254621308623876,0.38402668234466475
194,1549047600,838,389,0,1227,5,-0.254621308623876,1.6862960050810922
194,1549062000,518,157,0,675,5,-0.254621308623876,0.22817700680419978
194,1549090800,224,75,0,299,5,-0.254621308623876,-0.7650344847757126
194,1549105200,154,209,55,363,5,5.872203930138141,-0.5959772096131742
194,1549119600,454,271,0,725,5,-0.254621308623876,0.3602530030249328
194,1549134000,666,336,0,1002,5,-0.254621308623876,1.0919540220877937
194,1549148400,435,199,0,634,5,-0.254621308623876,0.1198746899031987
194,1549162800,277,49,0,326,5,-0.254621308623876,-0.6937134468165167
194,1549177200,56,24,0,80,5,-0.254621308623876,-1.3435273482225232
194,1549191600,125,121,0,246,5,-0.254621308623876,-0.9050350407696895
194,1549206000,393,237,0,630,5,-0.254621308623876,0.10930861020554007
194,1549220400,536,240,0,776,5,-0.254621308623876,0.4949705191700805
194,1549234800,309,77,0,386,5,-0.254621308623876,-0.535222251351637
194,1549249200,95,43,0,138,5,-0.254621308623876,-1.190319192606473
194,1549263600,55,55,0,110,5,-0.254621308623876,-1.2642817504900834
194,1549278000,533,403,0,936,5,-0.254621308623876,0.9176137070764262
194,1549292400,339,223,0,562,5,-0.254621308623876,-0.07031474465465684
194,1549306800,771,348,0,1119,5,-0.254621308623876,1.401011853244309
194,1549321200,533,174,0,707,5,-0.254621308623876,0.31270564438546894
194,1549335600,108,33,0,141,6,-0.2725210455690686,-1.2065661552280098
194,1549350000,50,66,16,116,6,3.3029550722971117,-1.2693252290689065
194,1549364400,652,426,0,1078,6,-0.2725210455690686,1.145643932328798
194,1549378800,405,259,0,664,6,-0.2725210455690686,0.10635366952354884
194,1549393200,839,385,0,1224,6,-0.2725210455690686,1.5121569235596346
194,1549407600,578,154,0,732,6,-0.2725210455690686,0.2770583503707878
194,1549422000,120,32,0,152,6,-0.2725210455690686,-1.1789521627380153
194,1549436400,53,77,24,130,6,5.090693131230202,-1.2341801477180043
194,1549450800,517,488,0,1005,6,-0.2725210455690686,0.9623874367133796
194,1549465200,404,279,0,683,6,-0.2725210455690686,0.1540505656426303
194,1549479600,870,454,0,1324,6,-0.2725210455690686,1.7631932189232213
194,1549494000,450,108,0,558,6,-0.2725210455690686,-0.15974480356185308
194,1549522800,137,80,0,217,6,-0.2725210455690686,-1.0157785707516838
194,1549537200,709,448,0,1157,6,-0.2725210455690686,1.3439626056660314
194,1549551600,383,261,0,644,6,-0.2725210455690686,0.05614641045083149
194,1549566000,899,396,0,1295,6,-0.2725210455690686,1.690392693267781
194,1549580400,605,215,0,820,6,-0.2725210455690686,0.49797029029074413
194,1549594800,132,46,0,178,6,-0.2725210455690686,-1.1136827259434827
194,1549609200,52,57,5,109,6,0.8448152412641127,-1.2868977697443575
194,1549623600,699,427,0,1126,6,-0.2725210455690686,1.2661413541033195
194,1549638000,461,283,0,744,6,-0.2725210455690686,0.3071827058144182
194,1549652400,882,428,0,1310,6,-0.2725210455690686,1.7280481375723191
194,1549666800,600,222,0,822,6,-0.2725210455690686,0.5029910161980159
194,1549681200,239,56,0,295,6,-0.2725210455690686,-0.8199702603680862
194,1549695600,49,41,0,90,6,-0.2725210455690686,-1.334594665863439
194,1549710000,196,191,0,387,6,-0.2725210455690686,-0.5890168686335864
194,1549724400,456,283,0,739,6,-0.2725210455690686,0.2946308910462389
194,1549738800,681,322,0,1003,6,-0.2725210455690686,0.9573667108061078
194,1549753200,461,176,0,637,6,-0.2725210455690686,0.03857386977538042
194,1549767600,268,56,0,324,6,-0.2725210455690686,-0.747169734712646
194,1549782000,46,27,0,73,6,-0.2725210455690686,-1.3772708360752488
194,1549796400,131,129,0,260,6,-0.2725210455690686,-0.9078329637453415
194,1549810800,377,237,0,614,6,-0.2725210455690686,-0.019164478158244527
194,1549825200,573,236,0,809,6,-0.2725210455690686,0.4703562978007496
194,1549839600,296,84,0,380,6,-0.2725210455690686,-0.6065894093090375
194,1549854000,94,23,0,117,6,-0.2725210455690686,-1.2668148661152705
194,1549868400,50,55,5,105,6,0.8448152412641127,-1.296939221558901
194,1549882800,580,374,0,954,6,-0.2725210455690686,0.8343589260779504
194,1549897200,373,216,0,589,6,-0.2725210455690686,-0.08192355199914121
194,1549911600,747,397,0,1144,6,-0.2725210455690686,1.311327887268765
194,1549926000,565,173,0,738,6,-0.2725210455690686,0.292120528092603
194,1549940400,112,42,0,154,7,-0.32668028124537346,-1.1710826985272933
194,1549954800,54,64,10,118,7,0.009608243566040422,-1.2606148338447463
194,1549969200,653,408,0,1061,7,-0.32668028124537346,1.0846297107207579
194,1549983600,370,207,0,577,7,-0.32668028124537346,-0.11908010854722091
194,1549998000,736,327,0,1063,7,-0.32668028124537346,1.0896037182383942
194,1550012400,554,136,0,690,7,-0.32668028124537346,0.16195131619922867
194,1550026800,116,50,0,166,7,-0.32668028124537346,-1.1412386534214756
194,1550041200,57,66,9,123,7,-0.024020608915100963,-1.2481798150506556
194,1550055600,675,458,0,1133,7,-0.32668028124537346,1.2636939813556638
194,1550070000,461,265,0,726,7,-0.32668028124537346,0.2514834515166816
194,1550084400,804,390,0,1194,7,-0.32668028124537346,1.41540121064357
194,1550098800,590,173,0,763,7,-0.32668028124537346,0.34350259059295274
194,1550113200,139,57,0,196,7,-0.32668028124537346,-1.0666285406569314
194,1550127600,54,64,10,118,7,0.009608243566040422,-1.2606148338447463
194,1550142000,640,371,0,1011,7,-0.32668028124537346,0.960279522779851
194,1550156400,432,245,0,677,7,-0.32668028124537346,0.1296202673345929
194,1550170800,883,449,0,1332,7,-0.32668028124537346,1.7586077293604732
194,1550185200,613,201,0,814,7,-0.32668028124537346,0.47033978229267775
194,1550199600,194,58,0,252,7,-0.32668028124537346,-0.9273563301631157
194,1550214000,53,87,34,140,7,0.8167007031134337,-1.2059007511507471
194,1550228400,618,607,0,1225,7,-0.32668028124537346,1.4924983271669323
194,1550242800,442,335,0,777,7,-0.32668028124537346,0.3783206432164067
194,1550257200,849,468,0,1317,7,-0.32668028124537346,1.721302672978201
194,1550271600,566,213,0,779,7,-0.32668028124537346,0.38329465073404295
194,1550286000,197,89,0,286,7,-0.32668028124537346,-0.842798202363299
194,1550300400,42,48,6,90,7,-0.12490716635852513,-1.3302509390916541
194,1550314800,108,250,142,358,7,4.448616771076703,-0.6637339317283931
194,1550329200,413,371,0,784,7,-0.32668028124537346,0.39572966952813365
194,1550343600,700,370,0,1070,7,-0.32668028124537346,1.107012744550121
194,1550358000,453,180,0,633,7,-0.32668028124537346,0.020192101946594813
194,1550372400,186,63,0,249,7,-0.32668028124537346,-0.9348173414395701
194,1550386800,44,37,0,81,7,-0.32668028124537346,-1.3526339729210173
194,1550401200,77,181,104,258,7,3.170720376793331,-0.9124343076102068
194,1550415600,414,321,0,735,7,-0.32668028124537346,0.27386648534604485
194,1550430000,753,422,0,1175,7,-0.32668028124537346,1.3681481392260255
194,1550444400,494,139,0,633,7,-0.32668028124537346,0.020192101946594813
194,1550458800,150,24,0,174,7,-0.32668028124537346,-1.1213426233509305
194,1550473200,40,22,0,62,7,-0.32668028124537346,-1.3998870443385618
194,1550487600,431,316,0,747,7,-0.32668028124537346,0.3037105304518625
194,1550502000,564,427,0,991,7,-0.32668028124537346,0.9105394476034882
194,1550516400,616,436,0,1052,7,-0.32668028124537346,1.0622466768913945
194,1550530800,184,277,93,461,7,2.8008029995007755,-0.4075725445701249
194,1550545200,34,23,0,57,8,-0.40507455039430124,-1.3057227840031749
194,1550559600,43,49,6,92,8,1.9385710626012986,-1.2161533857102742
194,1550574000,623,378,0,1001,8,-0.40507455039430124,1.1100918442396333
194,1550588400,399,230,0,629,8,-0.40507455039430124,0.1580970966693741
194,1550602800,740,392,0,1132,8,-0.40507455039430124,1.445337306421633
194,1550617200,545,162,0,707,8,-0.40507455039430124,0.35770889857926713
194,1550631600,95,26,0,121,8,-0.40507455039430124,-1.141938741410442
194,1550646000,57,62,5,119,8,1.5479634604353654,-1.147056992741465
194,1550660400,541,417,0,958,8,-0.40507455039430124,1.000049440622641
194,1550674800,343,240,0,583,8,-0.40507455039430124,0.04037731605584744
194,1550689200,753,423,0,1176,8,-0.40507455039430124,1.5579388357041368
194,1550703600,566,145,0,711,8,-0.40507455039430124,0.3679454012413129
194,1550718000,103,26,0,129,8,-0.40507455039430124,-1.1214657360863505
194,1550732400,51,51,0,102,8,-0.40507455039430124,-1.1905621290551596
194,1550739660,369,163,0,532,8,-0.40507455039430124,-0.09013809288523647
194,1550746800,273,253,0,526,8,-0.40507455039430124,-0.10549284687830517
194,1550761200,431,274,0,705,8,-0.40507455039430124,0.35259064724824424
194,1550775600,809,400,0,1209,8,-0.40507455039430124,1.6423899826660147
194,1550790000,601,237,0,838,8,-0.40507455039430124,0.692954360761267
194,1550804400,147,35,0,182,8,-0.40507455039430124,-0.9858320758142437
194,1550818800,52,61,9,113,8,3.1103938690990987,-1.1624117467345336
194,1550824757,206,112,0,318,8,-0.40507455039430124,-0.6377909853046866
194,1550832392,291,265,0,556,8,-0.40507455039430124,-0.02871907691296169
194,1550833200,18,26,8,44,8,2.7197862669331654,-1.3389914176548237
194,1550847600,443,275,0,718,8,-0.40507455039430124,0.3858592808998931
194,1550862000,827,433,0,1260,8,-0.40507455039430124,1.7729053916070985
194,1550876400,617,180,0,797,8,-0.40507455039430124,0.5880302084752975
194,1551495600,9867,7996,0,17863,9,-0.32038119847100355,4.109946641679444
194,1551510000,47,35,0,82,9,-0.32038119847100355,-0.354011407984049
194,1551524400,189,177,0,366,9,-0.32038119847100355,-0.28271260104943163
194,1551538800,430,282,0,712,9,-0.32038119847100355,-0.1958485616150034
194,1551553200,699,308,0,1007,9,-0.32038119847100355,-0.12178818117235506
194,1551567600,468,165,0,633,9,-0.32038119847100355,-0.21568168044540753
194,1551582000,289,64,0,353,9,-0.32038119847100355,-0.28597627883165005
194,1551596400,42,34,0,76,9,-0.32038119847100355,-0.35551772080661137
194,1551610800,124,160,36,284,9,3.831759133713202,-0.30329887629111696
194,1551625200,411,250,0,661,9,-0.32038119847100355,-0.2086522206067833
194,1551639600,623,242,0,865,9,-0.32038119847100355,-0.15743758463966376
194,1551654000,337,82,0,419,9,-0.32038119847100355,-0.2694068377834643
194,1551668400,96,23,0,119,9,-0.32038119847100355,-0.34472247891158125
194,1551682800,48,62,14,110,9,1.2943400418228541,-0.34698194814542477
194,1551697200,552,457,0,1009,9,-0.32038119847100355,-0.12128607689816762
194,1551711600,354,201,0,555,9,-0.32038119847100355,-0.23526374713871795
194,1551726000,697,365,0,1062,9,-0.32038119847100355,-0.10798031363220027
194,1551740400,498,184,0,682,9,-0.32038119847100355,-0.2033801257278151
194,1551754800,117,28,0,145,10,-0.27318764773280363,-1.1804182407663146
194,1551769200,46,71,25,117,10,3.101483294848888,-1.249498701136615
194,1551783600,637,450,0,1087,10,-0.27318764773280363,1.143645818834505
194,1551798000,423,219,0,642,10,-0.27318764773280363,0.04575993080651697
194,1551812400,852,359,0,1211,10,-0.27318764773280363,1.449573571902978
194,1551826800,582,170,0,752,10,-0.27318764773280363,0.3171474536898398
194,1551841200,109,56,0,165,10,-0.27318764773280363,-1.1310750547875286
194,1551855600,66,67,1,133,10,-0.13820081002953594,-1.2100241523535862
194,1551870000,658,416,0,1074,10,-0.27318764773280363,1.111572747948294
194,1551884400,433,262,0,695,10,-0.27318764773280363,0.17651937365029982
194,1551898800,803,432,0,1235,10,-0.27318764773280363,1.5087853950775212
194,1551913200,580,175,0,755,10,-0.27318764773280363,0.32454893158665776
194,1551927600,121,35,0,156,10,-0.27318764773280363,-1.1532794884779822
194,1551942000,58,69,11,127,10,1.2116675670031407,-1.224827108147222
194,1551946269,156,78,0,234,10,-0.27318764773280363,-0.9608410631607169
194,1551956400,511,443,0,954,10,-0.27318764773280363,0.8155136320755783
194,1551970800,426,252,0,678,10,-0.27318764773280363,0.13457766556833173
194,1551985200,817,428,0,1245,10,-0.27318764773280363,1.5334569880669142
194,1551999600,641,175,0,816,10,-0.27318764773280363,0.475045648821955
194,1552014000,158,48,0,206,10,-0.27318764773280363,-1.0299215235310173
194,1552028400,54,48,0,102,10,-0.27318764773280363,-1.2865060906207044
194,1552042800,649,421,0,1070,10,-0.27318764773280363,1.101704110752537
194,1552057200,490,293,0,783,10,-0.27318764773280363,0.3936293919569581
194,1552071600,966,419,0,1385,10,-0.27318764773280363,1.878859289918416
194,1552086000,662,196,0,858,10,-0.27318764773280363,0.5786663393774055
194,1552100400,288,70,0,358,10,-0.27318764773280363,-0.654913310092244
194,1552114800,43,50,7,93,10,0.67172021619007,-1.308710524311158
194,1552129200,169,210,41,379,10,5.261272698101171,-0.6031029648145186
194,1552143600,477,321,0,798,10,-0.27318764773280363,0.4306367814410476
194,1552158000,769,380,0,1149,10,-0.27318764773280363,1.2966096953687416
194,1552172400,506,191,0,697,10,-0.27318764773280363,0.1814536922481784
194,1552190400,270,62,0,332,10,-0.27318764773280363,-0.7190594518646657
194,1552204800,54,45,0,99,10,-0.27318764773280363,-1.2939075685175223
194,1552219200,152,152,0,304,10,-0.27318764773280363,-0.788139912234966
194,1552233600,386,255,0,641,10,-0.27318764773280363,0.04329277150757767
194,1552248000,561,225,0,786,10,-0.27318764773280363,0.401030869853776
194,1552262400,315,70,0,385,10,-0.27318764773280363,-0.5883000090208829
194,1552276800,54,25,0,79,10,-0.27318764773280363,-1.3432507544963084
194,1552291200,155,142,0,297,10,-0.27318764773280363,-0.8054100273275412
194,1552305600,660,375,0,1035,10,-0.27318764773280363,1.0153535352896614
194,1552320000,583,258,0,841,10,-0.27318764773280363,0.5367246312954375
194,1552334400,884,403,0,1287,10,-0.27318764773280363,1.6370776786223646
194,1552348800,423,111,0,534,11,-0.16800067200403204,-0.2321422763199975
194,1552363200,55,24,0,79,11,-0.16800067200403204,-1.3396437725893828
194,1552377600,179,137,0,316,11,-0.16800067200403204,-0.7627693668402745
194,1552392000,612,460,0,1072,11,-0.16800067200403204,1.0773869654227044
194,1552406400,549,281,0,830,11,-0.16800067200403204,0.48834221356074553
194,1552420800,1001,404,0,1405,11,-0.16800067200403204,1.8879320165385403
194,1552435200,436,120,0,556,11,-0.16800067200403204,-0.1785927534234558
194,1552449600,72,25,0,97,11,-0.16800067200403204,-1.2958305265831216
194,1552464000,142,131,0,273,11,-0.16800067200403204,-0.8674343434107878
194,1552478400,608,400,0,1008,11,-0.16800067200403204,0.9216065351782194
194,1552492800,480,279,0,759,11,-0.16800067200403204,0.31552329875827
194,1552507200,860,447,0,1307,11,-0.16800067200403204,1.6493932327266727
194,1552521600,471,139,0,610,11,-0.16800067200403204,-0.04715301540467158
194,1552536000,64,28,0,92,11,-0.16800067200403204,-1.308000872695972
194,1552550400,166,145,0,311,11,-0.16800067200403204,-0.7749397129531249
194,1552552193,109,33,0,142,11,-0.16800067200403204,-1.186297411567468
194,1552564800,535,386,0,921,11,-0.16800067200403204,0.7098425128146226
194,1552579200,517,250,0,767,11,-0.16800067200403204,0.33499585253883063
194,1552593600,906,527,0,1433,11,-0.16800067200403204,1.9560859547705025
194,1552608000,511,150,0,661,11,-0.16800067200403204,0.07698451494640239
194,1552622400,97,30,0,127,11,-0.16800067200403204,-1.2228084499060192
194,1552636800,147,150,3,297,11,0.4340017360104161,-0.8090166820691059
194,1552651200,598,431,0,1029,11,-0.16800067200403204,0.9727219888521911
194,1552665600,580,314,0,894,11,-0.16800067200403204,0.6441226438052305
194,1552680000,1000,460,0,1460,11,-0.16800067200403204,2.0218058237798946
194,1552694400,592,126,0,718,11,-0.16800067200403204,0.21572646063289683
194,1552708800,177,33,0,210,11,-0.16800067200403204,-1.0207807044327026
194,1552723200,77,64,0,141,11,-0.16800067200403204,-1.1887314807900382
194,1552737600,227,217,0,444,11,-0.16800067200403204,-0.4512085063513045
194,1552752000,566,410,0,976,11,-0.16800067200403204,0.843716320055977
194,1552766400,835,304,0,1139,11,-0.16800067200403204,1.2404696033348996
194,1552780800,461,135,0,596,11,-0.16800067200403204,-0.08122998452065266
194,1552795200,198,39,0,237,11,-0.16800067200403204,-0.9550608354233107
194,1552809600,48,48,0,96,11,-0.16800067200403204,-1.2982645958056915
194,1552824000,168,201,33,369,11,6.454025816154897,-0.6337636980440603
194,1552838400,438,274,0,712,11,-0.16800067200403204,0.20112204529747638
194,1552852800,567,211,0,778,11,-0.16800067200403204,0.36177061398710153
194,1552867200,314,92,0,406,11,-0.16800067200403204,-0.5437031368089674
194,1552881600,59,22,0,81,11,-0.16800067200403204,-1.3347756341442427
194,1552896000,158,129,0,287,11,-0.16800067200403204,-0.8333573742948067
194,1552910400,571,418,0,989,11,-0.16800067200403204,0.8753592199493879
194,1552924800,464,228,0,692,11,-0.16800067200403204,0.1524406608460748
194,1552939200,810,402,0,1212,11,-0.16800067200403204,1.4181566565825152
194,1552953600,391,103,0,494,12,-0.21335229882506598,-0.29638814306124606
194,1552968000,62,23,0,85,12,-0.21335229882506598,-1.3564246872015924
194,1552982400,145,146,1,291,12,-0.026669037353133238,-0.8225187505441074
194,1552996800,642,416,0,1058,12,-0.21335229882506598,1.1653737417679846
194,1553011200,463,263,0,726,12,-0.21335229882506598,0.3049039797763098
194,1553025600,827,362,0,1189,12,-0.21335229882506598,1.5048964490598802
194,1553040000,447,113,0,560,12,-0.21335229882506598,-0.12533090121952759
194,1553054400,71,24,0,95,12,-0.21335229882506598,-1.3305069232861804
194,1553068800,162,147,0,309,12,-0.21335229882506598,-0.775866775496366
194,1553083200,637,423,0,1060,12,-0.21335229882506598,1.170557294551067
194,1553097600,516,276,0,792,12,-0.21335229882506598,0.47596122161802823
194,1553112000,973,398,0,1371,12,-0.21335229882506598,1.9765997523203767
194,1553126400,439,132,0,571,12,-0.21335229882506598,-0.0968213609125745
194,1553140800,60,28,0,88,12,-0.21335229882506598,-1.3486493580269687
194,1553155200,157,117,0,274,12,-0.21335229882506598,-0.8665789492003076
194,1553169600,641,402,0,1043,12,-0.21335229882506598,1.1264970958948666
194,1553184000,487,243,0,730,12,-0.21335229882506598,0.31527108534247456
194,1553198400,779,399,0,1178,12,-0.21335229882506598,1.476386908752927
194,1553212800,503,119,0,622,12,-0.21335229882506598,0.03535923505602614
194,1553227200,91,32,0,123,12,-0.21335229882506598,-1.2579371843230271
194,1553241600,135,121,0,256,12,-0.21335229882506598,-0.913230924248049
194,1553256000,618,401,0,1019,12,-0.21335229882506598,1.064294462497878
194,1553270400,520,269,0,789,12,-0.21335229882506598,0.4681858924434047
194,1553284800,918,414,0,1332,12,-0.21335229882506598,1.8755204730502704
194,1553299200,537,184,0,721,12,-0.21335229882506598,0.29194509781860384
194,1553313600,143,40,0,183,12,-0.21335229882506598,-1.1024306008305558
194,1553328000,42,75,33,117,12,5.947195329748715,-1.2734878426722742
194,1553342400,231,210,0,441,12,-0.21335229882506598,-0.43375229181292907
194,1553356800,546,315,0,861,12,-0.21335229882506598,0.6547937926343703
194,1553371200,685,243,0,928,12,-0.21335229882506598,0.8284428108676299
194,1553385600,417,110,0,527,12,-0.21335229882506598,-0.2108595221403868
194,1553400000,204,30,0,234,12,-0.21335229882506598,-0.9702500048619551
194,1553414400,39,40,1,79,12,-0.026669037353133238,-1.3719753455508394
194,1553428800,164,177,13,341,12,2.21353010031006,-0.6929299309670479
194,1553443200,458,212,0,670,12,-0.21335229882506598,0.1597645018500032
194,1553457600,515,225,0,740,12,-0.21335229882506598,0.34118884925788645
194,1553472000,299,71,0,370,12,-0.21335229882506598,-0.6177684156123535
194,1553486400,56,21,0,77,12,-0.21335229882506598,-1.3771588983339218
194,1553500800,152,130,0,282,12,-0.21335229882506598,-0.8458447380679781
194,1553515200,589,408,0,997,12,-0.21335229882506598,1.007275381883972
194,1553529600,467,231,0,698,12,-0.21335229882506598,0.23233424081315648
194,1553544000,867,363,0,1230,12,-0.21335229882506598,1.611159281113069
194,1553558400,405,108,0,513,13,-0.15617376188860607,-0.3921215712247415
194,1553572800,53,19,0,72,13,-0.15617376188860607,-1.4581535310404854
194,1553587200,172,132,0,304,13,-0.15617376188860607,-0.897338531772339
194,1553601600,614,448,0,1062,13,-0.15617376188860607,0.93497943997445
194,1553616000,467,249,0,716,13,-0.15617376188860607,0.09859155313488671
194,1553630400,946,468,0,1414,13,-0.15617376188860607,1.7858711630019826
194,1553644800,424,127,0,551,13,-0.15617376188860607,-0.3002639420342692
194,1553659200,62,12,0,74,13,-0.15617376188860607,-1.453318918977829
194,1553673600,165,151,0,316,13,-0.15617376188860607,-0.8683308593964003
194,1553688000,596,408,0,1004,13,-0.15617376188860607,0.7947756901574135
194,1553702400,596,281,0,877,13,-0.15617376188860607,0.4877778241787298
194,1553716800,977,399,0,1376,13,-0.15617376188860607,1.6940135338115103
194,1553731200,495,126,0,621,13,-0.15617376188860607,-0.13105251984129396
194,1553745600,75,28,0,103,13,-0.15617376188860607,-1.3832170440693108
194,1553760000,151,141,0,292,13,-0.15617376188860607,-0.9263462041482776
194,1553774400,716,454,0,1170,13,-0.15617376188860607,1.1960484913578975
194,1553788800,497,261,0,758,13,-0.15617376188860607,0.20011840645067186
194,1553803200,876,445,0,1321,13,-0.15617376188860607,1.5610617020884585
194,1553817600,497,127,0,624,13,-0.15617376188860607,-0.12380060174730932
194,1553832000,81,31,0,112,13,-0.15617376188860607,-1.3614612897873568
194,1553846400,132,151,19,283,13,6.4031242374328485,-0.9481019584302316
194,1553860800,565,428,0,993,13,-0.15617376188860607,0.768185323812803
194,1553875200,606,291,0,897,13,-0.15617376188860607,0.5361239448052941
194,1553889600,1009,447,0,1456,13,-0.15617376188860607,1.8873980163177677
194,1553904000,548,157,0,705,13,-0.15617376188860607,0.07200118679027631
194,1553918400,204,75,0,279,13,-0.15617376188860607,-0.9577711825555444
194,1553932800,153,80,0,233,13,-0.15617376188860607,-1.0689672599966424
194,1553947200,435,219,0,654,13,-0.15617376188860607,-0.051281420807462785
194,1553961600,896,341,0,1237,13,-0.15617376188860607,1.3580079954568882
194,1553976000,901,313,0,1214,13,-0.15617376188860607,1.3024099567363392
194,1553990400,602,142,0,744,13,-0.15617376188860607,0.1662761220120768
194,1554004800,243,45,0,288,13,-0.15617376188860607,-0.9360154282735904
194,1554019200,108,53,0,161,13,-0.15617376188860607,-1.243013294252274
194,1554033600,229,205,0,434,13,-0.15617376188860607,-0.5830887476996707
194,1554048000,590,216,0,806,13,-0.15617376188860607,0.3161490959544263
194,1554062400,617,201,0,818,13,-0.15617376188860607,0.3451567683303649
194,1554076800,383,90,0,473,13,-0.15617376188860607,-0.4888138124778702
194,1554091200,76,28,0,104,13,-0.15617376188860607,-1.3807997380379826
194,1554105600,190,132,0,322,13,-0.15617376188860607,-0.8538270232084311
194,1554120000,625,383,0,1008,13,-0.15617376188860607,0.8044449142827262
194,1554134400,461,234,0,695,13,-0.15617376188860607,0.04782812647699414
194,1554148800,921,354,0,1275,13,-0.15617376188860607,1.4498656246473605
194,1554163200,416,120,0,536,14,-0.1772968828711745,-0.2678933001138837
194,1554177600,57,29,0,86,14,-0.1772968828711745,-1.3836234394158675
194,1554192000,163,139,0,302,14,-0.1772968828711745,-0.8480729725509153
194,1554206400,606,385,0,991,14,-0.1772968828711745,0.8602338407358999
194,1554220800,522,259,0,781,14,-0.1772968828711745,0.3395597757283075
194,1554235200,923,370,0,1293,14,-0.1772968828711745,1.609012734223009
194,1554249600,535,134,0,669,14,-0.1772968828711745,0.06186694105759151
194,1554264000,76,38,0,114,14,-0.1772968828711745,-1.3142002307481884
194,1554278400,182,108,0,290,14,-0.1772968828711745,-0.8778257762656348
194,1554292800,691,393,0,1084,14,-0.1772968828711745,1.0908180695249765
194,1554307200,621,250,0,871,14,-0.1772968828711745,0.5627058035887043
194,1554321600,945,406,0,1351,14,-0.1772968828711745,1.752817952177487
194,1554336000,511,128,0,639,14,-0.1772968828711745,-0.01251506822920741
194,1554350400,66,28,0,94,14,-0.1772968828711745,-1.3637882369393877
194,1554364800,188,133,0,321,14,-0.1772968828711745,-0.800964366669276
194,1554379200,666,459,0,1125,14,-0.1772968828711745,1.192473482216935
194,1554393600,523,298,0,821,14,-0.1772968828711745,0.438735788110706
194,1554408000,986,451,0,1437,14,-0.1772968828711745,1.9660463787996438
194,1554422400,571,168,0,739,14,-0.1772968828711745,0.23542496272678898
194,1554436800,83,28,0,111,14,-0.1772968828711745,-1.3216384316768683
194,1554451200,169,121,0,290,14,-0.1772968828711745,-0.8778257762656348
194,1554465600,643,428,0,1071,14,-0.1772968828711745,1.058585865500697
194,1554480000,592,281,0,873,14,-0.1772968828711745,0.5676646042078242
194,1554494400,924,391,0,1315,14,-0.1772968828711745,1.6635595410333281
194,1554508800,521,127,0,648,14,-0.1772968828711745,0.009799534556832265
194,1554523200,175,29,0,204,14,-0.1772968828711745,-1.0910542028877916
194,1554537600,51,79,28,130,14,6.338363562644489,-1.274529825795229
194,1554552000,253,249,0,502,14,-0.1772968828711745,-0.35219291063892244
194,1554566400,524,262,0,786,14,-0.1772968828711745,0.3519567772761073
194,1554580800,664,286,0,950,14,-0.1772968828711745,0.7585784280439414
194,1554595200,549,117,0,666,14,-0.1772968828711745,0.054428740128911614
194,1554609600,229,42,0,271,14,-0.1772968828711745,-0.9249343821472741
194,1554624000,44,48,4,92,14,0.7535117522024918,-1.3687470375585076
194,1554638400,176,174,0,350,14,-0.1772968828711745,-0.729061757692037
194,1554652800,444,220,0,664,14,-0.1772968828711745,0.049469939509791686
194,1554667200,560,183,0,743,14,-0.1772968828711745,0.24534256396502885
194,1554681600,280,43,0,323,14,-0.1772968828711745,-0.796005566050156
194,1554696000,54,22,0,76,14,-0.1772968828711745,-1.408417442511467
194,1554710400,162,138,0,300,14,-0.1772968828711745,-0.8530317731700352
194,1554724800,600,408,0,1008,14,-0.1772968828711745,0.9023836459984192
194,1554739200,504,326,0,830,14,-0.1772968828711745,0.4610503908967457
194,1554753600,924,379,0,1303,14,-0.1772968828711745,1.6338067373186087
194,1554768000,456,142,0,598,15,-0.2627493783568359,-0.1529409419055684
194,1554782400,66,29,0,95,15,-0.2627493783568359,-1.3937360028491312
194,1554796800,177,183,6,360,15,0.18767812739773992,-0.7400368156721051
194,1554811200,626,489,0,1115,15,-0.2627493783568359,1.122389170436026
194,1554825600,458,273,0,731,15,-0.2627493783568359,0.17514204637573155
194,1554840000,891,436,0,1327,15,-0.2627493783568359,1.645348520177647
194,1554854400,490,128,0,618,15,-0.2627493783568359,-0.10360515419409472
194,1554868800,94,45,0,139,15,-0.2627493783568359,-1.2851972698838892
194,1554883200,181,151,0,332,15,-0.2627493783568359,-0.8091069184681683
194,1554897600,671,446,0,1117,15,-0.2627493783568359,1.1273227492071736
194,1554912000,556,237,0,793,15,-0.2627493783568359,0.32808298828129995
194,1554926400,989,389,0,1378,15,-0.2627493783568359,1.7711547788419049
194,1554940800,556,151,0,707,15,-0.2627493783568359,0.11593910112196314
194,1554955200,84,23,0,107,15,-0.2627493783568359,-1.3641345302222472
194,1554969600,165,158,0,323,15,-0.2627493783568359,-0.8313080229383314
194,1554984000,685,448,0,1133,15,-0.2627493783568359,1.1667913793763525
194,1554998400,537,274,0,811,15,-0.2627493783568359,0.37248519722162626
194,1555012800,933,452,0,1385,15,-0.2627493783568359,1.7884223045409207
194,1555027200,542,159,0,701,15,-0.2627493783568359,0.10113836480852104
194,1555041600,98,33,0,131,15,-0.2627493783568359,-1.3049315849684788
194,1555056000,153,151,0,304,15,-0.2627493783568359,-0.8781770212642315
194,1555070400,657,367,0,1024,15,-0.2627493783568359,0.8979113363488209
194,1555084800,551,259,0,810,15,-0.2627493783568359,0.37001840783605255
194,1555099200,934,449,0,1383,15,-0.2627493783568359,1.7834887257697734
194,1555113600,550,167,0,717,15,-0.2627493783568359,0.14060699497769996
194,1555128000,158,30,0,188,15,-0.2627493783568359,-1.1643245899907788
194,1555142400,47,91,44,138,15,3.040385663843387,-1.287664059269463
194,1555156800,243,318,75,561,15,5.367594443575363,-0.2442121491717947
194,1555171200,532,312,0,844,15,-0.2627493783568359,0.4538892469455578
194,1555185600,669,402,0,1071,15,-0.2627493783568359,1.013850437470784
194,1555200000,428,185,0,613,15,-0.2627493783568359,-0.11593910112196314
194,1555214400,190,45,0,235,15,-0.2627493783568359,-1.0483854888688156
194,1555228800,67,70,3,137,15,-0.03753562547954799,-1.2901308486550367
194,1555243200,197,216,19,413,15,1.1636043898659876,-0.6092969782366999
194,1555257600,500,288,0,788,15,-0.2627493783568359,0.3157490413534315
194,1555272000,562,224,0,786,15,-0.2627493783568359,0.31081546258228415
194,1555286400,296,92,0,388,15,-0.2627493783568359,-0.670966712876042
194,1555300800,50,21,0,71,15,-0.2627493783568359,-1.4529389481028998
194,1555315200,168,114,0,282,15,-0.2627493783568359,-0.9324463877468525
194,1555329600,576,395,0,971,15,-0.2627493783568359,0.7671714989134156
194,1555344000,483,242,0,725,15,-0.2627493783568359,0.16034131006228944
194,1555358400,939,431,0,1370,15,-0.2627493783568359,1.7514204637573154
194,1555372800,451,93,0,544,16,-0.34408443844261466,-0.20341377596835333
194,1555387200,53,17,0,70,16,-0.34408443844261466,-1.3850774619846882
194,1555401600,168,165,0,333,16,-0.34408443844261466,-0.7294286235410256
194,1555416000,678,461,0,1139,16,-0.34408443844261466,1.2798982349593244
194,1555430400,521,306,0,827,16,-0.34408443844261466,0.5020942897333824
194,1555444800,891,457,0,1348,16,-0.34408443844261466,1.8009271598061893
194,1555459200,456,139,0,595,16,-0.34408443844261466,-0.07627274646026669
194,1555473600,70,19,0,89,16,-0.34408443844261466,-1.3377111960895187
194,1555488000,172,141,0,313,16,-0.34408443844261466,-0.7792878507990988
194,1555502400,699,428,0,1127,16,-0.34408443844261466,1.2499826986044804
194,1555516800,561,292,0,853,16,-0.34408443844261466,0.5669112851688776
194,1555531200,911,473,0,1384,16,-0.34408443844261466,1.8906737688707211
194,1555545600,511,180,0,691,16,-0.34408443844261466,0.16305154437848468
194,1555560000,71,15,0,86,16,-0.34408443844261466,-1.3451900801782297
194,1555574400,162,123,0,285,16,-0.34408443844261466,-0.8490907689604013
194,1555588800,694,421,0,1115,16,-0.34408443844261466,1.2200671622496364
194,1555603200,581,287,0,868,16,-0.34408443844261466,0.6043057056124325
194,1555617600,949,458,0,1407,16,-0.34408443844261466,1.9480118802175053
194,1555632000,544,126,0,670,16,-0.34408443844261466,0.11069935575750782
194,1555646400,96,21,0,117,16,-0.34408443844261466,-1.2679082779282163
194,1555660800,71,110,39,181,16,2.418711199640733,-1.108358750702382
194,1555675200,506,384,0,890,16,-0.34408443844261466,0.659150855596313
194,1555689600,658,324,0,982,16,-0.34408443844261466,0.8885033009834498
194,1555704000,952,311,0,1263,16,-0.34408443844261466,1.5890254439593783
194,1555718400,476,152,0,628,16,-0.34408443844261466,0.005994978515554093
194,1555732800,164,38,0,202,16,-0.34408443844261466,-1.056006562081405
194,1555747200,47,110,63,157,16,4.118893130768947,-1.1681898234120698
194,1555761600,213,263,50,476,16,3.197961251407831,-0.37293514864580224
194,1555776000,478,260,0,738,16,-0.34408443844261466,0.2802207284349567
194,1555790400,576,258,0,834,16,-0.34408443844261466,0.5195450192737081
194,1555804800,398,152,0,550,16,-0.34408443844261466,-0.18845600779093138
194,1555819200,151,34,0,185,16,-0.34408443844261466,-1.0983869052507673
194,1555833600,43,72,29,115,16,1.7103020616706437,-1.2728942006540236
194,1555848000,163,186,23,349,16,1.2852565788885901,-0.6895412417345671
194,1555862400,393,211,0,604,16,-0.34408443844261466,-0.053836094194133745
194,1555876800,443,200,0,643,16,-0.34408443844261466,0.043389398959108996
194,1555891200,304,126,0,430,16,-0.34408443844261466,-0.4876113713393706
194,1555905600,64,23,0,87,16,-0.34408443844261466,-1.342697118815326
194,1555920000,147,121,0,268,16,-0.34408443844261466,-0.8914711121297635
194,1555934400,546,379,0,925,16,-0.34408443844261466,0.7464045032979412
194,1555948800,468,253,0,721,16,-0.34408443844261466,0.23784038526559448
194,1555963200,846,340,0,1186,16,-0.34408443844261466,1.3970674190157963
194,1555977600,408,84,0,492,17,-0.18545192509055364,-0.30966019465148537
194,1555992000,68,12,0,80,17,-0.18545192509055364,-1.378419206622207
194,1556006400,161,146,0,307,17,-0.18545192509055364,-0.7895641199296006
194,1556020800,550,428,0,978,17,-0.18545192509055364,0.9510603874304823
194,1556035200,509,310,0,819,17,-0.18545192509055364,0.5386024192184805
194,1556049600,936,391,0,1327,17,-0.18545192509055364,1.8563926572794671
194,1556064000,473,121,0,594,17,-0.18545192509055364,-0.04506451693057859
194,1556078400,61,21,0,82,17,-0.18545192509055364,-1.3732310560786596
194,1556092800,169,134,0,303,17,-0.18545192509055364,-0.799940421016695
194,1556107200,651,352,0,1003,17,-0.18545192509055364,1.0159122692248221
194,1556121600,521,297,0,818,17,-0.18545192509055364,0.5360083439467069
194,1556136000,874,376,0,1250,17,-0.18545192509055364,1.6566488613529002
194,1556150400,555,157,0,712,17,-0.18545192509055364,0.2610363651387057
194,1556164800,86,40,0,126,17,-0.18545192509055364,-1.2590917441206215
194,1556179200,158,145,0,303,17,-0.18545192509055364,-0.799940421016695
194,1556193600,619,395,0,1014,17,-0.18545192509055364,1.0444470972143316
194,1556208000,539,327,0,866,17,-0.18545192509055364,0.6605239569918395
194,1556222400,964,434,0,1398,17,-0.18545192509055364,2.0405720015753923
194,1556236800,580,120,0,700,17,-0.18545192509055364,0.2299074618774226
194,1556251200,97,31,0,128,17,-0.18545192509055364,-1.2539035935770744
194,1556265600,132,126,0,258,17,-0.18545192509055364,-0.9166738082465068
194,1556280000,581,401,0,982,17,-0.18545192509055364,0.9614366885175766
194,1556294400,568,257,0,825,17,-0.18545192509055364,0.5541668708491221
194,1556308800,853,447,0,1300,17,-0.18545192509055364,1.7863526249415802
194,1556323200,506,128,0,634,17,-0.18545192509055364,0.05869849394036525
194,1556337600,144,42,0,186,17,-0.18545192509055364,-1.1034472278142058
194,1556352000,54,85,31,139,17,6.3200063945333405,-1.2253687655875647
194,1556366400,242,249,7,491,17,1.2835225341793581,-0.31225426992325894
194,1556380800,585,285,0,870,17,-0.18545192509055364,0.6709002580789338
194,1556395200,709,241,0,950,17,-0.18545192509055364,0.8784262798208216
194,1556409600,434,126,0,560,17,-0.18545192509055364,-0.13326307617088085
194,1556424000,179,36,0,215,17,-0.18545192509055364,-1.0282190449327715
194,1556438400,62,60,0,122,17,-0.18545192509055364,-1.2694680452077158
194,1556452800,197,166,0,363,17,-0.18545192509055364,-0.6442959047102792
194,1556467200,448,228,0,676,17,-0.18545192509055364,0.16764965535485626
194,1556481600,566,187,0,753,17,-0.18545192509055364,0.36739345128142314
194,1556496000,293,67,0,360,17,-0.18545192509055364,-0.6520781305256
194,1556510400,52,17,0,69,17,-0.18545192509055364,-1.4069540346117164
194,1556524800,166,134,0,300,17,-0.18545192509055364,-0.8077226468320158
194,1556526960,146,62,0,208,17,-0.18545192509055364,-1.0463775718351866
194,1556539200,488,262,0,750,17,-0.18545192509055364,0.35961122546610236
194,1556553600,497,253,0,750,17,-0.18545192509055364,0.35961122546610236
194,1556568000,860,368,0,1228,17,-0.18545192509055364,1.599579205373881
194,1556582400,314,119,0,433,18,-0.20648937605075615,-0.5227047354316625
194,1556596800,380,95,0,475,18,-0.20648937605075615,-0.419463087990004
194,1556611200,199,146,0,345,18,-0.20648937605075615,-0.7390205681665662
194,1556625600,752,409,0,1161,18,-0.20648937605075615,1.2668171535570865
194,1556640000,635,441,0,1076,18,-0.20648937605075615,1.0578757242108725
194,1556654400,1110,416,0,1526,18,-0.20648937605075615,2.1640362325143574
194,1556668800,563,137,0,700,18,-0.20648937605075615,0.1336171661617385
194,1556683200,68,20,0,88,18,-0.20648937605075615,-1.370761125131001
194,1556697600,219,124,0,343,18,-0.20648937605075615,-0.7439368370923596
194,1556712000,687,359,0,1046,18,-0.20648937605075615,0.9841316903239736
194,1556726400,506,253,0,759,18,-0.20648937605075615,0.2786470994726399
194,1556740800,916,389,0,1305,18,-0.20648937605075615,1.6207885162142015
194,1556755200,444,100,0,544,18,-0.20648937605075615,-0.2498518100501363
194,1556769600,66,33,0,99,18,-0.20648937605075615,-1.3437216460391381
194,1556784000,193,119,0,312,18,-0.20648937605075615,-0.8201390054421552
194,1556798400,629,351,0,980,18,-0.20648937605075615,0.8218948157727958
194,1556812800,545,271,0,816,18,-0.20648937605075615,0.41876076385774796
194,1556827200,934,452,0,1386,18,-0.20648937605075615,1.8198974077088288
194,1556841600,546,103,0,649,18,-0.20648937605075615,0.008252308554010206
194,1556856000,80,38,0,118,18,-0.20648937605075615,-1.297017091244102
194,1556870400,162,106,0,268,18,-0.20648937605075615,-0.928296921809607
194,1556884800,623,357,0,980,18,-0.20648937605075615,0.8218948157727958
194,1556899200,581,264,0,845,18,-0.20648937605075615,0.49004666328175034
194,1556913600,938,498,0,1436,18,-0.20648937605075615,1.9428041308536605
194,1556928000,525,131,0,656,18,-0.20648937605075615,0.02545924979428664
194,1556942400,153,73,0,226,18,-0.20648937605075615,-1.0315385692512657
194,1556956800,55,66,11,121,18,6.153383406312534,-1.2896426878554121
194,1556971200,231,223,0,454,18,-0.20648937605075615,-0.47108391171083325
194,1556985600,511,268,0,779,18,-0.20648937605075615,0.32780978873057254
194,1557000000,736,236,0,972,18,-0.20648937605075615,0.8022297400696228
194,1557014400,460,104,0,564,18,-0.20648937605075615,-0.2006891207922036
194,1557028800,185,34,0,219,18,-0.20648937605075615,-1.048745510491542
194,1557043200,44,47,3,91,18,1.5280213827755955,-1.363386721742311
194,1557057600,185,186,1,371,18,0.37168087689136103,-0.6751090721312538
194,1557072000,428,220,0,648,18,-0.20648937605075615,0.0057941740911135724
194,1557086400,495,179,0,674,18,-0.20648937605075615,0.06970567012642603
194,1557100800,322,56,0,378,18,-0.20648937605075615,-0.6579021308909774
194,1557115200,45,17,0,62,18,-0.20648937605075615,-1.4346726211663134
194,1557129600,172,97,0,269,18,-0.20648937605075615,-0.9258387873467104
194,1557144000,586,317,0,903,18,-0.20648937605075615,0.632618462129755
194,1557158400,514,228,0,742,18,-0.20648937605075615,0.23685881360339708
194,1557172800,888,410,0,1298,18,-0.20648937605075615,1.603581574973925
194,1557187200,446,97,0,543,19,-0.26335601016186544,-0.014346615514853932
194,1557201600,62,19,0,81,19,-0.26335601016186544,-1.1352814424327786
194,1557216000,176,115,0,291,19,-0.26335601016186544,-0.62576561201554
194,1557226565,523,287,0,810,19,-0.26335601016186544,0.6334663688727779
194,1557227153,14,20,6,34,19,3.5622365585052327,-1.2493159378118748
194,1557229081,43,32,0,75,19,-0.26335601016186544,-1.1498390375875567
194,1557230400,35,19,0,54,19,-0.26335601016186544,-1.2007906206292807
194,1557244800,493,246,0,739,19,-0.26335601016186544,0.46120149287456863
194,1557259200,916,368,0,1284,19,-0.26335601016186544,1.783516386100259
194,1557273600,495,141,0,636,19,-0.26335601016186544,0.2112961093842088
194,1557288000,72,26,0,98,19,-0.26335601016186544,-1.0940349228275734
194,1557299732,67,63,0,130,19,-0.26335601016186544,-1.016394415335423
194,1557302400,110,78,0,188,19,-0.26335601016186544,-0.8756709955058999
194,1557316800,680,338,0,1018,19,-0.26335601016186544,1.138129667571757
194,1557331200,526,254,0,780,19,-0.26335601016186544,0.5606783930988866
194,1557345600,942,416,0,1358,19,-0.26335601016186544,1.9630600596758572
194,1557360000,509,98,0,607,19,-0.26335601016186544,0.1409343994694473
194,1557374400,78,19,0,97,19,-0.26335601016186544,-1.0964611886867033
194,1557388800,173,112,0,285,19,-0.26335601016186544,-0.6403232071703183
194,1557403200,666,322,0,988,19,-0.26335601016186544,1.0653416917978658
194,1557417600,534,255,0,789,19,-0.26335601016186544,0.582514785831054
194,1557432000,963,443,0,1406,19,-0.26335601016186544,2.079520820914083
194,1557446400,499,103,0,602,19,-0.26335601016186544,0.12880307017379877
194,1557460800,86,26,0,112,19,-0.26335601016186544,-1.0600672007997576
194,1557475200,140,123,0,263,19,-0.26335601016186544,-0.6937010560711718
194,1557489600,626,334,0,960,19,-0.26335601016186544,0.9974062477422339
194,1557504000,574,271,0,845,19,-0.26335601016186544,0.7183856739423176
194,1557518400,977,464,0,1441,19,-0.26335601016186544,2.164440125983623
194,1557532800,509,129,0,638,19,-0.26335601016186544,0.21614864110246823
194,1557547200,178,28,0,206,19,-0.26335601016186544,-0.8319982100415652
194,1557561600,50,57,7,107,19,4.199835319949749,-1.0721985300954062
194,1557576000,218,164,0,382,19,-0.26335601016186544,-0.40497541883473676
194,1557590400,515,304,0,819,19,-0.26335601016186544,0.6553027616049452
194,1557604800,700,270,0,970,19,-0.26335601016186544,1.021668906333531
194,1557619200,404,111,0,515,19,-0.26335601016186544,-0.08228205957048573
194,1557633600,132,32,0,164,19,-0.26335601016186544,-0.9339013761250129
194,1557648000,40,46,6,86,19,3.5622365585052327,-1.12315011313713
194,1557662400,167,107,0,274,19,-0.26335601016186544,-0.6670121316207451
194,1557676800,350,163,0,513,19,-0.26335601016186544,-0.08713459128874514
194,1557691200,392,153,0,545,19,-0.26335601016186544,-0.009494083796594518
194,1557705600,252,63,0,315,19,-0.26335601016186544,-0.5675352313964271
194,1557720000,44,11,0,55,19,-0.26335601016186544,-1.198364354770151
194,1557734400,167,100,0,267,19,-0.26335601016186544,-0.683995992634653
194,1557748800,614,316,0,930,19,-0.26335601016186544,0.9246182719683427
194,1557763200,451,217,0,668,19,-0.26335601016186544,0.28893661687635946
194,1557777600,856,426,0,1282,19,-0.26335601016186544,1.7786638543819995
194,1557792000,401,88,0,489,20,-0.21905397716916175,-0.3776309977003344
194,1557806400,49,20,0,69,20,-0.21905397716916175,-1.4107282060492643
194,1557820800,179,122,0,301,20,-0.21905397716916175,-0.8400649861993793
194,1557835200,694,342,0,1036,20,-0.21905397716916175,0.9678551284112481
194,1557849600,542,263,0,805,20,-0.21905397716916175,0.3996516638193366
194,1557864000,851,402,0,1253,20,-0.21905397716916175,1.5016220193915284
194,1557878400,502,123,0,625,20,-0.21905397716916175,-0.04310428261591906
194,1557892800,84,17,0,101,20,-0.21905397716916175,-1.3320160377941077
194,1557907200,172,143,0,315,20,-0.21905397716916175,-0.8056284125877483
194,1557921600,642,422,0,1064,20,-0.21905397716916175,1.03672827563451
194,1557936000,541,250,0,791,20,-0.21905397716916175,0.3652150902077056
194,1557950400,1044,413,0,1457,20,-0.21905397716916175,2.0034120920181517
194,1557964800,529,112,0,641,20,-0.21905397716916175,-0.0037481984883407753
194,1557979200,81,18,0,99,20,-0.21905397716916175,-1.3369355483100551
194,1557993600,165,126,0,291,20,-0.21905397716916175,-0.8646625387791157
194,1558008000,656,326,0,982,20,-0.21905397716916175,0.8350283444806713
194,1558022400,554,233,0,787,20,-0.21905397716916175,0.35537606917581105
194,1558036800,924,449,0,1373,20,-0.21905397716916175,1.7967926503483655
194,1558051200,684,132,0,816,20,-0.21905397716916175,0.4267089716570467
194,1558065600,95,39,0,134,20,-0.21905397716916175,-1.2508441142809776
194,1558080000,161,110,0,271,20,-0.21905397716916175,-0.9138576439385885
194,1558094400,598,319,0,917,20,-0.21905397716916175,0.6751442527123845
194,1558108800,549,268,0,817,20,-0.21905397716916175,0.42916872691502034
194,1558123200,995,442,0,1437,20,-0.21905397716916175,1.9542169868586787
194,1558137600,581,152,0,733,20,-0.21905397716916175,0.22254928524523435
194,1558152000,183,50,0,233,20,-0.21905397716916175,-1.007328343741587
194,1558166400,57,63,6,120,20,5.301106247493714,-1.2852806878926086
194,1558180800,219,185,0,404,20,-0.21905397716916175,-0.586710194628094
194,1558195200,517,294,0,811,20,-0.21905397716916175,0.4144101953671785
194,1558209600,746,324,0,1070,20,-0.21905397716916175,1.051486807182352
194,1558224000,460,153,0,613,20,-0.21905397716916175,-0.07262134571160277
194,1558238400,192,46,0,238,20,-0.21905397716916175,-0.9950295674517188
194,1558252800,53,57,4,110,20,3.4610528392727558,-1.309878240472345
194,1558267200,201,168,0,369,20,-0.21905397716916175,-0.6728016286571715
194,1558281600,491,288,0,779,20,-0.21905397716916175,0.3356980271120219
194,1558296000,619,230,0,849,20,-0.21905397716916175,0.5078808951701769
194,1558310400,311,97,0,408,20,-0.21905397716916175,-0.5768711735961995
194,1558324800,60,16,0,76,20,-0.21905397716916175,-1.3935099192434488
194,1558339200,189,116,0,305,20,-0.21905397716916175,-0.8302259651674847
194,1558353600,559,340,0,899,20,-0.21905397716916175,0.6308686580688591
194,1558368000,488,233,0,721,20,-0.21905397716916175,0.19303222214955063
194,1558382400,950,427,0,1377,20,-0.21905397716916175,1.8066316713802602
194,1558396800,419,99,0,518,21,-0.26304596724206314,-0.06722838370242655
194,1558411200,70,17,0,87,21,-0.26304596724206314,-1.1556211231920432
194,1558425600,174,127,0,301,21,-0.26304596724206314,-0.6152126632134401
194,1558436790,595,293,0,888,21,-0.26304596724206314,0.8671226919615136
194,1558437021,12,6,0,18,21,-0.26304596724206314,-1.329864972437481
194,1558440000,111,58,0,169,21,-0.26304596724206314,-0.9485487226394944
194,1558454400,626,373,0,999,21,-0.26304596724206314,1.1474280146606957
194,1558468800,969,461,0,1430,21,-0.26304596724206314,2.2358207541503123
194,1558483200,502,124,0,626,21,-0.26304596724206314,0.20550111946434518
194,1558497600,65,20,0,85,21,-0.26304596724206314,-1.1606716695469836
194,1558512000,177,122,0,299,21,-0.26304596724206314,-0.6202632095683803
194,1558526400,673,343,0,1016,21,-0.26304596724206314,1.1903576586776876
194,1558540800,551,254,0,805,21,-0.26304596724206314,0.6575250182314946
194,1558555200,968,416,0,1384,21,-0.26304596724206314,2.1196581879866874
194,1558569600,534,112,0,646,21,-0.26304596724206314,0.25600658301374735
194,1558584000,73,25,0,98,21,-0.26304596724206314,-1.127843118239872
194,1558598400,169,121,0,290,21,-0.26304596724206314,-0.6429906681656113
194,1558612800,617,364,0,981,21,-0.26304596724206314,1.1019730974662336
194,1558627200,556,303,0,859,21,-0.26304596724206314,0.7938897698148805
194,1558641600,914,460,0,1374,21,-0.26304596724206314,2.0944054562119865
194,1558656000,551,131,0,682,21,-0.26304596724206314,0.34691641740267126
194,1558670400,96,21,0,117,21,-0.26304596724206314,-1.0798629278679401
194,1558684800,144,113,0,257,21,-0.26304596724206314,-0.7263246830221248
194,1558699200,523,310,0,833,21,-0.26304596724206314,0.7282326672006576
194,1558713600,670,370,0,1040,21,-0.26304596724206314,1.2509642149369702
194,1558728000,926,328,0,1254,21,-0.26304596724206314,1.7913726749155734
194,1558742400,526,121,0,647,21,-0.26304596724206314,0.25853185619121744
194,1558756800,149,29,0,178,21,-0.26304596724206314,-0.9258212640422635
194,1558771200,55,76,21,131,21,3.2380588080220165,-1.0445091033833585
194,1558785600,217,207,0,424,21,-0.26304596724206314,-0.30460406238461674
194,1558800000,456,243,0,699,21,-0.26304596724206314,0.3898460614196631
194,1558814400,626,230,0,856,21,-0.26304596724206314,0.7863139502824701
194,1558828800,400,107,0,507,21,-0.26304596724206314,-0.09500638865459773
194,1558843200,131,25,0,156,21,-0.26304596724206314,-0.9813772739466058
194,1558857600,43,44,1,87,21,-0.0963266922294879,-1.1556211231920432
194,1558872000,151,165,14,316,21,2.07102388293399,-0.5773335655513885
194,1558886400,397,210,0,607,21,-0.26304596724206314,0.1575209290924131
194,1558900800,484,191,0,675,21,-0.26304596724206314,0.3292395051603805
194,1558915200,315,96,0,411,21,-0.26304596724206314,-0.33743261369172817
194,1558929600,77,24,0,101,21,-0.26304596724206314,-1.1202672987074618
194,1558944000,33,66,33,99,21,5.23869010817292,-1.125317845062402
194,1558957471,148,146,0,294,21,-0.26304596724206314,-0.6328895754557309
194,1558958400,22,24,2,46,21,0.07039258278308733,-1.2591573234683178
194,1558972800,414,180,0,594,21,-0.26304596724206314,0.1246923777853017
194,1558987200,464,160,0,624,21,-0.26304596724206314,0.20045057310940495
194,1559001600,277,85,0,362,22,-0.22308686760470128,-0.6444044238920793
194,1559016000,51,10,0,61,22,-0.22308686760470128,-1.4459157114603265
194,1559030400,176,142,0,318,22,-0.22308686760470128,-0.76156886459973
194,1559044800,608,314,0,922,22,-0.22308686760470128,0.846779366932567
194,1559059200,467,255,0,722,22,-0.22308686760470128,0.31421372735233616
194,1559073600,826,352,0,1178,22,-0.22308686760470128,1.5284633855952623
194,1559088000,417,92,0,509,22,-0.22308686760470128,-0.25296867880060964
194,1559102400,50,16,0,66,22,-0.22308686760470128,-1.4326015704708208
194,1559116800,185,134,0,319,22,-0.22308686760470128,-0.7589060364018289
194,1559131200,697,346,0,1043,22,-0.22308686760470128,1.1689815788786067
194,1559145600,501,248,0,749,22,-0.22308686760470128,0.3861100886956673
194,1559160000,961,415,0,1376,22,-0.22308686760470128,2.055703368779691
194,1559174400,436,143,0,579,22,-0.22308686760470128,-0.06657070494752886
194,1559188800,60,21,0,81,22,-0.22308686760470128,-1.3926591475023036
194,1559203200,171,158,0,329,22,-0.22308686760470128,-0.7322777544228174
194,1559217600,677,409,0,1086,22,-0.22308686760470128,1.2834831913883562
194,1559232000,526,291,0,817,22,-0.22308686760470128,0.5671824061529458
194,1559246400,842,407,0,1249,22,-0.22308686760470128,1.7175241876462444
194,1559260800,485,126,0,611,22,-0.22308686760470128,0.018639797385308077
194,1559275200,93,23,0,116,22,-0.22308686760470128,-1.2994601605757632
194,1559289600,167,124,0,291,22,-0.22308686760470128,-0.8334652259430612
194,1559304000,628,356,0,984,22,-0.22308686760470128,1.0118747152024385
194,1559318400,603,310,0,913,22,-0.22308686760470128,0.8228139131514566
194,1559332800,865,375,0,1240,22,-0.22308686760470128,1.693558733865134
194,1559347200,525,147,0,672,22,-0.22308686760470128,0.18107231745727848
194,1559361600,161,51,0,212,22,-0.22308686760470128,-1.0438286535772523
194,1559376000,62,68,6,130,22,1.026199590981626,-1.262180565805147
194,1559390400,237,230,0,467,22,-0.22308686760470128,-0.3648074631124581
194,1559404800,495,311,0,806,22,-0.22308686760470128,0.5378912959760331
194,1559419200,578,278,0,856,22,-0.22308686760470128,0.6710327058710908
194,1559433600,399,140,0,539,22,-0.22308686760470128,-0.173083832863575
194,1559448000,179,39,0,218,22,-0.22308686760470128,-1.0278516843898455
194,1559462400,49,58,9,107,22,1.6508428202747896,-1.3234256143568734
194,1559476800,179,209,30,388,22,6.0233454253269345,-0.5751708907466493
194,1559491200,423,255,0,678,22,-0.22308686760470128,0.1970492866446854
194,1559505600,522,221,0,743,22,-0.22308686760470128,0.3701331195082604
194,1559520000,309,82,0,391,22,-0.22308686760470128,-0.5671824061529458
194,1559534400,52,24,0,76,22,-0.22308686760470128,-1.4059732884918092
194,1559548800,178,135,0,313,22,-0.22308686760470128,-0.7748830055892358
194,1559563200,588,325,0,913,22,-0.22308686760470128,0.8228139131514566
194,1559577600,526,241,0,767,22,-0.22308686760470128,0.4340409962578881
194,1559592000,785,386,0,1171,22,-0.22308686760470128,1.5098235882099542
194,1559606400,412,127,0,539,23,-0.32006096980144877,-0.18654713849188542
194,1559620800,67,19,0,86,23,-0.32006096980144877,-1.384807049682504
194,1559635200,176,139,0,315,23,-0.32006096980144877,-0.7790641806700279
194,1559649600,644,356,0,1000,23,-0.32006096980144877,1.0328740956336668
194,1559664000,487,253,0,740,23,-0.32006096980144877,0.34513110024832283
194,1559678400,835,426,0,1261,23,-0.32006096980144877,1.7232622563858775
194,1559692800,484,140,0,624,23,-0.32006096980144877,0.038291917691784735
194,1559707200,59,24,0,83,23,-0.32006096980144877,-1.3927425457831042
194,1559721600,184,136,0,320,23,-0.32006096980144877,-0.7658383538356944
194,1559736000,676,355,0,1031,23,-0.32006096980144877,1.1148742220065349
194,1559750400,486,251,0,737,23,-0.32006096980144877,0.3371956041477227
194,1559764800,938,448,0,1386,23,-0.32006096980144877,2.0539079272442162
194,1559779200,524,121,0,645,23,-0.32006096980144877,0.0938403903959856
194,1559793600,66,22,0,88,23,-0.32006096980144877,-1.3795167189487707
194,1559808000,179,125,0,304,23,-0.32006096980144877,-0.8081609997055618
194,1559822400,681,369,0,1050,23,-0.32006096980144877,1.1651323639770022
194,1559836800,541,280,0,821,23,-0.32006096980144877,0.5593894949645262
194,1559851200,880,448,0,1328,23,-0.32006096980144877,1.900488335965947
194,1559865600,574,138,0,712,23,-0.32006096980144877,0.271066469976055
194,1559880000,93,39,0,132,23,-0.32006096980144877,-1.2631294428066355
194,1559894400,185,130,0,315,23,-0.32006096980144877,-0.7790641806700279
194,1559908800,587,384,0,971,23,-0.32006096980144877,0.9561642999945323
194,1559923200,545,302,0,847,23,-0.32006096980144877,0.6281637945030606
194,1559937600,868,418,0,1286,23,-0.32006096980144877,1.7893913905575451
194,1559952000,504,152,0,656,23,-0.32006096980144877,0.12293720943151938
194,1559966400,189,70,0,259,23,-0.32006096980144877,-0.9271934412145636
194,1559980800,59,67,8,126,23,2.2404267886101414,-1.2790004350078357
194,1559995200,217,229,12,446,23,3.5206706678159367,-0.43254751761048926
194,1560009600,447,236,0,683,23,-0.32006096980144877,0.1943566743369205
194,1560024000,583,232,0,815,23,-0.32006096980144877,0.5435185027633259
194,1560038400,401,160,0,561,23,-0.32006096980144877,-0.12835350042081786
194,1560052800,146,39,0,185,23,-0.32006096980144877,-1.1229356783627
194,1560067200,43,53,10,96,23,2.880548728213039,-1.358355396013837
194,1560081600,159,171,12,330,23,3.5206706678159367,-0.7393867001670273
194,1560096000,431,238,0,669,23,-0.32006096980144877,0.15732435920078658
194,1560110400,528,173,0,701,23,-0.32006096980144877,0.24196965094052122
194,1560124800,274,86,0,360,23,-0.32006096980144877,-0.6600317391610261
194,1560139200,51,20,0,71,23,-0.32006096980144877,-1.4244845301855047
194,1560153600,171,111,0,282,23,-0.32006096980144877,-0.8663546377766294
194,1560168000,628,331,0,959,23,-0.32006096980144877,0.9244223155921318
194,1560182400,481,203,0,684,23,-0.32006096980144877,0.1970018397037872
194,1560196800,746,350,0,1096,23,-0.32006096980144877,1.2868099708528709
194,1560211200,393,83,0,476,24,-0.2122605904404675,-0.48040764699322375
194,1560225600,58,19,0,77,24,-0.2122605904404675,-1.364879090100903
194,1560240000,154,125,0,279,24,-0.2122605904404675,-0.9171015675250854
194,1560254400,610,392,0,1002,24,-0.2122605904404675,0.6855872880309349
194,1560268800,492,259,0,751,24,-0.2122605904404675,0.12919046542434967
194,1560283200,917,378,0,1295,24,-0.2122605904404675,1.3350863678067495
194,1560297600,495,127,0,622,24,-0.2122605904404675,-0.15676646730971203
194,1560312000,73,26,0,99,24,-0.2122605904404675,-1.316111241107497
194,1560325766,159,118,0,277,24,-0.2122605904404675,-0.9215350083426678
194,1560326400,26,16,0,42,24,-0.2122605904404675,-1.442464304408594
194,1560340800,686,380,0,1066,24,-0.2122605904404675,0.8274573941935701
194,1560355200,451,271,0,722,24,-0.2122605904404675,0.06490557356940557
194,1560369600,854,457,0,1311,24,-0.2122605904404675,1.3705538943474083
194,1560384000,509,128,0,637,24,-0.2122605904404675,-0.12351566117784439
194,1560398400,70,32,0,102,24,-0.2122605904404675,-1.3094610798811237
194,1560412800,151,140,0,291,24,-0.2122605904404675,-0.8905009226195914
194,1560427200,679,568,0,1247,24,-0.2122605904404675,1.228683788184773
194,1560441600,521,365,0,886,24,-0.2122605904404675,0.42844772061115843
194,1560456000,867,510,0,1377,24,-0.2122605904404675,1.516857441327626
194,1560470400,531,153,0,684,24,-0.2122605904404675,-0.019329801964659117
194,1560484800,101,26,0,127,24,-0.2122605904404675,-1.2540430696613443
194,1560499200,147,224,77,371,24,4.895259867033281,-0.7131632899162972
194,1560513600,615,618,3,1233,24,-0.013266286902529229,1.1976497024616966
194,1560528000,625,387,0,1012,24,-0.2122605904404675,0.7077544921188467
194,1560542400,870,462,0,1332,24,-0.2122605904404675,1.417105022932023
194,1561161600,8957,8483,0,17440,25,-0.5101127853361851,4.106814407855534
194,1561176000,210,99,0,309,25,-0.5101127853361851,-0.3059135329402565
194,1561190400,53,74,21,127,25,2.4114422579528747,-0.3527944205256184
194,1561204800,235,246,11,481,25,1.0202255706723702,-0.26160851829914533
194,1561219200,498,322,0,820,25,-0.5101127853361851,-0.17428642548904824
194,1561233600,678,364,0,1042,25,-0.5101127853361851,-0.11710204612668378
194,1561248000,466,183,0,649,25,-0.5101127853361851,-0.21833385283573437
194,1561262400,222,52,0,274,25,-0.5101127853361851,-0.3149290882451338
194,1561276800,49,62,13,111,25,1.2984689081284713,-0.3569158172364194
194,1561291200,156,177,21,333,25,2.4114422579528747,-0.299731437874055
194,1561305600,436,317,0,753,25,-0.5101127853361851,-0.1915447742155276
194,1561320000,573,244,0,817,25,-0.5101127853361851,-0.17505918737232343
194,1561334400,329,103,0,432,25,-0.5101127853361851,-0.2742302957259735
194,1561348800,65,22,0,87,25,-0.5101127853361851,-0.363097912302621
194,1561363200,159,106,0,265,25,-0.5101127853361851,-0.3172473738949594
194,1561377600,506,424,0,930,25,-0.5101127853361851,-0.14595182310229107
194,1561392000,447,254,0,701,25,-0.5101127853361851,-0.204939313525631
194,1561406400,929,439,0,1368,25,-0.5101127853361851,-0.03312858814411254
194,1561420800,508,134,0,642,26,-0.2991854316368459,-0.009866819932783802
194,1561435200,65,40,0,105,26,-0.2991854316368459,-1.3585714063812986
194,1561449600,145,155,10,300,26,1.7275545891288842,-0.8688183442631229
194,1561464000,672,442,0,1114,26,-0.2991854316368459,1.1755867458096725
194,1561478400,474,331,0,805,26,-0.2991854316368459,0.39951650891471696
194,1561492800,915,488,0,1403,26,-0.2991854316368459,1.901425899410456
194,1561507200,547,141,0,688,26,-0.2991854316368459,0.1056646716438115
194,1561521600,67,30,0,97,26,-0.2991854316368459,-1.3786638396989674
194,1561536000,157,131,0,288,26,-0.2991854316368459,-0.8989569942396259
194,1561550400,645,464,0,1109,26,-0.2991854316368459,1.1630289749861296
194,1561564800,502,269,0,771,26,-0.2991854316368459,0.31412366731462477
194,1561579200,935,456,0,1391,26,-0.2991854316368459,1.871287249433953
194,1561593600,577,144,0,721,26,-0.2991854316368459,0.1885459590791951
194,1561608000,75,33,0,108,26,-0.2991854316368459,-1.3510367438871729
194,1561622400,149,155,6,304,26,0.9168585808225922,-0.8587721276042884
194,1561636800,632,541,0,1173,26,-0.2991854316368459,1.3237684415274795
194,1561651200,512,349,0,861,26,-0.2991854316368459,0.5401635421383982
194,1561665600,840,589,0,1429,26,-0.2991854316368459,1.9667263076928794
194,1561680000,562,162,0,724,26,-0.2991854316368459,0.19608062157332087
194,1561694400,93,37,0,130,26,-0.2991854316368459,-1.2957825522635837
194,1561708800,144,132,0,276,26,-0.2991854316368459,-0.9290956442161291
194,1561723200,554,410,0,964,26,-0.2991854316368459,0.7988536211033834
194,1561737600,563,337,0,900,26,-0.2991854316368459,0.6381141545620334
194,1561752000,808,381,0,1189,26,-0.2991854316368459,1.363953308162817
194,1561766400,519,165,0,684,26,-0.2991854316368459,0.09561845498497713
194,1561780800,203,56,0,259,26,-0.2991854316368459,-0.9717920650161752
194,1561795200,58,86,28,144,26,5.375686626507199,-1.2606207939576635
194,1561809600,224,237,13,461,26,2.3355765953586034,-0.46445812374503925
194,1561824000,494,270,0,764,26,-0.2991854316368459,0.2965427881616646
194,1561838400,583,288,0,871,26,-0.2991854316368459,0.5652790837854842
194,1561852800,334,135,0,469,26,-0.2991854316368459,-0.4443656904273705
194,1561867200,189,42,0,231,26,-0.2991854316368459,-1.0421155816280159
194,1561881600,45,50,5,95,26,0.7141845787460191,-1.3836869480283847
194,1561896000,191,185,0,376,26,-0.2991854316368459,-0.6779402277452697
194,1561910400,414,275,0,689,26,-0.2991854316368459,0.1081762258085201
194,1561924800,576,231,0,807,26,-0.2991854316368459,0.4045396172441342
194,1561939200,374,122,0,496,26,-0.2991854316368459,-0.3765537279802385
194,1561953600,70,32,0,102,26,-0.2991854316368459,-1.3661060688754245
194,1561968000,142,132,0,274,26,-0.2991854316368459,-0.9341187525455463
194,1561982400,550,404,0,954,26,-0.2991854316368459,0.7737380794562975
194,1561996800,426,322,0,748,26,-0.2991854316368459,0.25635792152632714
194,1562011200,780,433,0,1213,26,-0.2991854316368459,1.4242306081158231
194,1562025600,462,120,0,582,27,-0.3948875381735043,0.22347788308955024
194,1562040000,89,22,0,111,27,-0.3948875381735043,-1.2317029869820377
194,1562054400,149,150,1,299,27,-0.3615837698938112,-0.6508664613483678
194,1562068800,589,429,0,1018,27,-0.3948875381735043,1.5705242936016783
194,1562083200,474,302,0,776,27,-0.3948875381735043,0.8228517446476991
194,1562097600,822,416,0,1238,27,-0.3948875381735043,2.2502266108325686
194,1562112000,461,106,0,567,27,-0.3948875381735043,0.17713454327835318
194,1562126400,59,31,0,90,27,-0.3948875381735043,-1.2965836627177136
194,1562140800,131,145,14,276,27,0.07136521774219956,-0.7219262490588699
194,1562155200,508,467,0,975,27,-0.3948875381735043,1.4376733861429134
194,1562169600,509,355,0,864,27,-0.3948875381735043,1.0947326715400552
194,1562184000,800,325,0,1125,27,-0.3948875381735043,1.9011067842548839
194,1562198400,431,136,0,567,27,-0.3948875381735043,0.17713454327835318
194,1562212800,100,27,0,127,27,-0.3948875381735043,-1.1822700911834274
194,1562227200,44,66,22,110,27,0.33779536397974463,-1.2347925429694508
194,1562241600,196,164,0,360,27,-0.3948875381735043,-0.46240354611616635
194,1562256000,358,214,0,572,27,-0.3948875381735043,0.19258232321541888
194,1562270400,337,146,0,483,27,-0.3948875381735043,-0.0823881596643504
194,1562284800,245,167,0,412,27,-0.3948875381735043,-0.3017466347706832
194,1562299200,78,29,0,107,27,-0.3948875381735043,-1.2440612109316902
194,1562313600,64,126,62,190,27,1.6699460951674698,-0.9876280639763998
194,1562328000,242,356,114,598,27,3.401742045711513,0.27291077888816045
194,1562342400,401,295,0,696,27,-0.3948875381735043,0.575687265654648
194,1562356800,565,308,0,873,27,-0.3948875381735043,1.1225386754267734
194,1562371200,380,135,0,515,27,-0.3948875381735043,0.01647763193287001
194,1562385600,147,35,0,182,27,-0.3948875381735043,-1.0123445118757048
194,1562400000,37,78,41,115,27,0.9705669612939142,-1.2193447630323853
194,1562414400,154,282,128,436,27,3.8679948016272165,-0.22759729107276788
194,1562428800,369,307,0,676,27,-0.3948875381735043,0.5138961459063852
194,1562443200,473,225,0,698,27,-0.3948875381735043,0.5818663776294742
194,1562457600,292,104,0,396,27,-0.3948875381735043,-0.3511795305692934
194,1562472000,124,32,0,156,27,-0.3948875381735043,-1.0926729675484466
194,1562486400,38,69,31,107,27,0.6375292784969828,-1.2440612109316902
194,1562500800,120,205,85,325,27,2.435932765600412,-0.5705380056756262
194,1562515200,374,275,0,649,27,-0.3948875381735043,0.4304781342462305
194,1562529600,442,217,0,659,27,-0.3948875381735043,0.4613736941203619
194,1562544000,283,75,0,358,27,-0.3948875381735043,-0.46858265809099264
194,1562558400,57,17,0,74,27,-0.3948875381735043,-1.3460165585163237
194,1562572800,145,138,0,283,27,-0.3948875381735043,-0.700299357146978
194,1562587200,518,409,0,927,27,-0.3948875381735043,1.2893746987470829
194,1562601600,447,231,0,678,27,-0.3948875381735043,0.5200752578812115
194,1562616000,773,383,0,1156,27,-0.3948875381735043,1.9968830198646912
194,1562630400,393,101,0,494,28,-0.23857158396222705,-0.30545134322750433
194,1562644800,50,31,0,81,28,-0.23857158396222705,-1.4053805522007847
194,1562659200,156,143,0,299,28,-0.23857158396222705,-0.8247883789412809
194,1562673600,607,491,0,1098,28,-0.23857158396222705,1.3031618340602957
194,1562688000,477,291,0,768,28,-0.23857158396222705,0.424283773621597
194,1562702400,804,449,0,1253,28,-0.23857158396222705,1.7159681957815027
194,1562716800,511,126,0,637,28,-0.23857158396222705,0.07539581629593177
194,1562731200,71,27,0,98,28,-0.23857158396222705,-1.3601050157539427
194,1562745600,168,132,0,300,28,-0.23857158396222705,-0.8221251120914665
194,1562760000,656,404,0,1060,28,-0.23857158396222705,1.2019576937673546
194,1562774400,526,265,0,791,28,-0.23857158396222705,0.4855389111673245
194,1562788800,827,476,0,1303,28,-0.23857158396222705,1.8491315382722147
194,1562803200,517,171,0,688,28,-0.23857158396222705,0.21122242563645793
194,1562817600,92,27,0,119,28,-0.23857158396222705,-1.3041764119078438
194,1562832000,170,121,0,291,28,-0.23857158396222705,-0.8460945137397947
194,1562846400,629,359,0,988,28,-0.23857158396222705,1.0102024805807295
194,1562860800,496,262,0,758,28,-0.23857158396222705,0.39765110512345464
194,1562875200,811,468,0,1279,28,-0.23857158396222705,1.7852131338766728
194,1562889600,500,132,0,632,28,-0.23857158396222705,0.062079482046860576
194,1562904000,88,21,0,109,28,-0.23857158396222705,-1.3308090804059862
194,1562918400,138,119,0,257,28,-0.23857158396222705,-0.9366455866334789
194,1562932800,548,414,0,962,28,-0.23857158396222705,0.9409575424855593
194,1562947200,517,386,0,903,28,-0.23857158396222705,0.7838247983465192
194,1562961600,789,428,0,1217,28,-0.23857158396222705,1.62009058918819
194,1562976000,525,157,0,682,28,-0.23857158396222705,0.1952428245375725
194,1562990400,197,41,0,238,28,-0.23857158396222705,-0.9872476567799494
194,1563004800,62,70,8,132,28,0.9231683031581831,-1.2695539428602587
194,1563019200,229,222,0,451,28,-0.23857158396222705,-0.4199718177695166
194,1563033600,448,309,0,757,28,-0.23857158396222705,0.39498783827364037
194,1563048000,584,303,0,887,28,-0.23857158396222705,0.7412125287494914
194,1563062400,394,184,0,578,28,-0.23857158396222705,-0.08173692784310829
194,1563076800,191,32,0,223,28,-0.23857158396222705,-1.0271966595271629
194,1563091200,43,64,21,107,28,2.8109956197288497,-1.3361356141056147
194,1563105600,135,175,40,310,28,5.570127851639823,-0.7954924435933242
194,1563120000,370,286,0,656,28,-0.23857158396222705,0.1259978864424023
194,1563134400,465,194,0,659,28,-0.23857158396222705,0.13398768699184502
194,1563148800,311,63,0,374,28,-0.23857158396222705,-0.625043365205213
194,1563163200,50,26,0,76,28,-0.23857158396222705,-1.418696886449856
194,1563177600,160,126,0,286,28,-0.23857158396222705,-0.8594108479888659
194,1563192000,585,333,0,918,28,-0.23857158396222705,0.8237738010937328
194,1563206400,424,240,0,664,28,-0.23857158396222705,0.1473040212409162
194,1563220800,759,423,0,1182,28,-0.23857158396222705,1.5268762494446917
194,1563235200,402,116,0,518,29,-0.24227276713883716,-0.1512824237761911
194,1563249600,52,23,0,75,29,-0.24227276713883716,-1.3444832617498297
194,1563264000,174,148,0,322,29,-0.24227276713883716,-0.6791997245500809
194,1563278400,640,322,0,962,29,-0.24227276713883716,1.0446118698136408
194,1563292800,474,245,0,719,29,-0.24227276713883716,0.39010215507866525
194,1563307200,830,421,0,1251,29,-0.24227276713883716,1.823020542893509
194,1563321600,465,133,0,598,29,-0.24227276713883716,0.06419402551927411
194,1563336000,78,20,0,98,29,-0.24227276713883716,-1.2825337825773835
194,1563350400,159,122,0,281,29,-0.24227276713883716,-0.7896314048140068
194,1563364800,633,396,0,1029,29,-0.24227276713883716,1.225073396098593
194,1563379200,485,280,0,765,29,-0.24227276713883716,0.5140011134235577
194,1563393600,816,461,0,1277,29,-0.24227276713883716,1.8930503889145351
194,1563408000,435,145,0,580,29,-0.24227276713883716,0.01571182442779444
194,1563422400,64,23,0,87,29,-0.24227276713883716,-1.31216179435551
194,1563436800,149,178,29,327,29,5.543770965706333,-0.6657324464691143
194,1563451200,616,390,0,1006,29,-0.24227276713883716,1.1631239169261467
194,1563465600,462,269,0,731,29,-0.24227276713883716,0.42242362247298504
194,1563480000,831,476,0,1307,29,-0.24227276713883716,1.9738540574003345
194,1563494400,485,134,0,619,29,-0.24227276713883716,0.12075659345933373
194,1563508800,87,27,0,114,29,-0.24227276713883716,-1.2394384927182904
194,1563523200,142,126,0,268,29,-0.24227276713883716,-0.8246463278245199
194,1563537600,519,352,0,871,29,-0.24227276713883716,0.7995074087400491
194,1563552000,537,318,0,855,29,-0.24227276713883716,0.7564121188809562
194,1563566400,769,565,0,1334,29,-0.24227276713883716,2.046577359037554
194,1563580800,436,140,0,576,29,-0.24227276713883716,0.00493800196302118
194,1563595200,175,42,0,217,29,-0.24227276713883716,-0.962012564250379
194,1563609600,52,68,16,120,29,2.9500272233964293,-1.2232777590211306
194,1563624000,181,185,4,366,29,0.5558022304949793,-0.560687677437575
194,1563638400,366,231,0,597,29,-0.24227276713883716,0.061500569903080796
194,1563652800,459,183,0,642,29,-0.24227276713883716,0.18270607263178
194,1563667200,327,129,0,456,29,-0.24227276713883716,-0.3182766719801766
194,1563681600,163,35,0,198,29,-0.24227276713883716,-1.013188220958052
194,1563696000,45,44,0,89,29,-0.24227276713883716,-1.3067748831231234
194,1563710400,145,147,2,292,29,0.15676473167807115,-0.7600033930358804
194,1563724800,306,227,0,533,29,-0.24227276713883716,-0.11088058953329137
194,1563739200,402,181,0,583,29,-0.24227276713883716,0.023792191276374386
194,1563753600,286,78,0,364,29,-0.24227276713883716,-0.5660745886699616
194,1563768000,43,24,0,67,29,-0.24227276713883716,-1.3660309066793763
194,1563782400,140,126,0,266,29,-0.24227276713883716,-0.8300332390569065
194,1563796800,544,428,0,972,29,-0.24227276713883716,1.071546425975574
194,1563811200,431,255,0,686,29,-0.24227276713883716,0.30121811974428586
194,1563825600,719,378,0,1097,29,-0.24227276713883716,1.4082283779997384
194,1563840000,358,118,0,476,30,-0.29318344845989047,-0.21755245153916217
194,1563854400,55,28,0,83,30,-0.29318344845989047,-1.3318643567569322
194,1563868800,143,131,0,274,30,-0.29318344845989047,-0.7903031000225961
194,1563879422,543,303,0,846,30,-0.29318344845989047,0.831545270930494
194,1563883200,87,75,0,162,30,-0.29318344845989047,-1.107867816013411
194,1563888386,147,91,0,238,30,-0.29318344845989047,-0.8923774730196438
194,1563897600,334,188,0,522,30,-0.29318344845989047,-0.08712408604293465
194,1563912000,756,498,0,1254,30,-0.29318344845989047,1.9883881648970338
194,1563926400,452,132,0,584,30,-0.29318344845989047,0.08867066745198071
194,1563940800,68,43,0,111,30,-0.29318344845989047,-1.2524731777592284
194,1563955200,160,125,0,285,30,-0.29318344845989047,-0.7591137082734982
194,1563969600,554,388,0,942,30,-0.29318344845989047,1.103743598922621
194,1563984000,414,282,0,696,30,-0.29318344845989047,0.4062353834427956
194,1563998400,738,443,0,1181,30,-0.29318344845989047,1.7814040196530205
194,1564012800,493,147,0,640,30,-0.29318344845989047,0.24745302544738815
194,1564027200,74,39,0,113,30,-0.29318344845989047,-1.2468023792593925
194,1564041600,144,131,0,275,30,-0.29318344845989047,-0.7874677007726781
194,1564056000,541,437,0,978,30,-0.29318344845989047,1.2058179719196687
194,1564070400,446,282,0,728,30,-0.29318344845989047,0.49696815944017125
194,1564084800,786,541,0,1327,30,-0.29318344845989047,2.195372310141047
194,1564099200,510,133,0,643,30,-0.29318344845989047,0.2559592231971421
194,1564113600,94,36,0,130,30,-0.29318344845989047,-1.1986005920107867
194,1564128000,129,143,14,272,30,1.8568285069126396,-0.795973898522432
194,1564142400,531,385,0,916,30,-0.29318344845989047,1.0300232184247533
194,1564156800,506,352,0,858,30,-0.29318344845989047,0.8655700619295099
194,1564171200,775,394,0,1169,30,-0.29318344845989047,1.7473792286540046
194,1564185600,487,147,0,634,30,-0.29318344845989047,0.2304406299478802
194,1564200000,195,40,0,235,30,-0.29318344845989047,-0.9008836707693977
194,1564214400,57,64,7,121,30,0.7818225292263746,-1.2241191852600486
194,1564228800,190,194,4,384,30,0.3211056816465467,-0.47840918253161724
194,1564243200,409,253,0,662,30,-0.29318344845989047,0.30983180894558393
194,1564257600,567,248,0,815,30,-0.29318344845989047,0.7436478941830363
194,1564272000,394,117,0,511,30,-0.29318344845989047,-0.11831347779203254
194,1564286400,197,35,0,232,30,-0.29318344845989047,-0.9093898685191517
194,1564300800,56,46,0,102,30,-0.29318344845989047,-1.2779917710084903
194,1564315200,145,178,33,323,30,4.774701874918216,-0.6513685367766147
194,1564329600,345,201,0,546,30,-0.29318344845989047,-0.0190745040449029
194,1564344000,486,218,0,704,30,-0.29318344845989047,0.42891857744213946
194,1564358400,314,105,0,419,30,-0.29318344845989047,-0.3791702087844876
194,1564372800,57,25,0,82,30,-0.29318344845989047,-1.33469975600685
194,1564387200,123,149,26,272,30,3.699695897231951,-0.795973898522432
194,1564401600,455,378,0,833,30,-0.29318344845989047,0.7946850806815602
194,1564416000,374,216,0,590,30,-0.29318344845989047,0.10568306295148865
194,1564430400,722,430,0,1152,30,-0.29318344845989047,1.6991774414053988
194,1564444800,391,104,0,495,31,-0.2679845192635737,-0.4198352475547985
194,1564459200,54,13,0,67,31,-0.2679845192635737,-1.527605004267588
194,1564473600,154,134,0,288,31,-0.2679845192635737,-0.9556023962453298
194,1564488000,594,327,0,921,31,-0.2679845192635737,0.6827580149677442
194,1564502400,450,256,0,706,31,-0.2679845192635737,0.12628488951622618
194,1564516800,765,388,0,1153,31,-0.2679845192635737,1.2832313410363592
194,1564531200,429,131,0,560,31,-0.2679845192635737,-0.2515991863717814
194,1564545600,69,32,0,101,31,-0.2679845192635737,-1.4396046030333944
194,1564560000,151,210,59,361,31,4.53538357285314,-0.7666603583013261
194,1564574400,590,508,0,1098,31,-0.2679845192635737,1.1408777508045753
194,1564588800,471,275,0,746,31,-0.2679845192635737,0.2298147733211598
194,1564603200,719,413,0,1132,31,-0.2679845192635737,1.228878152038769
194,1564617600,408,121,0,529,31,-0.2679845192635737,-0.33183484632060495
194,1564632000,68,21,0,89,31,-0.2679845192635737,-1.4706635681748745
194,1564646400,146,145,0,291,31,-0.2679845192635737,-0.9478376549599599
194,1564660800,555,544,0,1099,31,-0.2679845192635737,1.1434659978996988
194,1564675200,466,311,0,777,31,-0.2679845192635737,0.3100504332699833
194,1564689600,789,454,0,1243,31,-0.2679845192635737,1.5161735795974598
194,1564704000,504,134,0,638,31,-0.2679845192635737,-0.04971591295216092
194,1564718400,91,36,0,127,31,-0.2679845192635737,-1.3723101785601877
194,1564732800,125,145,20,270,31,1.3602758509454818,-1.00219084395755
194,1564747200,499,454,0,953,31,-0.2679845192635737,0.7655819220116912
194,1564761600,545,373,0,918,31,-0.2679845192635737,0.6749932736823743
194,1564776000,791,420,0,1211,31,-0.2679845192635737,1.4333496725535129
194,1565395200,9834,8189,0,18023,32,-0.42286404681630735,4.232678095695972
194,1565409600,163,32,0,195,32,-0.42286404681630735,-0.2954430191389241
194,1565424000,55,77,22,132,32,1.9657463797947259,-0.31144434459520626
194,1565438400,190,192,2,382,32,-0.2057176443971225,-0.2479470213559913
194,1565452800,394,244,0,638,32,-0.42286404681630735,-0.1829257623590352
194,1565467200,523,248,0,771,32,-0.42286404681630735,-0.14914518639577284
194,1565481600,382,113,0,495,32,-0.42286404681630735,-0.21924623125186615
194,1565496000,160,33,0,193,32,-0.42286404681630735,-0.2959509977248378
194,1565510400,48,45,0,93,32,-0.42286404681630735,-0.3213499270205238
194,1565524800,121,155,34,276,32,3.268624794309835,-0.27486988640941845
194,1565539200,369,201,0,570,32,-0.42286404681630735,-0.2001970342801017
194,1565553600,455,162,0,617,32,-0.42286404681630735,-0.18825953751112925
194,1565568000,275,89,0,364,32,-0.42286404681630735,-0.2525188286292148
194,1565582400,47,17,0,64,32,-0.42286404681630735,-0.32871561651627274
194,1565596800,114,130,16,244,32,1.3143071725371713,-0.28299754378403796
194,1565603702,317,203,0,520,32,-0.42286404681630735,-0.21289649892794466
194,1565611200,183,145,0,328,32,-0.42286404681630735,-0.26166244317566173
194,1565625600,464,274,0,738,32,-0.42286404681630735,-0.15752683306334922
194,1565640000,774,389,0,1163,32,-0.42286404681630735,-0.04958138355668382
194,1565654400,382,109,0,491,33,-0.40554997979520324,-0.18419346199094094
194,1565668800,57,27,0,84,33,-0.40554997979520324,-1.3772980619428707
194,1565683200,132,143,11,275,33,1.282414800974021,-0.8173890236361911
194,1565697600,498,471,0,969,33,-0.40554997979520324,1.2170448642425293
194,1565712000,418,298,0,716,33,-0.40554997979520324,0.47538524805619464
194,1565726400,740,418,0,1158,33,-0.40554997979520324,1.7710909806821231
194,1565740800,438,119,0,557,33,-0.40554997979520324,0.0092829596228855
194,1565755200,74,28,0,102,33,-0.40554997979520324,-1.3245317651390998
194,1565769600,137,149,12,286,33,1.4358661446803143,-0.7851429533672201
194,1565784000,536,403,0,939,33,-0.40554997979520324,1.1291010362362446
194,1565798400,457,277,0,734,33,-0.40554997979520324,0.5281515448599655
194,1565812800,725,414,0,1139,33,-0.40554997979520324,1.7153932229448094
194,1565827200,454,116,0,570,33,-0.40554997979520324,0.04739195175894222
194,1565841600,70,25,0,95,33,-0.40554997979520324,-1.3450519916738997
194,1565856000,127,143,16,270,33,2.0496715195054866,-0.8320463283039052
194,1565870400,590,347,0,937,33,-0.40554997979520324,1.123238114369159
194,1565884800,435,274,0,709,33,-0.40554997979520324,0.45486502152139485
194,1565899200,769,410,0,1179,33,-0.40554997979520324,1.8326516602865226
194,1565913600,546,122,0,668,33,-0.40554997979520324,0.3346751232461391
194,1565928000,81,31,0,112,33,-0.40554997979520324,-1.2952171558036716
194,1565942400,110,111,1,221,33,-0.2520986360889101,-0.9756879140475037
194,1565956800,452,371,0,823,33,-0.40554997979520324,0.7890515679452769
194,1565971200,490,341,0,831,33,-0.40554997979520324,0.8125032554136195
194,1565985600,798,344,0,1142,33,-0.40554997979520324,1.724187605745438
194,1566000000,445,139,0,584,33,-0.40554997979520324,0.08843240482854177
194,1566014400,165,41,0,206,33,-0.40554997979520324,-1.019659828050646
194,1566028800,57,72,15,129,33,1.8962201757991937,-1.2453823199334435
194,1566043200,204,205,1,409,33,-0.2520986360889101,-0.42457325854145256
194,1566057600,414,261,0,675,33,-0.40554997979520324,0.3551953497809388
194,1566072000,559,242,0,801,33,-0.40554997979520324,0.7245594274073347
194,1566086400,349,162,0,511,33,-0.40554997979520324,-0.12556424332008445
194,1566100800,167,54,0,221,33,-0.40554997979520324,-0.9756879140475037
194,1566115200,45,52,7,97,33,0.6686094261488487,-1.3391890698068138
194,1566129600,117,149,32,266,33,4.504893018806176,-0.8437721720380765
194,1566144000,331,211,0,542,33,-0.40554997979520324,-0.03468895438025687
194,1566158400,407,165,0,572,33,-0.40554997979520324,0.05325487362602787
194,1566172800,252,75,0,327,33,-0.40554997979520324,-0.6649530550919642
194,1566187200,62,19,0,81,33,-0.40554997979520324,-1.386092444743499
194,1566201600,114,130,16,244,33,2.0496715195054866,-0.9082643125760187
194,1566216000,496,371,0,867,33,-0.40554997979520324,0.9180358490211612
194,1566230400,408,237,0,645,33,-0.40554997979520324,0.2672515217746541
194,1566244800,721,356,0,1077,33,-0.40554997979520324,1.5336426450651544
194,1566259200,385,91,0,476,34,-0.28195753831578413,-0.19262495825290618
194,1566273600,53,18,0,71,34,-0.28195753831578413,-1.4097685466191527
194,1566288000,137,140,3,277,34,0.3004465572217372,-0.7906782275982964
194,1566302400,504,374,0,878,34,-0.28195753831578413,1.0155027516809978
194,1566316800,433,253,0,686,34,-0.28195753831578413,0.43848653201107346
194,1566331200,731,405,0,1136,34,-0.28195753831578413,1.7908682968624583
194,1566345600,475,103,0,578,34,-0.28195753831578413,0.11391490844674106
194,1566360000,66,14,0,80,34,-0.28195753831578413,-1.382720911322125
194,1566374400,134,120,0,254,34,-0.28195753831578413,-0.8597999622462561
194,1566388800,529,330,0,859,34,-0.28195753831578413,0.9584021882761614
194,1566403200,452,289,0,741,34,-0.28195753831578413,0.6037776366040205
194,1566417600,689,442,0,1131,34,-0.28195753831578413,1.7758418328085541
194,1566432000,426,138,0,564,34,-0.28195753831578413,0.07184080909580909
194,1566446400,84,42,0,126,34,-0.28195753831578413,-1.2444774420262057
194,1566460800,123,125,2,248,34,0.1063118587092301,-0.8778317191109413
194,1566475200,516,390,0,906,34,-0.28195753831578413,1.0996509503828615
194,1566489600,487,254,0,741,34,-0.28195753831578413,0.6037776366040205
194,1566504000,725,417,0,1142,34,-0.28195753831578413,1.8089000537271436
194,1566518400,441,117,0,558,34,-0.28195753831578413,0.05380905223112395
194,1566532800,80,23,0,103,34,-0.28195753831578413,-1.3135991766741653
194,1566547200,107,113,6,220,34,0.8828506527592586,-0.9619799178128052
194,1566561600,420,359,0,779,34,-0.28195753831578413,0.717978763413693
194,1566576000,474,295,0,769,34,-0.28195753831578413,0.6879258353058845
194,1566590400,713,361,0,1074,34,-0.28195753831578413,1.6045401425940453
194,1566604800,438,127,0,565,34,-0.28195753831578413,0.07484610190658994
194,1566619200,166,53,0,219,34,-0.28195753831578413,-0.964985210623586
194,1566633600,56,59,3,115,34,0.3004465572217372,-1.277535662944795
194,1566648000,175,194,19,369,34,3.406601733421851,-0.5141912890064577
194,1566662400,409,244,0,653,34,-0.28195753831578413,0.3393118692553052
194,1566676800,522,235,0,757,34,-0.28195753831578413,0.6518623215765141
194,1566691200,356,121,0,477,34,-0.28195753831578413,-0.18961966544212533
194,1566705600,163,40,0,203,34,-0.28195753831578413,-1.0130698955960797
194,1566720000,52,52,0,104,34,-0.28195753831578413,-1.3105938838633844
194,1566734400,119,147,28,266,34,5.153814020034415,-0.8237364485168859
194,1566748800,347,227,0,574,34,-0.28195753831578413,0.10189373720361763
194,1566763200,465,171,0,636,34,-0.28195753831578413,0.2882218914720307
194,1566777600,283,95,0,378,34,-0.28195753831578413,-0.48714365370943
194,1566792000,59,22,0,81,34,-0.28195753831578413,-1.3797156185113442
194,1566806400,127,106,0,233,34,-0.28195753831578413,-0.922911111272654
194,1566820800,507,361,0,868,34,-0.28195753831578413,0.9854498235731891
194,1566835200,393,236,0,629,34,-0.28195753831578413,0.2671848417965647
194,1566849600,724,436,0,1160,34,-0.28195753831578413,1.862995324321199
194,1566864000,369,105,0,474,35,-0.4374145495222999,-0.08971929239959872
194,1566878400,45,20,0,65,35,-0.4374145495222999,-1.374050963099855
194,1566892800,108,128,20,236,35,1.7112885007626824,-0.8370809980882564
194,1566907200,472,349,0,821,35,-0.4374145495222999,0.9999215137935283
194,1566921600,447,272,0,719,35,-0.4374145495222999,0.6796236399269607
194,1566936000,743,366,0,1109,35,-0.4374145495222999,1.9042919811814838
194,1566950400,426,116,0,542,35,-0.4374145495222999,0.12381262351144635
194,1566964800,69,21,0,90,35,-0.4374145495222999,-1.2955465822502061
194,1566979200,132,145,13,277,35,0.9592424331629386,-0.7083338134948323
194,1566993600,525,375,0,900,35,-0.4374145495222999,1.2479953572784188
194,1567008000,479,251,0,730,35,-0.4374145495222999,0.7141655675008063
194,1567022400,745,420,0,1165,35,-0.4374145495222999,2.0801417942846974
194,1567036800,398,105,0,503,35,-0.4374145495222999,0.0013457893859940325
194,1567051200,56,22,0,78,35,-0.4374145495222999,-1.3332286850580377
194,1567065600,128,119,0,247,35,-0.4374145495222999,-0.8025390705144109
194,1567080000,502,392,0,894,35,-0.4374145495222999,1.2291543058745031
194,1567094400,456,282,0,738,35,-0.4374145495222999,0.7392869693726939
194,1567108800,718,367,0,1085,35,-0.4374145495222999,1.8289277755658209
194,1567123200,406,123,0,529,35,-0.4374145495222999,0.08299034546962891
194,1567137600,89,28,0,117,35,-0.4374145495222999,-1.2107618509325853
194,1567152000,105,119,14,224,35,1.0666775856771877,-0.8747631008960879
194,1567166400,421,288,0,709,35,-0.4374145495222999,0.6482218875871012
194,1567180800,527,348,0,875,35,-0.4374145495222999,1.16949097642877
194,1567195200,744,307,0,1051,35,-0.4374145495222999,1.7221618176102984
194,1567209600,385,118,0,503,35,-0.4374145495222999,0.0013457893859940325
194,1567224000,122,42,0,164,35,-0.4374145495222999,-1.0631736149352453
194,1567238400,47,65,18,112,35,1.496418195734184,-1.226462727102515
194,1567252800,177,220,43,397,35,4.182297008590412,-0.3315127854165174
194,1567267200,380,236,0,616,35,-0.4374145495222999,0.35618559082640716
194,1567281600,509,258,0,767,35,-0.4374145495222999,0.8303520511582867
194,1567296000,338,118,0,456,35,-0.4374145495222999,-0.14624244661134594
194,1567310400,130,38,0,168,35,-0.4374145495222999,-1.0506129139993015
194,1567324800,35,49,14,84,35,1.0666775856771877,-1.3143876336541218
194,1567339200,178,148,0,326,35,-0.4374145495222999,-0.5544652270295203
194,1567353600,412,255,0,667,35,-0.4374145495222999,0.5163345277596909
194,1567368000,496,223,0,719,35,-0.4374145495222999,0.6796236399269607
194,1567382400,286,91,0,377,35,-0.4374145495222999,-0.39431629009623653
194,1567396800,90,38,0,128,35,-0.4374145495222999,-1.1762199233587398
194,1567411200,41,66,25,107,35,2.2484642633339282,-1.2421636032724448
194,1567425600,147,171,24,318,35,2.141029110819679,-0.579586628901408
194,1567440000,288,177,0,465,35,-0.4374145495222999,-0.11798086950547233
194,1567454400,390,166,0,556,35,-0.4374145495222999,0.16777507678724973
194,1567468800,251,57,0,308,36,-0.2521222008297229,-0.7818168604841911
194,1567483200,47,14,0,61,36,-0.2521222008297229,-1.4576975363727744
194,1567497600,134,124,0,258,36,-0.2521222008297229,-0.9186348110689246
194,1567512000,536,405,0,941,36,-0.2521222008297229,0.9502983939185347
194,1567526400,440,273,0,713,36,-0.2521222008297229,0.32640853925214997
194,1567540800,756,389,0,1145,36,-0.2521222008297229,1.5085156323042472
194,1567555200,366,128,0,494,36,-0.2521222008297229,-0.2728540843089826
194,1567569600,58,23,0,81,36,-0.2521222008297229,-1.402970356138881
194,1567584000,142,133,0,275,36,-0.2521222008297229,-0.8721167078701152
194,1567598400,584,412,0,996,36,-0.2521222008297229,1.1007981395617414
194,1567612800,507,259,0,766,36,-0.2521222008297229,0.47143556687196747
194,1567627200,761,406,0,1167,36,-0.2521222008297229,1.56871553056153
194,1567641600,426,122,0,548,36,-0.2521222008297229,-0.12509069767747047
194,1567656000,75,27,0,102,36,-0.2521222008297229,-1.345506816893293
194,1567670400,171,155,0,326,36,-0.2521222008297229,-0.7325623982736871
194,1567684800,596,458,0,1054,36,-0.2521222008297229,1.2595069622400323
194,1567699200,516,293,0,809,36,-0.2521222008297229,0.5890990043748382
194,1567713600,818,438,0,1256,36,-0.2521222008297229,1.8122514826023555
194,1567728000,511,124,0,635,36,-0.2521222008297229,0.11297253633996578
194,1567742400,105,31,0,136,36,-0.2521222008297229,-1.2524706104956742
194,1567756800,148,119,0,267,36,-0.2521222008297229,-0.8940075799636725
194,1567771200,564,407,0,971,36,-0.2521222008297229,1.0323891642693748
194,1567785600,561,329,0,890,36,-0.2521222008297229,0.8107440843221064
194,1567800000,761,430,0,1191,36,-0.2521222008297229,1.634388146842202
194,1567814400,406,138,0,544,36,-0.2521222008297229,-0.13603613372424914
194,1567828800,181,34,0,215,36,-0.2521222008297229,-1.0362982485717953
194,1567843200,53,77,24,130,36,2.3411347219902843,-1.2688887645658422
194,1567857600,236,257,21,493,36,2.0169776066377834,-0.2755904433206773
194,1567872000,467,305,0,772,36,-0.2521222008297229,0.48785372094213547
194,1567886400,661,280,0,941,36,-0.2521222008297229,0.9502983939185347
194,1567900800,463,165,0,628,36,-0.2521222008297229,0.09381802325810308
194,1567915200,192,42,0,234,36,-0.2521222008297229,-0.9843074273495966
194,1567929600,52,39,0,91,36,-0.2521222008297229,-1.3756067660219344
194,1567944000,157,210,53,367,36,5.474653503731126,-0.6203716787942056
194,1567958400,368,281,0,649,36,-0.2521222008297229,0.15128156250369115
194,1567972800,562,230,0,792,36,-0.2521222008297229,0.5425809011760289
194,1567987200,351,80,0,431,36,-0.2521222008297229,-0.4452447020457468
194,1568001600,57,19,0,76,36,-0.2521222008297229,-1.4166521511973544
194,1568016000,179,120,0,299,36,-0.2521222008297229,-0.8064440915894432
194,1568030400,521,407,0,928,36,-0.2521222008297229,0.9147257267665039
194,1568044800,495,269,0,764,36,-0.2521222008297229,0.46596284884857814
194,1568059200,771,421,0,1192,36,-0.2521222008297229,1.6371245058538966
194,1568073600,455,99,0,554,37,-0.2686923471878022,-0.26599175299182887
194,1568088000,73,25,0,98,37,-0.2686923471878022,-1.4100011968048778
194,1568102400,170,160,0,330,37,-0.2686923471878022,-0.8279613043385897
194,1568116800,574,462,0,1036,37,-0.2686923471878022,0.9432462994596833
194,1568131200,474,296,0,770,37,-0.2686923471878022,0.27590745723540483
194,1568145600,810,449,0,1259,37,-0.2686923471878022,1.5027070581665034
194,1568160000,504,126,0,630,37,-0.2686923471878022,-0.07532351235632072
194,1568174400,72,33,0,105,37,-0.2686923471878022,-1.3924396483252914
194,1568188800,159,150,0,309,37,-0.2686923471878022,-0.8806459497773486
194,1568203200,580,407,0,987,37,-0.2686923471878022,0.8203154601025794
194,1568217600,476,309,0,785,37,-0.2686923471878022,0.3135393468345183
194,1568232000,814,448,0,1262,37,-0.2686923471878022,1.510233436086326
194,1568246400,450,140,0,590,37,-0.2686923471878022,-0.1756752179539566
194,1568260800,77,43,0,120,37,-0.2686923471878022,-1.354807758726178
194,1568275200,152,150,0,302,37,-0.2686923471878022,-0.8982074982569348
194,1568289600,621,467,0,1088,37,-0.2686923471878022,1.07370351673661
194,1568304000,519,300,0,819,37,-0.2686923471878022,0.39883829659250875
194,1568318400,866,496,0,1362,37,-0.2686923471878022,1.7611127000804156
194,1568332800,477,180,0,657,37,-0.2686923471878022,-0.007586111077916508
194,1568347200,94,32,0,126,37,-0.2686923471878022,-1.3397550028865326
194,1568361600,164,116,0,280,37,-0.2686923471878022,-0.9534009363356346
194,1568376000,506,436,0,942,37,-0.2686923471878022,0.707419791305239
194,1568390400,574,296,0,870,37,-0.2686923471878022,0.5267867212294945
194,1568404800,942,514,0,1456,37,-0.2686923471878022,1.99693920823486
194,1568419200,783,211,0,994,37,-0.2686923471878022,0.8378770085821657
194,1568433600,200,76,0,276,37,-0.2686923471878022,-0.9634361068953982
194,1568448000,44,81,37,125,37,1.9405558408007937,-1.3422637955264736
194,1568462400,177,250,73,427,37,4.090094618303211,-0.5846084182643227
194,1568476800,530,356,0,886,37,-0.2686923471878022,0.5669274034685489
194,1568491200,932,255,0,1187,37,-0.2686923471878022,1.3220739880907588
194,1568505600,630,167,0,797,37,-0.2686923471878022,0.34364485851380905
194,1568520000,187,55,0,242,37,-0.2686923471878022,-1.0487350566533886
194,1568534400,43,45,2,88,37,-0.14927352621544565,-1.4350891232042868
194,1568548800,137,214,77,351,37,4.3289322602479245,-0.7752766588998309
194,1568563200,535,311,0,846,37,-0.2686923471878022,0.46657569787091296
194,1568577600,739,276,0,1015,37,-0.2686923471878022,0.8905616540209246
194,1568592000,459,128,0,587,37,-0.2686923471878022,-0.18320159587377927
194,1568606400,60,22,0,82,37,-0.2686923471878022,-1.4501418790439322
194,1568620800,167,149,0,316,37,-0.2686923471878022,-0.8630844012977623
194,1568635200,518,358,0,876,37,-0.2686923471878022,0.5418394770691399
194,1568649600,453,243,0,696,37,-0.2686923471878022,0.09025680187977847
194,1568664000,826,367,0,1193,37,-0.2686923471878022,1.3371267439304042
194,1568678400,494,94,0,588,38,-0.23040884378451634,-0.19632511391014754
194,1568692800,55,19,0,74,38,-0.23040884378451634,-1.452107798085633
194,1568707200,171,161,0,332,38,-0.23040884378451634,-0.8217732990247862
194,1568721600,585,428,0,1013,38,-0.23040884378451634,0.8420165996590768
194,1568736000,495,274,0,769,38,-0.23040884378451634,0.24588629822168684
194,1568750400,863,446,0,1309,38,-0.23040884378451634,1.5651910636978779
194,1568764800,607,111,0,718,38,-0.23040884378451634,0.12128529259337992
194,1568779200,56,15,0,71,38,-0.23040884378451634,-1.4594372690049453
194,1568793600,180,152,0,332,38,-0.23040884378451634,-0.8217732990247862
194,1568808000,588,412,0,1000,38,-0.23040884378451634,0.8102555590087241
194,1568822400,516,301,0,817,38,-0.23040884378451634,0.3631578329306816
194,1568836800,866,439,0,1305,38,-0.23040884378451634,1.5554184358054617
194,1568851200,669,127,0,796,38,-0.23040884378451634,0.3118515364954964
194,1568865600,75,26,0,101,38,-0.23040884378451634,-1.3861425598118235
194,1568880000,159,139,0,298,38,-0.23040884378451634,-0.9048406361103242
194,1568894400,608,409,0,1017,38,-0.23040884378451634,0.8517892275514931
194,1568908800,507,311,0,818,38,-0.23040884378451634,0.36560098990378564
194,1568923200,925,459,0,1384,38,-0.23040884378451634,1.7484278366806822
194,1568937600,716,148,0,864,38,-0.23040884378451634,0.4779862106665723
194,1568952000,97,21,0,118,38,-0.23040884378451634,-1.3446088912690546
194,1568966400,166,128,0,294,38,-0.23040884378451634,-0.9146132640027405
194,1568980800,547,415,0,962,38,-0.23040884378451634,0.7174155940307699
194,1568995200,557,404,0,961,38,-0.23040884378451634,0.7149724370576659
194,1569009600,1011,585,0,1596,38,-0.23040884378451634,2.2663771149787424
194,1569024000,758,150,0,908,38,-0.23040884378451634,0.5854851174831508
194,1569038400,193,45,0,238,38,-0.23040884378451634,-1.0514300544965676
194,1569052800,51,73,22,124,38,5.372164094554775,-1.32994994943043
194,1569067200,229,208,0,437,38,-0.23040884378451634,-0.5652418168488602
194,1569081600,557,319,0,876,38,-0.23040884378451634,0.507304094343821
194,1569096000,785,314,0,1099,38,-0.23040884378451634,1.0521280993460258
194,1569110400,672,233,0,905,38,-0.23040884378451634,0.5781556465638387
194,1569124800,184,47,0,231,38,-0.23040884378451634,-1.068532153308296
194,1569139200,49,50,1,99,38,0.024253562503633298,-1.3910288737580316
194,1569153600,174,188,14,362,38,3.3348648442495783,-0.7484785898316645
194,1569168000,505,245,0,750,38,-0.23040884378451634,0.19946631573270976
194,1569182400,711,212,0,923,38,-0.23040884378451634,0.6221324720797117
194,1569196800,386,78,0,464,38,-0.23040884378451634,-0.49927657857505064
194,1569211200,63,15,0,78,38,-0.23040884378451634,-1.4423351701932168
194,1569225600,150,151,1,301,38,0.024253562503633298,-0.897511165191012
194,1569240000,508,383,0,891,38,-0.23040884378451634,0.5439514489403818
194,1569254400,471,223,0,694,38,-0.23040884378451634,0.06264952523888254
194,1569268800,759,395,0,1154,38,-0.23040884378451634,1.1865017328667489
194,1569283200,388,103,0,491,39,-0.29884188872241063,-0.3077164725376302
194,1569297600,52,18,0,70,39,-0.29884188872241063,-1.4565852790009692
194,1569312000,202,123,0,325,39,-0.29884188872241063,-0.7607146242547663
194,1569326400,552,391,0,943,39,-0.29884188872241063,0.9257483743066199
194,1569340800,464,279,0,743,39,-0.29884188872241063,0.3799674686233234
194,1569355200,838,416,0,1254,39,-0.29884188872241063,1.774437682644146
194,1569369600,450,128,0,578,39,-0.29884188872241063,-0.0703017785653962
194,1569384000,70,19,0,89,39,-0.29884188872241063,-1.4047360929610562
194,1569398400,182,134,0,316,39,-0.29884188872241063,-0.7852747650105146
194,1569412800,580,402,0,982,39,-0.29884188872241063,1.0321756509148627
194,1569427200,543,277,0,820,39,-0.29884188872241063,0.5900931173113926
194,1569441600,812,429,0,1241,39,-0.29884188872241063,1.7389619237747318
194,1569456000,459,136,0,595,39,-0.29884188872241063,-0.023910401582315995
194,1569470400,80,25,0,105,39,-0.29884188872241063,-1.3610736205063925
194,1569484800,162,151,0,313,39,-0.29884188872241063,-0.7934614785957641
194,1569499200,568,359,0,927,39,-0.29884188872241063,0.8820859018519562
194,1569513600,534,297,0,831,39,-0.29884188872241063,0.6201110671239739
194,1569528000,833,439,0,1272,39,-0.29884188872241063,1.8235579641556428
194,1569542400,483,128,0,611,39,-0.29884188872241063,0.019752070872347725
194,1569556800,109,26,0,135,39,-0.29884188872241063,-1.279206484653898
194,1569571200,156,124,0,280,39,-0.29884188872241063,-0.883515328033508
194,1569585600,526,388,0,914,39,-0.29884188872241063,0.8466101429825419
194,1569600000,592,296,0,888,39,-0.29884188872241063,0.7756586252437134
194,1569614400,852,445,0,1297,39,-0.29884188872241063,1.8917805773660548
194,1569628800,522,153,0,675,39,-0.29884188872241063,0.1944019606910026
194,1569643200,193,47,0,240,39,-0.29884188872241063,-0.9926715091701673
194,1569657600,59,68,9,127,39,1.4390386333863772,-1.3010377208812298
194,1569672000,235,260,25,495,39,4.5286040060242225,-0.29680085442396426
194,1569686400,502,395,0,897,39,-0.29884188872241063,0.8002187659994617
194,1569700800,620,362,0,982,39,-0.29884188872241063,1.0321756509148627
194,1569715200,372,158,0,530,39,-0.29884188872241063,-0.20128919592938735
194,1569729600,175,47,0,222,39,-0.29884188872241063,-1.041791790681664
194,1569744000,64,52,0,116,39,-0.29884188872241063,-1.331055670693811
194,1569758400,170,190,20,360,39,3.563114827074896,-0.6652029657601893
194,1569772800,412,363,0,775,39,-0.29884188872241063,0.46729241353265083
194,1569787200,475,223,0,698,39,-0.29884188872241063,0.25716676484458173
194,1569801600,283,75,0,358,39,-0.29884188872241063,-0.6706607748170224
194,1569816000,57,22,0,79,39,-0.29884188872241063,-1.432025138245221
194,1569830400,115,126,11,241,39,1.825234304966108,-0.9899426046417508
194,1569844800,477,333,0,810,39,-0.29884188872241063,0.5628040720272277
194,1569859200,396,242,0,638,39,-0.29884188872241063,0.09343249313959276
194,1569873600,704,391,0,1095,39,-0.29884188872241063,1.3405418626259253
194,1569888000,344,107,0,451,40,-0.27832170781787074,-0.41957554656612867
194,1569902400,62,20,0,82,40,-0.27832170781787074,-1.4042184630836734
194,1569916800,152,128,0,280,40,-0.27832170781787074,-0.8758734834888933
194,1569931200,560,352,0,912,40,-0.27832170781787074,0.810560996833839
194,1569945600,476,268,0,744,40,-0.27832170781787074,0.36226828687463164
194,1569960000,750,375,0,1125,40,-0.27832170781787074,1.3789321112464052
194,1569974400,430,127,0,557,40,-0.27832170781787074,-0.13672419385377169
194,1569988800,74,20,0,94,40,-0.27832170781787074,-1.372197555229444
194,1570003200,184,133,0,317,40,-0.27832170781787074,-0.7771423509383536
194,1570017600,588,446,0,1034,40,-0.27832170781787074,1.1361068933518348
194,1570032000,459,283,0,742,40,-0.27832170781787074,0.3569314688989268
194,1570046400,800,423,0,1223,40,-0.27832170781787074,1.640436192055943
194,1570060800,430,135,0,565,40,-0.27832170781787074,-0.1153769219509523
194,1570075200,86,33,0,119,40,-0.27832170781787074,-1.3054873305331336
194,1570089600,168,145,0,313,40,-0.27832170781787074,-0.7878159868897633
194,1570104000,612,389,0,1001,40,-0.27832170781787074,1.0480493967527047
194,1570118400,512,262,0,774,40,-0.27832170781787074,0.4423205565102044
194,1570132800,831,527,0,1358,40,-0.27832170781787074,2.0006714054160204
194,1570147200,501,163,0,664,40,-0.27832170781787074,0.14879556784643772
194,1570161600,138,38,0,176,40,-0.27832170781787074,-1.1533880182255454
194,1570176000,153,127,0,280,40,-0.27832170781787074,-0.8758734834888933
194,1570190400,586,412,0,998,40,-0.27832170781787074,1.0400441697891474
194,1570204800,526,306,0,832,40,-0.27832170781787074,0.597088277805645
194,1570219200,852,485,0,1337,40,-0.27832170781787074,1.9446348166711194
194,1570233600,481,174,0,655,40,-0.27832170781787074,0.12477988695576589
194,1570248000,153,32,0,185,40,-0.27832170781787074,-1.1293723373348736
194,1570262400,63,72,9,135,40,0.7332706532893902,-1.2627927867274948
194,1570276800,240,277,37,517,40,3.8804468878453133,-0.24346055336786868
194,1570291200,473,339,0,812,40,-0.27832170781787074,0.5437200980485966
194,1570305600,625,313,0,938,40,-0.27832170781787074,0.879939630518002
194,1570320000,412,137,0,549,40,-0.27832170781787074,-0.1580714657565911
194,1570334400,175,42,0,217,40,-0.27832170781787074,-1.043983249723596
194,1570348800,38,52,14,90,40,1.2952664094600908,-1.3828711911808538
194,1570363200,147,191,44,338,40,4.667240946484294,-0.7211057621934527
194,1570377600,551,282,0,833,40,-0.27832170781787074,0.5997566867934975
194,1570392000,550,177,0,727,40,-0.27832170781787074,0.31690533408114047
194,1570406400,266,103,0,369,40,-0.27832170781787074,-0.6383850835700274
194,1570420800,59,11,0,70,40,-0.27832170781787074,-1.4362393709379024
194,1570435200,145,138,0,283,40,-0.27832170781787074,-0.867868256525336
194,1570449600,575,378,0,953,40,-0.27832170781787074,0.9199657653357883
194,1570464000,413,262,0,675,40,-0.27832170781787074,0.17814806671281438
194,1570478400,756,466,0,1222,40,-0.27832170781787074,1.6377677830680906
194,1570492800,430,105,0,535,41,-0.1863636297018922,-0.22312701995350445
194,1570507200,56,35,0,91,41,-0.1863636297018922,-1.45379033497656
194,1570521600,199,138,0,337,41,-0.1863636297018922,-0.7719363361124346
194,1570536000,558,408,0,966,41,-0.1863636297018922,0.9715033601702274
194,1570550400,490,271,0,761,41,-0.1863636297018922,0.403291694450123
194,1570564800,824,433,0,1257,41,-0.1863636297018922,1.7780867490704733
194,1570579200,421,129,0,550,41,-0.1863636297018922,-0.18155055660813096
194,1570593600,64,36,0,100,41,-0.1863636297018922,-1.428844456969336
194,1570608000,126,129,3,255,41,1.1949197433827203,-0.9992210024004765
194,1570622400,540,358,0,898,41,-0.1863636297018922,0.7830233930045343
194,1570636800,461,250,0,711,41,-0.1863636297018922,0.26470348329887794
194,1570651200,737,375,0,1112,41,-0.1863636297018922,1.376180936731863
194,1570665600,406,150,0,556,41,-0.1863636297018922,-0.16491997126998156
194,1570680000,57,34,0,91,41,-0.1863636297018922,-1.45379033497656
194,1570694400,184,145,0,329,41,-0.1863636297018922,-0.7941104498966338
194,1570708800,568,380,0,948,41,-0.1863636297018922,0.9216116041557793
194,1570723200,499,330,0,829,41,-0.1863636297018922,0.5917716616158162
194,1570737600,837,470,0,1307,41,-0.1863636297018922,1.9166749602217183
194,1570752000,504,188,0,692,41,-0.1863636297018922,0.21203996306140485
194,1570766400,103,59,0,162,41,-0.1863636297018922,-1.2569950751417922
194,1570780800,159,148,0,307,41,-0.1863636297018922,-0.8550892628031816
194,1570795200,537,395,0,932,41,-0.1863636297018922,0.8772633765873808
194,1570809600,563,343,0,906,41,-0.1863636297018922,0.8051975067887335
194,1570824000,856,477,0,1333,41,-0.1863636297018922,1.9887408300203657
194,1570838400,552,154,0,706,41,-0.1863636297018922,0.25084466218375345
194,1570852800,205,33,0,238,41,-0.1863636297018922,-1.0463409941918997
194,1570867200,70,66,0,136,41,-0.1863636297018922,-1.3290609449404396
194,1570881600,238,231,0,469,41,-0.1863636297018922,-0.40606345867314786
194,1570896000,537,316,0,853,41,-0.1863636297018922,0.6582940029684138
194,1570910400,765,311,0,1076,41,-0.1863636297018922,1.2763974247029664
194,1570924800,565,126,0,691,41,-0.1863636297018922,0.20926819883837994
194,1570939200,227,67,0,294,41,-0.1863636297018922,-0.8911221977025053
194,1570953600,59,52,0,111,41,-0.1863636297018922,-1.398355050516062
194,1570968000,197,178,0,375,41,-0.1863636297018922,-0.6666092956374885
194,1570982400,492,265,0,757,41,-0.1863636297018922,0.3922046375580234
194,1570996800,670,222,0,892,41,-0.1863636297018922,0.7663928076663848
194,1571011200,399,85,0,484,41,-0.1863636297018922,-0.36448699532777434
194,1571025600,79,32,0,111,41,-0.1863636297018922,-1.398355050516062
194,1571040000,101,115,14,216,41,6.259625444692967,-1.1073198070984476
194,1571054400,398,329,0,727,41,-0.1863636297018922,0.30905171086727634
194,1571068800,423,296,0,719,41,-0.1863636297018922,0.28687759708307714
194,1571083200,676,355,0,1031,41,-0.1863636297018922,1.151668034666846
194,1571097600,392,107,0,499,42,-0.2802408653475682,-0.3111683015279913
194,1571112000,76,32,0,108,42,-0.2802408653475682,-1.3606663191276365
194,1571126400,185,180,0,365,42,-0.2802408653475682,-0.6708428139534451
194,1571140800,551,558,7,1109,42,0.5870308653070113,1.3261559714535522
194,1571155200,530,313,0,843,42,-0.2802408653475682,0.6121752229075021
194,1571169600,805,476,0,1281,42,-0.2802408653475682,1.787827733671299
194,1571184000,471,151,0,622,42,-0.2802408653475682,0.01898069122074619
194,1571198400,102,30,0,132,42,-0.2802408653475682,-1.2962470034693463
194,1571212800,179,132,0,311,42,-0.2802408653475682,-0.8157862741845981
194,1571227200,548,447,0,995,42,-0.2802408653475682,1.0201642220766738
194,1571241600,541,295,0,836,42,-0.2802408653475682,0.5933862558405009
194,1571256000,870,380,0,1250,42,-0.2802408653475682,1.7046194509460075
194,1571270400,459,123,0,582,42,-0.2802408653475682,-0.08838483487640421
194,1571284800,80,25,0,105,42,-0.2802408653475682,-1.3687187335849227
194,1571299200,189,144,0,333,42,-0.2802408653475682,-0.7567352348311654
194,1571313600,568,385,0,953,42,-0.2802408653475682,0.9074304196746658
194,1571328000,532,312,0,844,42,-0.2802408653475682,0.6148593610599309
194,1571342400,823,491,0,1314,42,-0.2802408653475682,1.8764042927014482
194,1571356800,545,148,0,693,42,-0.2802408653475682,0.20955450004318815
194,1571371200,125,35,0,160,42,-0.2802408653475682,-1.221091135201341
194,1571385600,167,141,0,308,42,-0.2802408653475682,-0.8238386886418845
194,1571400000,516,340,0,856,42,-0.2802408653475682,0.6470690188890761
194,1571414400,462,354,0,816,42,-0.2802408653475682,0.5397034927919256
194,1571428800,880,450,0,1330,42,-0.2802408653475682,1.9193505031403082
194,1571443200,483,153,0,636,42,-0.2802408653475682,0.05655862535474883
194,1571457600,155,35,0,190,42,-0.2802408653475682,-1.140566990628478
194,1571472000,60,65,5,125,42,0.33923894226284573,-1.3150359705363475
194,1571486400,205,234,29,439,42,3.3127420187928327,-0.4722165906737169
194,1571500800,477,317,0,794,42,-0.2802408653475682,0.4806524534384929
194,1571515200,572,288,0,860,42,-0.2802408653475682,0.657805571498791
194,1571529600,431,133,0,564,42,-0.2802408653475682,-0.13669932162012188
194,1571544000,195,42,0,237,42,-0.2802408653475682,-1.0144124974643265
194,1571558400,46,56,10,102,42,0.9587187498732598,-1.3767711480422091
194,1571572800,148,192,44,340,42,5.171181441624075,-0.7379462677641642
194,1571587200,435,287,0,722,42,-0.2802408653475682,0.2873945064636222
194,1571601600,465,167,0,632,42,-0.2802408653475682,0.04582207274503379
194,1571616000,293,65,0,358,42,-0.2802408653475682,-0.6896317810204464
194,1571630400,49,17,0,66,42,-0.2802408653475682,-1.4734001215296444
194,1571644800,163,133,0,296,42,-0.2802408653475682,-0.8560483464710296
194,1571659200,543,366,0,909,42,-0.2802408653475682,0.7893283409678004
194,1571673600,484,256,0,740,42,-0.2802408653475682,0.3357089932073399
194,1571688000,767,405,0,1172,42,-0.2802408653475682,1.4952566750565641
194,1571702400,489,132,0,621,43,-0.18043874177926347,0.008687601187547073
194,1571716800,73,22,0,95,43,-0.18043874177926347,-1.4025365564249024
194,1571731200,178,139,0,317,43,-0.18043874177926347,-0.8069248397139447
194,1571745600,591,401,0,992,43,-0.18043874177926347,1.0040567313666702
194,1571760000,509,292,0,801,43,-0.18043874177926347,0.4916160201423777
194,1571774400,800,429,0,1229,43,-0.18043874177926347,1.6399124829905305
194,1571788800,500,175,0,675,43,-0.18043874177926347,0.15356612687399626
194,1571803200,76,30,0,106,43,-0.18043874177926347,-1.3730242641554404
194,1571817600,175,143,0,318,43,-0.18043874177926347,-0.8042419040530845
194,1571832000,571,354,0,925,43,-0.18043874177926347,0.8243000420890387
194,1571846400,527,286,0,813,43,-0.18043874177926347,0.5238112480726997
194,1571860800,845,476,0,1321,43,-0.18043874177926347,1.8867425637896662
194,1571875200,533,136,0,669,43,-0.18043874177926347,0.13746851290883524
194,1571889600,102,37,0,139,43,-0.18043874177926347,-1.284487387347055
194,1571904000,176,142,0,318,43,-0.18043874177926347,-0.8042419040530845
194,1571918400,586,380,0,966,43,-0.18043874177926347,0.9343004041843057
194,1571932800,497,282,0,779,43,-0.18043874177926347,0.4325914356034539
194,1571947200,796,467,0,1263,43,-0.18043874177926347,1.7311322954597763
194,1571961600,542,148,0,690,43,-0.18043874177926347,0.1938101617868988
194,1571976000,124,30,0,154,43,-0.18043874177926347,-1.2442433524341523
194,1571990400,163,97,0,260,43,-0.18043874177926347,-0.9598521723829744
194,1572004800,571,402,0,973,43,-0.18043874177926347,0.953080953810327
194,1572019200,541,327,0,868,43,-0.18043874177926347,0.671372709420009
194,1572033600,867,511,0,1378,43,-0.18043874177926347,2.0396698964586957
194,1572048000,509,172,0,681,43,-0.18043874177926347,0.16966374083915728
194,1572062400,188,39,0,227,43,-0.18043874177926347,-1.04838904919136
194,1572076800,57,64,7,121,43,0.9021937088963172,-1.332780229242538
194,1572091200,210,252,42,462,43,6.3153559622742215,-0.41789916888921996
194,1572105600,459,297,0,756,43,-0.18043874177926347,0.37088391540367005
194,1572120000,656,277,0,933,43,-0.18043874177926347,0.8457635273759202
194,1572134400,434,151,0,585,43,-0.18043874177926347,-0.08789808260341905
194,1572148800,216,44,0,260,43,-0.18043874177926347,-0.9598521723829744
194,1572163200,86,45,0,131,43,-0.18043874177926347,-1.3059508726339364
194,1572177600,188,136,0,324,43,-0.18043874177926347,-0.7881442900879234
194,1572192000,343,193,0,536,43,-0.18043874177926347,-0.2193619299855674
194,1572206400,443,193,0,636,43,-0.18043874177926347,0.04893163610044962
194,1572220800,287,64,0,351,43,-0.18043874177926347,-0.7157050272446989
194,1572235200,60,15,0,75,43,-0.18043874177926347,-1.4561952696421059
194,1572249600,169,142,0,311,43,-0.18043874177926347,-0.8230224536791056
194,1572264000,510,394,0,904,43,-0.18043874177926347,0.7679583932109753
194,1572278400,481,271,0,752,43,-0.18043874177926347,0.36015217276022937
194,1572292800,775,456,0,1231,43,-0.18043874177926347,1.645278354312251
194,1572307200,449,115,0,564,44,-0.24277091401000284,-0.20214026567551016
194,1572321600,64,32,0,96,44,-0.24277091401000284,-1.4427229757865085
194,1572336000,178,148,0,326,44,-0.24277091401000284,-0.833034891757599
194,1572350400,553,413,0,966,44,-0.24277091401000284,0.8634884724967576
194,1572364800,573,287,0,860,44,-0.24277091401000284,0.5825017902921298
194,1572379200,909,438,0,1347,44,-0.24277091401000284,1.8734500377794294
194,1572393600,460,130,0,590,44,-0.24277091401000284,-0.13321900400267692
194,1572408000,77,41,0,118,44,-0.24277091401000284,-1.3844049851402649
194,1572422400,169,159,0,328,44,-0.24277091401000284,-0.8277332562443042
194,1572436800,538,515,0,1053,44,-0.24277091401000284,1.0941096173250842
194,1572451200,494,355,0,849,44,-0.24277091401000284,0.5533427949690081
194,1572465600,780,455,0,1235,44,-0.24277091401000284,1.576558449034917
194,1572480000,468,136,0,604,44,-0.24277091401000284,-0.09610755540961287
194,1572494400,77,51,0,128,44,-0.24277091401000284,-1.3578968075737907
194,1572508800,165,152,0,317,44,-0.24277091401000284,-0.8568922515674259
194,1572523200,565,481,0,1046,44,-0.24277091401000284,1.0755538930285522
194,1572537600,464,356,0,820,44,-0.24277091401000284,0.4764690800262325
194,1572552000,764,514,0,1278,44,-0.24277091401000284,1.6905436125707565
194,1572566400,724,222,0,946,44,-0.24277091401000284,0.810472117363809
194,1572580800,158,54,0,212,44,-0.24277091401000284,-1.1352281160154063
194,1572595200,159,152,0,311,44,-0.24277091401000284,-0.8727971581073105
194,1572609600,536,398,0,934,44,-0.24277091401000284,0.7786623042840398
194,1572624000,529,301,0,830,44,-0.24277091401000284,0.5029772575927068
194,1572638400,852,486,0,1338,44,-0.24277091401000284,1.8495926779696024
194,1572652800,528,185,0,713,44,-0.24277091401000284,0.19283158006495726
194,1572667200,141,54,0,195,44,-0.24277091401000284,-1.1802920178784126
194,1572681600,58,92,34,150,44,1.696743164037124,-1.299578816927547
194,1572696000,230,341,111,571,44,6.089172105496793,-0.18358454137897814
194,1572710400,507,384,0,891,44,-0.24277091401000284,0.6646771407482002
194,1572724800,602,386,0,988,44,-0.24277091401000284,0.9218064631430012
194,1572739200,404,184,0,588,44,-0.24277091401000284,-0.1385206395159718
194,1572750000,172,45,0,217,44,-0.24277091401000284,-1.1219740272321692
194,1572764400,36,44,8,80,44,0.21358533964814463,-1.4851360598928673
194,1572778800,175,189,14,364,44,0.5558525298917553,-0.7323038170049966
194,1572793200,391,297,0,688,44,-0.24277091401000284,0.12656113614877146
194,1572807600,493,334,0,827,44,-0.24277091401000284,0.4950248043227645
194,1572822000,313,119,0,432,44,-0.24277091401000284,-0.5520482095529712
194,1572836400,116,34,0,150,44,-0.24277091401000284,-1.299578816927547
194,1572850800,54,70,16,124,44,0.6699415933062921,-1.3685000786003803
194,1572865200,582,392,0,974,44,-0.24277091401000284,0.884695014549937
194,1572879600,368,294,0,662,44,-0.24277091401000284,0.057639874475938206
194,1572894000,756,387,0,1143,44,-0.24277091401000284,1.3326832154233532
194,1572908400,514,164,0,678,44,-0.24277091401000284,0.10005295858229712
194,1572922800,134,26,0,160,45,-0.4052679852152777,-1.2193547923538557
194,1572937200,51,73,22,124,45,2.2695007172055552,-1.3140036165254778
194,1572951600,506,384,0,890,45,-0.4052679852152777,0.6999130311262619
194,1572966000,473,280,0,753,45,-0.4052679852152777,0.339721672473144
194,1572980400,775,420,0,1195,45,-0.4052679852152777,1.5017989025802836
194,1572994800,559,188,0,747,45,-0.4052679852152777,0.3239468684445403
194,1573009200,120,33,0,153,45,-0.4052679852152777,-1.2377587303872266
194,1573023600,63,83,20,146,45,2.0263399260763886,-1.2561626684205975
194,1573038000,600,380,0,980,45,-0.4052679852152777,0.9365350915553176
194,1573052400,417,251,0,668,45,-0.4052679852152777,0.1162452820679248
194,1573066800,802,452,0,1254,45,-0.4052679852152777,1.6569178088615535
194,1573081200,554,221,0,775,45,-0.4052679852152777,0.3975626205780242
194,1573095600,173,35,0,208,45,-0.4052679852152777,-1.093156360125026
194,1573110000,56,75,19,131,45,1.904759530511805,-1.2955996784921069
194,1573124400,633,432,0,1065,45,-0.4052679852152777,1.1600114819605367
194,1573138800,459,263,0,722,45,-0.4052679852152777,0.25821851832535814
194,1573153200,839,497,0,1336,45,-0.4052679852152777,1.8725067972524707
194,1573167600,617,186,0,803,45,-0.4052679852152777,0.4711783727115082
194,1573182000,177,44,0,221,45,-0.4052679852152777,-1.0589776180630512
194,1573196400,51,62,11,113,45,0.9321163659951386,-1.342924090577918
194,1573210800,548,376,0,924,45,-0.4052679852152777,0.7893035872883496
194,1573225200,494,309,0,803,45,-0.4052679852152777,0.4711783727115082
194,1573239600,874,482,0,1356,45,-0.4052679852152777,1.9250894773478164
194,1573254000,589,186,0,775,45,-0.4052679852152777,0.3975626205780242
194,1573268400,308,78,0,386,45,-0.4052679852152777,-0.6251705072764494
194,1573282800,58,39,0,97,45,-0.4052679852152777,-1.3849902346541947
194,1573297200,189,204,15,393,45,1.418437948253472,-0.6067665692430784
194,1573311600,481,327,0,808,45,-0.4052679852152777,0.48432404273534463
194,1573326000,817,307,0,1124,45,-0.4052679852152777,1.3151303882418064
194,1573340400,566,164,0,730,45,-0.4052679852152777,0.27925159036349645
194,1573354800,319,80,0,399,45,-0.4052679852152777,-0.5909917652144747
194,1573369200,63,28,0,91,45,-0.4052679852152777,-1.4007650386827983
194,1573383600,130,169,39,299,45,4.336367441803471,-0.8539051656912031
194,1573398000,440,269,0,709,45,-0.4052679852152777,0.22403977626338345
194,1573412400,629,258,0,887,45,-0.4052679852152777,0.6920256291119601
194,1573426800,411,98,0,509,45,-0.4052679852152777,-0.3017870246900734
194,1573441200,150,25,0,175,45,-0.4052679852152777,-1.1799177822823463
194,1573455600,50,64,14,114,45,1.2968575526888886,-1.3402949565731508
194,1573470000,453,353,0,806,45,-0.4052679852152777,0.47906577472581
194,1573484400,389,278,0,667,45,-0.4052679852152777,0.11361614806315752
194,1573498800,694,389,0,1083,45,-0.4052679852152777,1.207335894046348
194,1573513200,458,162,0,620,45,-0.4052679852152777,-0.009953150160904848
194,1573527600,142,37,0,179,46,-0.29361419700566044,-1.1752626625348648
194,1573542000,68,72,4,140,46,-0.10017425544899002,-1.277307732305981
194,1573556400,633,405,0,1038,46,-0.29361419700566044,1.0723454126802348
194,1573570800,390,262,0,652,46,-0.29361419700566044,0.06236087597123782
194,1573585200,861,409,0,1270,46,-0.29361419700566044,1.6793827508058496
194,1573599600,520,183,0,703,46,-0.29361419700566044,0.19580442874885143
194,1573614000,143,47,0,190,46,-0.29361419700566044,-1.1464807197789089
194,1573628400,56,79,23,135,46,0.8186654669451945,-1.2903904335586882
194,1573642800,615,390,0,1005,46,-0.29361419700566044,0.9859995844123672
194,1573657200,444,283,0,727,46,-0.29361419700566044,0.25860139476184607
194,1573671600,831,458,0,1289,46,-0.29361419700566044,1.729097015566137
194,1573686000,570,214,0,784,46,-0.29361419700566044,0.4077441890427083
194,1573700400,155,35,0,190,46,-0.29361419700566044,-1.1464807197789089
194,1573714800,54,62,8,116,46,0.09326568610768038,-1.3401046983189757
194,1573729200,626,394,0,1020,46,-0.29361419700566044,1.0252476881704888
194,1573743600,424,277,0,701,46,-0.29361419700566044,0.19057134824776853
194,1573758000,828,428,0,1256,46,-0.29361419700566044,1.6427511872982694
194,1573772400,607,198,0,805,46,-0.29361419700566044,0.4626915343040786
194,1573786800,202,38,0,240,46,-0.29361419700566044,-1.0156537072518368
194,1573801200,60,59,0,119,46,-0.29361419700566044,-1.3322550775673514
194,1573815600,572,399,0,971,46,-0.29361419700566044,0.8970372158939581
194,1573830000,477,318,0,795,46,-0.29361419700566044,0.4365261317986642
194,1573844400,812,482,0,1294,46,-0.29361419700566044,1.7421797168188442
194,1573858800,601,206,0,807,46,-0.29361419700566044,0.4679246148051615
194,1573873200,282,56,0,338,46,-0.29361419700566044,-0.7592327626987753
194,1573887600,51,64,13,115,46,0.3350656130535184,-1.342721238569517
194,1573902000,165,267,102,432,46,4.639104312689435,-0.5132779791478796
194,1573916400,451,416,0,867,46,-0.29361419700566044,0.6249170298376481
194,1573930800,712,342,0,1054,46,-0.29361419700566044,1.114210056688898
194,1573945200,481,251,0,732,46,-0.29361419700566044,0.2716840960145533
194,1573959600,316,73,0,389,46,-0.29361419700566044,-0.6257892099211617
194,1573974000,49,32,0,81,46,-0.29361419700566044,-1.4316836070879262
194,1573988400,121,211,90,332,46,4.058784488019423,-0.7749320042020239
194,1574002800,344,288,0,632,46,-0.29361419700566044,0.010030070960408964
194,1574017200,592,263,0,855,46,-0.29361419700566044,0.5935185468311508
194,1574031600,358,134,0,492,46,-0.29361419700566044,-0.3562855641153931
194,1574046000,111,29,0,140,46,-0.29361419700566044,-1.277307732305981
194,1574060400,52,67,15,119,46,0.43178558383185356,-1.3322550775673514
194,1574074800,515,388,0,903,46,-0.29361419700566044,0.71911247885714
194,1574089200,385,252,0,637,46,-0.29361419700566044,0.023112772213116178
194,1574103600,696,446,0,1142,46,-0.29361419700566044,1.3444655987365448
194,1574118000,516,181,0,697,46,-0.29361419700566044,0.18010518724560276
194,1574132400,104,23,0,127,47,-0.4356564450471781,-1.2550971832345814
194,1574146800,52,65,13,117,47,0.9235916635000173,-1.2806530477305587
194,1574161200,687,420,0,1107,47,-0.4356564450471781,1.2493775373711962
194,1574175600,353,270,0,623,47,-0.4356564450471781,0.012473695765893762
194,1574190000,875,433,0,1308,47,-0.4356564450471781,1.7630504137403404
194,1574204400,552,204,0,756,47,-0.4356564450471781,0.35236669356239214
194,1574218800,147,39,0,186,47,-0.4356564450471781,-1.1043175827083151
194,1574233200,54,77,23,131,47,1.9691671316132446,-1.2448748374361904
194,1574247600,592,395,0,987,47,-0.4356564450471781,0.9427071634194683
194,1574262000,432,276,0,708,47,-0.4356564450471781,0.229698543981701
194,1574276400,833,438,0,1271,47,-0.4356564450471781,1.6684937151052242
194,1574290800,630,181,0,811,47,-0.4356564450471781,0.4929239482902674
194,1574305200,184,28,0,212,47,-0.4356564450471781,-1.0378723350187742
194,1574319600,51,82,31,133,47,2.8056275061038267,-1.239763664536995
194,1574334000,626,427,0,1053,47,-0.4356564450471781,1.1113758690929185
194,1574348400,430,281,0,711,47,-0.4356564450471781,0.2373653033304942
194,1574362800,714,493,0,1207,47,-0.4356564450471781,1.5049361823309695
194,1574377200,599,206,0,805,47,-0.4356564450471781,0.47759042959268105
194,1574391600,210,50,0,260,47,-0.4356564450471781,-0.915204185438083
194,1574406000,54,71,17,125,47,1.3418218507453084,-1.260208356133777
194,1574420400,557,374,0,931,47,-0.4356564450471781,0.7995943222419953
194,1574434800,462,303,0,765,47,-0.4356564450471781,0.37536697160877175
194,1574449200,883,502,0,1385,47,-0.4356564450471781,1.9598305703593657
194,1574463600,540,188,0,728,47,-0.4356564450471781,0.28081027297365563
194,1574478000,275,56,0,331,47,-0.4356564450471781,-0.733757547516644
194,1574492400,53,44,0,97,47,-0.4356564450471781,-1.3317647767225134
194,1574506800,181,206,25,387,47,2.17828222523589,-0.5906447063391711
194,1574521200,425,378,0,803,47,-0.4356564450471781,0.47247925669348556
194,1574535600,781,325,0,1106,47,-0.4356564450471781,1.2468219509215985
194,1574550000,464,160,0,624,47,-0.4356564450471781,0.015029282215491494
194,1574564400,313,57,0,370,47,-0.4356564450471781,-0.6340896759823325
194,1574578800,38,44,6,82,47,0.19168883582075832,-1.3700985734664795
194,1574593200,116,155,39,271,47,3.6420878805944086,-0.887092734492508
194,1574607600,342,259,0,601,47,-0.4356564450471781,-0.043749206125256346
194,1574622000,529,202,0,731,47,-0.4356564450471781,0.28847703232244887
194,1574636400,343,100,0,443,47,-0.4356564450471781,-0.447531865161698
194,1574650800,96,24,0,120,47,-0.4356564450471781,-1.2729862883817655
194,1574665200,54,75,21,129,47,1.7600520379905993,-1.249986010335386
194,1574679600,489,370,0,859,47,-0.4356564450471781,0.6155920978709586
194,1574694000,399,255,0,654,47,-0.4356564450471781,0.09169687570342346
194,1574708400,797,419,0,1216,47,-0.4356564450471781,1.5279364603773489
194,1574722800,523,167,0,690,47,-0.4356564450471781,0.18369798788894182
194,1574737200,129,42,0,171,48,-0.4066044885430183,-0.919961961100157
194,1574751600,47,70,23,117,48,0.27530512245100197,-1.0914482541695378
194,1574766000,466,440,0,906,48,-0.4066044885430183,1.4141570278997482
194,1574780400,376,273,0,649,48,-0.4066044885430183,0.5980092997732507
194,1574794800,797,383,0,1180,48,-0.4066044885430183,2.284291181622162
194,1574809200,516,196,0,712,48,-0.4066044885430183,0.7980766416875282
194,1574823600,158,44,0,202,48,-0.4066044885430183,-0.821516126189957
194,1574838000,51,77,26,128,48,0.36424985431978724,-1.0565158611368861
194,1574852400,387,301,0,688,48,-0.4066044885430183,0.7218605114344702
194,1574866800,467,304,0,771,48,-0.4066044885430183,0.9854412952262961
194,1574881200,686,329,0,1015,48,-0.4066044885430183,1.7603052861323873
194,1574895600,393,130,0,523,48,-0.4066044885430183,0.1978746159446955
194,1574910000,142,38,0,180,48,-0.4066044885430183,-0.8913809122552602
194,1574924400,31,47,16,78,48,0.06776741475716974,-1.2152994658307572
194,1574938800,116,76,0,192,48,-0.4066044885430183,-0.8532728471287311
194,1574953200,190,121,0,311,48,-0.4066044885430183,-0.47536786795731795
194,1574967600,186,96,0,282,48,-0.4066044885430183,-0.5674623586797631
194,1574982000,125,52,0,177,48,-0.4066044885430183,-0.9009079285368925
194,1574996400,58,35,0,93,48,-0.4066044885430183,-1.1676643844225958
194,1575010800,19,47,28,66,48,0.42354634223231075,-1.2534075309572863
194,1575025200,156,220,64,376,48,1.4908831246577336,-0.2689491818552855
194,1575039600,336,359,23,695,48,0.27530512245100197,0.7440902160916121
194,1575054000,553,324,0,877,48,-0.4066044885430183,1.322062537177303
194,1575068400,384,111,0,495,48,-0.4066044885430183,0.10895579731612769
194,1575082800,171,62,0,233,48,-0.4066044885430183,-0.7230702912797569
194,1575097200,38,48,10,86,48,-0.11012204898040076,-1.1898940890797378
194,1575111600,95,259,164,354,48,4.455707520283909,-0.33881396792058877
194,1575126000,302,369,67,671,48,1.579827856526519,0.6678740858385539
194,1575140400,573,358,0,931,48,-0.4066044885430183,1.4935488302466837
194,1575154800,436,168,0,604,48,-0.4066044885430183,0.45510405554876665
194,1575169200,202,79,0,281,48,-0.4066044885430183,-0.5706380307736406
194,1575183600,32,37,5,69,48,-0.2583632687617095,-1.243880514675654
194,1575198000,85,215,130,300,48,3.4476672257710095,-0.5103002609899696
194,1575212400,298,282,0,580,48,-0.4066044885430183,0.3788879252957085
194,1575226800,498,243,0,741,48,-0.4066044885430183,0.8901711324099735
194,1575241200,241,103,0,344,48,-0.4066044885430183,-0.370570688859363
194,1575255600,93,30,0,123,48,-0.4066044885430183,-1.0723942216062732
194,1575270000,47,67,20,114,48,0.18636039058221673,-1.10097527045117
194,1575284400,527,321,0,848,48,-0.4066044885430183,1.2299680464548577
194,1575298800,377,204,0,581,48,-0.4066044885430183,0.38206359738958595
194,1575313200,669,370,0,1039,48,-0.4066044885430183,1.8365214163854453
194,1575327600,413,153,0,566,48,-0.4066044885430183,0.33442851598142465
194,1575342000,112,31,0,143,49,-0.3890947125831364,-1.2558404578585056
194,1575356400,42,62,20,104,49,3.087921867947019,-1.3565930987936201
194,1575370800,596,377,0,973,49,-0.3890947125831364,0.8883824133247
194,1575385200,446,304,0,750,49,-0.3890947125831364,0.3122839792598146
194,1575399600,748,426,0,1174,49,-0.3890947125831364,1.4076460242979822
194,1575414000,482,198,0,680,49,-0.3890947125831364,0.1314459057865322
194,1575428400,144,40,0,184,49,-0.3890947125831364,-1.1499210148241545
194,1575442800,62,73,11,135,49,1.5232644067084489,-1.2765076662554522
194,1575457200,506,427,0,933,49,-0.3890947125831364,0.7850463713399671
194,1575471600,430,270,0,700,49,-0.3890947125831364,0.18311392677889862
194,1575486000,750,449,0,1199,49,-0.3890947125831364,1.4722310505384404
194,1575500400,599,217,0,816,49,-0.3890947125831364,0.4827884485346237
194,1575514800,145,58,0,203,49,-0.3890947125831364,-1.1008363948814064
194,1575529200,57,73,16,130,49,2.3925185518409875,-1.2894246715035438
194,1575543600,544,404,0,948,49,-0.3890947125831364,0.823797387084242
194,1575558000,466,274,0,740,49,-0.3890947125831364,0.28644996876363144
194,1575572400,807,452,0,1259,49,-0.3890947125831364,1.6272351135155394
194,1575586800,682,191,0,873,49,-0.3890947125831364,0.630042308362868
194,1575601200,180,52,0,232,49,-0.3890947125831364,-1.025917764442475
194,1575615600,52,78,26,130,49,4.131026842106065,-1.2894246715035438
194,1575630000,599,357,0,956,49,-0.3890947125831364,0.8444645954811886
194,1575644400,452,311,0,763,49,-0.3890947125831364,0.34586819290485277
194,1575658800,863,500,0,1363,49,-0.3890947125831364,1.8959088226758447
194,1575673200,624,239,0,863,49,-0.3890947125831364,0.6042082978666847
194,1575687600,289,57,0,346,49,-0.3890947125831364,-0.7314100447859867
194,1575702000,47,54,7,101,49,0.8278610906024179,-1.364343301942475
194,1575716400,185,192,7,377,49,0.8278610906024179,-0.6513246122478188
194,1575730800,512,375,0,887,49,-0.3890947125831364,0.6662099230575245
194,1575745200,800,314,0,1114,49,-0.3890947125831364,1.252641961320883
194,1575759600,542,194,0,736,49,-0.3890947125831364,0.27611636456515815
194,1575774000,298,71,0,369,49,-0.3890947125831364,-0.6719918206447654
194,1575788400,52,32,0,84,49,-0.3890947125831364,-1.4082611197859864
194,1575802800,133,133,0,266,49,-0.3890947125831364,-0.9380821287554523
194,1575817200,385,282,0,667,49,-0.3890947125831364,0.09786169214149405
194,1575831600,607,239,0,846,49,-0.3890947125831364,0.5602904800231734
194,1575846000,398,100,0,498,49,-0.3890947125831364,-0.33873308524400203
194,1575860400,144,27,0,171,49,-0.3890947125831364,-1.1835052284691927
194,1575874800,49,56,7,105,49,0.8278610906024179,-1.3540096977440017
194,1575889200,594,372,0,966,49,-0.3890947125831364,0.8702986059773717
194,1575903600,393,235,0,628,49,-0.3890947125831364,-0.002890948793620431
194,1575918000,847,427,0,1274,49,-0.3890947125831364,1.6659861292598144
194,1575932400,566,171,0,737,49,-0.3890947125831364,0.27869976561477644
194,1575946800,127,27,0,154,50,-0.2920466758269568,-1.2361451590653643
194,1575961200,62,67,5,129,50,0.06660713659211298,-1.293978444143947
194,1575975600,643,414,0,1057,50,-0.2920466758269568,0.8527930979730441
194,1575990000,496,281,0,777,50,-0.2920466758269568,0.20506030509291756
194,1576004400,900,462,0,1362,50,-0.2920466758269568,1.5583591759317537
194,1576018800,645,233,0,878,50,-0.2920466758269568,0.43870677681039183
194,1576033200,180,54,0,234,50,-0.2920466758269568,-1.0510786468138995
194,1576047600,65,79,14,144,50,0.7121839989464386,-1.2592784730967972
194,1576062000,661,369,0,1030,50,-0.2920466758269568,0.7903331500881748
194,1576076400,814,648,0,1462,50,-0.2920466758269568,1.7896923162460845
194,1576090800,890,491,0,1381,50,-0.2920466758269568,1.6023124725914764
194,1576105200,656,219,0,875,50,-0.2920466758269568,0.4317667826009619
194,1576119600,165,37,0,202,50,-0.2920466758269568,-1.1251052517144853
194,1576134000,49,55,6,104,50,0.13833789907592692,-1.3518117292225296
194,1576148400,648,382,0,1030,50,-0.2920466758269568,0.7903331500881748
194,1576162800,473,288,0,761,50,-0.2920466758269568,0.16804700264262462
194,1576177200,929,521,0,1450,50,-0.2920466758269568,1.7619323394083648
194,1576191600,761,272,0,1033,50,-0.2920466758269568,0.7972731442976048
194,1576206000,276,78,0,354,50,-0.2920466758269568,-0.7734788784367023
194,1576220400,54,70,16,124,50,0.8556455239140665,-1.3055451011596635
194,1576234800,578,399,0,977,50,-0.2920466758269568,0.6677265857215794
194,1576249200,476,298,0,774,50,-0.2920466758269568,0.19812031088348764
194,1576263600,888,464,0,1352,50,-0.2920466758269568,1.5352258619003205
194,1576278000,691,195,0,886,50,-0.2920466758269568,0.45721342803553827
194,1576292400,338,68,0,406,50,-0.2920466758269568,-0.6531856454732502
194,1576306800,38,36,0,74,50,-0.2920466758269568,-1.421211671316829
194,1576321200,143,211,68,354,50,4.585645173072392,-0.7734788784367023
194,1576335600,418,352,0,770,50,-0.2920466758269568,0.1888669852709144
194,1576350000,809,288,0,1097,50,-0.2920466758269568,0.9453263540987765
194,1576364400,526,202,0,728,50,-0.2920466758269568,0.0917070663388954
194,1576378800,331,77,0,408,50,-0.2920466758269568,-0.6485589826669635
194,1576393200,47,48,1,95,50,-0.22031591334314285,-1.3726317118508193
194,1576407600,100,161,61,261,50,4.083529835685694,-0.9886186989290301
194,1576422000,422,315,0,737,50,-0.2920466758269568,0.11252704896718518
194,1576436400,705,311,0,1016,50,-0.2920466758269568,0.7579465104441685
194,1576450800,405,121,0,526,50,-0.2920466758269568,-0.37558587709605307
194,1576465200,107,33,0,140,50,-0.2920466758269568,-1.2685317987093705
194,1576479600,58,57,0,115,50,-0.2920466758269568,-1.3263650837879533
194,1576494000,562,390,0,952,50,-0.2920466758269568,0.6098933006429967
194,1576508400,422,288,0,710,50,-0.2920466758269568,0.05006710108231584
194,1576522800,799,423,0,1222,50,-0.2920466758269568,1.2344927794916902
194,1576537200,564,206,0,770,50,-0.2920466758269568,0.1888669852709144
194,1576551600,138,38,0,176,51,-0.32964425505574835,-1.09733894085151
194,1576566000,52,59,7,111,51,0.19140634164527323,-1.2665417258571368
194,1576580400,567,382,0,949,51,-0.32964425505574835,0.9148726408307901
194,1576594800,455,254,0,709,51,-0.32964425505574835,0.2901238961946297
194,1576609200,744,480,0,1224,51,-0.32964425505574835,1.6307305773930572
194,1576623600,599,223,0,822,51,-0.32964425505574835,0.5842764301274885
194,1576638000,147,48,0,195,51,-0.32964425505574835,-1.0478796652344806
194,1576652400,49,58,9,107,51,0.34027794070270795,-1.276954204934406
194,1576666800,511,386,0,897,51,-0.32964425505574835,0.7795104128262886
194,1576681200,425,356,0,781,51,-0.32964425505574835,0.4775485195854778
194,1576695600,817,422,0,1239,51,-0.32964425505574835,1.6697773739328172
194,1576710000,602,195,0,797,51,-0.32964425505574835,0.5191984358945552
194,1576724400,209,44,0,253,51,-0.32964425505574835,-0.8968987186140751
194,1576738800,48,56,8,104,51,0.2658421411739906,-1.284763564242358
194,1576753200,514,382,0,896,51,-0.32964425505574835,0.7769072930569714
194,1576767600,449,285,0,734,51,-0.32964425505574835,0.35520189042756306
194,1576782000,925,478,0,1403,51,-0.32964425505574835,2.0966890161008602
194,1576796400,643,195,0,838,51,-0.32964425505574835,0.6259263464365659
194,1576810800,163,43,0,206,51,-0.32964425505574835,-1.0192453477719898
194,1576825200,51,63,12,114,51,0.5635853392888601,-1.2587323665491847
194,1576839600,465,384,0,849,51,-0.32964425505574835,0.6545606638990565
194,1576854000,471,335,0,806,51,-0.32964425505574835,0.5426265138184112
194,1576868400,907,457,0,1364,51,-0.32964425505574835,1.995167345097484
194,1576882800,545,161,0,706,51,-0.32964425505574835,0.2823145368866777
194,1576897200,232,56,0,288,51,-0.32964425505574835,-0.8057895266879683
194,1576911600,42,41,0,83,51,-0.32964425505574835,-1.3394290793980221
194,1576926000,135,204,69,339,51,4.80642591242575,-0.6730304184527843
194,1576940400,423,271,0,694,51,-0.32964425505574835,0.25107709965486963
194,1576954800,697,296,0,993,51,-0.32964425505574835,1.0294099106807528
194,1576969200,435,142,0,577,51,-0.32964425505574835,-0.05348791335525854
194,1576983600,222,55,0,277,51,-0.32964425505574835,-0.834423844150459
194,1576998000,45,36,0,81,51,-0.32964425505574835,-1.3446353189366567
194,1577012400,92,136,44,228,51,2.945530924207816,-0.9619767128470085
194,1577026800,367,286,0,653,51,-0.32964425505574835,0.1443491891128589
194,1577041200,610,293,0,903,51,-0.32964425505574835,0.7951291314421927
194,1577055600,350,114,0,464,51,-0.32964425505574835,-0.3476404472881174
194,1577070000,122,32,0,154,51,-0.32964425505574835,-1.1546075757764913
194,1577084400,34,71,37,105,51,2.424480327506794,-1.2821604444730406
194,1577098800,296,239,0,535,51,-0.32964425505574835,-0.1628189436665866
194,1577113200,441,302,0,743,51,-0.32964425505574835,0.37862996835141904
194,1577127600,776,350,0,1126,51,-0.32964425505574835,1.3756248399999584
194,1577142000,445,129,0,574,51,-0.32964425505574835,-0.06129727266321055
194,1577156400,106,45,0,151,52,-0.38198819800977085,-0.767491987550493
194,1577170800,38,62,24,100,52,2.1182981889632746,-0.9506485858663057
194,1577185200,204,203,0,407,52,-0.38198819800977085,0.15188230987790033
194,1577199600,412,273,0,685,52,-0.38198819800977085,1.1502653359915462
194,1577214000,525,198,0,723,52,-0.38198819800977085,1.2867349582660732
194,1577228400,212,73,0,285,52,-0.38198819800977085,-0.28625700374031837
194,1577242800,79,31,0,110,52,-0.38198819800977085,-0.9147355273730091
194,1577257200,19,16,0,35,52,-0.38198819800977085,-1.1840834660727337
194,1577271600,66,57,0,123,52,-0.38198819800977085,-0.8680485513317235
194,1577286000,129,92,0,221,52,-0.38198819800977085,-0.5161005780974167
194,1577300400,190,90,0,280,52,-0.38198819800977085,-0.3042135329869667
194,1577314800,94,53,0,147,52,-0.38198819800977085,-0.7818572109478116
194,1577329200,45,29,0,74,52,-0.38198819800977085,-1.0440225379488768
194,1577343600,26,61,35,87,52,3.264262782992587,-0.9973355619075913
194,1577358000,190,183,0,373,52,-0.38198819800977085,0.029777911000691843
194,1577372400,325,272,0,597,52,-0.38198819800977085,0.8342304212505359
194,1577386800,591,291,0,882,52,-0.38198819800977085,1.8577525883094896
194,1577401200,362,99,0,461,52,-0.38198819800977085,0.345812825741702
194,1577415600,104,38,0,142,52,-0.38198819800977085,-0.7998137401944599
194,1577430000,39,66,27,105,52,2.430833987334905,-0.9326920566196574
194,1577444400,233,235,2,468,52,-0.17363099909535037,0.3709519666870097
194,1577458800,358,309,0,667,52,-0.38198819800977085,1.0856218307036123
194,1577473200,644,373,0,1017,52,-0.38198819800977085,2.342578877968994
194,1577487600,449,164,0,613,52,-0.38198819800977085,0.8916913148398106
