remote_unit_id,time_stamp,entries,exits,num_people_exited,sum_exit_entry,week_num,z_score_num_people_exited,z_score_sum_exit_entry
280,1546311600,43,16,0,59,1,-0.15617376188860604,-0.7725781765878743
280,1546326000,25,16,0,41,1,-0.15617376188860604,-0.8686895969433841
280,1546340400,79,6,0,85,1,-0.15617376188860604,-0.6337505694076936
280,1546354800,171,43,0,214,1,-0.15617376188860604,0.055047943140126565
280,1546369200,186,51,0,237,1,-0.15617376188860604,0.17785698026105573
280,1546383600,55,31,0,86,1,-0.15617376188860604,-0.6284110460546097
280,1546398000,24,5,0,29,1,-0.15617376188860604,-0.9327638771803907
280,1546412400,96,2,0,98,1,-0.15617376188860604,-0.5643367658176032
280,1546426800,598,20,0,618,1,-0.15617376188860604,2.2122153777860127
280,1546441200,211,41,0,252,1,-0.15617376188860604,0.2579498305573139
280,1546455600,243,88,0,331,1,-0.15617376188860604,0.6797721754509402
280,1546470000,57,46,0,103,1,-0.15617376188860604,-0.5376391490521838
280,1546484400,16,15,0,31,1,-0.15617376188860604,-0.922084830474223
280,1546498800,109,7,0,116,1,-0.15617376188860604,-0.4682253454620934
280,1546513200,669,29,0,698,1,-0.15617376188860604,2.639377246032723
280,1546527600,251,47,0,298,1,-0.15617376188860604,0.5035679047991722
280,1546542000,240,90,0,330,1,-0.15617376188860604,0.6744326520978563
280,1546556400,65,61,0,126,1,-0.15617376188860604,-0.41483011193125463
280,1546570800,13,4,0,17,1,-0.15617376188860604,-0.9968381574173972
280,1546585200,100,5,0,105,1,-0.15617376188860604,-0.526960102346016
280,1546599600,663,26,0,689,1,-0.15617376188860604,2.591321535854968
280,1546614000,228,43,0,271,1,-0.15617376188860604,0.35940077426590755
280,1546628400,263,73,0,336,1,-0.15617376188860604,0.7064697922163595
280,1546642800,78,48,0,126,1,-0.15617376188860604,-0.41483011193125463
280,1546657200,21,24,3,45,1,6.4031242374328485,-0.8473315035310486
280,1546671600,25,2,0,27,1,-0.15617376188860604,-0.9434429238865584
280,1546686000,169,22,0,191,1,-0.15617376188860604,-0.0677610939808026
280,1546700400,221,52,0,273,1,-0.15617376188860604,0.3700798209720753
280,1546714800,203,28,0,231,1,-0.15617376188860604,0.14581984014255248
280,1546729200,71,27,0,98,1,-0.15617376188860604,-0.5643367658176032
280,1546743600,19,9,0,28,1,-0.15617376188860604,-0.9381034005334745
280,1546758000,23,4,0,27,1,-0.15617376188860604,-0.9434429238865584
280,1546772400,138,25,0,163,1,-0.15617376188860604,-0.21726774786715117
280,1546786800,241,70,0,311,1,-0.15617376188860604,0.5729817083892627
280,1546801200,173,52,0,225,1,-0.15617376188860604,0.11378270002404921
280,1546815600,63,23,0,86,1,-0.15617376188860604,-0.6284110460546097
280,1546830000,11,6,0,17,1,-0.15617376188860604,-0.9968381574173972
280,1546844400,105,6,0,111,1,-0.15617376188860604,-0.49492296222751275
280,1546858800,712,34,0,746,1,-0.15617376188860604,2.8956743669807494
280,1546873200,192,45,0,237,1,-0.15617376188860604,0.17785698026105573
280,1546887600,251,96,0,347,1,-0.15617376188860604,0.7652045491002822
280,1546902000,58,38,0,96,1,-0.15617376188860604,-0.5750158125237709
280,1546916400,13,6,0,19,2,-0.17425135929432084,-0.9334166891542359
280,1546930800,112,8,0,120,2,-0.17425135929432084,-0.5223043184046411
280,1546945200,778,47,0,825,2,-0.17425135929432084,2.347341437817779
280,1546959600,194,39,0,233,2,-0.17425135929432084,-0.062346913506579456
280,1546974000,277,89,0,366,2,-0.17425135929432084,0.4790188816389267
280,1546988400,52,71,19,123,2,6.289644302147391,-0.5100930598675244
280,1547002800,13,2,0,15,2,-0.17425135929432084,-0.9496983672037248
280,1547017200,104,5,0,109,2,-0.17425135929432084,-0.5670789330407355
280,1547031600,764,39,0,803,2,-0.17425135929432084,2.25779220854559
280,1547046000,258,43,0,301,2,-0.17425135929432084,0.21444161333473194
280,1547060400,246,86,0,332,2,-0.17425135929432084,0.34062461821827095
280,1547074800,61,63,2,124,2,0.5061587103311225,-0.5060226403551521
280,1547089200,12,11,0,23,2,-0.17425135929432084,-0.917135011104747
280,1547103600,107,9,0,116,2,-0.17425135929432084,-0.53858599645413
280,1547118000,800,42,0,842,2,-0.17425135929432084,2.4165385695281065
280,1547132400,226,30,0,256,2,-0.17425135929432084,0.03127273527798176
280,1547146800,300,119,0,419,2,-0.17425135929432084,0.6947511157946547
280,1547161200,60,49,0,109,2,-0.17425135929432084,-0.5670789330407355
280,1547175600,16,14,0,30,2,-0.17425135929432084,-0.8886420745181415
280,1547204400,816,47,0,863,2,-0.17425135929432084,2.5020173792879237
280,1547218800,206,43,0,249,2,-0.17425135929432084,0.0027797986913761716
280,1547233200,290,110,0,400,2,-0.17425135929432084,0.6174131450595823
280,1547247600,89,30,0,119,2,-0.17425135929432084,-0.5263747379170133
280,1547262000,18,9,0,27,2,-0.17425135929432084,-0.9008533330552582
280,1547276400,34,6,0,40,2,-0.17425135929432084,-0.8479378793944192
280,1547290800,201,36,0,237,2,-0.17425135929432084,-0.04606523545709055
280,1547305200,267,47,0,314,2,-0.17425135929432084,0.2673570669955709
280,1547319600,209,64,0,273,2,-0.17425135929432084,0.1004698669883096
280,1547334000,84,35,0,119,2,-0.17425135929432084,-0.5263747379170133
280,1547348400,23,7,0,30,2,-0.17425135929432084,-0.8886420745181415
280,1547362800,18,4,0,22,2,-0.17425135929432084,-0.9212054306171192
280,1547377200,141,14,0,155,2,-0.17425135929432084,-0.37983963547161315
280,1547391600,207,45,0,252,2,-0.17425135929432084,0.014991057228492852
280,1547406000,152,50,0,202,2,-0.17425135929432084,-0.18852991839011848
280,1547420400,55,21,0,76,2,-0.17425135929432084,-0.701402776949019
280,1547434800,9,5,0,14,2,-0.17425135929432084,-0.9537687867160971
280,1547449200,111,4,0,115,2,-0.17425135929432084,-0.5426564159665022
280,1547463600,771,52,0,823,2,-0.17425135929432084,2.339200598793034
280,1547478000,192,29,0,221,2,-0.17425135929432084,-0.11119194765504617
280,1547492400,274,107,0,381,2,-0.17425135929432084,0.54007517432451
280,1547506800,51,33,0,84,2,-0.17425135929432084,-0.6688394208500412
280,1547521200,16,7,0,23,3,-0.15617376188860604,-0.8844721941855728
280,1547535600,112,7,0,119,3,-0.15617376188860604,-0.4544996975667846
280,1547550000,796,44,0,840,3,-0.15617376188860604,2.7747729072472396
280,1547564400,214,40,0,254,3,-0.15617376188860604,0.15014912580338632
280,1547578800,272,113,0,385,3,-0.15617376188860604,0.7368824284811077
280,1547593200,66,51,0,117,3,-0.15617376188860604,-0.46345745791300935
280,1547607600,14,6,0,20,3,-0.15617376188860604,-0.8979088347049099
280,1547622000,110,10,0,120,3,-0.15617376188860604,-0.4500208173936722
280,1547636400,767,38,0,805,3,-0.15617376188860604,2.6180121011883064
280,1547650800,241,49,0,290,3,-0.15617376188860604,0.3113888120354319
280,1547665200,262,109,0,371,3,-0.15617376188860604,0.6741781060575345
280,1547679600,73,56,0,129,3,-0.15617376188860604,-0.40971089583566084
280,1547694000,16,7,0,23,3,-0.15617376188860604,-0.8844721941855728
280,1547708400,115,9,0,124,3,-0.15617376188860604,-0.4321052967012227
280,1547722800,781,66,0,847,3,-0.15617376188860604,2.806125068459026
280,1547737200,217,38,0,255,3,-0.15617376188860604,0.15462800597649873
280,1547751600,270,115,0,385,3,-0.15617376188860604,0.7368824284811077
280,1547766000,79,61,0,140,3,-0.15617376188860604,-0.36044321393142464
280,1547780400,18,6,0,24,3,-0.15617376188860604,-0.8799933140124604
280,1547794800,94,13,0,107,3,-0.15617376188860604,-0.5082462596441332
280,1547809200,743,40,0,783,3,-0.15617376188860604,2.519476737379834
280,1547823600,204,39,0,243,3,-0.15617376188860604,0.10088144389915019
280,1547838000,333,107,0,440,3,-0.15617376188860604,0.9832208380022885
280,1547852400,85,42,0,127,3,-0.15617376188860604,-0.4186686561818856
280,1547866800,25,14,0,39,3,-0.15617376188860604,-0.8128101114157747
280,1547881200,26,4,0,30,3,-0.15617376188860604,-0.8531200329737861
280,1547895600,184,22,0,206,3,-0.15617376188860604,-0.06483712250600777
280,1547910000,232,60,0,292,3,-0.15617376188860604,0.32034657238165665
280,1547924400,143,51,0,194,3,-0.15617376188860604,-0.1185836845833563
280,1547938800,71,23,0,94,3,-0.15617376188860604,-0.5664717018945941
280,1547953200,17,20,3,37,3,6.4031242374328485,-0.8217678717619995
280,1547967600,15,4,0,19,3,-0.15617376188860604,-0.9023877148780223
280,1547982000,118,11,0,129,3,-0.15617376188860604,-0.40971089583566084
280,1547996400,182,32,0,214,3,-0.15617376188860604,-0.029006081121108755
280,1548010800,154,47,0,201,3,-0.15617376188860604,-0.08723152337156966
280,1548025200,60,16,0,76,3,-0.15617376188860604,-0.6470915450106168
280,1548039600,10,6,0,16,3,-0.15617376188860604,-0.9158243553973594
280,1548054000,42,2,0,44,3,-0.15617376188860604,-0.7904157105502129
280,1548068400,226,15,0,241,3,-0.15617376188860604,0.09192368355292543
280,1548082800,171,35,0,206,3,-0.15617376188860604,-0.06483712250600777
280,1548097200,149,32,0,181,3,-0.15617376188860604,-0.1768091268338172
280,1548111600,51,19,0,70,3,-0.15617376188860604,-0.6739648260492911
280,1548126000,10,6,0,16,4,-0.15617376188860607,-0.9686523204377483
280,1548140400,105,10,0,115,4,-0.15617376188860607,-0.5331829347333308
280,1548154800,699,34,0,733,4,-0.15617376188860607,2.1852017154215178
280,1548169200,203,29,0,232,4,-0.15617376188860607,-0.018537297082655613
280,1548183600,236,83,0,319,4,-0.15617376188860607,0.36414792065759005
280,1548198000,76,50,0,126,4,-0.15617376188860607,-0.48479744743284
280,1548212400,8,12,4,20,4,6.403124237432849,-0.9510575977830243
280,1548226800,106,8,0,114,4,-0.15617376188860607,-0.5375816153970118
280,1548241200,784,41,0,825,4,-0.15617376188860607,2.589880336480168
280,1548255600,252,37,0,289,4,-0.15617376188860607,0.23218750074716052
280,1548270000,247,82,0,329,4,-0.15617376188860607,0.40813472729439987
280,1548284400,56,39,0,95,4,-0.15617376188860607,-0.6211565480069505
280,1548298800,12,8,0,20,4,-0.15617376188860607,-0.9510575977830243
280,1548313200,102,12,0,114,4,-0.15617376188860607,-0.5375816153970118
280,1548327600,770,48,0,818,4,-0.15617376188860607,2.559089571834401
280,1548342000,192,40,0,232,4,-0.15617376188860607,-0.018537297082655613
280,1548356400,259,90,0,349,4,-0.15617376188860607,0.49610834056801956
280,1548370800,63,45,0,108,4,-0.15617376188860607,-0.5639736993790977
280,1548385200,13,2,0,15,4,-0.15617376188860607,-0.9730510011014293
280,1548399600,103,13,0,116,4,-0.15617376188860607,-0.5287842540696498
280,1548414000,696,51,0,747,4,-0.15617376188860607,2.2467832447130514
280,1548428400,232,21,0,253,4,-0.15617376188860607,0.07383499685464506
280,1548442800,281,93,0,374,4,-0.15617376188860607,0.6060753571600442
280,1548457200,84,59,0,143,4,-0.15617376188860607,-0.41001987615026325
280,1548471600,16,15,0,31,4,-0.15617376188860607,-0.9026721104825335
280,1548486000,25,5,0,30,4,-0.15617376188860607,-0.9070707911462145
280,1548500400,177,27,0,204,4,-0.15617376188860607,-0.14170035566572317
280,1548514800,238,60,0,298,4,-0.15617376188860607,0.2717756267202894
280,1548529200,218,41,0,259,4,-0.15617376188860607,0.10022708083673097
280,1548543600,87,23,0,110,4,-0.15617376188860607,-0.5551763380517357
280,1548558000,21,11,0,32,4,-0.15617376188860607,-0.8982734298188525
280,1548572400,32,2,0,34,4,-0.15617376188860607,-0.8894760684914905
280,1548586800,163,9,0,172,4,-0.15617376188860607,-0.2824581369035147
280,1548601200,242,55,0,297,4,-0.15617376188860607,0.2673769460566084
280,1548615600,159,40,0,199,4,-0.15617376188860607,-0.1636937589841281
280,1548630000,44,18,0,62,4,-0.15617376188860607,-0.766313009908423
280,1548644400,17,4,0,21,4,-0.15617376188860607,-0.9466589171193434
280,1548658800,119,9,0,128,4,-0.15617376188860607,-0.476000086105478
280,1548673200,746,32,0,778,4,-0.15617376188860607,2.383142345287162
280,1548687600,220,38,0,258,4,-0.15617376188860607,0.09582840017304999
280,1548702000,289,105,0,394,4,-0.15617376188860607,0.6940489704336639
280,1548716400,64,48,0,112,4,-0.15617376188860607,-0.5463789767243737
280,1548730800,12,4,0,16,5,-0.1561737618886061,-0.9800590365580002
280,1548745200,126,12,0,138,5,-0.1561737618886061,-0.44129468688273
280,1548759600,513,103,0,616,5,-0.1561737618886061,1.6696016995498857
280,1548774000,215,35,0,250,5,-0.1561737618886061,0.05330865052407538
280,1548788400,281,98,0,379,5,-0.1561737618886061,0.6229857087872709
280,1548802800,56,71,15,127,5,6.403124237432849,-0.48987180037804123
280,1548817200,12,5,0,17,5,-0.1561737618886061,-0.9756429353311536
280,1548831600,109,11,0,120,5,-0.1561737618886061,-0.5207845089659666
280,1548846000,842,35,0,877,5,-0.1561737618886061,2.822204119756816
280,1548860400,234,50,0,284,5,-0.1561737618886061,0.2034560922368556
280,1548874800,230,90,0,320,5,-0.1561737618886061,0.36243573640332877
280,1548889200,66,59,0,125,5,-0.1561737618886061,-0.4987040028317342
280,1548903600,11,6,0,17,5,-0.1561737618886061,-0.9756429353311536
280,1548918000,113,4,0,117,5,-0.1561737618886061,-0.534032812646506
280,1548932400,741,27,0,768,5,-0.1561737618886061,2.34084908603055
280,1548946800,181,25,0,206,5,-0.1561737618886061,-0.1409998034571696
280,1548961200,252,85,0,337,5,-0.1561737618886061,0.43750945725971885
280,1548975600,57,47,0,104,5,-0.1561737618886061,-0.5914421285955102
280,1548990000,9,6,0,15,5,-0.1561737618886061,-0.9844751377848466
280,1549004400,108,11,0,119,5,-0.1561737618886061,-0.525200610192813
280,1549018800,719,36,0,755,5,-0.1561737618886061,2.283439770081546
280,1549033200,204,46,0,250,5,-0.1561737618886061,0.05330865052407538
280,1549047600,287,99,0,386,5,-0.1561737618886061,0.6538984173751962
280,1549062000,80,41,0,121,5,-0.1561737618886061,-0.5163684077391201
280,1549076400,18,14,0,32,5,-0.1561737618886061,-0.9094014169284566
280,1549090800,30,6,0,36,5,-0.1561737618886061,-0.8917370120210706
280,1549105200,168,24,0,192,5,-0.1561737618886061,-0.20282522063302028
280,1549119600,256,56,0,312,5,-0.1561737618886061,0.32710692658855695
280,1549134000,223,56,0,279,5,-0.1561737618886061,0.1813755861026232
280,1549148400,94,28,0,122,5,-0.1561737618886061,-0.5119523065122736
280,1549162800,23,11,0,34,5,-0.1561737618886061,-0.9005692144747636
280,1549177200,22,6,0,28,5,-0.1561737618886061,-0.9270658218358424
280,1549191600,145,12,0,157,5,-0.1561737618886061,-0.35738876357264693
280,1549206000,211,44,0,255,5,-0.1561737618886061,0.07538915665830777
280,1549220400,171,56,0,227,5,-0.1561737618886061,-0.04826167769339358
280,1549234800,51,23,0,74,5,-0.1561737618886061,-0.7239251654009045
280,1549249200,14,8,0,22,5,-0.1561737618886061,-0.9535624291969212
280,1549263600,124,8,0,132,5,-0.1561737618886061,-0.4677912942438089
280,1549278000,798,43,0,841,5,-0.1561737618886061,2.663224475590343
280,1549292400,223,35,0,258,5,-0.1561737618886061,0.08863746033884719
280,1549306800,296,105,0,401,5,-0.1561737618886061,0.7201399357778934
280,1549321200,74,53,0,127,5,-0.1561737618886061,-0.48987180037804123
280,1549335600,12,9,0,21,6,-0.16012815380508713,-0.9726481533037477
280,1549350000,100,9,0,109,6,-0.16012815380508713,-0.6199780359130193
280,1549364400,735,39,0,774,6,-0.16012815380508713,2.0450859193691904
280,1549378800,237,42,0,279,6,-0.16012815380508713,0.06131650904634261
280,1549393200,270,89,0,359,6,-0.16012815380508713,0.38192570667427755
280,1549407600,69,65,0,134,6,-0.16012815380508713,-0.5197876616542896
280,1549422000,16,8,0,24,6,-0.16012815380508713,-0.9606253083927001
280,1549436400,110,10,0,120,6,-0.16012815380508713,-0.5758942712391781
280,1549450800,838,38,0,876,6,-0.16012815380508713,2.453862646344807
280,1549465200,238,49,0,287,6,-0.16012815380508713,0.0933774288091361
280,1549479600,252,98,0,350,6,-0.16012815380508713,0.3458571719411349
280,1549494000,74,61,0,135,6,-0.16012815380508713,-0.5157800466839403
280,1549508400,14,8,0,22,6,-0.16012815380508713,-0.9686405383333985
280,1549522800,114,4,0,118,6,-0.16012815380508713,-0.5839095011798765
280,1549537200,839,41,0,880,6,-0.16012815380508713,2.4698931062262037
280,1549551600,228,55,0,283,6,-0.16012815380508713,0.07734696892773936
280,1549566000,295,79,0,374,6,-0.16012815380508713,0.4420399312295154
280,1549580400,97,53,0,150,6,-0.16012815380508713,-0.45566582212870255
280,1549594800,15,6,0,21,6,-0.16012815380508713,-0.9726481533037477
280,1549609200,109,9,0,118,6,-0.16012815380508713,-0.5839095011798765
280,1549623600,751,43,0,794,6,-0.16012815380508713,2.1252382187761736
280,1549638000,238,31,0,269,6,-0.16012815380508713,0.021240359342850738
280,1549681200,421,190,0,611,6,-0.16012815380508713,1.3918446792022727
280,1549695600,25,3,0,28,6,-0.16012815380508713,-0.9445948485113034
280,1549710000,202,37,0,239,6,-0.16012815380508713,-0.09898808976762488
280,1549724400,265,77,0,342,6,-0.16012815380508713,0.3137962521783414
280,1549738800,215,57,0,272,6,-0.16012815380508713,0.033263204253898296
280,1549753200,103,35,0,138,6,-0.16012815380508713,-0.5037572017728927
280,1549767600,15,16,1,31,6,6.244997998398398,-0.9325720036002558
280,1549782000,16,4,0,20,6,-0.16012815380508713,-0.9766557682740968
280,1549796400,131,13,0,144,6,-0.16012815380508713,-0.47971151195079764
280,1549810800,221,56,0,277,6,-0.16012815380508713,0.053301279105644236
280,1549825200,154,49,0,203,6,-0.16012815380508713,-0.24326222870019562
280,1549839600,45,28,0,73,6,-0.16012815380508713,-0.7642521748455899
280,1549854000,8,4,0,12,6,-0.16012815380508713,-1.0087166880368903
280,1549868400,117,7,0,124,6,-0.16012815380508713,-0.5598638113577814
280,1549882800,780,40,0,820,6,-0.16012815380508713,2.2294362080052528
280,1549897200,215,27,0,242,6,-0.16012815380508713,-0.08696524485657732
280,1549911600,265,107,0,372,6,-0.16012815380508713,0.43402470128881704
280,1549926000,68,35,0,103,6,-0.16012815380508713,-0.6440237257351143
280,1549940400,10,7,0,17,7,-0.15249857033260467,-0.931645390418156
280,1549954800,116,11,0,127,7,-0.15249857033260467,-0.42017038025210846
280,1549969200,729,36,0,765,7,-0.15249857033260467,2.5463846787109667
280,1549983600,185,30,0,215,7,-0.15249857033260467,-0.01099037211927049
280,1549998000,280,103,0,383,7,-0.15249857033260467,0.7701714615888747
280,1550012400,45,39,0,84,7,-0.15249857033260467,-0.6201106114988361
280,1550026800,7,11,4,18,7,6.557438524302,-0.9269956175984646
280,1550041200,115,6,0,121,7,-0.15249857033260467,-0.4480690171702565
280,1550055600,786,40,0,826,7,-0.15249857033260467,2.8300208207121385
280,1550070000,295,74,0,369,7,-0.15249857033260467,0.7050746421131959
280,1550084400,257,78,0,335,7,-0.15249857033260467,0.5469823662436903
280,1550098800,73,58,0,131,7,-0.15249857033260467,-0.4015712889733431
280,1550113200,13,6,0,19,7,-0.15249857033260467,-0.9223458447787732
280,1550127600,126,13,0,139,7,-0.15249857033260467,-0.3643731064158124
280,1550139876,771,31,0,802,7,-0.15249857033260467,2.7184262730395465
280,1550142000,43,1,0,44,7,-0.15249857033260467,-0.8061015242864897
280,1550144716,44,7,0,51,7,-0.15249857033260467,-0.7735531145486504
280,1550156400,177,40,0,217,7,-0.15249857033260467,-0.0016908264798878082
280,1550170800,290,94,0,384,7,-0.15249857033260467,0.7748212344085661
280,1550185200,72,58,0,130,7,-0.15249857033260467,-0.4062210617930344
280,1550199600,18,8,0,26,7,-0.15249857033260467,-0.8897974350409339
280,1550214000,110,15,0,125,7,-0.15249857033260467,-0.42946992589149113
280,1550228400,746,46,0,792,7,-0.15249857033260467,2.671928544842633
280,1550242800,224,31,0,255,7,-0.15249857033260467,0.17500054066838314
280,1550257200,301,94,0,395,7,-0.15249857033260467,0.8259687354251708
280,1550271600,82,52,0,134,7,-0.15249857033260467,-0.38762197051426905
280,1550286000,23,19,0,42,7,-0.15249857033260467,-0.8154010699258724
280,1550300400,21,3,0,24,7,-0.15249857033260467,-0.8990969806803165
280,1550314800,158,20,0,178,7,-0.15249857033260467,-0.18303196644785008
280,1550329200,257,78,0,335,7,-0.15249857033260467,0.5469823662436903
280,1550343600,194,43,0,237,7,-0.15249857033260467,0.091304629913939
280,1550358000,60,39,0,99,7,-0.15249857033260467,-0.550364019203466
280,1550372400,28,17,0,45,7,-0.15249857033260467,-0.8014517514667984
280,1550386800,23,6,0,29,7,-0.15249857033260467,-0.8758481165818598
280,1550401200,143,17,0,160,7,-0.15249857033260467,-0.26672787720229424
280,1550415600,230,47,0,277,7,-0.15249857033260467,0.2772955427015926
280,1550430000,177,59,0,236,7,-0.15249857033260467,0.08665485709424767
280,1550444400,45,27,0,72,7,-0.15249857033260467,-0.6759078853351322
280,1550458800,10,9,0,19,7,-0.15249857033260467,-0.9223458447787732
280,1550473200,49,2,0,51,7,-0.15249857033260467,-0.7735531145486504
280,1550487600,248,17,0,265,7,-0.15249857033260467,0.22149826886529653
280,1550502000,214,46,0,260,7,-0.15249857033260467,0.19824940476683983
280,1550516400,188,62,0,250,7,-0.15249857033260467,0.15175167656992644
280,1550530800,48,33,0,81,7,-0.15249857033260467,-0.6340599299579102
280,1550545200,14,11,0,25,8,-0.2995012465378748,-0.9936943776575166
280,1550559600,99,2,0,101,8,-0.2995012465378748,-0.6810329070956208
280,1550574000,699,32,0,731,8,-0.2995012465378748,1.9107661251937789
280,1550588400,209,46,0,255,8,-0.2995012465378748,-0.04748203253598974
280,1550602800,233,75,0,308,8,-0.2995012465378748,0.1705582035137534
280,1550617200,56,57,1,113,8,0.49916874422979135,-0.6316653064805846
280,1550631600,8,10,2,18,8,1.2978387349974576,-1.0224921446829545
280,1550646000,96,7,0,103,8,-0.2995012465378748,-0.6728049736597814
280,1550660400,742,38,0,780,8,-0.2995012465378748,2.112350494371843
280,1550674800,256,41,0,297,8,-0.2995012465378748,0.1253045696166369
280,1550689200,181,58,0,239,8,-0.2995012465378748,-0.11330550002270465
280,1550703600,51,57,6,108,8,4.492518698068122,-0.652235140070183
280,1550718000,9,8,0,17,8,-0.2995012465378748,-1.026606111400874
280,1550732400,94,11,0,105,8,-0.2995012465378748,-0.664577040223942
280,1550746800,772,39,0,811,8,-0.2995012465378748,2.239883462627353
280,1550761200,221,50,0,271,8,-0.2995012465378748,0.018341434950725172
280,1550775600,286,84,0,370,8,-0.2995012465378748,0.42562414002477367
280,1550790000,66,55,0,121,8,-0.2995012465378748,-0.5987535727372272
280,1550804400,18,10,0,28,8,-0.2995012465378748,-0.9813524775037575
280,1550818800,101,8,0,109,8,-0.2995012465378748,-0.6481211733522633
280,1550833200,661,38,0,699,8,-0.2995012465378748,1.7791191902203491
280,1550847600,230,54,0,284,8,-0.2995012465378748,0.07182300228368103
280,1550862000,283,83,0,366,8,-0.2995012465378748,0.40916827315309495
280,1550876400,78,60,0,138,8,-0.2995012465378748,-0.5288161385325926
280,1551495600,8515,1599,0,10114,9,0.0,4.115852313997426
280,1551510000,28,10,0,38,9,0.0,-0.3052408862269509
280,1551524400,200,40,0,240,9,0.0,-0.21660841039871312
280,1551538800,239,79,0,318,9,0.0,-0.18238398903929456
280,1551553200,224,50,0,274,9,0.0,-0.20169007288306914
280,1551567600,96,30,0,126,9,0.0,-0.2666287185394018
280,1551582000,21,13,0,34,9,0.0,-0.30699598475820317
280,1551596400,18,11,0,29,9,0.0,-0.30918985792226844
280,1551610800,174,29,0,203,9,0.0,-0.2328430718127963
280,1551625200,244,62,0,306,9,0.0,-0.18764928463305128
280,1551639600,150,51,0,201,9,0.0,-0.2337206210784224
280,1551654000,48,20,0,68,9,0.0,-0.29207764724255914
280,1551668400,15,3,0,18,9,0.0,-0.3140163788832121
280,1551682800,73,8,0,81,9,0.0,-0.2863735770159894
280,1551697200,534,30,0,564,9,0.0,-0.07444542936728221
280,1551711600,190,42,0,232,9,0.0,-0.22011860746121759
280,1551726000,204,61,0,265,9,0.0,-0.20563904457838666
280,1551740400,53,42,0,95,9,0.0,-0.2802307321566066
280,1551754800,9,8,0,17,10,-0.24253562503633297,-0.8299229678766825
280,1551769200,117,13,0,130,10,-0.24253562503633297,-0.4966758418948106
280,1551783600,805,37,0,842,10,-0.24253562503633297,1.6030759607520282
280,1551798000,204,39,0,243,10,-0.24253562503633297,-0.1634287159129387
280,1551812400,312,101,0,413,10,-0.24253562503633297,0.3379165178650987
280,1551826800,67,47,0,114,10,-0.24253562503633297,-0.5438612756621553
280,1551841200,10,7,0,17,10,-0.24253562503633297,-0.8299229678766825
280,1551855600,110,12,0,122,10,-0.24253562503633297,-0.520268558778483
280,1551870000,860,39,0,899,10,-0.24253562503633297,1.7711740685481936
280,1551884400,236,58,0,294,10,-0.24253562503633297,-0.013025145779527496
280,1551898800,258,105,0,363,10,-0.24253562503633297,0.1904620373421465
280,1551913200,73,56,0,129,10,-0.24253562503633297,-0.49962493150526965
280,1551927600,11,8,0,19,10,-0.24253562503633297,-0.8240247886557645
280,1551942000,121,7,0,128,10,-0.24253562503633297,-0.5025740211157287
280,1551956400,839,40,0,879,10,-0.24253562503633297,1.7121922763390127
280,1551970800,235,38,0,273,10,-0.24253562503633297,-0.0749560275991674
280,1551985200,294,128,0,422,10,-0.24253562503633297,0.36445832435923003
280,1551999600,72,36,0,108,10,-0.24253562503633297,-0.5615558133249096
280,1552014000,12,16,4,28,10,4.123105625617661,-0.797482982161633
280,1552100400,1448,284,0,1732,10,-0.24253562503633297,4.227765714060577
280,1552114800,28,4,0,32,10,-0.24253562503633297,-0.7856866237197968
280,1552129200,191,34,0,225,10,-0.24253562503633297,-0.21651232890120148
280,1552143600,279,95,0,374,10,-0.24253562503633297,0.22290202305719597
280,1552158000,254,74,0,328,10,-0.24253562503633297,0.08724390097607998
280,1552172400,91,24,0,115,10,-0.24253562503633297,-0.5409121860516962
280,1552190400,27,22,0,49,10,-0.24253562503633297,-0.7355521003419931
280,1552204800,30,4,0,34,10,-0.24253562503633297,-0.7797884444988787
280,1552219200,169,21,0,190,10,-0.24253562503633297,-0.319730465267268
280,1552233600,199,55,0,254,10,-0.24253562503633297,-0.13098873019788923
280,1552248000,144,49,0,193,10,-0.24253562503633297,-0.31088319643589085
280,1552262400,35,15,0,50,10,-0.24253562503633297,-0.7326030107315341
280,1552276800,7,11,4,18,10,4.123105625617661,-0.8269738782662235
280,1552291200,382,20,0,402,10,-0.24253562503633297,0.30547653215004916
280,1552305600,606,54,0,660,10,-0.24253562503633297,1.0663416516484823
280,1552320000,242,61,0,303,10,-0.24253562503633297,0.013516660714603893
280,1552334400,256,88,0,344,10,-0.24253562503633297,0.13442933474342467
280,1552348800,41,38,0,79,11,-0.2926710796641323,-0.9444304381300119
280,1552363200,7,9,2,16,11,0.6528816392507567,-1.2777588280582515
280,1552377600,377,16,0,393,11,-0.2926710796641323,0.7169205846869278
280,1552392000,619,39,0,658,11,-0.2926710796641323,2.119016193115237
280,1552406400,240,52,0,292,11,-0.2926710796641323,0.18253697543689307
280,1552420800,259,96,0,355,11,-0.2926710796641323,0.5158653653651326
280,1552435200,50,43,0,93,11,-0.2926710796641323,-0.8703574625904031
280,1552449600,6,10,4,16,11,1.5984343581656457,-1.2777588280582515
280,1552464000,353,32,0,385,11,-0.2926710796641323,0.6745931700928657
280,1552478400,587,40,0,627,11,-0.2926710796641323,1.954997461563246
280,1552492800,279,64,0,343,11,-0.2926710796641323,0.4523742434740393
280,1552507200,209,91,0,300,11,-0.2926710796641323,0.2248643900309552
280,1552521600,37,49,12,86,11,5.380645233825202,-0.9073939503602075
280,1552536000,9,5,0,14,11,-0.2926710796641323,-1.288340681706767
280,1552550400,386,19,0,405,11,-0.2926710796641323,0.7804117065780211
280,1552564800,605,29,0,634,11,-0.2926710796641323,1.9920339493330503
280,1552579200,255,57,0,312,11,-0.2926710796641323,0.28835551192204845
280,1552593600,257,104,0,361,11,-0.2926710796641323,0.5476109263106792
280,1552608000,58,48,0,106,11,-0.2926710796641323,-0.8015754138750522
280,1552622400,13,7,0,20,11,-0.2926710796641323,-1.2565951207612203
280,1552636800,333,13,0,346,11,-0.2926710796641323,0.4682470239468126
280,1552651200,566,32,0,598,11,-0.2926710796641323,1.8015605836597706
280,1552665600,251,64,0,315,11,-0.2926710796641323,0.30422829239482174
280,1552680000,274,110,0,384,11,-0.2926710796641323,0.6693022432686079
280,1552694400,62,44,0,106,11,-0.2926710796641323,-0.8015754138750522
280,1552708800,10,16,6,26,11,2.543987077080535,-1.2248495598156737
280,1552723200,52,11,0,63,11,-0.2926710796641323,-1.0290852673181363
280,1552737600,254,48,0,302,11,-0.2926710796641323,0.23544624367947076
280,1552752000,309,79,0,388,11,-0.2926710796641323,0.690465950565639
280,1552766400,211,65,0,276,11,-0.2926710796641323,0.09788214624876874
280,1552780800,77,33,0,110,11,-0.2926710796641323,-0.7804117065780211
280,1552795200,17,5,0,22,11,-0.2926710796641323,-1.2460132671127049
280,1552809600,40,10,0,50,11,-0.2926710796641323,-1.0978673160334873
280,1552824000,174,36,0,210,11,-0.2926710796641323,-0.25131902415224405
280,1552838400,264,59,0,323,11,-0.2926710796641323,0.34655570698888394
280,1552852800,147,41,0,188,11,-0.2926710796641323,-0.367719414285915
280,1552867200,39,25,0,64,11,-0.2926710796641323,-1.0237943404938785
280,1552881600,4,6,2,10,11,0.6528816392507567,-1.309504389003798
280,1552896000,355,21,0,376,11,-0.2926710796641323,0.6269748286745457
280,1552910400,554,27,0,581,11,-0.2926710796641323,1.7116148276473886
280,1552924800,236,50,0,286,11,-0.2926710796641323,0.15079141449134645
280,1552939200,217,79,0,296,11,-0.2926710796641323,0.20370068273392414
280,1552953600,40,29,0,69,12,-0.15617376188860607,-0.9703484815306346
280,1552968000,11,8,0,19,12,-0.15617376188860607,-1.2352986585185857
280,1552982400,362,13,0,375,12,-0.15617376188860607,0.6511466016356267
280,1552996800,627,41,0,668,12,-0.15617376188860607,2.203754638785021
280,1553011200,253,65,0,318,12,-0.15617376188860607,0.34910339986936234
280,1553025600,245,110,0,355,12,-0.15617376188860607,0.5451665308404462
280,1553040000,47,40,0,87,12,-0.15617376188860607,-0.8749664178149722
280,1553054400,7,8,1,15,12,6.403124237432849,-1.2564946726776218
280,1553068800,342,30,0,372,12,-0.15617376188860607,0.6352495910163496
280,1553083200,601,50,0,651,12,-0.15617376188860607,2.1136715786091176
280,1553097600,283,57,0,340,12,-0.15617376188860607,0.4656814777440609
280,1553112000,238,101,0,339,12,-0.15617376188860607,0.46038247420430184
280,1553126400,52,36,0,88,12,-0.15617376188860607,-0.8696674142752131
280,1553140800,8,8,0,16,12,-0.15617376188860607,-1.2511956691378627
280,1553155200,344,18,0,362,12,-0.15617376188860607,0.5822595556187594
280,1553169600,564,38,0,602,12,-0.15617376188860607,1.8540204051609253
280,1553184000,247,52,0,299,12,-0.15617376188860607,0.2484223326139409
280,1553198400,232,99,0,331,12,-0.15617376188860607,0.41799044588622963
280,1553212800,52,18,0,70,12,-0.15617376188860607,-0.9650494779908756
280,1553227200,10,5,0,15,12,-0.15617376188860607,-1.2564946726776218
280,1553241600,332,24,0,356,12,-0.15617376188860607,0.5504655343802053
280,1553256000,548,45,0,593,12,-0.15617376188860607,1.806329373303094
280,1553270400,248,83,0,331,12,-0.15617376188860607,0.41799044588622963
280,1553284800,267,83,0,350,12,-0.15617376188860607,0.518671513141651
280,1553299200,65,53,0,118,12,-0.15617376188860607,-0.7106973080824424
280,1553313600,10,8,0,18,12,-0.15617376188860607,-1.2405976620583448
280,1553328000,47,5,0,52,12,-0.15617376188860607,-1.060431541706538
280,1553342400,222,32,0,254,12,-0.15617376188860607,0.009967173324784823
280,1553356800,261,88,0,349,12,-0.15617376188860607,0.5133725096018921
280,1553371200,192,72,0,264,12,-0.15617376188860607,0.06295720872237506
280,1553385600,59,47,0,106,12,-0.15617376188860607,-0.7742853505595507
280,1553400000,18,7,0,25,12,-0.15617376188860607,-1.2035046372800315
280,1553414400,44,5,0,49,12,-0.15617376188860607,-1.076328552325815
280,1553428800,170,30,0,200,12,-0.15617376188860607,-0.27617901782220244
280,1553443200,224,67,0,291,12,-0.15617376188860607,0.20603030429586872
280,1553457600,145,34,0,179,12,-0.15617376188860607,-0.38745809215714194
280,1553472000,39,20,0,59,12,-0.15617376188860607,-1.0233385169282248
280,1553486400,11,5,0,16,12,-0.15617376188860607,-1.2511956691378627
280,1553500800,335,16,0,351,12,-0.15617376188860607,0.5239705166814101
280,1553515200,559,33,0,592,12,-0.15617376188860607,1.801030369763335
280,1553529600,255,52,0,307,12,-0.15617376188860607,0.29081436093201307
280,1553544000,237,101,0,338,12,-0.15617376188860607,0.4550834706645428
280,1553558400,37,37,0,74,13,-0.15617376188860604,-0.9680096169152927
280,1553572800,6,2,0,8,13,-0.15617376188860604,-1.3080581098932664
280,1553587200,398,21,0,419,13,-0.15617376188860604,0.809516596378661
280,1553601600,581,40,0,621,13,-0.15617376188860604,1.850271074887005
280,1553616000,258,54,0,312,13,-0.15617376188860604,0.2582258577628551
280,1553630400,231,97,0,328,13,-0.15617376188860604,0.3406618560605457
280,1553644800,50,35,0,85,13,-0.15617376188860604,-0.9113348680856304
280,1553659200,10,5,0,15,13,-0.15617376188860604,-1.2719923606380268
280,1553673600,353,25,0,378,13,-0.15617376188860604,0.5982743507408289
280,1553688000,608,32,0,640,13,-0.15617376188860604,1.9481638228655127
280,1553702400,271,72,0,343,13,-0.15617376188860604,0.4179456044646307
280,1553716800,221,102,0,323,13,-0.15617376188860604,0.3149006065925174
280,1553731200,52,44,0,96,13,-0.15617376188860604,-0.8546601192559681
280,1553745600,4,1,0,5,13,-0.15617376188860604,-1.3235148595740835
280,1553760000,357,28,0,385,13,-0.15617376188860604,0.6343400999960686
280,1553774400,616,35,0,651,13,-0.15617376188860604,2.004838571695175
280,1553788800,257,72,0,329,13,-0.15617376188860604,0.3458141059541514
280,1553803200,247,78,0,325,13,-0.15617376188860604,0.3252051063797287
280,1553817600,46,44,0,90,13,-0.15617376188860604,-0.8855736186176021
280,1553832000,10,3,0,13,13,-0.15617376188860604,-1.282296860425238
280,1553846400,329,28,0,357,13,-0.15617376188860604,0.49007710297511
280,1553860800,601,31,0,632,13,-0.15617376188860604,1.9069458237166672
280,1553875200,255,97,0,352,13,-0.15617376188860604,0.46431585350708166
280,1553889600,283,99,0,382,13,-0.15617376188860604,0.6188833503152515
280,1553904000,52,48,0,100,13,-0.15617376188860604,-0.8340511196815454
280,1553918400,8,6,0,14,13,-0.15617376188860604,-1.2771446105316324
280,1553932800,54,5,0,59,13,-0.15617376188860604,-1.0452933653193777
280,1553947200,246,63,0,309,13,-0.15617376188860604,0.24276910808203814
280,1553961600,322,95,0,417,13,-0.15617376188860604,0.7992120965914498
280,1553976000,245,77,0,322,13,-0.15617376188860604,0.30974835669891176
280,1553990400,71,46,0,117,13,-0.15617376188860604,-0.7464628714902491
280,1554004800,12,10,0,22,13,-0.15617376188860604,-1.2359266113827871
280,1554019200,45,10,0,55,13,-0.15617376188860604,-1.0659023648938002
280,1554033600,199,43,0,242,13,-0.15617376188860604,-0.1024316347895413
280,1554048000,217,69,0,286,13,-0.15617376188860604,0.12426736052910788
280,1554062400,142,52,0,194,13,-0.15617376188860604,-0.34973962968261313
280,1554076800,42,23,0,65,13,-0.15617376188860604,-1.0143798659577437
280,1554091200,4,6,2,10,13,6.403124237432848,-1.2977536101060552
280,1554105600,372,26,0,398,13,-0.15617376188860604,0.7013193486129421
280,1554120000,578,36,0,614,13,-0.15617376188860604,1.8142053256317654
280,1554134400,244,62,0,306,13,-0.15617376188860604,0.22731235840122113
280,1554148800,218,88,0,306,13,-0.15617376188860604,0.22731235840122113
280,1554163200,43,32,0,75,14,-0.21160368475757946,-0.9804458185320185
280,1554177600,8,3,0,11,14,-0.21160368475757946,-1.3208537699934066
280,1554192000,386,22,0,408,14,-0.21160368475757946,0.7907393039155161
280,1554206400,597,38,0,635,14,-0.21160368475757946,1.9981237567551267
280,1554220800,238,58,0,296,14,-0.21160368475757946,0.19502538885808698
280,1554235200,248,91,0,339,14,-0.21160368475757946,0.42373698124620707
280,1554249600,47,47,0,94,14,-0.21160368475757946,-0.8793872079419189
280,1554264000,5,4,0,9,14,-0.21160368475757946,-1.331491518476575
280,1554278400,408,26,0,434,14,-0.21160368475757946,0.9290300341967049
280,1554292800,595,31,0,626,14,-0.21160368475757946,1.9502538885808691
280,1554307200,265,46,0,311,14,-0.21160368475757946,0.2748085024818498
280,1554321600,211,123,0,334,14,-0.21160368475757946,0.39714261003828616
280,1554336000,42,44,2,86,14,5.713299488454646,-0.9219382018745925
280,1554350400,8,7,0,15,14,-0.21160368475757946,-1.2995782730270697
280,1554364800,374,16,0,390,14,-0.21160368475757946,0.6949995675670007
280,1554379200,592,38,0,630,14,-0.21160368475757946,1.9715293855472058
280,1554393600,285,71,0,356,14,-0.21160368475757946,0.5141578433531383
280,1554408000,238,95,0,333,14,-0.21160368475757946,0.39182373579670193
280,1554422400,52,39,0,91,14,-0.21160368475757946,-0.8953438306666716
280,1554436800,10,2,0,12,14,-0.21160368475757946,-1.3155348957518225
280,1554451200,314,9,0,323,14,-0.21160368475757946,0.33863499338086006
280,1554465600,529,37,0,566,14,-0.21160368475757946,1.6311214340858178
280,1554480000,291,40,0,331,14,-0.21160368475757946,0.3811859873135336
280,1554494400,232,85,0,317,14,-0.21160368475757946,0.3067217479313549
280,1554508800,40,41,1,81,14,2.750847901848533,-0.9485325730825135
280,1554523200,10,10,0,20,14,-0.21160368475757946,-1.2729839018191489
280,1554537600,60,5,0,65,14,-0.21160368475757946,-1.0336345609478605
280,1554552000,250,64,0,314,14,-0.21160368475757946,0.29076512520660236
280,1554566400,315,95,0,410,14,-0.21160368475757946,0.8013770523986844
280,1554580800,261,58,0,319,14,-0.21160368475757946,0.3173594964145233
280,1554595200,69,36,0,105,14,-0.21160368475757946,-0.820879591284493
280,1554609600,14,7,0,21,14,-0.21160368475757946,-1.2676650275775647
280,1554624000,44,8,0,52,14,-0.21160368475757946,-1.102779926088455
280,1554638400,195,40,0,235,14,-0.21160368475757946,-0.12942593987854847
280,1554652800,277,93,0,370,14,-0.21160368475757946,0.5886220827353169
280,1554667200,195,57,0,252,14,-0.21160368475757946,-0.039005077771617276
280,1554681600,38,32,0,70,14,-0.21160368475757946,-1.0070401897399395
280,1554696000,10,2,0,12,14,-0.21160368475757946,-1.3155348957518225
280,1554710400,332,14,0,346,14,-0.21160368475757946,0.46096910093729637
280,1554724800,552,18,0,570,14,-0.21160368475757946,1.6523969310521545
280,1554739200,244,61,0,305,14,-0.21160368475757946,0.24289525703234469
280,1554753600,216,107,0,323,14,-0.21160368475757946,0.33863499338086006
280,1554768000,45,46,1,91,15,1.5322617553657474,-0.8780667487732873
280,1554782400,11,9,0,20,15,-0.25537695922762454,-1.257984776173453
280,1554796800,342,14,0,356,15,-0.25537695922762454,0.5399371563118386
280,1554811200,593,32,0,625,15,-0.25537695922762454,1.9793448939265514
280,1554825600,254,23,0,277,15,-0.25537695922762454,0.11721146385249914
280,1554840000,215,94,0,309,15,-0.25537695922762454,0.28844212408919356
280,1554854400,48,41,0,89,15,-0.25537695922762454,-0.8887686650380807
280,1554868800,7,3,0,10,15,-0.25537695922762454,-1.31149435749742
280,1554883200,352,10,0,362,15,-0.25537695922762454,0.5720429051062188
280,1554897600,570,39,0,609,15,-0.25537695922762454,1.8937295638082041
280,1554912000,246,51,0,297,15,-0.25537695922762454,0.22423062650043316
280,1554926400,220,100,0,320,15,-0.25537695922762454,0.3473026635455573
280,1554940800,55,50,0,105,15,-0.25537695922762454,-0.8031533349197335
280,1554955200,11,3,0,14,15,-0.25537695922762454,-1.2900905249678334
280,1554969600,341,10,0,351,15,-0.25537695922762454,0.5131823656498551
280,1554984000,591,46,0,637,15,-0.25537695922762454,2.043556391515312
280,1554998400,250,52,0,302,15,-0.25537695922762454,0.2509854171624167
280,1555012800,223,101,0,324,15,-0.25537695922762454,0.3687064960751441
280,1555027200,45,48,3,93,15,5.107539184552492,-0.8673648325084939
280,1555041600,9,11,2,20,15,3.3199004699591192,-1.257984776173453
280,1555056000,302,15,0,317,15,-0.25537695922762454,0.33124978914836717
280,1555070400,565,53,0,618,15,-0.25537695922762454,1.9418881869997744
280,1555084800,250,64,0,314,15,-0.25537695922762454,0.3151969147511771
280,1555099200,270,90,0,360,15,-0.25537695922762454,0.5613409888414254
280,1555113600,52,43,0,95,15,-0.25537695922762454,-0.8566629162437005
280,1555128000,11,9,0,20,15,-0.25537695922762454,-1.257984776173453
280,1555142400,60,4,0,64,15,-0.25537695922762454,-1.0225426183479982
280,1555156800,245,63,0,308,15,-0.25537695922762454,0.2830911659567969
280,1555171200,324,99,0,423,15,-0.25537695922762454,0.8984513511824176
280,1555185600,240,60,0,300,15,-0.25537695922762454,0.24028350089762326
280,1555200000,66,38,0,104,15,-0.25537695922762454,-0.8085042930521302
280,1555214400,15,6,0,21,15,-0.25537695922762454,-1.2526338180410563
280,1555228800,40,7,0,47,15,-0.25537695922762454,-1.1135089065987422
280,1555243200,201,46,0,247,15,-0.25537695922762454,-0.043317280119401905
280,1555257600,291,99,0,390,15,-0.25537695922762454,0.7218697328133264
280,1555272000,162,52,0,214,15,-0.25537695922762454,-0.21989889848849306
280,1555286400,42,27,0,69,15,-0.25537695922762454,-0.9957878276860147
280,1555300800,6,2,0,8,15,-0.25537695922762454,-1.3221962737622135
280,1555315200,355,22,0,377,15,-0.25537695922762454,0.6523072770921693
280,1555329600,574,33,0,607,15,-0.25537695922762454,1.8830276475434107
280,1555344000,234,63,0,297,15,-0.25537695922762454,0.22423062650043316
280,1555358400,215,88,0,303,15,-0.25537695922762454,0.25633637529481335
280,1555372800,45,32,0,77,16,-0.15617376188860604,-1.0130576650979777
280,1555387200,9,3,0,12,16,-0.15617376188860604,-1.3550444866285178
280,1555401600,393,22,0,415,16,-0.15617376188860604,0.7652738068608317
280,1555416000,627,38,0,665,16,-0.15617376188860604,2.080607735824448
280,1555430400,262,55,0,317,16,-0.15617376188860604,0.2496629067070941
280,1555444800,263,107,0,370,16,-0.15617376188860604,0.5285136996473807
280,1555459200,38,41,3,79,16,6.403124237432848,-1.0025349936662686
280,1555473600,8,8,0,16,16,-0.15617376188860604,-1.3339991437651
280,1555488000,387,20,0,407,16,-0.15617376188860604,0.723183121133996
280,1555502400,614,44,0,658,16,-0.15617376188860604,2.0437783858134666
280,1555516800,307,79,0,386,16,-0.15617376188860604,0.6126950711010521
280,1555531200,246,115,0,361,16,-0.15617376188860604,0.4811616782046906
280,1555545600,54,40,0,94,16,-0.15617376188860604,-0.9236149579284517
280,1555560000,9,6,0,15,16,-0.15617376188860604,-1.3392604794809544
280,1555574400,349,27,0,376,16,-0.15617376188860604,0.5600817139425075
280,1555588800,608,43,0,651,16,-0.15617376188860604,2.0069490358024855
280,1555603200,288,83,0,371,16,-0.15617376188860604,0.5337750353632352
280,1555617600,243,88,0,331,16,-0.15617376188860604,0.3233216067290566
280,1555632000,57,41,0,98,16,-0.15617376188860604,-0.9025696150650337
280,1555646400,13,3,0,16,16,-0.15617376188860604,-1.3339991437651
280,1555660800,210,15,0,225,16,-0.15617376188860604,-0.2343799791515167
280,1555675200,471,77,0,548,16,-0.15617376188860604,1.4650314570694756
280,1555689600,278,87,0,365,16,-0.15617376188860604,0.5022070210681084
280,1555704000,223,58,0,281,16,-0.15617376188860604,0.06025482093633334
280,1555718400,56,37,0,93,16,-0.15617376188860604,-0.9288762936443061
280,1555732800,24,19,0,43,16,-0.15617376188860604,-1.1919430794370294
280,1555747200,94,5,0,99,16,-0.15617376188860604,-0.8973082793491793
280,1555761600,270,61,0,331,16,-0.15617376188860604,0.3233216067290566
280,1555776000,375,89,0,464,16,-0.15617376188860604,1.0230792569377005
280,1555790400,274,59,0,333,16,-0.15617376188860604,0.3338442781607655
280,1555804800,93,43,0,136,16,-0.15617376188860604,-0.7026388578625641
280,1555819200,19,19,0,38,16,-0.15617376188860604,-1.2182497580163016
280,1555833600,70,7,0,77,16,-0.15617376188860604,-1.0130576650979777
280,1555848000,267,65,0,332,16,-0.15617376188860604,0.32858294244491104
280,1555862400,363,123,0,486,16,-0.15617376188860604,1.1388286426864986
280,1555876800,193,55,0,248,16,-0.15617376188860604,-0.11336925768686401
280,1555891200,81,29,0,110,16,-0.15617376188860604,-0.8394335864747802
280,1555905600,12,8,0,20,16,-0.15617376188860604,-1.3129538009016821
280,1555920000,270,22,0,292,16,-0.15617376188860604,0.11812951381073246
280,1555934400,510,37,0,547,16,-0.15617376188860604,1.4597701213536212
280,1555948800,225,60,0,285,16,-0.15617376188860604,0.0813001637997512
280,1555963200,177,76,0,253,16,-0.15617376188860604,-0.08706257910759169
280,1555977600,37,39,2,76,17,0.6936769379809548,-1.0302919261936605
280,1555992000,7,4,0,11,17,-0.1760075812787497,-1.3782687860858653
280,1556006400,297,25,0,322,17,-0.1760075812787497,0.2866666512445307
280,1556020800,549,41,0,590,17,-0.1760075812787497,1.7214020120308529
280,1556035200,283,83,0,366,17,-0.1760075812787497,0.5222202179407925
280,1556049600,266,107,0,373,17,-0.1760075812787497,0.5596946490061069
280,1556064000,51,47,0,98,17,-0.1760075812787497,-0.9125151428455295
280,1556078400,9,4,0,13,17,-0.1760075812787497,-1.3675618057814898
280,1556092800,300,16,0,316,17,-0.1760075812787497,0.2545457103314041
280,1556107200,535,47,0,582,17,-0.1760075812787497,1.6785740908133506
280,1556121600,309,72,0,381,17,-0.1760075812787497,0.6025225702236091
280,1556136000,215,83,0,298,17,-0.1760075812787497,0.15818288759202426
280,1556150400,45,60,15,105,17,6.346626313169033,-0.8750407117802151
280,1556164800,18,8,0,26,17,-0.1760075812787497,-1.297966433803049
280,1556179200,306,19,0,325,17,-0.1760075812787497,0.302727121701094
280,1556193600,543,31,0,574,17,-0.1760075812787497,1.6357461695958484
280,1556208000,280,85,0,365,17,-0.1760075812787497,0.5168667277886048
280,1556222400,265,86,0,351,17,-0.1760075812787497,0.44191786565797603
280,1556236800,59,47,0,106,17,-0.1760075812787497,-0.8696872216280274
280,1556251200,11,6,0,17,17,-0.1760075812787497,-1.3461478451727389
280,1556265600,251,21,0,272,17,-0.1760075812787497,0.018992143635142265
280,1556280000,516,49,0,565,17,-0.1760075812787497,1.5875647582261585
280,1556294400,236,70,0,306,17,-0.1760075812787497,0.2010108088095264
280,1556308800,187,67,0,254,17,-0.1760075812787497,-0.07737067910423757
280,1556323200,60,39,0,99,17,-0.1760075812787497,-0.9071616526933417
280,1556337600,23,9,0,32,17,-0.1760075812787497,-1.2658454928899223
280,1556352000,99,7,0,106,17,-0.1760075812787497,-0.8696872216280274
280,1556366400,374,68,0,442,17,-0.1760075812787497,0.9290854695070629
280,1556380800,471,132,0,603,17,-0.1760075812787497,1.7909973840092939
280,1556395200,357,72,0,429,17,-0.1760075812787497,0.8594900975286219
280,1556409600,91,66,0,157,17,-0.1760075812787497,-0.5966592238664512
280,1556424000,13,9,0,22,17,-0.1760075812787497,-1.3193803944117999
280,1556438400,64,8,0,72,17,-0.1760075812787497,-1.0517058868024116
280,1556452800,241,39,0,280,17,-0.1760075812787497,0.061820064852644414
280,1556467200,270,78,0,348,17,-0.1760075812787497,0.4258573952014127
280,1556481600,155,56,0,211,17,-0.1760075812787497,-0.30757075564831166
280,1556496000,45,22,0,67,17,-0.1760075812787497,-1.0784733375633504
280,1556510400,14,4,0,18,17,-0.1760075812787497,-1.340794355020551
280,1556524800,361,23,0,384,17,-0.1760075812787497,0.6185830406801723
280,1556539200,574,40,0,614,17,-0.1760075812787497,1.8498857756833593
280,1556553600,275,68,0,343,17,-0.1760075812787497,0.39908994444047385
280,1556568000,258,98,0,356,17,-0.1760075812787497,0.46868531641891487
280,1556582400,40,35,0,75,18,-0.24194335156365349,-0.958488022457507
280,1556596800,6,5,0,11,18,-0.24194335156365349,-1.2861512304399283
280,1556611200,373,27,0,400,18,-0.24194335156365349,0.7054267055782262
280,1556625600,585,32,0,617,18,-0.24194335156365349,1.8164097701436233
280,1556640000,249,49,0,298,18,-0.24194335156365349,0.1832134678562422
280,1556654400,241,97,0,338,18,-0.24194335156365349,0.38800297284525553
280,1556668800,40,47,7,87,18,5.685668761745857,-0.8970511709608029
280,1556683200,7,5,0,12,18,-0.24194335156365349,-1.281031492815203
280,1556697600,371,22,0,393,18,-0.24194335156365349,0.6695885422051489
280,1556712000,614,35,0,649,18,-0.24194335156365349,1.980241374134834
280,1556726400,239,66,0,305,18,-0.24194335156365349,0.21905163122931953
280,1556740800,255,107,0,362,18,-0.24194335156365349,0.5108766758386635
280,1556755200,43,46,3,89,18,2.2984618398547085,-0.8868116957113523
280,1556769600,7,2,0,9,18,-0.24194335156365349,-1.2963907056893789
280,1556784000,371,19,0,390,18,-0.24194335156365349,0.6542293293309728
280,1556798400,644,40,0,684,18,-0.24194335156365349,2.1594321910002208
280,1556812800,303,50,0,353,18,-0.24194335156365349,0.4647990372161355
280,1556827200,241,101,0,342,18,-0.24194335156365349,0.40848192334415684
280,1556841600,47,49,2,96,18,1.451660109381921,-0.850973532338275
280,1556856000,5,2,0,7,18,-0.24194335156365349,-1.3066301809388294
280,1556870400,305,11,0,316,18,-0.24194335156365349,0.2753687451012982
280,1556884800,607,45,0,652,18,-0.24194335156365349,1.9956005870090099
280,1556899200,265,63,0,328,18,-0.24194335156365349,0.3368055965980022
280,1556913600,253,72,0,325,18,-0.24194335156365349,0.32144638372382617
280,1556928000,72,51,0,123,18,-0.24194335156365349,-0.712740616470691
280,1556942400,14,8,0,22,18,-0.24194335156365349,-1.2298341165679496
280,1556956800,68,7,0,75,18,-0.24194335156365349,-0.958488022457507
280,1556971200,284,55,0,339,18,-0.24194335156365349,0.3931227104699808
280,1556985600,285,74,0,359,18,-0.24194335156365349,0.4955174629644875
280,1557000000,220,69,0,289,18,-0.24194335156365349,0.13713582923371423
280,1557014400,73,30,0,103,18,-0.24194335156365349,-0.8151353689651977
280,1557028800,17,6,0,23,18,-0.24194335156365349,-1.2247143789432242
280,1557043200,46,5,0,51,18,-0.24194335156365349,-1.081361725450915
280,1557057600,219,35,0,254,18,-0.24194335156365349,-0.04205498763167242
280,1557072000,254,63,0,317,18,-0.24194335156365349,0.28048848272602356
280,1557086400,114,45,0,159,18,-0.24194335156365349,-0.528430061980579
280,1557100800,43,16,0,59,18,-0.24194335156365349,-1.0404038244531122
280,1557115200,9,6,0,15,18,-0.24194335156365349,-1.265672279941027
280,1557129600,332,17,0,349,18,-0.24194335156365349,0.44432008671723416
280,1557144000,566,45,0,611,18,-0.24194335156365349,1.7856913443952713
280,1557158400,310,70,0,380,18,-0.24194335156365349,0.6030319530837195
280,1557172800,241,106,0,347,18,-0.24194335156365349,0.4340806114677835
280,1557187200,47,33,0,80,19,-0.21905397716916175,-0.940321132351884
280,1557201600,8,1,0,9,19,-0.21905397716916175,-1.2969328094055934
280,1557216000,399,19,0,418,19,-0.21905397716916175,0.7573513584108458
280,1557230400,601,44,0,645,19,-0.21905397716916175,1.8975041850473537
280,1557244800,287,68,0,355,19,-0.21905397716916175,0.4409212787716388
280,1557259200,247,89,0,336,19,-0.21905397716916175,0.3454899849121954
280,1557273600,44,42,0,86,19,-0.21905397716916175,-0.9101849342910071
280,1557288000,9,2,0,11,19,-0.21905397716916175,-1.2868874100519678
280,1557302400,403,31,0,434,19,-0.21905397716916175,0.8377145532398508
280,1557316800,627,39,0,666,19,-0.21905397716916175,2.0029808782604226
280,1557331200,295,77,0,372,19,-0.21905397716916175,0.5263071732774566
280,1557345600,270,103,0,373,19,-0.21905397716916175,0.5313298729542694
280,1557360000,45,44,0,89,19,-0.21905397716916175,-0.8951168352605687
280,1557374400,5,2,0,7,19,-0.21905397716916175,-1.3069782087592192
280,1557388800,374,24,0,398,19,-0.21905397716916175,0.6568973648745896
280,1557403200,608,42,0,650,19,-0.21905397716916175,1.9226176834314177
280,1557417600,299,60,0,359,19,-0.21905397716916175,0.46101207747889
280,1557432000,264,107,0,371,19,-0.21905397716916175,0.5212844736006438
280,1557446400,47,36,0,83,19,-0.21905397716916175,-0.9252530333214456
280,1557460800,7,2,0,9,19,-0.21905397716916175,-1.2969328094055934
280,1557475200,328,24,0,352,19,-0.21905397716916175,0.42585317974120035
280,1557489600,565,55,0,620,19,-0.21905397716916175,1.7719366931270335
280,1557504000,294,71,0,365,19,-0.21905397716916175,0.49114827553976687
280,1557518400,256,86,0,342,19,-0.21905397716916175,0.37562618297307226
280,1557532800,46,40,0,86,19,-0.21905397716916175,-0.9101849342910071
280,1557547200,17,6,0,23,19,-0.21905397716916175,-1.226615013930214
280,1557561600,65,9,0,74,19,-0.21905397716916175,-0.9704573304127608
280,1557576000,296,66,0,362,19,-0.21905397716916175,0.47608017650932843
280,1557590400,349,101,0,450,19,-0.21905397716916175,0.9180777480688558
280,1557604800,254,65,0,319,19,-0.21905397716916175,0.2601040904063776
280,1557619200,94,32,0,126,19,-0.21905397716916175,-0.7092769472184948
280,1557633600,7,10,3,17,19,5.301106247493714,-1.256751211991091
280,1557648000,55,5,0,60,19,-0.21905397716916175,-1.0407751258881401
280,1557662400,188,28,0,216,19,-0.21905397716916175,-0.25723397630534184
280,1557676800,203,32,0,235,19,-0.21905397716916175,-0.16180268244589843
280,1557691200,117,48,0,165,19,-0.21905397716916175,-0.5133916598227951
280,1557705600,39,12,0,51,19,-0.21905397716916175,-1.0859794229794555
280,1557720000,3,5,2,8,19,3.4610528392727558,-1.3019555090824062
280,1557734400,370,31,0,401,19,-0.21905397716916175,0.6719654639050281
280,1557748800,542,38,0,580,19,-0.21905397716916175,1.5710287060545212
280,1557763200,236,64,0,300,19,-0.21905397716916175,0.16467279654693423
280,1557777600,219,101,0,320,19,-0.21905397716916175,0.26512679008319046
280,1557792000,47,42,0,89,20,-0.22217143437509063,-1.0488269960002787
280,1557806400,5,5,0,10,20,-0.22217143437509063,-1.4488738948080642
280,1557820800,360,20,0,380,20,-0.22217143437509063,0.4247634793549815
280,1557835200,586,24,0,610,20,-0.22217143437509063,1.589456982213091
280,1557849600,263,60,0,323,20,-0.22217143437509063,0.13612204603797173
280,1557864000,255,92,0,347,20,-0.22217143437509063,0.2576552811188179
280,1557878400,42,46,4,88,20,3.9250286739599343,-1.053890880795314
280,1557892800,6,3,0,9,20,-0.22217143437509063,-1.4539377796030994
280,1557907200,365,18,0,383,20,-0.22217143437509063,0.43995513374008727
280,1557921600,615,33,0,648,20,-0.22217143437509063,1.7818846044244308
280,1557936000,282,70,0,352,20,-0.22217143437509063,0.28297470509399425
280,1557950400,253,104,0,357,20,-0.22217143437509063,0.30829412906917053
280,1557964800,58,53,0,111,20,-0.22217143437509063,-0.937421530509503
280,1557979200,13,3,0,16,20,-0.22217143437509063,-1.4184905860378527
280,1557993600,365,20,0,385,20,-0.22217143437509063,0.45008290333015777
280,1558008000,580,45,0,625,20,-0.22217143437509063,1.6654152541386198
280,1558022400,316,62,0,378,20,-0.22217143437509063,0.414635709764911
280,1558036800,281,90,0,371,20,-0.22217143437509063,0.37918851619966415
280,1558051200,53,58,5,111,20,4.96182870104369,-0.937421530509503
280,1558065600,13,7,0,20,20,-0.22217143437509063,-1.3982350468577116
280,1558080000,324,27,0,351,20,-0.22217143437509063,0.27791082029895897
280,1558094400,572,34,0,606,20,-0.22217143437509063,1.56920144303295
280,1558108800,275,62,0,337,20,-0.22217143437509063,0.20701643316846535
280,1558123200,294,95,0,389,20,-0.22217143437509063,0.4703384425102988
280,1558137600,63,41,0,104,20,-0.22217143437509063,-0.9728687240747499
280,1558152000,23,8,0,31,20,-0.22217143437509063,-1.3425323141123238
280,1558166400,121,14,0,135,20,-0.22217143437509063,-0.8158882954286569
280,1558180800,401,65,0,466,20,-0.22217143437509063,0.8602575717280138
280,1558195200,472,93,0,565,20,-0.22217143437509063,1.3615821664365044
280,1558209600,346,90,0,436,20,-0.22217143437509063,0.708341027876956
280,1558224000,107,65,0,172,20,-0.22217143437509063,-0.6285245580123523
280,1558238400,24,6,0,30,20,-0.22217143437509063,-1.347596198907359
280,1558252800,79,7,0,86,20,-0.22217143437509063,-1.0640186503853846
280,1558267200,354,52,0,406,20,-0.22217143437509063,0.5564244840258982
280,1558281600,443,132,0,575,20,-0.22217143437509063,1.412221014386857
280,1558296000,234,79,0,313,20,-0.22217143437509063,0.08548319808761914
280,1558310400,88,37,0,125,20,-0.22217143437509063,-0.8665271433790095
280,1558324800,17,8,0,25,20,-0.22217143437509063,-1.3729156228825354
280,1558339200,356,20,0,376,20,-0.22217143437509063,0.40450794017484043
280,1558353600,560,36,0,596,20,-0.22217143437509063,1.5185625950825974
280,1558368000,284,61,0,345,20,-0.22217143437509063,0.2475275115287474
280,1558382400,262,93,0,355,20,-0.22217143437509063,0.29816635947910003
280,1558396800,53,41,0,94,21,-0.2271099895830676,-0.33011423550800645
280,1558411200,8,6,0,14,21,-0.2271099895830676,-0.414618472139589
280,1558425600,380,19,0,399,21,-0.2271099895830676,-0.007941833350097823
280,1558440000,560,45,0,605,21,-0.2271099895830676,0.20965657597622733
280,1558454400,319,74,0,393,21,-0.2271099895830676,-0.014279651097466517
280,1558468800,285,127,0,412,21,-0.2271099895830676,0.005790105102534347
280,1558483200,61,36,0,97,21,-0.2271099895830676,-0.3269453266343221
280,1558497600,9,2,0,11,21,-0.2271099895830676,-0.41778738101327334
280,1558512000,398,20,0,418,21,-0.2271099895830676,0.012127922849903041
280,1558742400,4242,912,0,5154,21,-0.2271099895830676,5.014778731439592
280,1558756800,16,9,0,25,21,-0.2271099895830676,-0.4029991396027464
280,1558771200,48,11,0,59,21,-0.2271099895830676,-0.3670848390343238
280,1558785600,269,69,0,338,21,-0.2271099895830676,-0.07237631378167954
280,1558800000,323,116,0,439,21,-0.2271099895830676,0.034310284965693466
280,1558814400,218,65,0,283,21,-0.2271099895830676,-0.13047297646589257
280,1558828800,60,33,0,93,21,-0.2271099895830676,-0.3311705384659012
280,1558843200,10,11,1,21,21,0.6488856845230503,-0.40722435143432556
280,1558857600,40,7,0,47,21,-0.2271099895830676,-0.3797604745290612
280,1558872000,208,62,0,270,21,-0.2271099895830676,-0.14420491491852475
280,1558886400,319,114,0,433,21,-0.2271099895830676,0.027972467218324776
280,1558900800,218,52,0,270,21,-0.2271099895830676,-0.14420491491852475
280,1558915200,49,36,0,85,21,-0.2271099895830676,-0.33962096212905946
280,1558929600,10,16,6,26,21,5.02886405505364,-0.40194283664485164
280,1558944000,41,6,0,47,21,-0.2271099895830676,-0.3797604745290612
280,1558958400,194,63,0,257,21,-0.2271099895830676,-0.1579368533711569
280,1558972800,282,119,0,401,21,-0.2271099895830676,-0.005829227434308259
280,1558987200,231,54,0,285,21,-0.2271099895830676,-0.12836037055010302
280,1559001600,56,25,0,81,22,-0.21160368475757949,-1.0693885726748837
280,1559016000,15,5,0,20,22,-0.21160368475757949,-1.3776439195687917
280,1559030400,343,16,0,359,22,-0.21160368475757949,0.3354472705465322
280,1559044800,551,48,0,599,22,-0.21160368475757949,1.5482551927520711
280,1559059200,248,41,0,289,22,-0.21160368475757949,-0.018288373430083386
280,1559073600,228,92,0,320,22,-0.21160368475757949,0.13836598318813206
280,1559088000,40,30,0,70,22,-0.21160368475757949,-1.1249756024426376
280,1559102400,8,3,0,11,22,-0.21160368475757949,-1.4231242166514995
280,1559116800,368,17,0,385,22,-0.21160368475757949,0.4668347954521322
280,1559131200,599,41,0,640,22,-0.21160368475757949,1.7554432127955173
280,1559145600,303,81,0,384,22,-0.21160368475757949,0.4617814291096091
280,1559160000,232,93,0,325,22,-0.21160368475757949,0.16363281490074746
280,1559174400,40,46,6,86,22,5.713299488454647,-1.0441217409622685
280,1559188800,9,4,0,13,22,-0.21160368475757949,-1.413017483966453
280,1559203200,367,18,0,385,22,-0.21160368475757949,0.4668347954521322
280,1559217600,581,44,0,625,22,-0.21160368475757949,1.6796427176576711
280,1559232000,266,66,0,332,22,-0.21160368475757949,0.199006379298409
280,1559246400,263,105,0,368,22,-0.21160368475757949,0.38092756762923985
280,1559260800,52,37,0,89,22,-0.21160368475757949,-1.0289616419346992
280,1559275200,6,9,3,15,22,2.7508479018485334,-1.402910751281407
280,1559289600,336,25,0,361,22,-0.21160368475757949,0.3455540032315783
280,1559304000,539,61,0,600,22,-0.21160368475757949,1.553308559094594
280,1559318400,320,84,0,404,22,-0.21160368475757949,0.5628487559600707
280,1559332800,296,111,0,407,22,-0.21160368475757949,0.57800885498764
280,1559347200,74,49,0,123,22,-0.21160368475757949,-0.8571471862889145
280,1559361600,24,12,0,36,22,-0.21160368475757949,-1.2967900580884224
280,1559376000,101,11,0,112,22,-0.21160368475757949,-0.9127342160566684
280,1559390400,410,82,0,492,22,-0.21160368475757949,1.0075449941021017
280,1559404800,452,144,0,596,22,-0.21160368475757949,1.5330950937245018
280,1559419200,340,74,0,414,22,-0.21160368475757949,0.6133824193853015
280,1559433600,101,62,0,163,22,-0.21160368475757949,-0.6550125325879913
280,1559448000,22,15,0,37,22,-0.21160368475757949,-1.2917366917458992
280,1559462400,82,11,0,93,22,-0.21160368475757949,-1.008748176564607
280,1559476800,353,51,0,404,22,-0.21160368475757949,0.5628487559600707
280,1559491200,378,119,0,497,22,-0.21160368475757949,1.032811825814717
280,1559505600,216,78,0,294,22,-0.21160368475757949,0.006978458282532008
280,1559520000,86,42,0,128,22,-0.21160368475757949,-0.8318803545762992
280,1559534400,18,5,0,23,22,-0.21160368475757949,-1.3624838205412224
280,1559548800,347,20,0,367,22,-0.21160368475757949,0.3758742012867168
280,1559563200,578,35,0,613,22,-0.21160368475757949,1.6190023215473943
280,1559577600,269,82,0,351,22,-0.21160368475757949,0.2950203398063475
280,1559592000,273,106,0,379,22,-0.21160368475757949,0.4365145973969937
280,1559606400,69,39,0,108,23,-0.19658927487319616,-0.5672734734613507
280,1559620800,6,9,3,15,23,6.14341483978738,-1.037044983167696
280,1559635200,321,29,0,350,23,-0.19658927487319616,0.6551427130863436
280,1559649600,585,44,0,629,23,-0.19658927487319616,2.0644572422053797
280,1559664000,287,69,0,356,23,-0.19658927487319616,0.685450552422237
280,1559678400,275,85,0,360,23,-0.19658927487319616,0.7056557786461658
280,1559692800,74,52,0,126,23,-0.19658927487319616,-0.476349955453671
280,1559707200,6,6,0,12,23,-0.19658927487319616,-1.0521989028356427
280,1559721600,366,21,0,387,23,-0.19658927487319616,0.8420410556576854
280,1559736000,586,28,0,614,23,-0.19658927487319616,1.9886876438656467
280,1559750400,266,75,0,341,23,-0.19658927487319616,0.6096809540825038
280,1559764800,239,70,0,309,23,-0.19658927487319616,0.4480391442910731
280,1559779200,46,43,0,89,23,-0.19658927487319616,-0.6632482980250127
280,1559793600,5,5,0,10,23,-0.19658927487319616,-1.062301515947607
280,1559808000,326,29,0,355,23,-0.19658927487319616,0.6803992458662547
280,1559822400,568,35,0,603,23,-0.19658927487319616,1.9331232717498423
280,1559836800,253,68,0,321,23,-0.19658927487319616,0.5086548229628597
280,1559851200,285,90,0,375,23,-0.19658927487319616,0.7814253769858989
280,1559865600,72,44,0,116,23,-0.19658927487319616,-0.526863021013493
280,1559880000,6,5,0,11,23,-0.19658927487319616,-1.057250209391625
280,1559894400,326,19,0,345,23,-0.19658927487319616,0.6298861803064326
280,1559908800,554,39,0,593,23,-0.19658927487319616,1.8826102061900203
280,1559923200,314,63,0,377,23,-0.19658927487319616,0.7915279900978633
280,1559937600,289,93,0,382,23,-0.19658927487319616,0.8167845228777744
280,1559952000,39,31,0,70,23,-0.19658927487319616,-0.7592231225886746
280,1559966400,0,1,1,1,23,1.9167454300136626,-1.107763274951447
280,1559980800,0,0,0,0,23,-0.19658927487319616,-1.1128145815074293
280,1559995200,0,0,0,0,23,-0.19658927487319616,-1.1128145815074293
280,1560009600,0,0,0,0,23,-0.19658927487319616,-1.1128145815074293
280,1560024000,0,0,0,0,23,-0.19658927487319616,-1.1128145815074293
280,1560038400,0,0,0,0,23,-0.19658927487319616,-1.1128145815074293
280,1560052800,0,0,0,0,23,-0.19658927487319616,-1.1128145815074293
280,1560067200,26,6,0,32,23,-0.19658927487319616,-0.9511727717159986
280,1560081600,108,13,0,121,23,-0.19658927487319616,-0.501606488233582
280,1560096000,186,102,0,288,23,-0.19658927487319616,0.3419617066154468
280,1560110400,168,52,0,220,23,-0.19658927487319616,-0.0015271391913433982
280,1560124800,47,20,0,67,23,-0.19658927487319616,-0.7743770422566213
280,1560139200,8,5,0,13,23,-0.19658927487319616,-1.0471475962796606
280,1560153600,344,14,0,358,23,-0.19658927487319616,0.6955531655342013
280,1560154088,26,1,0,27,23,-0.19658927487319616,-0.9764293044959096
280,1560168000,467,49,0,516,23,-0.19658927487319616,1.4936596013793901
280,1560182400,234,51,0,285,23,-0.19658927487319616,0.3268077869475001
280,1560196800,214,77,0,291,23,-0.19658927487319616,0.3571156262833934
280,1560211200,53,40,0,93,24,0.0,-1.1266971951632128
280,1560225600,15,9,0,24,24,0.0,-1.4880782827460677
280,1560240000,401,14,0,415,24,0.0,0.5597478802234439
280,1560254400,593,49,0,642,24,0.0,1.7486392843003726
280,1560268800,277,73,0,350,24,0.0,0.21931642090626163
280,1560283200,259,95,0,354,24,0.0,0.2402660491719344
280,1560297600,72,58,0,130,24,0.0,-0.9329131337057398
280,1560312000,10,7,0,17,24,0.0,-1.524740132210995
280,1560326400,366,22,0,388,24,0.0,0.41833788943015277
280,1560340800,576,50,0,626,24,0.0,1.6648407712376816
280,1560355200,302,71,0,373,24,0.0,0.33977678343387996
280,1560369600,260,97,0,357,24,0.0,0.2559782703711889
280,1560384000,81,66,0,147,24,0.0,-0.8438772135766306
280,1560398400,10,4,0,14,24,0.0,-1.5404523534102497
280,1560412800,344,19,0,363,24,0.0,0.2874027127696981
280,1560427200,548,35,0,583,24,0.0,1.4396322673816995
280,1560441600,276,61,0,337,24,0.0,0.15123012904282518
280,1560456000,237,115,0,352,24,0.0,0.229791235039098
280,1560470400,74,55,0,129,24,0.0,-0.938150540772158
280,1560484800,17,10,0,27,24,0.0,-1.4723660615468133
280,1560499200,328,19,0,347,24,0.0,0.20360419970700708
280,1560513600,548,36,0,584,24,0.0,1.4448696744481178
280,1560528000,283,81,0,364,24,0.0,0.29264011983611626
280,1560542400,291,88,0,379,24,0.0,0.37120122583238907
280,1561161600,9307,1997,0,11304,25,0.0,4.1126407640271845
280,1561176000,23,17,0,40,25,0.0,-0.34061883408031
280,1561190400,113,10,0,123,25,0.0,-0.30780450998203923
280,1561204800,360,100,0,460,25,0.0,-0.1745704470770121
280,1561219200,447,126,0,573,25,0.0,-0.1298955239070772
280,1561233600,326,84,0,410,25,0.0,-0.19433811219645233
280,1561248000,137,55,0,192,25,0.0,-0.28052513211721175
280,1561262400,21,12,0,33,25,0.0,-0.34338630719703167
280,1561276800,95,8,0,103,25,0.0,-0.3157115760298153
280,1561291200,305,43,0,348,25,0.0,-0.21885001694455822
280,1561305600,433,111,0,544,25,0.0,-0.14136076967635253
280,1561320000,291,101,0,392,25,0.0,-0.20145447163945082
280,1561334400,102,39,0,141,25,0.0,-0.30068815053904074
280,1561348800,28,5,0,33,25,0.0,-0.34338630719703167
280,1561363200,289,15,0,304,25,0.0,-0.2362455622496656
280,1561377600,534,57,0,591,25,0.0,-0.12277916446407873
280,1561392000,248,55,0,303,25,0.0,-0.23664091555205444
280,1561406400,234,100,0,334,25,0.0,-0.2243849631780015
280,1561420800,81,52,0,133,26,-0.21160368475757946,-0.6922427560813904
280,1561435200,13,6,0,19,26,-0.21160368475757946,-1.3437973690394593
280,1561449600,295,13,0,308,26,-0.21160368475757946,0.30795072872266294
280,1561464000,547,31,0,578,26,-0.21160368475757946,1.851106390991774
280,1561478400,236,74,0,310,26,-0.21160368475757946,0.31938151140613785
280,1561492800,240,71,0,311,26,-0.21160368475757946,0.3250969027478753
280,1561507200,65,52,0,117,26,-0.21160368475757946,-0.7836890175491895
280,1561521600,14,9,0,23,26,-0.21160368475757946,-1.3209358036725096
280,1561536000,322,11,0,333,26,-0.21160368475757946,0.45083551226609914
280,1561550400,573,48,0,621,26,-0.21160368475757946,2.096868218686484
280,1561564800,228,45,0,273,26,-0.21160368475757946,0.10791203176185228
280,1561579200,237,93,0,330,26,-0.21160368475757946,0.4336893382408868
280,1561593600,84,52,0,136,26,-0.21160368475757946,-0.6750965820561781
280,1561608000,10,9,0,19,26,-0.21160368475757946,-1.3437973690394593
280,1561622400,268,10,0,278,26,-0.21160368475757946,0.1364889884705395
280,1561636800,595,60,0,655,26,-0.21160368475757946,2.291191524305557
280,1561651200,267,66,0,333,26,-0.21160368475757946,0.45083551226609914
280,1561665600,239,96,0,335,26,-0.21160368475757946,0.462266294949574
280,1561680000,81,60,0,141,26,-0.21160368475757946,-0.6465196253474907
280,1561694400,18,11,0,29,26,-0.21160368475757946,-1.286643455622085
280,1561708800,233,13,0,246,26,-0.21160368475757946,-0.04640353446505881
280,1561723200,541,55,0,596,26,-0.21160368475757946,1.953983435143048
280,1561737600,285,66,0,351,26,-0.21160368475757946,0.5537125564173732
280,1561752000,293,82,0,375,26,-0.21160368475757946,0.6908819486190719
280,1561766400,84,40,0,124,26,-0.21160368475757946,-0.7436812781570274
280,1561780800,13,17,4,30,26,5.713299488454646,-1.2809280642803476
280,1561795200,71,6,0,77,26,-0.21160368475757946,-1.0123046712186874
280,1561809600,234,53,0,287,26,-0.21160368475757946,0.18792751054617654
280,1561824000,296,95,0,391,26,-0.21160368475757946,0.782328210086871
280,1561838400,242,54,0,296,26,-0.21160368475757946,0.23936603262181358
280,1561852800,89,32,0,121,26,-0.21160368475757946,-0.7608274521822398
280,1561867200,15,17,2,32,26,2.750847901848533,-1.2694972815968726
280,1561881600,46,8,0,54,26,-0.21160368475757946,-1.1437586720786488
280,1561896000,284,29,0,313,26,-0.21160368475757946,0.3365276854313502
280,1561910400,292,66,0,358,26,-0.21160368475757946,0.5937202958095353
280,1561924800,155,47,0,202,26,-0.21160368475757946,-0.2978807535015065
280,1561939200,65,25,0,90,26,-0.21160368475757946,-0.9380045837761006
280,1561953600,11,4,0,15,26,-0.21160368475757946,-1.3666589344064093
280,1561968000,227,10,0,237,26,-0.21160368475757946,-0.09784205654069583
280,1561982400,522,47,0,569,26,-0.21160368475757946,1.799667868916137
280,1561996800,261,52,0,313,26,-0.21160368475757946,0.3365276854313502
280,1562011200,243,71,0,314,26,-0.21160368475757946,0.34224307677308763
280,1562025600,64,46,0,110,27,0.0,-0.7629291275604918
280,1562040000,9,2,0,11,27,0.0,-1.398652436657992
280,1562054400,268,9,0,277,27,0.0,0.30945261606862445
280,1562068800,545,38,0,583,27,0.0,2.2744155714608976
280,1562083200,259,66,0,325,27,0.0,0.6176820992674124
280,1562097600,235,86,0,321,27,0.0,0.5919963090008468
280,1562112000,67,42,0,109,27,0.0,-0.7693505751271332
280,1562126400,11,4,0,15,27,0.0,-1.3729666463914263
280,1562140800,230,11,0,241,27,0.0,0.07828050366953353
280,1562155200,515,45,0,560,27,0.0,2.126722277428145
280,1562169600,249,71,0,320,27,0.0,0.5855748614342053
280,1562184000,234,98,0,332,27,0.0,0.6626322322339023
280,1562198400,64,42,0,106,27,0.0,-0.7886149178270575
280,1562212800,14,2,0,16,27,0.0,-1.3665451988247848
280,1562227200,60,8,0,68,27,0.0,-1.0326299253594313
280,1562241600,181,38,0,219,27,0.0,-0.0629913427965776
280,1562256000,249,69,0,318,27,0.0,0.5727319663009225
280,1562270400,209,51,0,260,27,0.0,0.20028800743572042
280,1562284800,72,53,0,125,27,0.0,-0.6666074140608707
280,1562299200,11,6,0,17,27,0.0,-1.3601237512581434
280,1562313600,127,5,0,132,27,0.0,-0.6216572810943807
280,1562328000,291,45,0,336,27,0.0,0.6883180225004679
280,1562342400,293,68,0,361,27,0.0,0.8488542116665033
280,1562356800,237,66,0,303,27,0.0,0.4764102528013013
280,1562371200,90,38,0,128,27,0.0,-0.6473430713609464
280,1562385600,20,9,0,29,27,0.0,-1.2830663804584466
280,1562400000,74,9,0,83,27,0.0,-0.9363082118598101
280,1562414400,308,55,0,363,27,0.0,0.8616971067997862
280,1562428800,355,89,0,444,27,0.0,1.3818343596977407
280,1562443200,226,53,0,279,27,0.0,0.3222955112019073
280,1562457600,83,65,0,148,27,0.0,-0.5189141200281181
280,1562472000,23,13,0,36,27,0.0,-1.2381162474919565
280,1562486400,63,9,0,72,27,0.0,-1.0069441350928656
280,1562500800,262,39,0,301,27,0.0,0.46356735766801843
280,1562515200,352,77,0,429,27,0.0,1.2855126461981197
280,1562529600,210,55,0,265,27,0.0,0.2323952452689275
280,1562544000,87,34,0,121,27,0.0,-0.6922932043274362
280,1562558400,18,8,0,26,27,0.0,-1.3023307231583707
280,1562572800,256,13,0,269,27,0.0,0.25808103553549316
280,1562587200,516,47,0,563,27,0.0,2.145986620128069
280,1562601600,235,52,0,287,27,0.0,0.37366709173503865
280,1562616000,209,93,0,302,27,0.0,0.46998880523465986
280,1562630400,40,40,0,80,28,-0.21905397716916175,-0.9448860296932672
280,1562644800,9,5,0,14,28,-0.21905397716916175,-1.2893847899602324
280,1562659200,270,12,0,282,28,-0.21905397716916175,0.10948896385108098
280,1562673600,558,43,0,601,28,-0.21905397716916175,1.7745663051414131
280,1562688000,240,57,0,297,28,-0.21905397716916175,0.18778413663902763
280,1562702400,259,106,0,365,28,-0.21905397716916175,0.5427222532777191
280,1562716800,52,34,0,86,28,-0.21905397716916175,-0.9135679605780885
280,1562731200,11,9,0,20,28,-0.21905397716916175,-1.2580667208450538
280,1562745600,301,13,0,314,28,-0.21905397716916175,0.2765186657987005
280,1562760000,582,50,0,632,28,-0.21905397716916175,1.9363763289031695
280,1562774400,274,39,0,313,28,-0.21905397716916175,0.2712989876128374
280,1562788800,223,101,0,324,28,-0.21905397716916175,0.32871544765733157
280,1562803200,57,46,0,103,28,-0.21905397716916175,-0.8248334314184157
280,1562817600,5,2,0,7,28,-0.21905397716916175,-1.3259225372612742
280,1562832000,270,11,0,281,28,-0.21905397716916175,0.10426928566521787
280,1562846400,619,78,0,697,28,-0.21905397716916175,2.2756554109842715
280,1562860800,245,62,0,307,28,-0.21905397716916175,0.23998091849765874
280,1562875200,214,75,0,289,28,-0.21905397716916175,0.14602671115212273
280,1562889600,54,47,0,101,28,-0.21905397716916175,-0.8352727877901419
280,1562904000,6,8,2,14,28,3.4610528392727558,-1.2893847899602324
280,1562918400,243,16,0,259,28,-0.21905397716916175,-0.01056363442377055
280,1562932800,523,60,0,583,28,-0.21905397716916175,1.680612097795877
280,1562947200,287,60,0,347,28,-0.21905397716916175,0.4487680459321831
280,1562961600,273,79,0,352,28,-0.21905397716916175,0.47486643686149865
280,1562976000,64,46,0,110,28,-0.21905397716916175,-0.7882956841173739
280,1562990400,19,10,0,29,28,-0.21905397716916175,-1.2110896171722858
280,1563004800,91,6,0,97,28,-0.21905397716916175,-0.8561515005335943
280,1563019200,353,81,0,434,28,-0.21905397716916175,0.9028800481022737
280,1563033600,405,116,0,521,28,-0.21905397716916175,1.3569920502723642
280,1563048000,263,77,0,340,28,-0.21905397716916175,0.41223029863114136
280,1563062400,0,3,3,3,28,5.301106247493714,-1.3468012500047266
280,1563076800,9,5,0,14,28,-0.21905397716916175,-1.2893847899602324
280,1563091200,73,7,0,80,28,-0.21905397716916175,-0.9448860296932672
280,1563105600,269,48,0,317,28,-0.21905397716916175,0.2921777003562898
280,1563120000,335,88,0,423,28,-0.21905397716916175,0.8454635880577794
280,1563134400,226,41,0,267,28,-0.21905397716916175,0.03119379106313433
280,1563148800,78,40,0,118,28,-0.21905397716916175,-0.7465382586304691
280,1563163200,19,6,0,25,28,-0.21905397716916175,-1.2319683299157382
280,1563177600,285,14,0,299,28,-0.21905397716916175,0.19822349301075384
280,1563192000,542,59,0,601,28,-0.21905397716916175,1.7745663051414131
280,1563206400,255,64,0,319,28,-0.21905397716916175,0.30261705672801603
280,1563220800,214,84,0,298,28,-0.21905397716916175,0.19300381482489073
280,1563235200,73,32,0,105,29,0.0,-0.8156347800204967
280,1563249600,11,8,0,19,29,0.0,-1.3156471400737952
280,1563264000,279,14,0,293,29,0.0,0.27741549544485333
280,1563278400,573,69,0,642,29,0.0,2.3065354217076575
280,1563292800,246,73,0,319,29,0.0,0.4285820229028273
280,1563307200,223,101,0,324,29,0.0,0.45765250895243764
280,1563321600,59,41,0,100,29,0.0,-0.8447052660701071
280,1563336000,14,2,0,16,29,0.0,-1.3330894317035615
280,1563350400,275,12,0,287,29,0.0,0.24253091218532088
280,1563364800,554,47,0,601,29,0.0,2.0681574361008526
280,1563379200,221,55,0,276,29,0.0,0.17857584287617806
280,1563393600,222,87,0,309,29,0.0,0.37044105080360656
280,1563408000,51,37,0,88,29,0.0,-0.914474432589172
280,1563422400,17,8,0,25,29,0.0,-1.2807625568142629
280,1563436800,280,14,0,294,29,0.0,0.28322959265477543
280,1563451200,564,40,0,604,29,0.0,2.0855997277306186
280,1563465600,240,39,0,279,29,0.0,0.1960181345059443
280,1563480000,209,110,0,319,29,0.0,0.4285820229028273
280,1563494400,56,49,0,105,29,0.0,-0.8156347800204967
280,1563508800,15,5,0,20,29,0.0,-1.3098330428638731
280,1563523200,227,14,0,241,29,0.0,-0.02491755947109456
280,1563537600,516,63,0,579,29,0.0,1.9402472974825669
280,1563552000,260,63,0,323,29,0.0,0.4518384117425156
280,1563566400,291,84,0,375,29,0.0,0.7541714666584635
280,1563580800,76,54,0,130,29,0.0,-0.6702823497724449
280,1563595200,21,9,0,30,29,0.0,-1.2516920707646524
280,1563609600,121,8,0,129,29,0.0,-0.6760964469823669
280,1563624000,306,48,0,354,29,0.0,0.6320754252501
280,1563638400,297,74,0,371,29,0.0,0.7309150778187752
280,1563652800,196,43,0,239,29,0.0,-0.03654575389093871
280,1563667200,78,33,0,111,29,0.0,-0.7807501967609644
280,1563681600,15,3,0,18,29,0.0,-1.3214612372837173
280,1563696000,84,6,0,90,29,0.0,-0.9028462381693279
280,1563710400,238,30,0,268,29,0.0,0.13206306519680147
280,1563724800,264,59,0,323,29,0.0,0.4518384117425156
280,1563739200,159,44,0,203,29,0.0,-0.2458532534481334
280,1563753600,65,32,0,97,29,0.0,-0.8621475576998734
280,1563768000,12,8,0,20,29,0.0,-1.3098330428638731
280,1563782400,280,11,0,291,29,0.0,0.2657873010250092
280,1563796800,531,27,0,558,29,0.0,1.8181512560742032
280,1563811200,237,54,0,291,29,0.0,0.2657873010250092
280,1563825600,181,55,0,236,29,0.0,-0.053988045520704936
280,1563840000,30,33,3,63,30,3.761230270384033,-1.0957691910335428
280,1563854400,8,5,0,13,30,-0.22124883943435486,-1.3760853441789245
280,1563868800,256,16,0,272,30,-0.22124883943435486,0.07595232911415341
280,1563883200,554,37,0,591,30,-0.22124883943435486,1.8643693861816897
280,1563897600,212,53,0,265,30,-0.22124883943435486,0.03670806767379994
280,1563912000,233,87,0,320,30,-0.22124883943435486,0.34505583613372
280,1563926400,52,32,0,84,30,-0.22124883943435486,-0.9780364067124824
280,1563940800,10,6,0,16,30,-0.22124883943435486,-1.3592663749902016
280,1563955200,277,11,0,288,30,-0.22124883943435486,0.1656534981206756
280,1563969600,559,46,0,605,30,-0.22124883943435486,1.9428579090623965
280,1563984000,239,55,0,294,30,-0.22124883943435486,0.19929143649812142
280,1563998400,244,75,0,319,30,-0.22124883943435486,0.33944951307081234
280,1564012800,75,52,0,127,30,-0.22124883943435486,-0.736964515007454
280,1564027200,21,4,0,25,30,-0.22124883943435486,-1.308809467424033
280,1564041600,256,11,0,267,30,-0.22124883943435486,0.04792071379961522
280,1564056000,565,42,0,607,30,-0.22124883943435486,1.9540705551882118
280,1564070400,259,71,0,330,30,-0.22124883943435486,0.40111906676279635
280,1564084800,221,81,0,302,30,-0.22124883943435486,0.24414202100138252
280,1564099200,62,45,0,107,30,-0.22124883943435486,-0.8490909762656067
280,1564113600,12,5,0,17,30,-0.22124883943435486,-1.353660051927294
280,1564128000,241,15,0,256,30,-0.22124883943435486,-0.013748839892368789
280,1564142400,495,65,0,560,30,-0.22124883943435486,1.690573371231553
280,1564156800,291,67,0,358,30,-0.22124883943435486,0.5580961125242102
280,1564171200,310,93,0,403,30,-0.22124883943435486,0.8103806503550538
280,1564185600,74,47,0,121,30,-0.22124883943435486,-0.7706024533848997
280,1564200000,15,8,0,23,30,-0.22124883943435486,-1.3200221135498482
280,1564214400,92,5,0,97,30,-0.22124883943435486,-0.9051542068946831
280,1564228800,334,72,0,406,30,-0.22124883943435486,0.8271996195437767
280,1564243200,422,83,0,505,30,-0.22124883943435486,1.3822256027716329
280,1564257600,302,42,0,344,30,-0.22124883943435486,0.47960758964350325
280,1564272000,103,43,0,146,30,-0.22124883943435486,-0.6304443768122089
280,1564286400,12,16,4,28,30,5.088723306990162,-1.29199049823531
280,1564300800,76,13,0,89,30,-0.22124883943435486,-0.9500047913979441
280,1564315200,266,42,0,308,30,-0.22124883943435486,0.2777799593788283
280,1564329600,347,85,0,432,30,-0.22124883943435486,0.9729640191793754
280,1564344000,219,60,0,279,30,-0.22124883943435486,0.11519659055450686
280,1564358400,74,30,0,104,30,-0.22124883943435486,-0.8659099454543296
280,1564372800,14,7,0,21,30,-0.22124883943435486,-1.3312347596756635
280,1564387200,252,13,0,265,30,-0.22124883943435486,0.03670806767379994
280,1564401600,528,48,0,576,30,-0.22124883943435486,1.780274540238075
280,1564416000,238,59,0,297,30,-0.22124883943435486,0.21611040568684434
280,1564430400,211,114,0,325,30,-0.22124883943435486,0.37308745144825817
280,1564444800,53,35,0,88,31,0.0,-0.9397780802342379
280,1564459200,14,6,0,20,31,0.0,-1.24756813179801
280,1564473600,277,13,0,290,31,0.0,-0.025460574118326737
280,1564488000,544,43,0,587,31,0.0,1.3188577393293248
280,1564502400,283,59,0,342,31,0.0,0.20990828884220486
280,1564516800,372,89,0,461,31,0.0,0.7485408790788061
280,1564531200,55,50,0,105,31,0.0,-0.8628305673432949
280,1564545600,10,7,0,17,31,0.0,-1.2611471046611176
280,1564560000,268,11,0,279,31,0.0,-0.07525014128305457
280,1564574400,566,34,0,600,31,0.0,1.3776999550694577
280,1564588800,236,52,0,288,31,0.0,-0.0345132226937318
280,1564603200,188,96,0,284,31,0.0,-0.05261851984454192
280,1564617600,50,38,0,88,31,0.0,-0.9397780802342379
280,1564632000,6,6,0,12,31,0.0,-1.2837787260996303
280,1564646400,273,11,0,284,31,0.0,-0.05261851984454192
280,1564660800,570,44,0,614,31,0.0,1.4410684950972932
280,1564675200,253,65,0,318,31,0.0,0.10127650593734412
280,1564689600,232,108,0,340,31,0.0,0.2008556402667998
280,1564704000,60,40,0,100,31,0.0,-0.8854621887818076
280,1564718400,18,4,0,22,31,0.0,-1.238515483222605
280,1564732800,219,12,0,231,31,0.0,-0.2925137070927761
280,1564747200,472,29,0,501,31,0.0,0.9295938505869072
280,1564761600,743,137,0,880,31,0.0,2.6450707556261666
280,1564776000,244,100,0,344,31,0.0,0.2189609374176099
280,1565395200,8957,2487,0,11444,32,0.0,4.113978254431383
280,1565409600,14,10,0,24,32,0.0,-0.3300366382132358
280,1565424000,65,8,0,73,32,0.0,-0.31096862334987446
280,1565438400,285,76,0,361,32,0.0,-0.1988953931325671
280,1565452800,334,110,0,444,32,0.0,-0.16659651081299587
280,1565467200,263,83,0,346,32,0.0,-0.20473254053971854
280,1565481600,94,51,0,145,32,0.0,-0.28295031579554764
280,1565496000,25,9,0,34,32,0.0,-0.3261452066084682
280,1565510400,50,10,0,60,32,0.0,-0.31602748443607237
280,1565524800,211,41,0,252,32,0.0,-0.24131199762453412
280,1565539200,291,87,0,378,32,0.0,-0.19227995940446216
280,1565553600,200,72,0,272,32,0.0,-0.2335291344149989
280,1565568000,55,31,0,86,32,0.0,-0.30590976226367655
280,1565582400,11,5,0,16,32,0.0,-0.3331497834970499
280,1565596800,270,60,0,330,32,0.0,-0.2109588311073467
280,1565611200,571,47,0,618,32,0.0,-0.09888560089003934
280,1565625600,345,76,0,421,32,0.0,-0.1755468035039614
280,1565640000,241,153,0,394,32,0.0,-0.18605366883683397
280,1565654400,51,78,27,129,33,5.3697069432997,-0.688639011709916
280,1565668800,10,6,0,16,33,-0.2887439986856734,-1.2691644385243928
280,1565683200,295,35,0,330,33,-0.2887439986856734,0.3439770129777815
280,1565697600,580,63,0,643,33,-0.2887439986856734,1.9519810713223054
280,1565712000,315,64,0,379,33,-0.2887439986856734,0.595709277702643
280,1565726400,240,200,0,440,33,-0.2887439986856734,0.9090902603193075
280,1565740800,45,54,9,99,33,1.597406315309451,-0.8427608064394231
280,1565755200,9,4,0,13,33,-0.2887439986856734,-1.2845766179973435
280,1565769600,277,16,0,293,33,-0.2887439986856734,0.15389346614472274
280,1565784000,590,48,0,638,33,-0.2887439986856734,1.9262941055340543
280,1565792973,156,40,0,196,33,-0.2887439986856734,-0.34443367014735016
280,1565793050,1,1,0,2,33,-0.2887439986856734,-1.3410879427314961
280,1565793140,4,0,0,4,33,-0.2887439986856734,-1.3308131564161956
280,1565798400,115,34,0,149,33,-0.2887439986856734,-0.5858911485569113
280,1565812800,250,156,0,406,33,-0.2887439986856734,0.7344188929591995
280,1565827200,51,61,10,112,33,1.8069785724200205,-0.77597469538997
280,1565841600,8,10,2,18,33,0.13040051553546542,-1.2588896522090922
280,1565856000,260,11,0,271,33,-0.2887439986856734,0.040870816676417544
280,1565870400,591,64,0,655,33,-0.2887439986856734,2.013629789214108
280,1565884800,260,61,0,321,33,-0.2887439986856734,0.2977404745589294
280,1565899200,278,147,0,425,33,-0.2887439986856734,0.832029362954554
280,1565913600,58,72,14,130,33,2.645267600862298,-0.6835016185522658
280,1565928000,10,3,0,13,33,-0.2887439986856734,-1.2845766179973435
280,1565942400,242,14,0,256,33,-0.2887439986856734,-0.036190080688336
280,1565956800,536,68,0,604,33,-0.2887439986856734,1.7516227381739462
280,1565971200,287,74,0,361,33,-0.2887439986856734,0.5032362008649388
280,1565985600,275,111,0,386,33,-0.2887439986856734,0.6316710298061947
280,1566000000,72,54,0,126,33,-0.2887439986856734,-0.7040511911828667
280,1566014400,18,14,0,32,33,-0.2887439986856734,-1.1869661480019889
280,1566028800,95,7,0,102,33,-0.2887439986856734,-0.8273486269664724
280,1566043200,326,55,0,381,33,-0.2887439986856734,0.6059840640179436
280,1566057600,424,106,0,530,33,-0.2887439986856734,1.3714556445078288
280,1566072000,282,86,0,368,33,-0.2887439986856734,0.5391979529684905
280,1566086400,105,39,0,144,33,-0.2887439986856734,-0.6115781143451625
280,1566100800,22,6,0,28,33,-0.2887439986856734,-1.20751572063259
280,1566115200,80,10,0,90,33,-0.2887439986856734,-0.8889973448582752
280,1566129600,301,43,0,344,33,-0.2887439986856734,0.4159005171848848
280,1566144000,375,98,0,473,33,-0.2887439986856734,1.0786242345217654
280,1566158400,217,80,0,297,33,-0.2887439986856734,0.1744430387753237
280,1566172800,66,27,0,93,33,-0.2887439986856734,-0.8735851653853245
280,1566187200,13,3,0,16,33,-0.2887439986856734,-1.2691644385243928
280,1566201600,266,20,0,286,33,-0.2887439986856734,0.11793171404117109
280,1566216000,536,31,0,567,33,-0.2887439986856734,1.5615391913408876
280,1566230400,235,68,0,303,33,-0.2887439986856734,0.2052673977212251
280,1566244800,217,151,0,368,33,-0.2887439986856734,0.5391979529684905
280,1566259200,56,64,8,120,34,3.7217098211236324,-0.8619825336816344
280,1566273600,11,4,0,15,34,-0.2734802743956663,-1.421744420522454
280,1566288000,271,26,0,297,34,-0.2734802743956663,0.081616075564319
280,1566302400,601,53,0,654,34,-0.2734802743956663,1.9848064908231065
280,1566316800,265,60,0,325,34,-0.2734802743956663,0.23088591205520428
280,1566331200,237,149,0,386,34,-0.2734802743956663,0.5560809129817758
280,1566345600,50,48,0,98,34,-0.2734802743956663,-0.9792659766387586
280,1566360000,16,10,0,26,34,-0.2734802743956663,-1.3631026990438921
280,1566374400,245,19,0,264,34,-0.2734802743956663,-0.09430908887136721
280,1566388800,513,71,0,584,34,-0.2734802743956663,1.6116318995958931
280,1566403200,256,81,0,337,34,-0.2734802743956663,0.29485869912272655
280,1566417600,236,145,0,381,34,-0.2734802743956663,0.5294255850369749
280,1566432000,44,53,9,97,34,4.221108583063545,-0.9845970422277187
280,1566446400,9,2,0,11,34,-0.2734802743956663,-1.443068682878295
280,1566460800,282,24,0,306,34,-0.2734802743956663,0.1295956658649607
280,1566475200,581,52,0,633,34,-0.2734802743956663,1.8728541134549423
280,1566489600,240,55,0,295,34,-0.2734802743956663,0.07095394438639863
280,1566504000,264,146,0,410,34,-0.2734802743956663,0.6840264871168203
280,1566518400,55,61,6,116,34,2.722912297243808,-0.8833067960374751
280,1566532800,8,7,0,15,34,-0.2734802743956663,-1.421744420522454
280,1566547200,228,15,0,243,34,-0.2734802743956663,-0.20626146623953118
280,1566561600,511,51,0,562,34,-0.2734802743956663,1.494348456638769
280,1566576000,266,69,0,335,34,-0.2734802743956663,0.2841965679448062
280,1566590400,249,115,0,364,34,-0.2734802743956663,0.43879747002465164
280,1566604800,84,62,0,146,34,-0.2734802743956663,-0.7233748283686695
280,1566619200,14,7,0,21,34,-0.2734802743956663,-1.389758026988693
280,1566633600,106,8,0,114,34,-0.2734802743956663,-0.8939689272153956
280,1566648000,347,90,0,437,34,-0.2734802743956663,0.8279652580187454
280,1566662400,453,128,0,581,34,-0.2734802743956663,1.5956387028290127
280,1566676800,298,85,0,383,34,-0.2734802743956663,0.5400877162148953
280,1566691200,104,77,0,181,34,-0.2734802743956663,-0.5367875327550629
280,1566705600,26,12,0,38,34,-0.2734802743956663,-1.29912991197637
280,1566720000,75,11,0,86,34,-0.2734802743956663,-1.0432387637062808
280,1566734400,283,55,0,338,34,-0.2734802743956663,0.30018976471168674
280,1566748800,365,111,0,476,34,-0.2734802743956663,1.0358768159881928
280,1566763200,287,84,0,371,34,-0.2734802743956663,0.47611492914737297
280,1566777600,92,50,0,142,34,-0.2734802743956663,-0.7446990907245102
280,1566792000,21,7,0,28,34,-0.2734802743956663,-1.3524405678659717
280,1566806400,285,19,0,304,34,-0.2734802743956663,0.11893353468704032
280,1566820800,551,43,0,594,34,-0.2734802743956663,1.664942555485495
280,1566835200,275,81,0,356,34,-0.2734802743956663,0.3961489453129701
280,1566849600,219,142,0,361,34,-0.2734802743956663,0.4228042732577711
280,1566864000,69,69,0,138,35,-0.22217143437509065,-0.6504928628890092
280,1566878400,15,8,0,23,35,-0.22217143437509065,-1.289346162554303
280,1566892800,328,21,0,349,35,-0.22217143437509065,0.5216640608447035
280,1566907200,607,51,0,658,35,-0.22217143437509065,2.2382351008149275
280,1566921600,257,54,0,311,35,-0.22217143437509065,0.31056470965095434
280,1566936000,231,140,0,371,35,-0.22217143437509065,0.6438794746937162
280,1566950400,62,62,0,124,35,-0.22217143437509065,-0.7282663080656536
280,1566964800,16,10,0,26,35,-0.22217143437509065,-1.2726804243021648
280,1566979200,339,31,0,370,35,-0.22217143437509065,0.6383242286096702
280,1566993600,612,48,0,660,35,-0.22217143437509065,2.2493455929830195
280,1567008000,246,73,0,319,35,-0.22217143437509065,0.35500667832332256
280,1567022400,239,155,0,394,35,-0.22217143437509065,0.771650134626775
280,1567036800,57,63,6,120,35,5.998628728127448,-0.7504872924018378
280,1567051200,11,9,0,20,35,-0.22217143437509065,-1.306011900806441
280,1567065600,324,26,0,350,35,-0.22217143437509065,0.5272193069287496
280,1567080000,578,55,0,633,35,-0.22217143437509065,2.0993539487137767
280,1567094400,282,78,0,360,35,-0.22217143437509065,0.5827717677692099
280,1567108800,233,137,0,370,35,-0.22217143437509065,0.6383242286096702
280,1567123200,69,71,2,140,35,1.8514286197924223,-0.6393823707209172
280,1567137600,20,13,0,33,35,-0.22217143437509065,-1.2337937017138425
280,1567152000,258,31,0,289,35,-0.22217143437509065,0.18834929580194162
280,1567166400,478,46,0,524,35,-0.22217143437509065,1.4938321255527593
280,1567180800,322,104,0,426,35,-0.22217143437509065,0.949418009316248
280,1567195200,306,112,0,418,35,-0.22217143437509065,0.9049760406438797
280,1567209600,86,61,0,147,35,-0.22217143437509065,-0.6004956481325949
280,1567224000,10,11,1,21,35,0.8146285927086658,-1.300456654722395
280,1567238400,72,5,0,77,35,-0.22217143437509065,-0.9893628740158171
280,1567252800,243,55,0,298,35,-0.22217143437509065,0.2383465105583559
280,1567267200,303,118,0,421,35,-0.22217143437509065,0.9216417788960178
280,1567281600,241,102,0,343,35,-0.22217143437509065,0.48833258434042737
280,1567296000,72,46,0,118,35,-0.22217143437509065,-0.7615977845699299
280,1567310400,14,9,0,23,35,-0.22217143437509065,-1.289346162554303
280,1567324800,59,10,0,69,35,-0.22217143437509065,-1.0338048426881854
280,1567339200,196,53,0,249,35,-0.22217143437509065,-0.03386054755989966
280,1567353600,299,97,0,396,35,-0.22217143437509065,0.782760626794867
280,1567368000,234,67,0,301,35,-0.22217143437509065,0.255012248810494
280,1567382400,47,40,0,87,35,-0.22217143437509065,-0.9338104131753568
280,1567396800,10,4,0,14,35,-0.22217143437509065,-1.3393433773107173
280,1567411200,54,8,0,62,35,-0.22217143437509065,-1.0726915652765077
280,1567425600,149,39,0,188,35,-0.22217143437509065,-0.3727305586867076
280,1567440000,206,50,0,256,35,-0.22217143437509065,0.005026175028422563
280,1567454400,156,62,0,218,35,-0.22217143437509065,-0.20607317616532667
280,1567468800,36,45,9,81,36,4.690173860645155,-1.0316697189174688
280,1567483200,10,3,0,13,36,-0.3038704191403903,-1.3563114903176772
280,1567497600,352,15,0,367,36,-0.3038704191403903,0.3337353784422311
280,1567512000,606,84,0,690,36,-0.3038704191403903,1.8757837925932208
280,1567526400,258,67,0,325,36,-0.3038704191403903,0.13322134316563183
280,1567540800,228,164,0,392,36,-0.3038704191403903,0.4530889708687783
280,1567555200,56,60,4,116,36,1.9157048163198518,-0.8645746895203027
280,1567569600,8,7,0,15,36,-0.3038704191403903,-1.3467632029235534
280,1567584000,360,33,0,393,36,-0.3038704191403903,0.45786311456584017
280,1567598400,632,52,0,684,36,-0.3038704191403903,1.8471389304108494
280,1567612800,289,74,0,363,36,-0.3038704191403903,0.31463880365398356
280,1567627200,234,182,0,416,36,-0.3038704191403903,0.5676684195982636
280,1567641600,61,60,0,121,36,-0.3038704191403903,-0.8407039710349933
280,1567656000,10,4,0,14,36,-0.3038704191403903,-1.3515373466206153
280,1567670400,398,38,0,436,36,-0.3038704191403903,0.6631512935395013
280,1567684800,618,33,0,651,36,-0.3038704191403903,1.6895921884078071
280,1567699200,274,91,0,365,36,-0.3038704191403903,0.32418709104810733
280,1567713600,294,162,0,456,36,-0.3038704191403903,0.7586341674807391
280,1567728000,61,67,6,128,36,3.0254924340499727,-0.80728496515556
280,1567742400,12,4,0,16,36,-0.3038704191403903,-1.3419890592264914
280,1567756800,380,30,0,410,36,-0.3038704191403903,0.5390235574158923
280,1567771200,620,62,0,682,36,-0.3038704191403903,1.8375906430167257
280,1567785600,304,113,0,417,36,-0.3038704191403903,0.5724425632953255
280,1567800000,257,167,0,424,36,-0.3038704191403903,0.6058615691747588
280,1567814400,58,54,0,112,36,-0.3038704191403903,-0.8836712643085503
280,1567828800,12,9,0,21,36,-0.3038704191403903,-1.318118340741182
280,1567843200,61,5,0,66,36,-0.3038704191403903,-1.103281874373397
280,1567857600,290,78,0,368,36,-0.3038704191403903,0.338509522139293
280,1567872000,314,113,0,427,36,-0.3038704191403903,0.6201840002659443
280,1567886400,252,101,0,353,36,-0.3038704191403903,0.26689736668336467
280,1567900800,95,45,0,140,36,-0.3038704191403903,-0.7499952407908174
280,1567915200,13,11,0,24,36,-0.3038704191403903,-1.3037959096499963
280,1567929600,52,11,0,63,36,-0.3038704191403903,-1.1176043054645828
280,1567944000,217,30,0,247,36,-0.3038704191403903,-0.23916186520519542
280,1567958400,284,102,0,386,36,-0.3038704191403903,0.424444108686407
280,1567972800,192,90,0,282,36,-0.3038704191403903,-0.07206683580802935
280,1567987200,44,48,4,92,36,1.9157048163198518,-0.979154138249788
280,1568001600,10,3,0,13,36,-0.3038704191403903,-1.3563114903176772
280,1568016000,431,25,0,456,36,-0.3038704191403903,0.7586341674807391
280,1568030400,625,61,0,686,36,-0.3038704191403903,1.8566872178049734
280,1568044800,255,83,0,338,36,-0.3038704191403903,0.19528521122743636
280,1568059200,250,179,0,429,36,-0.3038704191403903,0.6297322876600682
280,1568073600,53,78,25,131,37,3.041591744765977,-0.963082936723813
280,1568088000,16,5,0,21,37,-0.2955778811528066,-1.4682996016112906
280,1568102400,453,35,0,488,37,-0.2955778811528066,0.6765747847746372
280,1568116800,658,43,0,701,37,-0.2955778811528066,1.654857963147662
280,1568131200,278,93,0,371,37,-0.2955778811528066,0.13920796848522918
280,1568145600,270,153,0,423,37,-0.2955778811528066,0.37803766461385496
280,1568160000,64,70,6,134,37,0.5053428290677014,-0.9493043004087
280,1568174400,11,5,0,16,37,-0.2955778811528066,-1.4912639954698124
280,1568188800,442,31,0,473,37,-0.2955778811528066,0.607681603199072
280,1568203200,629,49,0,678,37,-0.2955778811528066,1.5492217513984623
280,1568217600,296,85,0,381,37,-0.2955778811528066,0.1851367562022726
280,1568232000,253,171,0,424,37,-0.2955778811528066,0.3826305433855593
280,1568246400,60,95,35,155,37,4.376459595133491,-0.8528538462029087
280,1568260800,8,7,0,15,37,-0.2955778811528066,-1.4958568742415166
280,1568275200,414,39,0,453,37,-0.2955778811528066,0.5158240277649853
280,1568289600,638,48,0,686,37,-0.2955778811528066,1.585964781572097
280,1568304000,314,87,0,401,37,-0.2955778811528066,0.27699433163635945
280,1568318400,255,161,0,416,37,-0.2955778811528066,0.34588751321192457
280,1568332800,46,72,26,118,37,3.1750785298027284,-1.0227903607559694
280,1568347200,9,10,1,19,37,-0.1620910961160552,-1.4774853591546993
280,1568361600,395,29,0,424,37,-0.2955778811528066,0.3826305433855593
280,1568376000,621,48,0,669,37,-0.2955778811528066,1.5078858424531232
280,1568390400,318,90,0,408,37,-0.2955778811528066,0.30914448303828984
280,1568404800,321,177,0,498,37,-0.2955778811528066,0.7225035724916806
280,1568419200,92,74,0,166,37,-0.2955778811528066,-0.8023321797141609
280,1568433600,23,18,0,41,37,-0.2955778811528066,-1.3764420261772037
280,1568448000,119,16,0,135,37,-0.2955778811528066,-0.9447114216369956
280,1568462400,429,84,0,513,37,-0.2955778811528066,0.7913967540672457
280,1568476800,466,146,0,612,37,-0.2955778811528066,1.2460917524659756
280,1568491200,397,125,0,522,37,-0.2955778811528066,0.8327326630125849
280,1568505600,129,90,0,219,37,-0.2955778811528066,-0.5589096048138309
280,1568520000,23,6,0,29,37,-0.2955778811528066,-1.431556571437656
280,1568534400,89,7,0,96,37,-0.2955778811528066,-1.123833693733465
280,1568548800,357,67,0,424,37,-0.2955778811528066,0.3826305433855593
280,1568563200,420,127,0,547,37,-0.2955778811528066,0.9475546323051934
280,1568577600,252,120,0,372,37,-0.2955778811528066,0.1438008472569335
280,1568592000,75,50,0,125,37,-0.2955778811528066,-0.990640209354039
280,1568606400,18,10,0,28,37,-0.2955778811528066,-1.4361494502093601
280,1568620800,441,31,0,472,37,-0.2955778811528066,0.6030887244273677
280,1568635200,619,65,0,684,37,-0.2955778811528066,1.5767790240286883
280,1568649600,277,68,0,345,37,-0.2955778811528066,0.019793120420916268
280,1568664000,297,179,0,476,37,-0.2955778811528066,0.621460239514185
280,1568678400,44,77,33,121,38,3.6818892361285283,-0.919409781118514
280,1568692800,14,10,0,24,38,-0.3142724563336019,-1.3683700410102586
280,1568707200,440,21,0,461,38,-0.3142724563336019,0.6542653566463641
280,1568721600,631,34,0,665,38,-0.3142724563336019,1.598470439305291
280,1568736000,325,96,0,421,38,-0.3142724563336019,0.46912710514461375
280,1568750400,277,164,0,441,38,-0.3142724563336019,0.5616962308954889
280,1568764800,58,85,27,143,38,2.9553143829535955,-0.8175837427925513
280,1568779200,20,2,0,22,38,-0.3142724563336019,-1.377626953585346
280,1568793600,424,40,0,464,38,-0.3142724563336019,0.6681507255089955
280,1568808000,654,66,0,720,38,-0.3142724563336019,1.8530355351201977
280,1568822400,317,88,0,405,38,-0.3142724563336019,0.3950718045439136
280,1568836800,271,166,0,437,38,-0.3142724563336019,0.543182405745314
280,1568851200,53,87,34,140,38,3.802985044991017,-0.8314691116551826
280,1568865600,14,12,0,26,38,-0.3142724563336019,-1.3591131284351712
280,1568880000,437,29,0,466,38,-0.3142724563336019,0.6774076380840829
280,1568894400,648,47,0,695,38,-0.3142724563336019,1.7373241279316038
280,1568908800,306,80,0,386,38,-0.3142724563336019,0.3071311350805822
280,1568923200,318,180,0,498,38,-0.3142724563336019,0.8255182392854832
280,1568937600,48,61,13,109,38,1.2599730588787525,-0.9749512565690391
280,1568952000,15,8,0,23,38,-0.3142724563336019,-1.3729984972978024
280,1568966400,385,28,0,413,38,-0.3142724563336019,0.4320994548442637
280,1568980800,653,48,0,701,38,-0.3142724563336019,1.7650948656568664
280,1568995200,293,94,0,387,38,-0.3142724563336019,0.311759591368126
280,1569009600,308,156,0,464,38,-0.3142724563336019,0.6681507255089955
280,1569024000,76,64,0,140,38,-0.3142724563336019,-0.8314691116551826
280,1569038400,17,11,0,28,38,-0.3142724563336019,-1.3498562158600835
280,1569052800,58,9,0,67,38,-0.3142724563336019,-1.169346420645877
280,1569067200,301,79,0,380,38,-0.3142724563336019,0.27936039735531965
280,1569081600,387,106,0,493,38,-0.3142724563336019,0.8023759578477644
280,1569096000,270,96,0,366,38,-0.3142724563336019,0.214562009329707
280,1569110400,84,55,0,139,38,-0.3142724563336019,-0.8360975679427263
280,1569124800,14,11,0,25,38,-0.3142724563336019,-1.3637415847227148
280,1569139200,51,11,0,62,38,-0.3142724563336019,-1.1924887020835957
280,1569153600,242,54,0,296,38,-0.3142724563336019,-0.10942993079835613
280,1569168000,309,104,0,413,38,-0.3142724563336019,0.4320994548442637
280,1569182400,230,106,0,336,38,-0.3142724563336019,0.07570832070339423
280,1569196800,43,45,2,88,38,-0.0720808386086243,-1.072148838607458
280,1569211200,11,6,0,17,38,-0.3142724563336019,-1.400769235023065
280,1569225600,438,27,0,465,38,-0.3142724563336019,0.6727791817965392
280,1569240000,620,42,0,662,38,-0.3142724563336019,1.5845850704426596
280,1569254400,277,72,0,349,38,-0.3142724563336019,0.1358782524414631
280,1569268800,265,202,0,467,38,-0.3142724563336019,0.6820360943716267
280,1569283200,56,45,0,101,39,-0.3077479960202456,-0.876654656855885
280,1569297600,10,10,0,20,39,-0.3077479960202456,-1.142819685202491
280,1569312000,451,29,0,480,39,-0.3077479960202456,0.368734796765889
280,1569326400,668,50,0,718,39,-0.3077479960202456,1.1507999417843116
280,1569340800,302,91,0,393,39,-0.3077479960202456,0.08285384039360844
280,1569355200,294,203,0,497,39,-0.3077479960202456,0.42459659283863344
280,1569369600,51,61,10,112,39,0.8672898069661468,-0.840508788808815
280,1569384000,10,2,0,12,39,-0.3077479960202456,-1.1691075892367235
280,1569398400,431,23,0,454,39,-0.3077479960202456,0.2832991086546327
280,1569412800,662,65,0,727,39,-0.3077479960202456,1.1803738338228233
280,1569427200,346,115,0,461,39,-0.3077479960202456,0.3063010246845863
280,1569441600,278,160,0,438,39,-0.3077479960202456,0.23072330058616733
280,1569456000,60,110,50,170,39,5.567441018911715,-0.6499214845606279
280,1569470400,8,4,0,12,39,-0.3077479960202456,-1.1691075892367235
280,1569484800,440,29,0,469,39,-0.3077479960202456,0.332588928718819
280,1569499200,645,58,0,703,39,-0.3077479960202456,1.1015101217201253
280,1569513600,316,79,0,395,39,-0.3077479960202456,0.0894258164021666
280,1569528000,274,170,0,444,39,-0.3077479960202456,0.25043922861184187
280,1569542400,66,87,21,153,39,2.159831390251178,-0.7057832806333724
280,1569556800,9,6,0,15,39,-0.3077479960202456,-1.1592496252238864
280,1569571200,402,28,0,430,39,-0.3077479960202456,0.20443539655193463
280,1569585600,608,57,0,665,39,-0.3077479960202456,0.97664257755752
280,1569600000,333,113,0,446,39,-0.3077479960202456,0.2570112046204
280,1569614400,323,182,0,505,39,-0.3077479960202456,0.45088449687286614
280,1569628800,76,85,9,161,39,0.7497860266675075,-0.6794953765991397
280,1569643200,13,25,12,38,39,1.1022973675634251,-1.0836719011254674
280,1569657600,66,9,0,75,39,-0.3077479960202456,-0.9620903449671412
280,1569672000,328,100,0,428,39,-0.3077479960202456,0.19786342054337647
280,1569686400,352,136,0,488,39,-0.3077479960202456,0.3950227008001217
280,1569700800,279,78,0,357,39,-0.3077479960202456,-0.0354417277604387
280,1569715200,77,54,0,131,39,-0.3077479960202456,-0.7780750167275123
280,1569729600,10,18,8,28,39,0.6322822463688683,-1.1165317811682582
280,1569744000,44,8,0,52,39,-0.3077479960202456,-1.0376680690655602
280,1569758400,230,227,0,457,39,-0.3077479960202456,0.29315707266747
280,1569772800,824,629,0,1453,39,-0.3077479960202456,3.5660011249294405
280,1569787200,1099,82,0,1181,39,-0.3077479960202456,2.672212387765529
280,1569801600,64,35,0,99,39,-0.3077479960202456,-0.8832266328644431
280,1569816000,12,4,0,16,39,-0.3077479960202456,-1.1559636372196074
280,1569830400,280,27,0,307,39,-0.3077479960202456,-0.19974112797439303
280,1569844800,538,44,0,582,39,-0.3077479960202456,0.7039055732023558
280,1569859200,294,80,0,374,39,-0.3077479960202456,0.02042006831230578
280,1569873600,246,154,0,400,39,-0.3077479960202456,0.10585575642356204
280,1569888000,56,49,0,105,40,-0.24505839978043809,-0.9418946300290665
280,1569902400,7,3,0,10,40,-0.24505839978043809,-1.3781796978043133
280,1569916800,309,26,0,335,40,-0.24505839978043809,0.11437448142679411
280,1569931200,591,59,0,650,40,-0.24505839978043809,1.5610039166815597
280,1569945600,298,89,0,387,40,-0.24505839978043809,0.3531831501037713
280,1569960000,266,160,0,426,40,-0.24505839978043809,0.5322896516115042
280,1569974400,56,60,4,116,40,0.4901167995608763,-0.8913774116550905
280,1569988800,6,7,1,13,40,-0.061264599945109514,-1.3644022746114108
280,1570003200,434,26,0,460,40,-0.24505839978043809,0.6884337811310662
280,1570017600,687,58,0,745,40,-0.24505839978043809,1.9972889844568065
280,1570032000,299,93,0,392,40,-0.24505839978043809,0.3761455220919422
280,1570046400,246,191,0,437,40,-0.24505839978043809,0.5828068699854801
280,1570060800,52,78,26,130,40,4.533580395938105,-0.8270827700882121
280,1570075200,6,4,0,10,40,-0.24505839978043809,-1.3781796978043133
280,1570089600,405,32,0,437,40,-0.24505839978043809,0.5828068699854801
280,1570104000,666,46,0,712,40,-0.24505839978043809,1.8457373293348787
280,1570118400,289,70,0,359,40,-0.24505839978043809,0.22459386697001435
280,1570132800,254,177,0,431,40,-0.24505839978043809,0.5552520235996751
280,1570147200,56,81,25,137,40,4.349786596102777,-0.7949354493047729
280,1570161600,9,3,0,12,40,-0.24505839978043809,-1.3689947490090448
280,1570176000,402,22,0,424,40,-0.24505839978043809,0.5231047028162359
280,1570190400,635,79,0,714,40,-0.24505839978043809,1.854922278130147
280,1570204800,331,82,0,413,40,-0.24505839978043809,0.4725874844422599
280,1570219200,343,150,0,493,40,-0.24505839978043809,0.839985436252994
280,1570233600,86,69,0,155,40,-0.24505839978043809,-0.7122709101473577
280,1570248000,11,11,0,22,40,-0.24505839978043809,-1.3230700050327031
280,1570262400,69,6,0,75,40,-0.24505839978043809,-1.0796688619580919
280,1570276800,305,87,0,392,40,-0.24505839978043809,0.3761455220919422
280,1570291200,318,128,0,446,40,-0.24505839978043809,0.6241391395641878
280,1570305600,275,127,0,402,40,-0.24505839978043809,0.42207026606828396
280,1570320000,81,60,0,141,40,-0.24505839978043809,-0.7765655517142361
280,1570334400,13,6,0,19,40,-0.24505839978043809,-1.3368474282256058
280,1570348800,38,12,0,50,40,-0.24505839978043809,-1.1944807218989462
280,1570363200,239,37,0,276,40,-0.24505839978043809,-0.1565815080336223
280,1570377600,294,150,0,444,40,-0.24505839978043809,0.6149541907689193
280,1570392000,161,85,0,246,40,-0.24505839978043809,-0.2943557399626476
280,1570406400,35,33,0,68,40,-0.24505839978043809,-1.111816182741531
280,1570420800,7,6,0,13,40,-0.24505839978043809,-1.3644022746114108
280,1570435200,426,27,0,453,40,-0.24505839978043809,0.6562864603476269
280,1570449600,606,47,0,653,40,-0.24505839978043809,1.5747813398744623
280,1570464000,293,85,0,378,40,-0.24505839978043809,0.3118508805250637
280,1570478400,261,182,0,443,40,-0.24505839978043809,0.6103617163712852
280,1570492800,49,70,21,119,41,2.0461409820320764,-0.48959263773134404
280,1570507200,6,9,3,15,41,0.044999219527225465,-0.9314398777335157
280,1570521600,425,35,0,460,41,-0.28852440755691633,0.9591564857373148
280,1570536000,641,54,0,695,41,-0.28852440755691633,1.957561306896068
280,1570550400,330,94,0,424,41,-0.28852440755691633,0.8062093641981016
280,1570564800,267,181,0,448,41,-0.28852440755691633,0.9081741118909105
280,1570579200,55,50,0,105,41,-0.28852440755691633,-0.5490720738854825
280,1570593600,10,6,0,16,41,-0.28852440755691633,-0.9271913465796486
280,1570608000,282,25,0,307,41,-0.28852440755691633,0.3091312191956585
280,1570622400,566,44,0,610,41,-0.28852440755691633,1.59643615881737
280,1570636800,256,86,0,342,41,-0.28852440755691633,0.4578298095810047
280,1570651200,216,145,0,361,41,-0.28852440755691633,0.5385519015044784
280,1570665600,53,62,9,115,41,0.7120464736955091,-0.5065867623468121
280,1570680000,7,7,0,14,41,-0.28852440755691633,-0.9356884088873827
280,1570694400,482,32,0,514,41,-0.28852440755691633,1.1885771680461348
280,1570708800,748,35,0,783,41,-0.28852440755691633,2.3314320484363673
280,1570723200,344,71,0,415,41,-0.28852440755691633,0.7679725838132982
280,1570737600,303,166,0,469,41,-0.28852440755691633,0.9973932661221182
280,1570752000,44,96,52,140,41,5.492551795234875,-0.4003734835001363
280,1570766400,17,7,0,24,41,-0.28852440755691633,-0.8932030973487123
280,1570780800,385,30,0,415,41,-0.28852440755691633,0.7679725838132982
280,1570795200,585,52,0,637,41,-0.28852440755691633,1.71114649997178
280,1570809600,333,105,0,438,41,-0.28852440755691633,0.86568880035224
280,1570824000,307,162,0,469,41,-0.28852440755691633,0.9973932661221182
280,1570838400,60,81,21,141,41,2.0461409820320764,-0.39612495234626927
280,1570852800,4,4,0,8,41,-0.28852440755691633,-0.9611795958105849
280,1570867200,0,0,0,0,41,-0.28852440755691633,-0.9951678450415211
280,1570881600,0,0,0,0,41,-0.28852440755691633,-0.9951678450415211
280,1570896000,0,2,2,2,41,-0.06617532283415513,-0.986670782733787
280,1570910400,0,0,0,0,41,-0.28852440755691633,-0.9951678450415211
280,1570924800,0,1,1,1,41,-0.17734986519553572,-0.9909193138876541
280,1570939200,0,0,0,0,41,-0.28852440755691633,-0.9951678450415211
280,1570953600,0,0,0,0,41,-0.28852440755691633,-0.9951678450415211
280,1570968000,0,0,0,0,41,-0.28852440755691633,-0.9951678450415211
280,1570982400,0,0,0,0,41,-0.28852440755691633,-0.9951678450415211
280,1570996800,1,0,0,1,41,-0.28852440755691633,-0.9909193138876541
280,1571011200,0,0,0,0,41,-0.28852440755691633,-0.9951678450415211
280,1571025600,0,0,0,0,41,-0.28852440755691633,-0.9951678450415211
280,1571040000,170,8,0,178,41,-0.28852440755691633,-0.23892929965318896
280,1571054400,444,43,0,487,41,-0.28852440755691633,1.0738668268917249
280,1571068800,294,66,0,360,41,-0.28852440755691633,0.5343033703506114
280,1571083200,224,101,0,325,41,-0.28852440755691633,0.38560477996526515
280,1571097600,51,44,0,95,42,-0.3196368966342414,-0.9947423429177606
280,1571112000,9,7,0,16,42,-0.3196368966342414,-1.3625331935753413
280,1571126400,355,16,0,371,42,-0.3196368966342414,0.2901978441897366
280,1571140800,642,52,0,694,42,-0.3196368966342414,1.793950309536554
280,1571155200,284,69,0,353,42,-0.3196368966342414,0.20639739720446504
280,1571169600,274,153,0,427,42,-0.3196368966342414,0.5509103459216925
280,1571184000,51,58,7,109,42,0.5669031751626168,-0.9295642174847716
280,1571198400,7,8,1,15,42,-0.19298831494897592,-1.3671887739634119
280,1571212800,366,15,0,381,42,-0.3196368966342414,0.336753648070443
280,1571227200,642,43,0,685,42,-0.3196368966342414,1.7520500860439183
280,1571241600,269,74,0,343,42,-0.3196368966342414,0.15984159332375864
280,1571256000,222,181,0,403,42,-0.3196368966342414,0.43917641660799717
280,1571270400,40,71,31,111,42,3.6064691356089873,-0.9202530567086303
280,1571284800,9,5,0,14,42,-0.3196368966342414,-1.3718443543514827
280,1571299200,410,28,0,438,42,-0.3196368966342414,0.6021217301904697
280,1571313600,658,56,0,714,42,-0.3196368966342414,1.8870619172979668
280,1571328000,332,99,0,431,42,-0.3196368966342414,0.5695326674739751
280,1571342400,283,157,0,440,42,-0.3196368966342414,0.6114328909666109
280,1571356800,58,93,35,151,42,4.113063462350049,-0.7340298411858046
280,1571371200,12,6,0,18,42,-0.3196368966342414,-1.3532220327992
280,1571385600,379,28,0,407,42,-0.3196368966342414,0.4577987381602797
280,1571400000,597,62,0,659,42,-0.3196368966342414,1.6310049959540815
280,1571414400,354,125,0,479,42,-0.3196368966342414,0.793000526101366
280,1571428800,332,143,0,475,42,-0.3196368966342414,0.7743782045490833
280,1571443200,63,88,25,151,42,2.8465776454973946,-0.7340298411858046
280,1571457600,12,16,4,28,42,0.18695743010682045,-1.3066662289184936
280,1571472000,74,5,0,79,42,-0.3196368966342414,-1.0692316291268908
280,1571486400,330,86,0,416,42,-0.3196368966342414,0.4996989616529155
280,1571500800,360,168,0,528,42,-0.3196368966342414,1.0211239651168273
280,1571515200,329,107,0,436,42,-0.3196368966342414,0.5928105694143283
280,1571529600,79,53,0,132,42,-0.3196368966342414,-0.8224858685591468
280,1571544000,9,12,3,21,42,0.06030884842155499,-1.339255291634988
280,1571558400,58,5,0,63,42,-0.3196368966342414,-1.1437209153360213
280,1571572800,249,64,0,313,42,-0.3196368966342414,0.020174181681639362
280,1571587200,293,102,0,395,42,-0.3196368966342414,0.401931773503432
280,1571601600,152,66,0,218,42,-0.3196368966342414,-0.42210595518507166
280,1571616000,34,28,0,62,42,-0.3196368966342414,-1.1483764957240918
280,1571630400,6,3,0,9,42,-0.3196368966342414,-1.3951222562918357
280,1571644800,389,27,0,416,42,-0.3196368966342414,0.4996989616529155
280,1571659200,586,52,0,638,42,-0.3196368966342414,1.533237807804598
280,1571673600,299,84,0,383,42,-0.3196368966342414,0.3460648088465843
280,1571688000,275,172,0,447,42,-0.3196368966342414,0.6440219536831054
280,1571702400,50,56,6,106,43,0.6368678453990311,-0.9338313548986846
280,1571716800,6,5,0,11,43,-0.2698592565250132,-1.3632409556876384
280,1571731200,391,16,0,407,43,-0.2698592565250132,0.42671906444315844
280,1571745600,609,53,0,662,43,-0.2698592565250132,1.5793448349819292
280,1571760000,282,91,0,373,43,-0.2698592565250132,0.27303562837132234
280,1571774400,260,154,0,414,43,-0.2698592565250132,0.45835977186971294
280,1571788800,42,59,17,101,43,2.299200865593112,-0.9564318602033665
280,1571803200,10,4,0,14,43,-0.2698592565250132,-1.3496806525048295
280,1571817600,419,26,0,445,43,-0.2698592565250132,0.59848290475874
280,1571832000,685,69,0,754,43,-0.2698592565250132,1.995194132588074
280,1571846400,330,94,0,424,43,-0.2698592565250132,0.5035607824790765
280,1571860800,253,163,0,416,43,-0.2698592565250132,0.46739997399158567
280,1571875200,54,56,2,110,43,0.032383110783001566,-0.9157509506549393
280,1571889600,13,2,0,15,43,-0.2698592565250132,-1.3451605514438931
280,1571904000,429,27,0,456,43,-0.2698592565250132,0.6482040164290399
280,1571918400,672,75,0,747,43,-0.2698592565250132,1.9635534251615194
280,1571932800,316,91,0,407,43,-0.2698592565250132,0.42671906444315844
280,1571947200,305,159,0,464,43,-0.2698592565250132,0.6843648249165307
280,1571961600,51,91,40,142,43,5.774988089635282,-0.7711077167049758
280,1571976000,9,4,0,13,43,-0.2698592565250132,-1.3542007535657659
280,1571990400,365,27,0,392,43,-0.2698592565250132,0.3589175485291131
280,1572004800,610,56,0,666,43,-0.2698592565250132,1.5974252392256747
280,1572019200,352,112,0,464,43,-0.2698592565250132,0.6843648249165307
280,1572033600,331,147,0,478,43,-0.2698592565250132,0.7476462397696397
280,1572048000,72,78,6,150,43,0.6368678453990311,-0.734946908217485
280,1572062400,11,13,2,24,43,0.032383110783001566,-1.3044796418954658
280,1572076800,74,7,0,81,43,-0.2698592565250132,-1.0468338814220937
280,1572091200,302,91,0,393,43,-0.2698592565250132,0.3634376495900495
280,1572105600,380,159,0,539,43,-0.2698592565250132,1.0233724044867574
280,1572120000,322,95,0,417,43,-0.2698592565250132,0.47192007505252204
280,1572134400,97,66,0,163,43,-0.2698592565250132,-0.6761855944253123
280,1572148800,14,14,0,28,43,-0.2698592565250132,-1.2863992376517204
280,1572163200,56,2,0,58,43,-0.2698592565250132,-1.1507962058236296
280,1572177600,211,33,0,244,43,-0.2698592565250132,-0.31005740848946756
280,1572192000,193,85,0,278,43,-0.2698592565250132,-0.15637397241763146
280,1572206400,159,84,0,243,43,-0.2698592565250132,-0.3145775095504039
280,1572220800,40,25,0,65,43,-0.2698592565250132,-1.1191554983970753
280,1572235200,5,7,2,12,43,0.032383110783001566,-1.358720854626702
280,1572249600,402,26,0,428,43,-0.2698592565250132,0.5216411867228219
280,1572264000,641,42,0,683,43,-0.2698592565250132,1.6742669572615927
280,1572278400,339,78,0,417,43,-0.2698592565250132,0.47192007505252204
280,1572292800,244,181,0,425,43,-0.2698592565250132,0.5080808835400129
280,1572307200,47,58,11,105,44,1.9807225557951291,-0.8870403222199131
280,1572321600,8,4,0,12,44,-0.3155562895261848,-1.286328283561362
280,1572336000,427,29,0,456,44,-0.3155562895261848,0.6199497254236203
280,1572350400,676,37,0,713,44,-0.3155562895261848,1.7233583927865492
280,1572364800,283,71,0,354,44,-0.3155562895261848,0.18202099362977295
280,1572379200,280,176,0,456,44,-0.3155562895261848,0.6199497254236203
280,1572393600,61,61,0,122,44,-0.3155562895261848,-0.8140522002542719
280,1572408000,10,3,0,13,44,-0.3155562895261848,-1.2820348646222068
280,1572422400,413,27,0,440,44,-0.3155562895261848,0.5512550223971344
280,1572436800,706,62,0,768,44,-0.3155562895261848,1.9594964344400945
280,1572451200,293,81,0,374,44,-0.3155562895261848,0.26788937241288024
280,1572465600,260,161,0,421,44,-0.3155562895261848,0.46968006255318245
280,1572480000,61,84,23,145,44,4.485754023418381,-0.7153035646536985
280,1572494400,10,5,0,15,44,-0.3155562895261848,-1.2734480267438961
280,1572508800,383,27,0,410,44,-0.3155562895261848,0.4224524542224734
280,1572523200,662,50,0,712,44,-0.3155562895261848,1.719064973847394
280,1572537600,275,65,0,340,44,-0.3155562895261848,0.12191312848159781
280,1572552000,255,183,0,438,44,-0.3155562895261848,0.5426681845188237
280,1572566400,61,66,5,127,44,0.7282068219835034,-0.7925851055584952
280,1572580800,6,5,0,11,44,-0.3155562895261848,-1.2906217025005176
280,1572595200,366,24,0,390,44,-0.3155562895261848,0.3365840754393661
280,1572609600,646,53,0,699,44,-0.3155562895261848,1.6632505276383742
280,1572624000,342,94,0,436,44,-0.3155562895261848,0.5340813466405129
280,1572638400,317,157,0,474,44,-0.3155562895261848,0.6972312663284168
280,1572652800,65,72,7,137,44,1.1457120665873788,-0.7496509161669415
280,1572667200,16,15,0,31,44,-0.3155562895261848,-1.2047533237174102
280,1572681600,61,4,0,65,44,-0.3155562895261848,-1.0587770797861278
280,1572696000,295,74,0,369,44,-0.3155562895261848,0.24642227771710343
280,1572710400,381,141,0,522,44,-0.3155562895261848,0.9033153754078744
280,1572724800,310,96,0,406,44,-0.3155562895261848,0.405278778465852
280,1572739200,79,54,0,133,44,-0.3155562895261848,-0.7668245919235629
280,1572750000,12,6,0,18,44,-0.3155562895261848,-1.26056776992643
280,1572764400,31,3,0,34,44,-0.3155562895261848,-1.1918730668999442
280,1572778800,216,48,0,264,44,-0.3155562895261848,-0.20438671089420998
280,1572793200,350,91,0,441,44,-0.3155562895261848,0.5555484413362898
280,1572807600,262,99,0,361,44,-0.3155562895261848,0.2120749262038605
280,1572822000,63,53,0,116,44,-0.3155562895261848,-0.8398127138892041
280,1572836400,14,4,0,18,44,-0.3155562895261848,-1.26056776992643
280,1572850800,126,13,0,139,44,-0.3155562895261848,-0.7410640782886307
280,1572865200,851,43,0,894,44,-0.3155562895261848,2.5004672207736705
280,1572879600,258,81,0,339,44,-0.3155562895261848,0.11761970954244245
280,1572894000,330,192,0,522,44,-0.3155562895261848,0.9033153754078744
280,1572908400,70,89,19,159,44,3.6507435342106302,-0.6551956995055234
280,1572922800,10,10,0,20,45,-0.30946791060012785,-1.0328678700925877
280,1572937200,113,15,0,128,45,-0.30946791060012785,-0.6281785154463083
280,1572951600,808,55,0,863,45,-0.30946791060012785,2.125957370340872
280,1572966000,298,59,0,357,45,-0.30946791060012785,0.22991280134996955
280,1572980400,350,171,0,521,45,-0.30946791060012785,0.8444410806276532
280,1572994800,58,74,16,132,45,1.2780316002646501,-0.6131900208297794
280,1573009200,14,6,0,20,45,-0.30946791060012785,-1.0328678700925877
280,1573023600,124,10,0,134,45,-0.30946791060012785,-0.6056957735215149
280,1573038000,885,54,0,939,45,-0.30946791060012785,2.4107387680549204
280,1573052400,311,54,0,365,45,-0.30946791060012785,0.2598897905830273
280,1573066800,324,151,0,475,45,-0.30946791060012785,0.6720733925375713
280,1573081200,60,100,40,160,45,3.659280866561817,-0.5082705585140773
280,1573095600,0,0,0,0,45,-0.30946791060012785,-1.1078103431752322
280,1573110000,122,6,0,128,45,-0.30946791060012785,-0.6281785154463083
280,1573124400,892,58,0,950,45,-0.30946791060012785,2.451957128250375
280,1573138800,271,58,0,329,45,-0.30946791060012785,0.12499333903426744
280,1573153200,337,152,0,489,45,-0.30946791060012785,0.7245331236954222
280,1573167600,50,101,51,151,45,4.7506867802813515,-0.5419946714012672
280,1573182000,0,0,0,0,45,-0.30946791060012785,-1.1078103431752322
280,1573196400,111,14,0,125,45,-0.30946791060012785,-0.639419886408705
280,1573210800,813,71,0,884,45,-0.30946791060012785,2.2046469670776485
280,1573225200,289,72,0,361,45,-0.30946791060012785,0.2449012959664984
280,1573239600,366,165,0,531,45,-0.30946791060012785,0.8819123171689754
280,1573254000,76,88,12,164,45,0.8811567225484557,-0.4932820638975485
280,1573268400,18,12,0,30,45,-0.30946791060012785,-0.9953966335512656
280,1573282800,34,4,0,38,45,-0.30946791060012785,-0.9654196443182078
280,1573297200,221,43,0,264,45,-0.30946791060012785,-0.11856969848432669
280,1573311600,373,116,0,489,45,-0.30946791060012785,0.7245331236954222
280,1573326000,300,88,0,388,45,-0.30946791060012785,0.3460736346280683
280,1573340400,92,66,0,158,45,-0.30946791060012785,-0.5157648058223417
280,1573354800,14,19,5,33,45,0.18662568654511527,-0.984155262588869
280,1573369200,21,6,0,27,45,-0.30946791060012785,-1.0066380045136623
280,1573383600,188,30,0,218,45,-0.30946791060012785,-0.2909373865744087
280,1573398000,310,109,0,419,45,-0.30946791060012785,0.462234467906167
280,1573412400,245,94,0,339,45,-0.30946791060012785,0.16246457557558963
280,1573426800,43,34,0,77,45,-0.30946791060012785,-0.8192818218070513
280,1573441200,8,5,0,13,45,-0.30946791060012785,-1.0590977356715132
280,1573455600,82,15,0,97,45,-0.30946791060012785,-0.744339348724407
280,1573470000,664,59,0,723,45,-0.30946791060012785,1.601360058762361
280,1573484400,269,60,0,329,45,-0.30946791060012785,0.12499333903426744
280,1573498800,298,136,0,434,45,-0.30946791060012785,0.5184413227181502
280,1573513200,54,61,7,115,45,0.3850631254032125,-0.6768911229500271
280,1573527600,0,0,0,0,46,-0.3759454552023273,-1.0584004029972314
280,1573542000,134,14,0,148,46,-0.3759454552023273,-0.5229550619839011
280,1573556400,894,50,0,944,46,-0.3759454552023273,2.3568725829256327
280,1573570800,216,50,0,266,46,-0.3759454552023273,-0.09604593874354299
280,1573585200,316,181,0,497,46,-0.3759454552023273,0.7396829381083444
280,1573599600,45,86,41,131,46,2.3906275100045433,-0.5844589187219187
280,1573614000,0,0,0,0,46,-0.3759454552023273,-1.0584004029972314
280,1573628400,104,13,0,117,46,-0.3759454552023273,-0.6351091536826392
280,1573642800,924,33,0,957,46,-0.3759454552023273,2.4039049439605877
280,1573657200,316,86,0,402,46,-0.3759454552023273,0.39598491516059847
280,1573671600,302,142,0,444,46,-0.3759454552023273,0.5479356200427599
280,1573686000,53,109,56,162,46,3.402788350933886,-0.4723048270231806
280,1573700400,0,0,0,0,46,-0.3759454552023273,-1.0584004029972314
280,1573714800,110,12,0,122,46,-0.3759454552023273,-0.6170197840538104
280,1573729200,874,50,0,924,46,-0.3759454552023273,2.284515104410318
280,1573743600,256,55,0,311,46,-0.3759454552023273,0.0667583879159156
280,1573758000,347,132,0,479,46,-0.3759454552023273,0.6745612074445609
280,1573772400,56,97,41,153,46,2.3906275100045433,-0.5048656923550723
280,1573786800,0,4,4,4,46,-0.10603589762116923,-1.0439289072941684
280,1573801200,106,21,0,127,46,-0.3759454552023273,-0.5989304144249817
280,1573815600,838,55,0,893,46,-0.3759454552023273,2.1723610127115798
280,1573830000,285,57,0,342,46,-0.3759454552023273,0.17891247961465373
280,1573844400,352,137,0,489,46,-0.3759454552023273,0.7107399467022184
280,1573858800,85,108,23,193,46,1.1760345008893318,-0.3601507353244425
280,1573873200,14,11,0,25,46,-0.3759454552023273,-0.9679535548530878
280,1573887600,25,5,0,30,46,-0.3759454552023273,-0.9498641852242591
280,1573902000,207,29,0,236,46,-0.3759454552023273,-0.20458215651651537
280,1573916400,343,100,0,443,46,-0.3759454552023273,0.5443177461169941
280,1573930800,272,76,0,348,46,-0.3759454552023273,0.2006197231692482
280,1573945200,101,59,0,160,46,-0.3759454552023273,-0.4795405748747121
280,1573959600,15,26,11,41,46,0.3663058281458574,-0.9100675720408359
280,1573974000,24,5,0,29,46,-0.3759454552023273,-0.9534820591500248
280,1573988400,182,28,0,210,46,-0.3759454552023273,-0.29864687858642475
280,1574002800,291,94,0,385,46,-0.3759454552023273,0.3344810584225808
280,1574017200,206,81,0,287,46,-0.3759454552023273,-0.020070586302462314
280,1574031600,49,41,0,90,46,-0.3759454552023273,-0.7327917496783143
280,1574046000,7,5,0,12,46,-0.3759454552023273,-1.0149859158880425
280,1574060400,99,11,0,110,46,-0.3759454552023273,-0.6604342711629994
280,1574074800,846,43,0,889,46,-0.3759454552023273,2.157889517008517
280,1574089200,217,39,0,256,46,-0.3759454552023273,-0.13222467800120044
280,1574103600,299,194,0,493,46,-0.3759454552023273,0.7252114424052813
280,1574118000,40,98,58,138,46,3.537743129724465,-0.5591338012415585
280,1574132400,0,1,1,1,47,-0.24509568344381424,-1.0578821545327217
280,1574146800,108,9,0,117,47,-0.32744783308093584,-0.6362524214761592
280,1574161200,884,53,0,937,47,-0.32744783308093584,2.3442336225443694
280,1574175600,259,54,0,313,47,-0.32744783308093584,0.07615643782630854
280,1574190000,364,162,0,526,47,-0.32744783308093584,0.8503558614560311
280,1574204400,67,93,26,160,47,1.8137080574842255,-0.4799586411189852
280,1574218800,0,6,6,6,47,0.16666506474179368,-1.0397084591423527
280,1574233200,115,7,0,122,47,-0.32744783308093584,-0.6180787260857902
280,1574247600,888,55,0,943,47,-0.32744783308093584,2.366042057012812
280,1574262000,273,67,0,340,47,-0.32744783308093584,0.17429439293430155
280,1574276400,328,170,0,498,47,-0.32744783308093584,0.7485831672699643
280,1574290800,64,120,56,184,47,4.284272546597873,-0.3927249032452136
280,1574305200,0,2,2,2,47,-0.16274353380669268,-1.054247415454648
280,1574319600,105,16,0,121,47,-0.32744783308093584,-0.6217134651638639
280,1574334000,930,53,0,983,47,-0.32744783308093584,2.5114316201357645
280,1574348400,279,42,0,321,47,-0.32744783308093584,0.10523435045089907
280,1574362800,334,167,0,501,47,-0.32744783308093584,0.7594873845041858
280,1574377200,58,111,53,169,47,4.037216097686509,-0.4472459894163208
280,1574391600,0,0,0,0,47,-0.32744783308093584,-1.0615168936107955
280,1574406000,103,10,0,113,47,-0.32744783308093584,-0.6507913777884545
280,1574420400,814,37,0,851,47,-0.32744783308093584,2.031646061830021
280,1574434800,279,78,0,357,47,-0.32744783308093584,0.2360849572615564
280,1574449200,369,143,0,512,47,-0.32744783308093584,0.7994695143629977
280,1574463600,88,54,0,142,47,-0.32744783308093584,-0.5453839445243138
280,1574478000,13,13,0,26,47,-0.32744783308093584,-0.9670136775808764
280,1574492400,26,6,0,32,47,-0.32744783308093584,-0.9452052431124335
280,1574506800,237,37,0,274,47,-0.32744783308093584,-0.06559838621857024
280,1574521200,316,91,0,407,47,-0.32744783308093584,0.4178219111652472
280,1574535600,309,74,0,383,47,-0.32744783308093584,0.3305881732914756
280,1574550000,101,48,0,149,47,-0.32744783308093584,-0.5199407709777971
280,1574564400,17,22,5,39,47,0.08431291510467209,-0.9197620695659168
280,1574578800,17,4,0,21,47,-0.32744783308093584,-0.9851873729712455
280,1574593200,167,24,0,191,47,-0.32744783308093584,-0.3672817296986969
280,1574607600,247,55,0,302,47,-0.32744783308093584,0.03617430796749658
280,1574622000,181,65,0,246,47,-0.32744783308093584,-0.16737108040463708
280,1574636400,45,52,7,97,47,0.24901721437891527,-0.7089472030376355
280,1574650800,8,8,0,16,47,-0.32744783308093584,-1.0033610683616145
280,1574665200,109,5,0,114,47,-0.32744783308093584,-0.6471566387103806
280,1574679600,817,37,0,854,47,-0.32744783308093584,2.0425502790642427
280,1574694000,275,68,0,343,47,-0.32744783308093584,0.18519861016852301
280,1574708400,275,131,0,406,47,-0.32744783308093584,0.41418717208717337
280,1574722800,68,79,11,147,47,0.5784258129274016,-0.5272102491339448
280,1574737200,14,4,0,18,48,-0.2095610364460444,-0.976250847115535
280,1574751600,115,6,0,121,48,-0.2095610364460444,-0.48149204151316805
280,1574766000,796,41,0,837,48,-0.2095610364460444,2.9578021799557135
280,1574780400,233,52,0,285,48,-0.2095610364460444,0.3062792606109891
280,1574794800,293,155,0,448,48,-0.2095610364460444,1.0892470791856086
280,1574809200,82,77,0,159,48,-0.2095610364460444,-0.2989596666307414
280,1574823600,9,15,6,24,48,1.990829846237422,-0.9474299458183097
280,1574838000,98,7,0,105,48,-0.2095610364460444,-0.5583477783057688
280,1574852400,664,38,0,702,48,-0.2095610364460444,2.3093319007681448
280,1574866800,265,71,0,336,48,-0.2095610364460444,0.5512569216374038
280,1574881200,298,161,0,459,48,-0.2095610364460444,1.1420853982305217
280,1574895600,71,63,0,134,48,-0.2095610364460444,-0.41904675536918
280,1574910000,17,7,0,24,48,-0.2095610364460444,-0.9474299458183097
280,1574924400,45,9,0,54,48,-0.2095610364460444,-0.8033254393321835
280,1574938800,134,15,0,149,48,-0.2095610364460444,-0.3469945021261168
280,1574953200,207,57,0,264,48,-0.2095610364460444,0.20540610607070064
280,1574967600,151,38,0,189,48,-0.2095610364460444,-0.15485516014461512
280,1574982000,79,37,0,116,48,-0.2095610364460444,-0.5055094592608558
280,1574996400,14,7,0,21,48,-0.2095610364460444,-0.9618403964669224
280,1575010800,40,6,0,46,48,-0.2095610364460444,-0.8417533077284838
280,1575025200,256,26,0,282,48,-0.2095610364460444,0.29186880996237646
280,1575039600,287,56,0,343,48,-0.2095610364460444,0.5848813064841666
280,1575054000,258,74,0,332,48,-0.2095610364460444,0.5320429874392536
280,1575068400,79,55,0,134,48,-0.2095610364460444,-0.41904675536918
280,1575082800,11,6,0,17,48,-0.2095610364460444,-0.9810543306650725
280,1575097200,24,3,0,27,48,-0.2095610364460444,-0.9330194951696972
280,1575111600,158,29,0,187,48,-0.2095610364460444,-0.1644621272436902
280,1575126000,274,88,0,362,48,-0.2095610364460444,0.6761474939253799
280,1575140400,289,94,0,383,48,-0.2095610364460444,0.7770206484656683
280,1575154800,84,50,0,134,48,-0.2095610364460444,-0.41904675536918
280,1575169200,17,18,1,35,48,0.15717077733453333,-0.8945916267733968
280,1575183600,16,6,0,22,48,-0.2095610364460444,-0.9570369129173849
280,1575198000,132,19,0,151,48,-0.2095610364460444,-0.3373875350270418
280,1575212400,198,67,0,265,48,-0.2095610364460444,0.2102095896202382
280,1575226800,134,66,0,200,48,-0.2095610364460444,-0.10201684109970213
280,1575241200,57,28,0,85,48,-0.2095610364460444,-0.6544174492965196
280,1575255600,12,5,0,17,48,-0.2095610364460444,-0.9810543306650725
280,1575270000,112,9,0,121,48,-0.2095610364460444,-0.48149204151316805
280,1575284400,844,33,0,877,48,-0.2095610364460444,3.149941521937215
280,1575298800,212,52,0,264,48,-0.2095610364460444,0.20540610607070064
280,1575313200,284,154,0,438,48,-0.2095610364460444,1.0412122436902331
280,1575327600,54,71,17,125,48,6.024879797823776,-0.4622781073150179
280,1575342000,7,5,0,12,49,-0.34902503586966815,-0.9997561511124989
280,1575356400,108,10,0,118,49,-0.34902503586966815,-0.609362422982166
280,1575370451,855,35,0,890,49,-0.34902503586966815,2.233882464910446
280,1575370800,13,2,0,15,49,-0.34902503586966815,-0.9887072720144706
280,1575385200,249,45,0,294,49,-0.34902503586966815,0.0388384841021601
280,1575399600,320,166,0,486,49,-0.34902503586966815,0.7459667463759705
280,1575414000,66,109,43,175,49,3.605198723803458,-0.39943372011962863
280,1575428400,10,6,0,16,49,-0.34902503586966815,-0.9850243123151279
280,1575441442,76,5,0,81,49,-0.34902503586966815,-0.7456319318578483
280,1575442800,43,8,0,51,49,-0.34902503586966815,-0.8561207228381311
280,1575457200,907,47,0,954,49,-0.34902503586966815,2.469591885668383
280,1575471600,291,47,0,338,49,-0.34902503586966815,0.20088871087324164
280,1575486000,288,157,0,445,49,-0.34902503586966815,0.5949653987029172
280,1575500400,64,95,31,159,49,2.5016944187783996,-0.4583610753091128
280,1575514800,7,13,6,20,49,0.20272711664286114,-0.9702924735177568
280,1575529200,119,9,0,128,49,-0.34902503586966815,-0.5725328259887384
280,1575543600,909,43,0,952,49,-0.34902503586966815,2.4622259662696977
280,1575558000,256,42,0,298,49,-0.34902503586966815,0.05357032289953115
280,1575572400,328,173,0,501,49,-0.34902503586966815,0.8012111418661119
280,1575586800,82,115,33,197,49,2.685611802949243,-0.31840860673408783
280,1575601200,8,14,6,22,49,0.20272711664286114,-0.9629265541190712
280,1575615600,110,11,0,121,49,-0.34902503586966815,-0.5983135438841378
280,1575630000,844,57,0,901,49,-0.34902503586966815,2.2743950216032167
280,1575644400,262,58,0,320,49,-0.34902503586966815,0.13459543628507192
280,1575658800,337,163,0,500,49,-0.34902503586966815,0.7975281821667691
280,1575673200,98,95,0,193,49,-0.34902503586966815,-0.3331404455314589
280,1575687600,16,17,1,33,49,-0.2570663437842466,-0.9224139974263009
280,1575702000,34,6,0,40,49,-0.34902503586966815,-0.8966332795309016
280,1575716400,247,32,0,279,49,-0.34902503586966815,-0.01640591138798134
280,1575730800,326,80,0,406,49,-0.34902503586966815,0.4513299704285495
280,1575745200,295,85,0,380,49,-0.34902503586966815,0.35557301824563764
280,1575759600,90,70,0,160,49,-0.34902503586966815,-0.45467811560977006
280,1575774000,30,19,0,49,49,-0.34902503586966815,-0.8634866422368167
280,1575788400,18,3,0,21,49,-0.34902503586966815,-0.966609513818414
280,1575802800,182,20,0,202,49,-0.34902503586966815,-0.29999380823737404
280,1575817200,298,67,0,365,49,-0.34902503586966815,0.3003286227554962
280,1575831600,189,95,0,284,49,-0.34902503586966815,0.002008887108732473
280,1575846000,57,61,4,118,49,0.018809732472018045,-0.609362422982166
280,1575860400,16,5,0,21,49,-0.34902503586966815,-0.966609513818414
280,1575874800,107,15,0,122,49,-0.34902503586966815,-0.594630584184795
280,1575889200,870,40,0,910,49,-0.34902503586966815,2.3075416588973017
280,1575903600,252,47,0,299,49,-0.34902503586966815,0.05725328259887391
280,1575918000,307,144,0,451,49,-0.34902503586966815,0.6170631568989737
280,1575932400,51,94,43,145,49,3.605198723803458,-0.5099225110999115
280,1575946800,3,9,6,12,50,0.12237205536355009,-1.0713309544213436
280,1575961200,123,5,0,128,50,-0.3594679126304284,-0.6375994927343911
280,1575975600,892,34,0,926,50,-0.3594679126304284,2.346173838525851
280,1575990000,246,45,0,291,50,-0.3594679126304284,-0.02813200777772514
280,1576004400,339,174,0,513,50,-0.3594679126304284,0.8019402723473046
280,1576018800,57,109,52,166,50,3.8164784766507185,-0.4955150483886653
280,1576033200,12,9,0,21,50,-0.3594679126304284,-1.037679375497356
280,1576047600,120,13,0,133,50,-0.3594679126304284,-0.6189041711099535
280,1576062000,889,31,0,920,50,-0.3594679126304284,2.323739452576526
280,1576076400,284,56,0,340,50,-0.3594679126304284,0.1550821441417634
280,1576090800,322,140,0,462,50,-0.3594679126304284,0.611247991778041
280,1576105200,80,115,35,195,50,2.451265234001113,-0.3870821829669272
280,1576119600,15,17,2,32,50,-0.1988545899657689,-0.9965496679235931
280,1576134000,111,15,0,126,50,-0.3594679126304284,-0.6450776213841661
280,1576148400,886,45,0,931,50,-0.3594679126304284,2.3648691601502883
280,1576162800,278,42,0,320,50,-0.3594679126304284,0.08030085764401297
280,1576177200,366,154,0,520,50,-0.3594679126304284,0.8281137226215173
280,1576191600,75,115,40,190,50,2.8527985406627616,-0.4057775045913648
280,1576206000,21,18,0,39,50,-0.3594679126304284,-0.9703762176493805
280,1576220400,95,16,0,111,50,-0.3594679126304284,-0.701163586257479
280,1576234800,813,43,0,856,50,-0.3594679126304284,2.0844393357837245
280,1576249200,269,55,0,324,50,-0.3594679126304284,0.09525711494356306
280,1576263600,363,142,0,505,50,-0.3594679126304284,0.7720277577482044
280,1576278000,85,76,0,161,50,-0.3594679126304284,-0.5142103700131029
280,1576292400,24,34,10,58,50,0.44359870069286905,-0.8993339954765176
280,1576306800,27,2,0,29,50,-0.3594679126304284,-1.0077668608982557
280,1576321200,230,29,0,259,50,-0.3594679126304284,-0.14778206617412581
280,1576335600,318,85,0,403,50,-0.3594679126304284,0.3906431966096772
280,1576350000,242,82,0,324,50,-0.3594679126304284,0.09525711494356306
280,1576364400,97,76,0,173,50,-0.3594679126304284,-0.46934159811445264
280,1576378800,32,22,0,54,50,-0.3594679126304284,-0.9142902527760677
280,1576393200,27,4,0,31,50,-0.3594679126304284,-1.0002887322484806
280,1576407600,162,17,0,179,50,-0.3594679126304284,-0.4469072121651275
280,1576422000,322,58,0,380,50,-0.3594679126304284,0.30464471713726426
280,1576436400,184,72,0,256,50,-0.3594679126304284,-0.15899925914878837
280,1576450800,79,41,0,120,50,-0.3594679126304284,-0.6675120073334913
280,1576465200,7,9,2,16,50,-0.1988545899657689,-1.0563746971217935
280,1576479600,117,9,0,126,50,-0.3594679126304284,-0.6450776213841661
280,1576494000,840,52,0,892,50,-0.3594679126304284,2.219045651479675
280,1576508400,242,59,0,301,50,-0.3594679126304284,0.009258635471150073
280,1576522800,341,181,0,522,50,-0.3594679126304284,0.8355918512712923
280,1576537200,76,117,41,193,50,2.933105201995091,-0.39456031161670224
280,1576551600,11,6,0,17,51,-0.3469268003870204,-1.0575492801351587
280,1576566000,123,15,0,138,51,-0.3469268003870204,-0.5755344423192953
280,1576580400,841,45,0,886,51,-0.3469268003870204,2.404193645996951
280,1576594800,236,46,0,282,51,-0.3469268003870204,-0.001896949381408378
280,1576609200,348,139,0,487,51,-0.3469268003870204,0.8147397593148891
280,1576623600,75,92,17,167,51,1.7522743477174927,-0.46001022499152644
280,1576638000,12,11,0,23,51,-0.3469268003870204,-1.0336477179294135
280,1576652400,122,9,0,131,51,-0.3469268003870204,-0.6034195982259982
280,1576666800,902,61,0,963,51,-0.3469268003870204,2.710930360970682
280,1576681200,318,66,0,384,51,-0.3469268003870204,0.40442960811626155
280,1576695600,307,138,0,445,51,-0.3469268003870204,0.647428823874672
280,1576710000,72,114,42,186,51,4.839334859635895,-0.384321944673333
280,1576724400,10,14,4,24,51,0.14700288151992394,-1.0296641242284559
280,1576738800,112,12,0,124,51,-0.3469268003870204,-0.631304754132701
280,1576753200,876,46,0,922,51,-0.3469268003870204,2.5476030192314227
280,1576767600,258,39,0,297,51,-0.3469268003870204,0.05785695613295485
280,1576782000,341,135,0,476,51,-0.3469268003870204,0.7709202286043559
280,1576796400,76,100,24,176,51,2.6166512910546453,-0.4241578816829085
280,1576810800,15,14,0,29,51,-0.3469268003870204,-1.009746155723668
280,1576825200,98,8,0,106,51,-0.3469268003870204,-0.7030094407499369
280,1576839600,757,43,0,800,51,-0.3469268003870204,2.0616045877146014
280,1576854000,291,59,0,350,51,-0.3469268003870204,0.2689874222837049
280,1576868400,349,194,0,543,51,-0.3469268003870204,1.0378210065685118
280,1576882800,75,94,19,169,51,1.9992391886709648,-0.45204303758961134
280,1576897200,18,22,4,40,51,0.14700288151992394,-0.9659266250131351
280,1576911600,27,6,0,33,51,-0.3469268003870204,-0.9938117809198379
280,1576926000,179,20,0,199,51,-0.3469268003870204,-0.3325352265608849
280,1576940400,313,100,0,413,51,-0.3469268003870204,0.5199538254440305
280,1576954800,279,74,0,353,51,-0.3469268003870204,0.28093820338657755
280,1576969200,73,63,0,136,51,-0.3469268003870204,-0.5835016297212104
280,1576983600,27,19,0,46,51,-0.3469268003870204,-0.9420250628073897
280,1576998000,24,4,0,28,51,-0.3469268003870204,-1.0137297494246256
280,1577012400,175,18,0,193,51,-0.3469268003870204,-0.35643678876663015
280,1577026800,305,63,0,368,51,-0.3469268003870204,0.34069210890094076
280,1577041200,197,69,0,266,51,-0.3469268003870204,-0.06563444859672915
280,1577055600,68,56,0,124,51,-0.3469268003870204,-0.631304754132701
280,1577070000,9,6,0,15,51,-0.3469268003870204,-1.0655164675370739
280,1577084400,79,8,0,87,51,-0.3469268003870204,-0.7786977210681303
280,1577098800,473,45,0,518,51,-0.3469268003870204,0.9382311640445731
280,1577113200,303,68,0,371,51,-0.3469268003870204,0.35264289000381344
280,1577127600,265,136,0,401,51,-0.3469268003870204,0.47215070103253987
280,1577142000,70,78,8,148,51,0.6409325634268682,-0.5356985053097199
280,1577156400,10,19,9,29,52,4.795831523312719,-1.1245601488067878
280,1577170800,62,2,0,64,52,-0.20851441405707474,-0.8631069174207645
280,1577185200,316,23,0,339,52,-0.20851441405707474,1.1911684720408462
280,1577199600,241,66,0,307,52,-0.20851441405707474,0.9521255176307678
280,1577214000,226,74,0,300,52,-0.20851441405707474,0.8998348713535631
280,1577228400,75,45,0,120,52,-0.20851441405707474,-0.44478174720312746
280,1577242800,15,13,0,28,52,-0.20851441405707474,-1.1320302411321026
280,1577257200,21,3,0,24,52,-0.20851441405707474,-1.1619106104333625
280,1577271600,68,10,0,78,52,-0.20851441405707474,-0.7585256248663552
280,1577286000,142,22,0,164,52,-0.20851441405707474,-0.11609768488926975
280,1577300400,143,45,0,188,52,-0.20851441405707474,0.063184530918289
280,1577314800,51,30,0,81,52,-0.20851441405707474,-0.7361153478904104
280,1577329200,14,5,0,19,52,-0.20851441405707474,-1.1992610720599373
280,1577343600,63,4,0,67,52,-0.20851441405707474,-0.8406966404448196
280,1577358000,346,20,0,366,52,-0.20851441405707474,1.3928609648243497
280,1577372400,270,52,0,322,52,-0.20851441405707474,1.064176902510492
280,1577386800,232,85,0,317,52,-0.20851441405707474,1.0268264408839172
280,1577401200,62,58,0,120,52,-0.20851441405707474,-0.44478174720312746
280,1577415600,18,13,0,31,52,-0.20851441405707474,-1.1096199641561577
280,1577430000,60,7,0,67,52,-0.20851441405707474,-0.8406966404448196
280,1577444400,362,30,0,392,52,-0.20851441405707474,1.5870833652825382
280,1577458800,287,78,0,365,52,-0.20851441405707474,1.3853908724990347
280,1577473200,269,100,0,369,52,-0.20851441405707474,1.4152712418002946
280,1577487600,76,76,0,152,52,-0.20851441405707474,-0.2057387927930491
