remote_unit_id,time_stamp,entries,exits,num_people_exited,sum_exit_entry,week_num,z_score_num_people_exited,z_score_sum_exit_entry
282,1546311600,205,27,0,232,1,-0.23890011943493444,-0.6473321852505629
282,1546326000,30,12,0,42,1,-0.23890011943493444,-0.983051353268987
282,1546340400,55,42,0,97,1,-0.23890011943493444,-0.8858694888426011
282,1546354800,229,139,0,368,1,-0.23890011943493444,-0.4070279386689541
282,1546369200,415,135,0,550,1,-0.23890011943493444,-0.08544431456709521
282,1546383600,220,66,0,286,1,-0.23890011943493444,-0.5519172638137476
282,1546398000,54,18,0,72,1,-0.23890011943493444,-0.9300430635818674
282,1546412400,41,38,0,79,1,-0.23890011943493444,-0.9176744626548728
282,1546426800,443,314,0,757,1,-0.23890011943493444,0.28031288427402995
282,1546441200,605,203,0,808,1,-0.23890011943493444,0.37042697674213326
282,1546455600,1865,177,0,2042,1,-0.23890011943493444,2.5508346258723194
282,1546470000,663,62,0,725,1,-0.23890011943493444,0.22377070860776907
282,1546484400,105,18,0,123,1,-0.23890011943493444,-0.8399289711137641
282,1546498800,47,48,1,95,1,-0.14052948202054966,-0.8894033748217424
282,1546513200,515,316,0,831,1,-0.23890011943493444,0.4110666655022583
282,1546527600,671,192,0,863,1,-0.23890011943493444,0.4676088411685192
282,1546542000,1939,154,0,2093,1,-0.23890011943493444,2.6409487183404226
282,1546556400,791,75,0,866,1,-0.23890011943493444,0.4729096701372312
282,1546570800,122,18,0,140,1,-0.23890011943493444,-0.809890940291063
282,1546585200,47,56,9,103,1,0.6464356172945285,-0.8752678309051771
282,1546599600,524,302,0,826,1,-0.23890011943493444,0.402231950554405
282,1546614000,730,198,0,928,1,-0.23890011943493444,0.5824601354906116
282,1546628400,1852,187,0,2039,1,-0.23890011943493444,2.5455337969036074
282,1546642800,739,91,0,830,1,-0.23890011943493444,0.40929972251268765
282,1546657200,168,25,0,193,1,-0.23890011943493444,-0.7162429618438183
282,1546671600,19,20,1,39,1,-0.14052948202054966,-0.9883521822376989
282,1546686000,102,161,59,263,1,5.564967488013767,-0.5925569525738726
282,1546700400,384,267,0,651,1,-0.23890011943493444,0.09301692737954075
282,1546714800,631,216,0,847,1,-0.23890011943493444,0.43933775333538877
282,1546729200,408,138,0,546,1,-0.23890011943493444,-0.09251208652537782
282,1546743600,117,22,0,139,1,-0.23890011943493444,-0.8116578832806336
282,1546758000,19,11,0,30,1,-0.23890011943493444,-1.0042546691438348
282,1546772400,77,109,32,186,1,2.9089602778253782,-0.728611562770813
282,1546786800,369,217,0,586,1,-0.23890011943493444,-0.021834366942551697
282,1546801200,616,156,0,772,1,-0.23890011943493444,0.3068170291175898
282,1546815600,309,83,0,392,1,-0.23890011943493444,-0.36462130691925837
282,1546830000,68,16,0,84,1,-0.23890011943493444,-0.9088397477070196
282,1546844400,35,30,0,65,1,-0.23890011943493444,-0.9424116645088619
282,1546858800,539,357,0,896,1,-0.23890011943493444,0.5259179598243507
282,1546873200,638,175,0,813,1,-0.23890011943493444,0.3792616916899865
282,1546887600,1899,141,0,2040,1,-0.23890011943493444,2.5473007398931777
282,1546902000,736,58,0,794,1,-0.23890011943493444,0.3456897748881441
282,1546916400,112,15,0,127,2,0.0,-0.8442136583457709
282,1546930800,49,35,0,84,2,0.0,-0.9155641560492552
282,1546945200,581,306,0,887,2,0.0,0.41686490571581136
282,1546959600,551,196,0,747,2,0.0,0.18456095970446726
282,1546974000,1823,159,0,1982,2,0.0,2.2338136263045385
282,1546988400,784,60,0,844,2,0.0,0.3455144080123271
282,1547002800,101,10,0,111,2,0.0,-0.8707626807470674
282,1547017200,50,34,0,84,2,0.0,-0.9155641560492552
282,1547031600,569,334,0,903,2,0.0,0.44341392811710784
282,1547046000,652,180,0,832,2,0.0,0.32560264121135474
282,1547060400,1903,163,0,2066,2,0.0,2.3731959939113447
282,1547074800,852,67,0,919,2,0.0,0.4699629505184043
282,1547089200,102,12,0,114,2,0.0,-0.8657847390468243
282,1547103600,57,26,0,83,2,0.0,-0.9172234699493362
282,1547118000,607,286,0,893,2,0.0,0.4268207891162975
282,1547132400,718,188,0,906,2,0.0,0.4483918698173509
282,1547146800,1945,218,0,2163,2,0.0,2.5341494422192046
282,1547161200,830,72,0,902,2,0.0,0.4417546142170268
282,1547175600,133,17,0,150,2,0.0,-0.8060494386439072
282,1547190000,59,39,0,98,2,0.0,-0.8923337614481208
282,1547204400,563,297,0,860,2,0.0,0.37206343041362355
282,1547218800,670,175,0,845,2,0.0,0.34717372191240814
282,1547224997,319,30,0,349,2,0.0,-0.47584597252778243
282,1547233200,1788,179,0,1967,2,0.0,2.208923917803323
282,1547247600,660,87,0,747,2,0.0,0.18456095970446726
282,1547262000,137,13,0,150,2,0.0,-0.8060494386439072
282,1547276400,19,9,0,28,2,0.0,-1.0084857344537927
282,1547290800,98,43,0,141,2,0.0,-0.8209832637446365
282,1547305200,359,91,0,450,2,0.0,-0.30825526861959845
282,1547319600,725,92,0,817,2,0.0,0.3007129327101393
282,1547334000,431,41,0,472,2,0.0,-0.27175036281781584
282,1547348400,134,15,0,149,2,0.0,-0.8077087525439883
282,1547362800,15,8,0,23,2,0.0,-1.0167823039541979
282,1547377200,91,23,0,114,2,0.0,-0.8657847390468243
282,1547391600,323,76,0,399,2,0.0,-0.39288027752373095
282,1547406000,558,68,0,626,2,0.0,-0.0162160222053373
282,1547420400,279,27,0,306,2,0.0,-0.5471964702312667
282,1547434800,56,4,0,60,2,0.0,-0.9553876896511999
282,1547449200,49,27,0,76,2,0.0,-0.9288386672499034
282,1547451890,72,33,0,105,2,0.0,-0.8807185641475536
282,1547463600,510,249,0,759,2,0.0,0.2044727265054396
282,1547478000,568,175,0,743,2,0.0,0.17792370410414313
282,1547492400,1935,145,0,2080,2,0.0,2.3964263885124795
282,1547506800,745,68,0,813,2,0.0,0.2940756771098152
282,1547521200,87,21,0,108,3,-0.2026982669791056,-0.8688987441986611
282,1547535600,47,41,0,88,3,-0.2026982669791056,-0.903837707584342
282,1547550000,564,337,0,901,3,-0.2026982669791056,0.516431154043589
282,1547564400,656,192,0,848,3,-0.2026982669791056,0.42384290107153444
282,1547578800,1913,177,0,2090,3,-0.2026982669791056,2.593552527322322
282,1547593200,784,68,0,852,3,-0.2026982669791056,0.43083069374867067
282,1547607600,108,19,0,127,3,-0.2026982669791056,-0.8357067289822642
282,1547622000,48,51,3,99,3,2.1191182456906494,-0.8846212777222175
282,1547636400,605,329,0,934,3,-0.2026982669791056,0.5740804436299626
282,1547650800,595,250,0,845,3,-0.2026982669791056,0.4186020565636823
282,1547665200,1929,151,0,2080,3,-0.2026982669791056,2.5760830456294816
282,1547679600,837,76,0,913,3,-0.2026982669791056,0.5373945320749975
282,1547694000,112,11,0,123,3,-0.2026982669791056,-0.8426945216594004
282,1547708400,59,38,0,97,3,-0.2026982669791056,-0.8881151740607857
282,1547722800,603,314,0,917,3,-0.2026982669791056,0.5443823247521338
282,1547737200,655,189,0,844,3,-0.2026982669791056,0.41685510839439827
282,1547751600,1858,163,0,2021,3,-0.2026982669791056,2.473013103641723
282,1547766000,774,60,0,834,3,-0.2026982669791056,0.3993856267015578
282,1547780400,129,14,0,143,3,-0.2026982669791056,-0.8077555582737194
282,1547794800,48,34,0,82,3,-0.2026982669791056,-0.9143193966000464
282,1547809200,534,320,0,854,3,-0.2026982669791056,0.4343245900872387
282,1547823600,694,177,0,871,3,-0.2026982669791056,0.4640227089650676
282,1547838000,1857,170,0,2027,3,-0.2026982669791056,2.483494792657427
282,1547852400,688,69,0,757,3,-0.2026982669791056,0.26487061766668607
282,1547866800,138,11,0,149,3,-0.2026982669791056,-0.7972738692580151
282,1547881200,24,13,0,37,3,-0.2026982669791056,-0.9929320642178285
282,1547895600,125,32,0,157,3,-0.2026982669791056,-0.7832982839037427
282,1547910000,390,93,0,483,3,-0.2026982669791056,-0.21379318071714307
282,1547924400,705,92,0,797,3,-0.2026982669791056,0.334748544438048
282,1547938800,390,55,0,445,3,-0.2026982669791056,-0.2801772111499369
282,1547953200,132,7,0,139,3,-0.2026982669791056,-0.8147433509508556
282,1547967600,16,6,0,22,3,-0.2026982669791056,-1.0191362867570892
282,1547982000,59,31,0,90,3,-0.2026982669791056,-0.9003438112457739
282,1547996400,305,88,0,393,3,-0.2026982669791056,-0.3710185159527074
282,1548010800,481,71,0,552,3,-0.2026982669791056,-0.09325375703654376
282,1548025200,285,27,0,312,3,-0.2026982669791056,-0.5125213176647153
282,1548039600,79,10,0,89,3,-0.2026982669791056,-0.902090759415058
282,1548054000,21,29,8,50,3,5.988812433473574,-0.9702217380171358
282,1548068400,214,139,0,353,3,-0.2026982669791056,-0.4408964427240693
282,1548082800,437,151,0,588,3,-0.2026982669791056,-0.030363622942318026
282,1548097200,802,119,0,921,3,-0.2026982669791056,0.55137011742927
282,1548111600,348,46,0,394,3,-0.2026982669791056,-0.36927156778342335
282,1548126000,67,18,0,85,4,-0.25307671242933294,-1.0200855554416444
282,1548140400,49,37,0,86,4,-0.25307671242933294,-1.018376119487108
282,1548154800,530,261,0,791,4,-0.25307671242933294,0.18677622846114628
282,1548169200,537,174,0,711,4,-0.25307671242933294,0.05002135209822381
282,1548183600,1778,147,0,1925,4,-0.25307671242933294,2.125276600905572
282,1548198000,830,65,0,895,4,-0.25307671242933294,0.36455756773294545
282,1548212400,103,4,0,107,4,-0.25307671242933294,-0.9824779644418408
282,1548226800,61,28,0,89,4,-0.25307671242933294,-1.0132478116234982
282,1548241200,578,295,0,873,4,-0.25307671242933294,0.3269499767331418
282,1548255600,616,178,0,794,4,-0.25307671242933294,0.19190453632475585
282,1548270000,1832,174,0,2006,4,-0.25307671242933294,2.263740913223031
282,1548284400,848,62,0,910,4,-0.25307671242933294,0.3901991070509934
282,1548298800,110,6,0,116,4,-0.25307671242933294,-0.9670930408510119
282,1548313200,55,36,0,91,4,-0.25307671242933294,-1.0098289397144251
282,1548327600,582,307,0,889,4,-0.25307671242933294,0.35430095200572626
282,1548342000,660,177,0,837,4,-0.25307671242933294,0.26541028236982667
282,1548356400,1881,176,0,2057,4,-0.25307671242933294,2.350922146904394
282,1548370800,754,73,0,827,4,-0.25307671242933294,0.24831592282446138
282,1548385200,140,5,0,145,4,-0.25307671242933294,-0.9175193981694526
282,1548399600,43,34,0,77,4,-0.25307671242933294,-1.0337610430779367
282,1548414000,571,260,0,831,4,-0.25307671242933294,0.25515366664260747
282,1548428400,755,153,0,908,4,-0.25307671242933294,0.38678023514192034
282,1548442800,1824,194,0,2018,4,-0.25307671242933294,2.2842541446774693
282,1548457200,724,96,0,820,4,-0.25307671242933294,0.23634987114270564
282,1548471600,170,28,0,198,4,-0.25307671242933294,-0.8269192925790164
282,1548486000,19,26,7,45,4,4.707226851185593,-1.0884629936231056
282,1548500400,126,128,2,254,4,1.1641528771749314,-0.7311908791249707
282,1548514800,441,235,0,676,4,-0.25307671242933294,-0.009808906310554762
282,1548529200,884,215,0,1099,4,-0.25307671242933294,0.7132825024583977
282,1548543600,464,113,0,577,4,-0.25307671242933294,-0.1790430658096713
282,1548558000,159,34,0,193,4,-0.25307671242933294,-0.8354664723516991
282,1548572400,22,14,0,36,4,-0.25307671242933294,-1.1038479172139344
282,1548586800,98,104,6,202,4,3.9986120563834606,-0.8200815487608702
282,1548601200,422,222,0,644,4,-0.25307671242933294,-0.06451085685572375
282,1548615600,754,117,0,871,4,-0.25307671242933294,0.3235311048240687
282,1548630000,347,68,0,415,4,-0.25307671242933294,-0.4559716904445893
282,1548644400,58,15,0,73,4,-0.25307671242933294,-1.0405987868960827
282,1548658800,48,38,0,86,4,-0.25307671242933294,-1.018376119487108
282,1548673200,588,299,0,887,4,-0.25307671242933294,0.3508820800966532
282,1548687600,594,166,0,760,4,-0.25307671242933294,0.13378371387051383
282,1548702000,1778,149,0,1927,4,-0.25307671242933294,2.128695472814645
282,1548716400,726,76,0,802,4,-0.25307671242933294,0.2055800239610481
282,1548730800,106,31,0,137,5,0.0,-0.8687305789356398
282,1548745200,52,34,0,86,5,0.0,-0.9570844510252908
282,1548759600,601,321,0,922,5,0.0,0.4912260796991849
282,1548774000,629,168,0,797,5,0.0,0.27467247163631475
282,1548788400,2004,180,0,2184,5,0.0,2.6775513067019223
282,1548802800,767,71,0,838,5,0.0,0.34570205508093615
282,1548817200,86,12,0,98,5,0.0,-0.9362953046512552
282,1548831600,56,38,0,94,5,0.0,-0.9432250201092671
282,1548846000,577,269,0,846,5,0.0,0.35956148599695986
282,1548860400,526,170,0,696,5,0.0,0.09969715632151564
282,1548874800,1707,158,0,1865,5,0.0,2.1249064989254776
282,1548889200,782,81,0,863,5,0.0,0.3890127766935102
282,1548903600,94,33,0,127,5,0.0,-0.8860548675806694
282,1548918000,55,40,0,95,5,0.0,-0.9414925912447641
282,1548932400,571,298,0,869,5,0.0,0.39940734988052795
282,1548946800,545,145,0,690,5,0.0,0.08930258313449788
282,1548961200,1717,179,0,1896,5,0.0,2.1786117937250693
282,1548975600,670,57,0,727,5,0.0,0.15340245112110745
282,1548990000,104,17,0,121,5,0.0,-0.8964494407676872
282,1549004400,51,27,0,78,5,0.0,-0.9709438819413145
282,1549018800,500,261,0,761,5,0.0,0.21230503251420813
282,1549033200,575,160,0,735,5,0.0,0.16726188203713113
282,1549047600,1747,193,0,1940,5,0.0,2.2548386637631994
282,1549062000,660,73,0,733,5,0.0,0.1637970243081252
282,1549076400,521,35,0,556,5,0.0,-0.14284288470889894
282,1549090800,22,19,0,41,5,0.0,-1.0350437499279241
282,1549105200,102,48,0,150,5,0.0,-0.8462090036971013
282,1549119600,357,92,0,449,5,0.0,-0.32821277321071585
282,1549134000,644,115,0,759,5,0.0,0.2088401747852022
282,1549148400,412,50,0,462,5,0.0,-0.3056911979721773
282,1549162800,138,25,0,163,5,0.0,-0.8236874284585628
282,1549177200,19,13,0,32,5,0.0,-1.0506356097084508
282,1549191600,88,44,0,132,5,0.0,-0.8773927232581545
282,1549206000,290,115,0,405,5,0.0,-0.4044396432488461
282,1549220400,506,60,0,566,5,0.0,-0.12551859606386934
282,1549234800,257,21,0,278,5,0.0,-0.6244581090407222
282,1549249200,52,18,0,70,5,0.0,-0.9848033128573381
282,1549263600,45,35,0,80,5,0.0,-0.9674790242123086
282,1549278000,573,288,0,861,5,0.0,0.38554791896450424
282,1549292400,628,178,0,806,5,0.0,0.2902643314168414
282,1549306800,1807,142,0,1949,5,0.0,2.2704305235437263
282,1549321200,788,70,0,858,5,0.0,0.38035063237099537
282,1549335600,98,24,0,122,6,0.0,-0.9124427146783746
282,1549350000,62,45,0,107,6,0.0,-0.936532854241168
282,1549364400,590,293,0,883,6,0.0,0.3097303658073437
282,1549378800,619,199,0,818,6,0.0,0.205339761035239
282,1549393200,1783,141,0,1924,6,0.0,1.9815860514652053
282,1549407600,759,65,0,824,6,0.0,0.21497581686035636
282,1549422000,108,13,0,121,6,0.0,-0.9140487239825608
282,1549436400,57,43,0,100,6,0.0,-0.9477749193704715
282,1549450800,615,349,0,964,6,0.0,0.43981711944642804
282,1549465200,711,157,0,868,6,0.0,0.2856402262445503
282,1549479600,2006,176,0,2182,6,0.0,2.3959364519452517
282,1549494000,882,77,0,959,6,0.0,0.4317870729254969
282,1549508400,124,19,0,143,6,0.0,-0.8787165192904638
282,1549522800,47,38,0,85,6,0.0,-0.9718650589332649
282,1549537200,628,305,0,933,6,0.0,0.39003083101665503
282,1549551600,736,187,0,923,6,0.0,0.37397073797479274
282,1549566000,1853,210,0,2063,6,0.0,2.204821344747091
282,1549580400,864,83,0,947,6,0.0,0.41251496127526216
282,1549594800,117,36,0,153,6,0.0,-0.8626564262486015
282,1549609200,45,38,0,83,6,0.0,-0.9750770775416373
282,1549623600,576,355,0,931,6,0.0,0.3868188124082826
282,1549638000,610,169,0,779,6,0.0,0.14270539817197617
282,1549652400,1898,227,0,2125,6,0.0,2.304393921606637
282,1549666800,869,110,0,979,6,0.0,0.4639072590092214
282,1549681200,199,20,0,219,6,0.0,-0.7566598121723106
282,1549695600,24,11,0,35,6,0.0,-1.0521655241425762
282,1549710000,100,56,0,156,6,0.0,-0.8578383983360428
282,1549724400,370,134,0,504,6,0.0,-0.2989471604792361
282,1549738800,695,82,0,777,6,0.0,0.13949337956360372
282,1549753200,395,46,0,441,6,0.0,-0.40012574664296835
282,1549767600,140,28,0,168,6,0.0,-0.8385662866858081
282,1549782000,15,13,0,28,6,0.0,-1.0634075892718797
282,1549796400,80,73,0,153,6,0.0,-0.8626564262486015
282,1549810800,329,130,0,459,6,0.0,-0.3712175791676163
282,1549825200,602,80,0,682,6,0.0,-0.01307750433408779
282,1549839600,295,27,0,322,6,0.0,-0.5912408538411292
282,1549854000,59,13,0,72,6,0.0,-0.9927431798876859
282,1549868400,46,33,0,79,6,0.0,-0.9815011147583823
282,1549882800,572,305,0,877,6,0.0,0.30009430998222636
282,1549897200,627,161,0,788,6,0.0,0.1571594819096522
282,1549911600,2037,139,0,2176,6,0.0,2.3863003961201343
282,1549926000,957,77,0,1034,6,0.0,0.5522377707394639
282,1549940400,143,15,0,158,7,-0.23618874648666507,-0.8848421028251646
282,1549954800,53,52,0,105,7,-0.23618874648666507,-0.9732667277808915
282,1549969200,748,338,0,1086,7,-0.23618874648666507,0.6634230284751098
282,1549983600,946,192,0,1138,7,-0.23618874648666507,0.7501792642807287
282,1549998000,1901,158,0,2059,7,-0.23618874648666507,2.286765671530247
282,1550012400,765,74,0,839,7,-0.23618874648666507,0.2513309083984204
282,1550026800,119,19,0,138,7,-0.23618874648666507,-0.9182098858273257
282,1550041200,49,34,0,83,7,-0.23618874648666507,-1.0099712890832686
282,1550055600,664,328,0,992,7,-0.23618874648666507,0.5065944483649527
282,1550070000,720,185,0,905,7,-0.23618874648666507,0.361444592305552
282,1550084400,1983,189,0,2172,7,-0.23618874648666507,2.475293645492457
282,1550098800,909,82,0,991,7,-0.23618874648666507,0.5049260592148447
282,1550113200,133,27,0,160,7,-0.23618874648666507,-0.8815053245249485
282,1550127600,45,49,4,94,7,1.9682395540555426,-0.9916190084320801
282,1550142000,644,279,0,923,7,-0.23618874648666507,0.391475597007497
282,1550156400,752,227,0,979,7,-0.23618874648666507,0.48490538941354805
282,1550170800,2100,177,0,2277,7,-0.23618874648666507,2.6504745062538024
282,1550185200,762,81,0,843,7,-0.23618874648666507,0.25800446499885266
282,1550199600,153,31,0,184,7,-0.23618874648666507,-0.8414639849223552
282,1550214000,52,45,0,97,7,-0.23618874648666507,-0.9866138409817559
282,1550228400,570,308,0,878,7,-0.23618874648666507,0.3163980852526345
282,1550242800,738,187,0,925,7,-0.23618874648666507,0.39481237530771307
282,1550257200,1920,137,0,2057,7,-0.23618874648666507,2.2834288932300306
282,1550271600,702,111,0,813,7,-0.23618874648666507,0.207952790495611
282,1550286000,136,25,0,161,7,-0.23618874648666507,-0.8798369353748404
282,1550300400,30,29,0,59,7,-0.23618874648666507,-1.050012628685862
282,1550314800,132,128,0,260,7,-0.23618874648666507,-0.7146664095141431
282,1550329200,434,256,0,690,7,-0.23618874648666507,0.002740925032320321
282,1550343600,816,179,0,995,7,-0.23618874648666507,0.5115996158152769
282,1550358000,482,105,0,587,7,-0.23618874648666507,-0.16910315742880927
282,1550372400,135,29,0,164,7,-0.23618874648666507,-0.8748317679245162
282,1550386800,15,18,3,33,7,1.4171324789199906,-1.0933907465886714
282,1550401200,91,102,11,193,7,5.825989080004406,-0.8264484825713827
282,1550415600,389,228,0,617,7,-0.23618874648666507,-0.11905148292556765
282,1550430000,812,193,0,1005,7,-0.23618874648666507,0.5282835073163574
282,1550444400,389,66,0,455,7,-0.23618874648666507,-0.38933052524307243
282,1550458800,64,25,0,89,7,-0.23618874648666507,-0.9999609541826203
282,1550473200,22,15,0,37,7,-0.23618874648666507,-1.086717189988239
282,1550487600,211,122,0,333,7,-0.23618874648666507,-0.5928740015562551
282,1550502000,467,216,0,683,7,-0.23618874648666507,-0.00893779901843606
282,1550516400,995,132,0,1127,7,-0.23618874648666507,0.7318269836295401
282,1550530800,464,63,0,527,7,-0.23618874648666507,-0.26920650643529254
282,1550545200,72,15,0,87,8,-0.2041241452319315,-1.0726155787183898
282,1550559600,41,44,3,85,8,4.898979485566356,-1.0757863708985909
282,1550574000,587,298,0,885,8,-0.2041241452319315,0.19253050118180404
282,1550588400,571,214,0,785,8,-0.2041241452319315,0.03399089217175467
282,1550602800,1872,172,0,2044,8,-0.2041241452319315,2.030004569608276
282,1550617200,837,75,0,912,8,-0.2041241452319315,0.23533619561451735
282,1550631600,88,5,0,93,8,-0.2041241452319315,-1.0631032021777869
282,1550646000,40,28,0,68,8,-0.2041241452319315,-1.1027381044302993
282,1550660400,610,269,0,879,8,-0.2041241452319315,0.18301812464120107
282,1550674800,672,210,0,882,8,-0.2041241452319315,0.18777431291150254
282,1550689200,1756,170,0,1926,8,-0.2041241452319315,1.8429278309764179
282,1550703600,801,74,0,875,8,-0.2041241452319315,0.1766765402807991
282,1550718000,89,15,0,104,8,-0.2041241452319315,-1.0456638451866815
282,1550732400,49,34,0,83,8,-0.2041241452319315,-1.0789571630787917
282,1550746800,592,307,0,899,8,-0.2041241452319315,0.21472604644321094
282,1550761200,592,225,0,817,8,-0.2041241452319315,0.08472356705497046
282,1550775600,1830,168,0,1998,8,-0.2041241452319315,1.9570763494636534
282,1550790000,848,101,0,949,8,-0.2041241452319315,0.2939958509482356
282,1550804400,116,21,0,137,8,-0.2041241452319315,-0.9933457742133651
282,1550818800,49,27,0,76,8,-0.2041241452319315,-1.0900549357094953
282,1550824638,190,71,0,261,8,-0.2041241452319315,-0.796756659040904
282,1550833200,381,207,0,588,8,-0.2041241452319315,-0.2783321375780426
282,1550847600,695,185,0,880,8,-0.2041241452319315,0.18460352073130157
282,1550862000,1751,188,0,1939,8,-0.2041241452319315,1.8635379801477243
282,1550876400,740,97,0,837,8,-0.2041241452319315,0.11643148885698033
282,1551495600,6051,439,0,6490,9,-0.24253562503633297,3.944053262688837
282,1551510000,26,23,0,49,9,-0.24253562503633297,-0.5618260771903375
282,1551524400,126,160,34,286,9,4.123105625617661,-0.3960298648706101
282,1551538800,404,209,0,613,9,-0.24253562503633297,-0.1672730655940241
282,1551553200,763,190,0,953,9,-0.24253562503633297,0.07057804068744142
282,1551567600,461,98,0,559,9,-0.24253562503633297,-0.20504941776813923
282,1551582000,142,19,0,161,9,-0.24253562503633297,-0.4834751245329136
282,1551596400,21,16,0,37,9,-0.24253562503633297,-0.5702208221179187
282,1551610800,109,105,0,214,9,-0.24253562503633297,-0.4463983344360969
282,1551625200,393,233,0,626,9,-0.24253562503633297,-0.15817875858914454
282,1551639600,714,166,0,880,9,-0.24253562503633297,0.019510009044656176
282,1551654000,336,68,0,404,9,-0.24253562503633297,-0.3134815397493956
282,1551668400,63,12,0,75,9,-0.24253562503633297,-0.5436374631805784
282,1551682800,30,26,0,56,9,-0.24253562503633297,-0.5569291426492485
282,1551697200,512,286,0,798,9,-0.24253562503633297,-0.03785408129381492
282,1551711600,497,147,0,644,9,-0.24253562503633297,-0.14558664119777284
282,1551726000,1580,156,0,1736,9,-0.24253562503633297,0.6183351472121106
282,1551740400,676,81,0,757,9,-0.24253562503633297,-0.06653612646305047
282,1551754800,80,11,0,91,10,-0.15811388300841894,-1.0161203090901816
282,1551769200,41,35,0,76,10,-0.15811388300841894,-1.0400817350905827
282,1551783600,509,321,0,830,10,-0.15811388300841894,0.1643792785295811
282,1551798000,571,153,0,724,10,-0.15811388300841894,-0.004948131873253608
282,1551812400,1813,164,0,1977,10,-0.15811388300841894,1.9966296533602548
282,1551826800,787,88,0,875,10,-0.15811388300841894,0.23626355653078449
282,1551841200,106,10,0,116,10,-0.15811388300841894,-0.9761845990895129
282,1551855600,47,36,0,83,10,-0.15811388300841894,-1.0288997362903956
282,1551870000,824,280,0,1104,10,-0.15811388300841894,0.6020746601369085
282,1551884400,969,156,0,1125,10,-0.15811388300841894,0.6356206565374701
282,1551898800,2125,161,0,2286,10,-0.15811388300841894,2.490235028968518
282,1551913200,869,77,0,946,10,-0.15811388300841894,0.3496809729326832
282,1551927600,105,14,0,119,10,-0.15811388300841894,-0.9713923138894328
282,1551942000,56,37,0,93,10,-0.15811388300841894,-1.012925452290128
282,1551956400,626,265,0,891,10,-0.15811388300841894,0.2618224109312124
282,1551970800,646,207,0,853,10,-0.15811388300841894,0.20112013173019616
282,1551985200,1995,171,0,2166,10,-0.15811388300841894,2.298543620965309
282,1551999600,885,88,0,973,10,-0.15811388300841894,0.39281153973340527
282,1552014000,133,20,0,153,10,-0.15811388300841894,-0.9170797482885236
282,1552028400,49,38,0,87,10,-0.15811388300841894,-1.0225100226902886
282,1552042800,589,250,0,839,10,-0.15811388300841894,0.17875613412982178
282,1552057200,782,176,0,958,10,-0.15811388300841894,0.36885011373300414
282,1552071600,1854,229,0,2083,10,-0.15811388300841894,2.1659570637630896
282,1552086000,783,117,0,900,10,-0.15811388300841894,0.27619926653145305
282,1552100400,175,38,0,213,10,-0.15811388300841894,-0.8212340442869189
282,1552114800,29,22,0,51,10,-0.15811388300841894,-1.0800174450912512
282,1552129200,149,112,0,261,10,-0.15811388300841894,-0.7445574810856354
282,1552143600,501,193,0,694,10,-0.15811388300841894,-0.05287098387405588
282,1552158000,961,178,0,1139,10,-0.15811388300841894,0.6579846541378445
282,1552172400,574,125,0,699,10,-0.15811388300841894,-0.044883841873922165
282,1552190400,162,29,0,191,10,-0.15811388300841894,-0.8563774690875073
282,1552204800,33,21,0,54,10,-0.15811388300841894,-1.075225159891171
282,1552219200,124,133,9,257,10,6.324555320336758,-0.7509471946857423
282,1552233600,452,216,0,668,10,-0.15811388300841894,-0.09440412227475119
282,1552248000,667,106,0,773,10,-0.15811388300841894,0.07332585972805677
282,1552262400,300,41,0,341,10,-0.15811388300841894,-0.6167632090834959
282,1552276800,32,11,0,43,10,-0.15811388300841894,-1.0927968722914652
282,1552291200,138,86,0,224,10,-0.15811388300841894,-0.8036623318866248
282,1552305600,570,372,0,942,10,-0.15811388300841894,0.34329125933257626
282,1552320000,810,199,0,1009,10,-0.15811388300841894,0.45031896213436795
282,1552334400,1762,142,0,1904,10,-0.15811388300841894,1.8800173801583027
282,1552348800,521,59,0,580,11,0.0,-0.24435971829925546
282,1552363200,48,14,0,62,11,0.0,-1.0955108600409467
282,1552377600,133,75,0,208,11,0.0,-0.8556111173878831
282,1552392000,648,302,0,950,11,0.0,0.3636053829448097
282,1552406400,865,156,0,1021,11,0.0,0.48026895642677897
282,1552420800,2061,170,0,2231,11,0.0,2.4684791523871
282,1552435200,573,65,0,638,11,0.0,-0.14905708080694255
282,1552449600,57,23,0,80,11,0.0,-1.065934179439884
282,1552464000,140,81,0,221,11,0.0,-0.8342501813982268
282,1552478400,631,326,0,957,11,0.0,0.3751074254007785
282,1552492800,920,181,0,1101,11,0.0,0.6117208702092796
282,1552507200,1936,157,0,2093,11,0.0,2.2417246011122867
282,1552521600,587,52,0,639,11,0.0,-0.1474139318846613
282,1552536000,59,17,0,76,11,0.0,-1.0725067751290092
282,1552550400,125,93,0,218,11,0.0,-0.8391796281650705
282,1552564800,633,293,0,926,11,0.0,0.3241698088100595
282,1552579200,886,204,0,1090,11,0.0,0.5936462320641858
282,1552593600,1889,204,0,2093,11,0.0,2.2417246011122867
282,1552608000,615,74,0,689,11,0.0,-0.06525648577059842
282,1552622400,52,24,0,76,11,0.0,-1.0725067751290092
282,1552636800,124,83,0,207,11,0.0,-0.8572542663101644
282,1552651200,590,290,0,880,11,0.0,0.2485849583851217
282,1552665600,1002,184,0,1186,11,0.0,0.7513885286031864
282,1552680000,1698,181,0,1879,11,0.0,1.8900907317440974
282,1552694400,593,60,0,653,11,0.0,-0.12440984697272368
282,1552708800,110,20,0,130,11,0.0,-0.9837767333258212
282,1552723200,37,30,0,67,11,0.0,-1.0872951154295405
282,1552737600,239,162,0,401,11,0.0,-0.5384833753876005
282,1552752000,700,270,0,970,11,0.0,0.39646836139043484
282,1552766400,951,189,0,1140,11,0.0,0.6758036781782486
282,1552780800,418,91,0,509,11,0.0,-0.3610232917812247
282,1552795200,79,19,0,98,11,0.0,-1.0363574988388213
282,1552809600,24,20,0,44,11,0.0,-1.1250875406420093
282,1552824000,197,154,0,351,11,0.0,-0.6206408215016633
282,1552838400,502,205,0,707,11,0.0,-0.03567980516953579
282,1552852800,716,158,0,874,11,0.0,0.23872606485143416
282,1552867200,310,45,0,355,11,0.0,-0.6140682258125383
282,1552881600,31,15,0,46,11,0.0,-1.1218012427974469
282,1552896000,136,91,0,227,11,0.0,-0.8243912878645393
282,1552910400,566,315,0,881,11,0.0,0.25022810730740297
282,1552924800,913,201,0,1114,11,0.0,0.6330818061989358
282,1552939200,1758,180,0,1938,11,0.0,1.9870365181586915
282,1552953600,300,29,0,329,12,-0.15617376188860607,-0.5033378059337185
282,1552968000,1,1,0,2,12,-0.15617376188860607,-1.0044499064551893
282,1552982400,145,77,0,222,12,-0.15617376188860607,-0.6673102669606218
282,1552996800,718,361,0,1079,12,-0.15617376188860607,0.646001874161398
282,1553011200,989,176,0,1165,12,-0.15617376188860607,0.777792824145638
282,1553025600,2035,191,0,2226,12,-0.15617376188860607,2.4037253582535296
282,1553040000,312,34,0,346,12,-0.15617376188860607,-0.47728610651822917
282,1553054400,0,0,0,0,12,-0.15617376188860607,-1.0075148122687763
282,1553068800,138,124,0,262,12,-0.15617376188860607,-0.6060121506888823
282,1553083200,617,316,0,933,12,-0.15617376188860607,0.42226374976954867
282,1553097600,891,188,0,1079,12,-0.15617376188860607,0.646001874161398
282,1553112000,1978,174,0,2152,12,-0.15617376188860607,2.2903238431508113
282,1553126400,335,26,0,361,12,-0.15617376188860607,-0.45429931291632686
282,1553140800,0,1,1,1,12,6.403124237432849,-1.0059823593619828
282,1553155200,144,64,0,208,12,-0.15617376188860607,-0.6887646076557307
282,1553169600,626,289,0,915,12,-0.15617376188860607,0.3946795974472659
282,1553184000,896,155,0,1051,12,-0.15617376188860607,0.6030931927711803
282,1553198400,1964,215,0,2179,12,-0.15617376188860607,2.3317000716342355
282,1553212800,364,46,0,410,12,-0.15617376188860607,-0.3792091204834459
282,1553227200,2,0,0,2,12,-0.15617376188860607,-1.0044499064551893
282,1553241600,137,80,0,217,12,-0.15617376188860607,-0.6749725314945892
282,1553256000,634,304,0,938,12,-0.15617376188860607,0.4299260143035161
282,1553270400,911,201,0,1112,12,-0.15617376188860607,0.6965728200855832
282,1553284800,1756,183,0,1939,12,-0.15617376188860607,1.9639113740037983
282,1553299200,364,80,0,444,12,-0.15617376188860607,-0.3271057216524673
282,1553313600,42,17,0,59,12,-0.15617376188860607,-0.9171000907679604
282,1553328000,16,12,0,28,12,-0.15617376188860607,-0.9646061308785586
282,1553342400,137,78,0,215,12,-0.15617376188860607,-0.6780374373081762
282,1553356800,412,156,0,568,12,-0.15617376188860607,-0.1370815612100747
282,1553371200,657,115,0,772,12,-0.15617376188860607,0.175538831775797
282,1553385600,348,46,0,394,12,-0.15617376188860607,-0.40372836699214176
282,1553400000,37,11,0,48,12,-0.15617376188860607,-0.9339570727426888
282,1553414400,25,5,0,30,12,-0.15617376188860607,-0.9615412250649716
282,1553428800,170,58,0,228,12,-0.15617376188860607,-0.6581155495198608
282,1553443200,421,101,0,522,12,-0.15617376188860607,-0.20757439492257518
282,1553457600,551,72,0,623,12,-0.15617376188860607,-0.052796651336432826
282,1553472000,200,23,0,223,12,-0.15617376188860607,-0.6657778140538283
282,1553486400,19,1,0,20,12,-0.15617376188860607,-0.9768657541329065
282,1553500800,130,68,0,198,12,-0.15617376188860607,-0.7040891367236656
282,1553515200,620,315,0,935,12,-0.15617376188860607,0.42532865558313565
282,1553529600,872,195,0,1067,12,-0.15617376188860607,0.6276124392798762
282,1553544000,1934,177,0,2111,12,-0.15617376188860607,2.227493273972278
282,1553558400,322,28,0,350,13,-0.23385358667337133,-0.5751040121785139
282,1553572800,0,0,0,0,13,-0.23385358667337133,-1.1214416739999018
282,1553587200,153,84,0,237,13,-0.23385358667337133,-0.7514930287094191
282,1553601600,615,402,0,1017,13,-0.23385358667337133,0.46605947477824505
282,1553616000,953,198,0,1151,13,-0.23385358667337133,0.6752287510184335
282,1553630400,1986,213,0,2199,13,-0.23385358667337133,2.3111198069864747
282,1553644800,317,26,0,343,13,-0.23385358667337133,-0.5860307654149417
282,1553659200,2,1,0,3,13,-0.23385358667337133,-1.1167587797557184
282,1553673600,138,77,0,215,13,-0.23385358667337133,-0.7858342531667635
282,1553688000,702,338,0,1040,13,-0.23385358667337133,0.5019616639836506
282,1553702400,944,171,0,1115,13,-0.23385358667337133,0.6190340200882336
282,1553716800,1941,187,0,2128,13,-0.23385358667337133,2.2002913098741357
282,1553731200,326,45,0,371,13,-0.23385358667337133,-0.5423237524692307
282,1553745600,1,1,0,2,13,-0.23385358667337133,-1.1183197445037796
282,1553760000,142,69,0,211,13,-0.23385358667337133,-0.7920781121590079
282,1553774400,620,320,0,940,13,-0.23385358667337133,0.3458651891775398
282,1553788800,909,178,0,1087,13,-0.23385358667337133,0.5753270071425226
282,1553803200,2011,218,0,2229,13,-0.23385358667337133,2.357948749428308
282,1553817600,355,28,0,383,13,-0.23385358667337133,-0.5235921754924974
282,1553832000,1,1,0,2,13,-0.23385358667337133,-1.1183197445037796
282,1553846400,117,70,0,187,13,-0.23385358667337133,-0.8295412661124746
282,1553860800,609,278,0,887,13,-0.23385358667337133,0.26313405753030106
282,1553875200,971,190,0,1161,13,-0.23385358667337133,0.6908383984990446
282,1553889600,1651,187,0,1838,13,-0.23385358667337133,1.7476115329364146
282,1553904000,547,103,0,650,13,-0.23385358667337133,-0.10681458776018156
282,1553918400,65,25,0,90,13,-0.23385358667337133,-0.980954846674402
282,1553932800,33,49,16,82,13,0.701560760020114,-0.9934425646588909
282,1553947200,196,296,100,492,13,5.612486080160912,-0.3534470179538366
282,1553961600,564,377,0,941,13,-0.23385358667337133,0.3474261539256009
282,1553976000,917,398,0,1315,13,-0.23385358667337133,0.9312269697004553
282,1553990400,450,173,0,623,13,-0.23385358667337133,-0.14896063595783146
282,1554004800,75,36,0,111,13,-0.23385358667337133,-0.9481745869651188
282,1554019200,31,31,0,62,13,-0.23385358667337133,-1.0246618596201131
282,1554033600,173,225,52,398,13,2.806243040080456,-0.5001777042715808
282,1554048000,486,362,0,848,13,-0.23385358667337133,0.20225643235591784
282,1554062400,611,264,0,875,13,-0.23385358667337133,0.24440248055356775
282,1554076800,288,68,0,356,13,-0.23385358667337133,-0.5657382236901473
282,1554091200,21,14,0,35,13,-0.23385358667337133,-1.066807907817763
282,1554105600,139,68,0,207,13,-0.23385358667337133,-0.7983219711512524
282,1554120000,622,288,0,910,13,-0.23385358667337133,0.2990362467357065
282,1554134400,859,172,0,1031,13,-0.23385358667337133,0.4879129812511006
282,1554148800,1852,200,0,2052,13,-0.23385358667337133,2.0816579890214917
282,1554163200,481,62,0,543,14,0.0,-0.23181806896138596
282,1554177600,35,5,0,40,14,0.0,-1.0159020466876494
282,1554192000,165,78,0,243,14,0.0,-0.6994625884800321
282,1554206400,646,340,0,986,14,0.0,0.4587370048611482
282,1554220800,911,190,0,1101,14,0.0,0.6380007373432959
282,1554235200,2016,206,0,2222,14,0.0,2.3854324252779704
282,1554249600,543,59,0,602,14,0.0,-0.13984798012271887
282,1554264000,46,12,0,58,14,0.0,-0.9878433755165306
282,1554278400,149,92,0,241,14,0.0,-0.7025802186101564
282,1554292800,675,299,0,974,14,0.0,0.44003122408040235
282,1554307200,921,159,0,1080,14,0.0,0.6052656209769907
282,1554321600,1963,176,0,2139,14,0.0,2.2560507748778114
282,1554336000,567,49,0,616,14,0.0,-0.11802456921184871
282,1554350400,47,16,0,63,14,0.0,-0.9800493001912198
282,1554364800,148,97,0,245,14,0.0,-0.6963449583499078
282,1554379200,677,300,0,977,14,0.0,0.4447076692755888
282,1554393600,938,160,0,1098,14,0.0,0.6333242921481095
282,1554408000,2081,216,0,2297,14,0.0,2.5023435551576316
282,1554422400,592,68,0,660,14,0.0,-0.04943670634911394
282,1554436800,71,13,0,84,14,0.0,-0.9473141838249146
282,1554451200,138,71,0,209,14,0.0,-0.7524623006921454
282,1554465600,692,259,0,951,14,0.0,0.40417847758397285
282,1554480000,1047,164,0,1211,14,0.0,0.8094703945001328
282,1554494400,1896,197,0,2093,14,0.0,2.1843452818849523
282,1554508800,310,58,0,368,14,0.0,-0.5046107053472628
282,1554523200,56,5,0,61,14,0.0,-0.9831669303213441
282,1554537600,21,13,0,34,14,0.0,-1.0252549370780222
282,1554552000,184,73,0,257,14,0.0,-0.6776391775691619
282,1554566400,465,135,0,600,14,0.0,-0.14296561025284318
282,1554580800,660,115,0,775,14,0.0,0.12982702613303373
282,1554595200,362,39,0,401,14,0.0,-0.4531698082002118
282,1554609600,62,9,0,71,14,0.0,-0.9675787796707226
282,1554624000,31,5,0,36,14,0.0,-1.022137306947898
282,1554638400,175,42,0,217,14,0.0,-0.7399917801716481
282,1554652800,435,67,0,502,14,0.0,-0.2957294866289343
282,1554667200,564,77,0,641,14,0.0,-0.07905419258529486
282,1554681600,215,20,0,235,14,0.0,-0.7119331090005293
282,1554696000,23,2,0,25,14,0.0,-1.0392842726635816
282,1554710400,146,95,0,241,14,0.0,-0.7025802186101564
282,1554724800,608,323,0,931,14,0.0,0.37300217628272975
282,1554739200,832,199,0,1031,14,0.0,0.5288836827889452
282,1554753600,1745,148,0,1893,14,0.0,1.8725822688725215
282,1554768000,464,65,0,529,15,0.0,-0.277189529776867
282,1554782400,38,18,0,56,15,0.0,-1.026495176605992
282,1554796800,156,102,0,258,15,0.0,-0.706495724894611
282,1554811200,608,323,0,931,15,0.0,0.3596410622428122
282,1554825600,923,173,0,1096,15,0.0,0.6210267529971581
282,1554840000,2030,188,0,2218,15,0.0,2.398449450126711
282,1554854400,545,55,0,600,15,0.0,-0.1647144749674212
282,1554868800,43,9,0,52,15,0.0,-1.032831799412158
282,1554883200,154,96,0,250,15,0.0,-0.719168970506943
282,1554897600,633,349,0,982,15,0.0,0.44043300302142824
282,1554912000,951,166,0,1117,15,0.0,0.6542940227295294
282,1554926400,1909,179,0,2088,15,0.0,2.192509208926317
282,1554940800,570,85,0,655,15,0.0,-0.0775859113826392
282,1554955200,74,7,0,81,15,0.0,-0.9868912840674549
282,1554969600,150,84,0,234,15,0.0,-0.7445154617316068
282,1554984000,651,283,0,934,15,0.0,0.3643935293474367
282,1554998400,968,179,0,1147,15,0.0,0.7018186937757742
282,1555012800,1951,181,0,2132,15,0.0,2.2622120597941424
282,1555027200,590,60,0,650,15,0.0,-0.08550668989034665
282,1555041600,63,17,0,80,15,0.0,-0.9884754397689963
282,1555056000,132,79,0,211,15,0.0,-0.7809510428670611
282,1555070400,626,328,0,954,15,0.0,0.3960766433782665
282,1555084800,962,220,0,1182,15,0.0,0.7572641433297264
282,1555099200,1834,194,0,2028,15,0.0,2.0974598668338276
282,1555113600,565,97,0,662,15,0.0,-0.06649682147184877
282,1555128000,74,28,0,102,15,0.0,-0.9536240143350835
282,1555142400,31,16,0,47,15,0.0,-1.0407525779198654
282,1555156800,172,139,0,311,15,0.0,-0.622535472712912
282,1555171200,477,192,0,669,15,0.0,-0.05540773156105833
282,1555185600,687,205,0,892,15,0.0,0.29785898988269405
282,1555200000,307,111,0,418,15,0.0,-0.45303081264797246
282,1555214400,67,26,0,93,15,0.0,-0.9678814156489569
282,1555228800,30,25,0,55,15,0.0,-1.0280793323075337
282,1555243200,124,108,0,232,15,0.0,-0.7476837731346897
282,1555257600,359,189,0,548,15,0.0,-0.2470905714475787
282,1555272000,530,125,0,655,15,0.0,-0.0775859113826392
282,1555286400,204,58,0,262,15,0.0,-0.700159102088445
282,1555300800,15,9,0,24,15,0.0,-1.0771881590553198
282,1555315200,146,94,0,240,15,0.0,-0.7350105275223578
282,1555329600,474,232,0,706,15,0.0,0.0032060293959768177
282,1555344000,857,171,0,1028,15,0.0,0.5133041652923368
282,1555358400,1936,222,0,2158,15,0.0,2.3034001080342215
282,1555372800,515,56,0,571,16,0.0,-0.22531550927671248
282,1555387200,39,12,0,51,16,0.0,-1.062486438606995
282,1555401600,156,101,0,257,16,0.0,-0.7308379550646138
282,1555416000,627,315,0,942,16,0.0,0.3719737499185467
282,1555430400,957,180,0,1137,16,0.0,0.6859128484174026
282,1555444800,1982,189,0,2171,16,0.0,2.350595042508772
282,1555459200,537,47,0,584,16,0.0,-0.20438623604345543
282,1555473600,44,9,0,53,16,0.0,-1.0592665504172631
282,1555488000,143,81,0,224,16,0.0,-0.7839661101951895
282,1555502400,667,329,0,996,16,0.0,0.4589107310413068
282,1555516800,967,249,0,1216,16,0.0,0.813098431911811
282,1555531200,1990,216,0,2206,16,0.0,2.4069430858290795
282,1555545600,581,53,0,634,16,0.0,-0.12388903130015903
282,1555560000,48,19,0,67,16,0.0,-1.03672733308914
282,1555574400,167,61,0,228,16,0.0,-0.7775263338157257
282,1555588800,680,327,0,1007,16,0.0,0.476620116084832
282,1555603200,990,194,0,1184,16,0.0,0.7615802208761012
282,1555617600,1916,176,0,2092,16,0.0,2.2234094590143636
282,1555632000,639,84,0,723,16,0.0,0.01939599314290854
282,1555646400,63,17,0,80,16,0.0,-1.0157980598558831
282,1555660800,100,79,0,179,16,0.0,-0.8564135944641562
282,1555675200,568,270,0,838,16,0.0,0.20453956405249024
282,1555689600,1084,194,0,1278,16,0.0,0.9129149657934985
282,1555704000,1543,158,0,1701,16,0.0,1.593921317921786
282,1555718400,471,67,0,538,16,0.0,-0.27844366440728807
282,1555732800,84,26,0,110,16,0.0,-0.9674997370099052
282,1555747200,43,36,0,79,16,0.0,-1.017408003950749
282,1555761600,212,160,0,372,16,0.0,-0.5456943841550321
282,1555776000,496,222,0,718,16,0.0,0.011346272668578902
282,1555790400,739,191,0,930,16,0.0,0.3526544207801556
282,1555804800,338,90,0,428,16,0.0,-0.4555375148425402
282,1555819200,62,24,0,86,16,0.0,-1.0061383952866874
282,1555833600,30,26,0,56,16,0.0,-1.0544367181326653
282,1555848000,156,118,0,274,16,0.0,-0.703468905451893
282,1555862400,395,169,0,564,16,0.0,-0.23658511794077397
282,1555876800,563,145,0,708,16,0.0,-0.004753168280080376
282,1555891200,241,58,0,299,16,0.0,-0.6632203030802448
282,1555905600,29,10,0,39,16,0.0,-1.081805767745386
282,1555920000,110,76,0,186,16,0.0,-0.8451439858000946
282,1555934400,590,336,0,926,16,0.0,0.3462146444006919
282,1555948800,827,197,0,1024,16,0.0,0.5039891656975528
282,1555963200,1904,200,0,2104,16,0.0,2.2427287881527547
282,1555977600,511,64,0,575,17,-0.15617376188860607,-0.25234509666577665
282,1555992000,38,5,0,43,17,-0.15617376188860607,-1.0937715762807765
282,1556006400,148,87,0,235,17,-0.15617376188860607,-0.7900988618332578
282,1556020800,648,325,0,973,17,-0.15617376188860607,0.37714313432439245
282,1556035200,1021,228,0,1249,17,-0.15617376188860607,0.8136726613427007
282,1556049600,2136,135,0,2271,17,-0.15617376188860607,2.4300972142873056
282,1556064000,580,48,0,628,17,-0.15617376188860607,-0.16851877444849284
282,1556078400,49,8,0,57,17,-0.15617376188860607,-1.071628774185645
282,1556092800,131,97,0,228,17,-0.15617376188860607,-0.8011702628808236
282,1556107200,609,334,0,943,17,-0.15617376188860607,0.3296942726919676
282,1556121600,869,208,0,1077,17,-0.15617376188860607,0.5416325213167984
282,1556136000,1923,172,0,2095,17,-0.15617376188860607,2.1517305593770804
282,1556150400,578,60,0,638,17,-0.15617376188860607,-0.1527024872376846
282,1556164800,53,13,0,66,17,-0.15617376188860607,-1.0573941156959175
282,1556179200,135,91,0,226,17,-0.15617376188860607,-0.8043335203229852
282,1556193600,647,303,0,950,17,-0.15617376188860607,0.3407656737395334
282,1556208000,881,219,0,1100,17,-0.15617376188860607,0.5780099819016574
282,1556222400,2086,205,0,2291,17,-0.15617376188860607,2.4617297887089222
282,1556236800,644,49,0,693,17,-0.15617376188860607,-0.0657129075782391
282,1556251200,68,18,0,86,17,-0.15617376188860607,-1.025761541274301
282,1556265600,126,90,0,216,17,-0.15617376188860607,-0.8201498075337935
282,1556280000,632,249,0,881,17,-0.15617376188860607,0.23163329198495636
282,1556294400,930,177,0,1107,17,-0.15617376188860607,0.5890813829492232
282,1556308800,1652,201,0,1853,17,-0.15617376188860607,1.76897640887552
282,1556323200,509,81,0,590,17,-0.15617376188860607,-0.22862066584956428
282,1556337600,97,22,0,119,17,-0.15617376188860607,-0.9735677934786338
282,1556352000,32,34,2,66,17,6.403124237432849,-1.0573941156959175
282,1556366400,243,169,0,412,17,-0.15617376188860607,-0.5101505782019514
282,1556380800,709,273,0,982,17,-0.15617376188860607,0.3913777928141199
282,1556395200,819,165,0,984,17,-0.15617376188860607,0.3945410502562815
282,1556409600,433,87,0,520,17,-0.15617376188860607,-0.33933467632522213
282,1556424000,97,19,0,116,17,-0.15617376188860607,-0.9783126796418762
282,1556438400,32,20,0,52,17,-0.15617376188860607,-1.0795369177910492
282,1556452800,181,150,0,331,17,-0.15617376188860607,-0.6382625046094984
282,1556467200,468,195,0,663,17,-0.15617376188860607,-0.11316176921066391
282,1556481600,667,121,0,788,17,-0.15617376188860607,0.08454182092443946
282,1556496000,293,61,0,354,17,-0.15617376188860607,-0.6018850440246394
282,1556510400,29,10,0,39,17,-0.15617376188860607,-1.1000980911651
282,1556524800,154,83,0,237,17,-0.15617376188860607,-0.7869356043910961
282,1556539200,575,308,0,883,17,-0.15617376188860607,0.234796549427118
282,1556553600,901,168,0,1069,17,-0.15617376188860607,0.5289794915481518
282,1556568000,1984,181,0,2165,17,-0.15617376188860607,2.2624445698527382
282,1556582400,542,55,0,597,18,-0.15617376188860604,-0.21573062084328382
282,1556596800,49,11,0,60,18,-0.15617376188860604,-1.0662092823534086
282,1556611200,145,73,0,218,18,-0.15617376188860604,-0.8159753372535954
282,1556625600,604,329,0,933,18,-0.15617376188860604,0.3164124522803698
282,1556640000,895,157,0,1052,18,-0.15617376188860604,0.5048797906783304
282,1556654400,1867,175,0,2042,18,-0.15617376188860604,2.0728013454176666
282,1556668800,582,48,0,630,18,-0.15617376188860604,-0.16346656901863926
282,1556683200,62,9,0,71,18,-0.15617376188860604,-1.0487879317451938
282,1556697600,135,77,0,212,18,-0.15617376188860604,-0.8254778921308036
282,1556712000,651,322,0,973,18,-0.15617376188860604,0.3797628181284238
282,1556726400,985,188,0,1173,18,-0.15617376188860604,0.6965146473686937
282,1556740800,2030,186,0,2216,18,-0.15617376188860604,2.3483754368567014
282,1556755200,595,54,0,649,18,-0.15617376188860604,-0.13337514524081362
282,1556769600,53,6,0,59,18,-0.15617376188860604,-1.06779304149961
282,1556784000,123,81,0,204,18,-0.15617376188860604,-0.8381479653004144
282,1556798400,656,364,0,1020,18,-0.15617376188860604,0.45419949799988724
282,1556812800,953,135,0,1088,18,-0.15617376188860604,0.561895119941579
282,1556827200,2076,205,0,2281,18,-0.15617376188860604,2.451319781359789
282,1556841600,586,71,0,657,18,-0.15617376188860604,-0.1207050720712028
282,1556856000,74,16,0,90,18,-0.15617376188860604,-1.0186965079673682
282,1556870400,130,77,0,207,18,-0.15617376188860604,-0.8333966878618103
282,1556884800,661,281,0,942,18,-0.15617376188860604,0.3306662845961819
282,1556899200,988,180,0,1168,18,-0.15617376188860604,0.688595851637687
282,1556913600,1715,215,0,1930,18,-0.15617376188860604,1.8954203210431155
282,1556928000,567,82,0,649,18,-0.15617376188860604,-0.13337514524081362
282,1556942400,96,19,0,115,18,-0.15617376188860604,-0.9791025293123344
282,1556956800,32,28,0,60,18,-0.15617376188860604,-1.0662092823534086
282,1556971200,240,147,0,387,18,-0.15617376188860604,-0.5483200415455672
282,1556985600,614,253,0,867,18,-0.15617376188860604,0.2118843486310807
282,1557000000,813,198,0,1011,18,-0.15617376188860604,0.43994566568407506
282,1557014400,445,73,0,518,18,-0.15617376188860604,-0.34084759339319043
282,1557028800,91,15,0,106,18,-0.15617376188860604,-0.9933563616281467
282,1557043200,23,24,1,47,18,6.403124237432848,-1.0867981512540263
282,1557057600,188,155,0,343,18,-0.15617376188860604,-0.6180054439784267
282,1557072000,488,217,0,705,18,-0.15617376188860604,-0.04468463305353801
282,1557086400,623,157,0,780,18,-0.15617376188860604,0.07409730291156323
282,1557100800,262,37,0,299,18,-0.15617376188860604,-0.6876908464112861
282,1557115200,27,9,0,36,18,-0.15617376188860604,-1.1042195018622412
282,1557129600,145,95,0,240,18,-0.15617376188860604,-0.7811326360371658
282,1557144000,619,337,0,956,18,-0.15617376188860604,0.3528389126430008
282,1557158400,861,160,0,1021,18,-0.15617376188860604,0.4557832571460886
282,1557172800,1994,189,0,2183,18,-0.15617376188860604,2.296111385032057
282,1557187200,516,46,0,562,19,-0.15617376188860604,-0.27575885457703714
282,1557201600,46,12,0,58,19,-0.15617376188860604,-1.0861522231299625
282,1557216000,174,91,0,265,19,-0.15617376188860604,-0.7533120896171539
282,1557230400,692,303,0,995,19,-0.15617376188860604,0.42047195610434523
282,1557244800,920,158,0,1078,19,-0.15617376188860604,0.5539295941795294
282,1557259200,1912,196,0,2108,19,-0.15617376188860604,2.2100906449920554
282,1557273600,610,63,0,673,19,-0.15617376188860604,-0.09727936269335712
282,1557288000,52,13,0,65,19,-0.15617376188860604,-1.0748967596778385
282,1557302400,152,84,0,236,19,-0.15617376188860604,-0.7999418667759531
282,1557316800,664,291,0,955,19,-0.15617376188860604,0.3561550220922083
282,1557331200,908,191,0,1099,19,-0.15617376188860604,0.5876959845359012
282,1557345600,1884,169,0,2053,19,-0.15617376188860604,2.1216548607253674
282,1557360000,556,71,0,627,19,-0.15617376188860604,-0.1712438368073146
282,1557374400,48,17,0,65,19,-0.15617376188860604,-1.0748967596778385
282,1557388800,145,74,0,219,19,-0.15617376188860604,-0.8272765637311114
282,1557403200,645,352,0,997,19,-0.15617376188860604,0.42368780280495205
282,1557417600,965,195,0,1160,19,-0.15617376188860604,0.6857793089044101
282,1557432000,2076,187,0,2263,19,-0.15617376188860604,2.459318764289086
282,1557446400,647,52,0,699,19,-0.15617376188860604,-0.055473355585468107
282,1557460800,63,13,0,76,19,-0.15617376188860604,-1.0572096028245008
282,1557475200,128,87,0,215,19,-0.15617376188860604,-0.833708257132325
282,1557489600,624,245,0,869,19,-0.15617376188860604,0.21787361396611388
282,1557504000,1044,199,0,1243,19,-0.15617376188860604,0.8192369469795943
282,1557518400,1704,223,0,1927,19,-0.15617376188860604,1.9190565185871358
282,1557532800,559,98,0,657,19,-0.15617376188860604,-0.12300613629821189
282,1557547200,107,24,0,131,19,-0.15617376188860604,-0.9687738185578126
282,1557561600,37,31,0,68,19,-0.15617376188860604,-1.0700729896269283
282,1557576000,214,188,0,402,19,-0.15617376188860604,-0.5330265906255849
282,1557590400,590,251,0,841,19,-0.15617376188860604,0.17285176015761802
282,1557604800,870,205,0,1075,19,-0.15617376188860604,0.5491058241286191
282,1557619200,435,104,0,539,19,-0.15617376188860604,-0.31274109163401587
282,1557633600,90,29,0,119,19,-0.15617376188860604,-0.9880688987614537
282,1557648000,28,30,2,58,19,6.403124237432848,-1.0861522231299625
282,1557662400,179,138,0,317,19,-0.15617376188860604,-0.6697000754013759
282,1557676800,451,219,0,670,19,-0.15617376188860604,-0.10210313274426738
282,1557691200,494,183,0,677,19,-0.15617376188860604,-0.09084766929214343
282,1557705600,237,58,0,295,19,-0.15617376188860604,-0.7050743891080512
282,1557720000,26,9,0,35,19,-0.15617376188860604,-1.1231344601869413
282,1557734400,134,106,0,240,19,-0.15617376188860604,-0.7935101733747394
282,1557748800,605,330,0,935,19,-0.15617376188860604,0.32399655508613984
282,1557763200,973,156,0,1129,19,-0.15617376188860604,0.6359336850450039
282,1557777600,1939,173,0,2112,19,-0.15617376188860604,2.2165223383932693
282,1557792000,474,54,0,528,20,-0.15617376188860604,-0.3657677869497192
282,1557806400,48,9,0,57,20,-0.15617376188860604,-1.1221569110809488
282,1557820800,172,88,0,260,20,-0.15617376188860604,-0.7961548045020962
282,1557835200,613,308,0,921,20,-0.15617376188860604,0.2653594440132814
282,1557849600,984,183,0,1167,20,-0.15617376188860604,0.6604161840053886
282,1557864000,2047,218,0,2265,20,-0.15617376188860604,2.4237182186043063
282,1557878400,601,45,0,646,20,-0.15617376188860604,-0.17626902549009052
282,1557892800,52,10,0,62,20,-0.15617376188860604,-1.114127302544524
282,1557907200,174,87,0,261,20,-0.15617376188860604,-0.7945488827948112
282,1557921600,662,342,0,1004,20,-0.15617376188860604,0.39865094571793547
282,1557936000,988,166,0,1154,20,-0.15617376188860604,0.6395392018106838
282,1557950400,1955,185,0,2140,20,-0.15617376188860604,2.2229780051936827
282,1557964800,647,67,0,714,20,-0.15617376188860604,-0.06706634939471129
282,1557979200,63,21,0,84,20,-0.15617376188860604,-1.0787970249842542
282,1557993600,159,83,0,242,20,-0.15617376188860604,-0.825061395233226
282,1558008000,651,343,0,994,20,-0.15617376188860604,0.38259172864508556
282,1558022400,973,187,0,1160,20,-0.15617376188860604,0.6491747320543937
282,1558036800,2009,151,0,2160,20,-0.15617376188860604,2.2550964393393826
282,1558051200,700,52,0,752,20,-0.15617376188860604,-0.006041324517881711
282,1558065600,75,22,0,97,20,-0.15617376188860604,-1.0579200427895494
282,1558080000,140,79,0,219,20,-0.15617376188860604,-0.8619975945007807
282,1558094400,608,252,0,860,20,-0.15617376188860604,0.16739821986889708
282,1558108800,1026,185,0,1211,20,-0.15617376188860604,0.7310767391259282
282,1558123200,1872,187,0,2059,20,-0.15617376188860604,2.0928983469035987
282,1558137600,589,96,0,685,20,-0.15617376188860604,-0.11363807890597596
282,1558152000,122,24,0,146,20,-0.15617376188860604,-0.979229879132585
282,1558166400,38,25,0,63,20,-0.15617376188860604,-1.112521380837239
282,1558180800,239,154,0,393,20,-0.15617376188860604,-0.5825672174331927
282,1558195200,632,203,0,835,20,-0.15617376188860604,0.12725017718677237
282,1558209600,880,137,0,1017,20,-0.15617376188860604,0.4195279279126403
282,1558224000,475,90,0,565,20,-0.15617376188860604,-0.3063486837801746
282,1558238400,111,30,0,141,20,-0.15617376188860604,-0.9872594876690098
282,1558252800,38,18,0,56,20,-0.15617376188860604,-1.1237628327882339
282,1558267200,172,179,7,351,20,6.4031242374328485,-0.6500159291391622
282,1558281600,630,257,0,887,20,-0.15617376188860604,0.21075810596559177
282,1558296000,735,161,0,896,20,-0.15617376188860604,0.22521140133115666
282,1558310400,322,69,0,391,20,-0.15617376188860604,-0.5857790608477627
282,1558324800,45,18,0,63,20,-0.15617376188860604,-1.112521380837239
282,1558339200,155,76,0,231,20,-0.15617376188860604,-0.8427265340133608
282,1558353600,613,344,0,957,20,-0.15617376188860604,0.323172625475541
282,1558368000,950,170,0,1120,20,-0.15617376188860604,0.5849378637629942
282,1558382400,1766,162,0,1928,20,-0.15617376188860604,1.882522603249265
282,1558396800,529,60,0,589,21,-0.28988551782622424,-0.12534623050181853
282,1558411200,65,7,0,72,21,-0.28988551782622424,-1.007172828693568
282,1558425600,170,98,0,268,21,-0.28988551782622424,-0.6728633253171986
282,1558440000,666,279,0,945,21,-0.28988551782622424,0.48186898991648464
282,1558454400,995,190,0,1185,21,-0.28988551782622424,0.8912275654793856
282,1558468800,2036,192,0,2228,21,-0.28988551782622424,2.670231708446493
282,1558483200,682,50,0,732,21,-0.28988551782622424,0.11856325410440999
282,1558497600,56,18,0,74,21,-0.28988551782622424,-1.0037615072305437
282,1558512000,159,105,0,264,21,-0.28988551782622424,-0.679685968243247
282,1558526400,680,276,0,956,21,-0.28988551782622424,0.5006312579631176
282,1558540800,1025,180,0,1205,21,-0.28988551782622424,0.9253407801096274
282,1558555200,2039,226,0,2265,21,-0.28988551782622424,2.73334115551244
282,1558569600,634,61,0,695,21,-0.28988551782622424,0.055453807038462755
282,1558584000,59,12,0,71,21,-0.28988551782622424,-1.00887848942508
282,1558598400,142,104,0,246,21,-0.28988551782622424,-0.7103878614104646
282,1558612800,636,320,0,956,21,-0.28988551782622424,0.5006312579631176
282,1558627200,949,172,0,1121,21,-0.28988551782622424,0.7820652786626121
282,1558641600,1986,163,0,2149,21,-0.28988551782622424,2.535484510657038
282,1558656000,639,61,0,700,21,-0.28988551782622424,0.06398211069602319
282,1558670400,60,18,0,78,21,-0.28988551782622424,-0.9969388643044953
282,1558684800,124,65,0,189,21,-0.28988551782622424,-0.8076105231066536
282,1558687204,91,28,0,119,21,-0.28988551782622424,-0.9270067743124997
282,1558699200,461,201,0,662,21,-0.28988551782622424,-0.0008329971014361403
282,1558713600,1267,209,0,1476,21,-0.28988551782622424,1.387574838349403
282,1558728000,1409,193,0,1602,21,-0.28988551782622424,1.6024880905199261
282,1558742400,474,126,0,600,21,-0.28988551782622424,-0.10658396245518557
282,1558756800,110,34,0,144,21,-0.28988551782622424,-0.8843652560246975
282,1558771200,36,40,4,76,21,4.696145388784833,-1.0003501857675194
282,1558785600,200,201,1,401,21,0.95662220882654,-0.446010448026091
282,1558800000,577,268,0,845,21,-0.28988551782622424,0.3113029167652759
282,1558814400,738,212,0,950,21,-0.28988551782622424,0.4903972935740451
282,1558828800,368,109,0,477,21,-0.28988551782622424,-0.31638023243117236
282,1558843200,84,21,0,105,21,-0.28988551782622424,-0.950886024553669
282,1558857600,24,26,2,50,21,2.2031299354793044,-1.0446973647868338
282,1558872000,158,156,0,314,21,-0.28988551782622424,-0.5944029316676427
282,1558886400,448,251,0,699,21,-0.28988551782622424,0.0622764499645111
282,1558900800,549,207,0,756,21,-0.28988551782622424,0.1594991116607001
282,1558915200,303,90,0,393,21,-0.28988551782622424,-0.4596557338781877
282,1558929600,55,21,0,76,21,-0.28988551782622424,-1.0003501857675194
282,1558944000,18,21,3,39,21,3.449637662132069,-1.0634596328334667
282,1558958400,176,163,0,339,21,-0.28988551782622424,-0.5517614133798404
282,1558972800,435,195,0,630,21,-0.28988551782622424,-0.05541414050982294
282,1558987200,615,131,0,746,21,-0.28988551782622424,0.14244250434557923
282,1559001600,295,61,0,356,22,-0.15617376188860602,-0.5500916617804048
282,1559016000,31,16,0,47,22,-0.15617376188860602,-1.0281343554047582
282,1559030400,141,86,0,227,22,-0.15617376188860602,-0.7496628833905717
282,1559044800,609,360,0,969,22,-0.15617376188860602,0.3982584068012413
282,1559059200,890,208,0,1098,22,-0.15617376188860602,0.5978296284114082
282,1559073600,1924,208,0,2132,22,-0.15617376188860602,2.1974935287595683
282,1559088000,480,38,0,518,22,-0.15617376188860602,-0.299467336967637
282,1559102400,62,5,0,67,22,-0.15617376188860602,-0.9971930807365152
282,1559116800,141,91,0,232,22,-0.15617376188860602,-0.7419275647235111
282,1559131200,650,379,0,1029,22,-0.15617376188860602,0.4910822308059701
282,1559145600,939,190,0,1129,22,-0.15617376188860602,0.6457886041471848
282,1559160000,2031,200,0,2231,22,-0.15617376188860602,2.350652838367371
282,1559174400,426,32,0,458,22,-0.15617376188860602,-0.3922911609723658
282,1559188800,44,3,0,47,22,-0.15617376188860602,-1.0281343554047582
282,1559203200,134,63,0,197,22,-0.15617376188860602,-0.7960747953929361
282,1559217600,633,380,0,1013,22,-0.15617376188860602,0.46632921107137576
282,1559232000,868,172,0,1040,22,-0.15617376188860602,0.5080999318735037
282,1559246400,2058,173,0,2231,22,-0.15617376188860602,2.350652838367371
282,1559260800,480,30,0,510,22,-0.15617376188860602,-0.31184384683493416
282,1559275200,50,10,0,60,22,-0.15617376188860602,-1.0080225268704004
282,1559289600,133,102,0,235,22,-0.15617376188860602,-0.7372863735232745
282,1559304000,638,350,0,988,22,-0.15617376188860602,0.42765261773607205
282,1559318400,1059,174,0,1233,22,-0.15617376188860602,0.8066832324220481
282,1559332800,1743,196,0,1939,22,-0.15617376188860602,1.898910228211024
282,1559347200,463,43,0,506,22,-0.15617376188860602,-0.31803210176858276
282,1559361600,97,14,0,111,22,-0.15617376188860602,-0.9291222764663808
282,1559376000,29,34,5,63,22,6.403124237432848,-1.0033813356701637
282,1559390400,217,159,0,376,22,-0.15617376188860602,-0.5191503871121619
282,1559404800,591,246,0,837,22,-0.15617376188860602,0.19404599399083788
282,1559419200,738,136,0,874,22,-0.15617376188860602,0.2512873521270873
282,1559433600,254,54,0,308,22,-0.15617376188860602,-0.6243507209841879
282,1559448000,93,12,0,105,22,-0.15617376188860602,-0.9384046588668536
282,1559462400,30,26,0,56,22,-0.15617376188860602,-1.0142107818040489
282,1559476800,158,131,0,289,22,-0.15617376188860602,-0.6537449319190186
282,1559491200,512,231,0,743,22,-0.15617376188860602,0.04862200305009607
282,1559505600,730,143,0,873,22,-0.15617376188860602,0.24974028839367518
282,1559520000,207,53,0,260,22,-0.15617376188860602,-0.6986097801879709
282,1559534400,40,7,0,47,22,-0.15617376188860602,-1.0281343554047582
282,1559548800,130,82,0,212,22,-0.15617376188860602,-0.772868839391754
282,1559563200,616,341,0,957,22,-0.15617376188860602,0.37969364200029554
282,1559577600,912,186,0,1098,22,-0.15617376188860602,0.5978296284114082
282,1559592000,1964,221,0,2185,22,-0.15617376188860602,2.279487906630412
282,1559606400,552,69,0,621,23,-0.16387112209638077,-0.18711157930863268
282,1559620800,54,16,0,70,23,-0.16387112209638077,-1.0785723974384205
282,1559635200,164,92,0,256,23,-0.16387112209638077,-0.7776437002113052
282,1559636135,45,15,0,60,23,-0.16387112209638077,-1.094751359654932
282,1559649600,630,332,0,962,23,-0.16387112209638077,0.3645910322744121
282,1559664000,970,175,0,1145,23,-0.16387112209638077,0.660666040836574
282,1559678400,1783,124,0,1907,23,-0.16387112209638077,1.8935029617347563
282,1559692800,704,61,0,765,23,-0.16387112209638077,0.04586547660913404
282,1559707200,58,19,0,77,23,-0.16387112209638077,-1.0672471238868624
282,1559721600,126,91,0,217,23,-0.16387112209638077,-0.8407416528557003
282,1559736000,678,331,0,1009,23,-0.16387112209638077,0.4406321546920165
282,1559750400,889,186,0,1075,23,-0.16387112209638077,0.547413305320993
282,1559764800,1984,183,0,2167,23,-0.16387112209638077,2.3141559793640574
282,1559779200,705,73,0,778,23,-0.16387112209638077,0.06689812749059909
282,1559793600,57,9,0,66,23,-0.16387112209638077,-1.085043982325025
282,1559808000,137,83,0,220,23,-0.16387112209638077,-0.8358879641907468
282,1559822400,678,288,0,966,23,-0.16387112209638077,0.37106261716101674
282,1559836800,830,193,0,1023,23,-0.16387112209638077,0.4632827017951327
282,1559851200,2010,209,0,2219,23,-0.16387112209638077,2.3982865828899174
282,1559865600,743,78,0,821,23,-0.16387112209638077,0.13646766502159888
282,1559880000,100,12,0,112,23,-0.16387112209638077,-1.0106207561290719
282,1559894400,131,100,0,231,23,-0.16387112209638077,-0.8180911057525841
282,1559908800,633,279,0,912,23,-0.16387112209638077,0.2836962211918542
282,1559923200,1134,178,0,1312,23,-0.16387112209638077,0.9308547098523173
282,1559937600,1820,191,0,2011,23,-0.16387112209638077,2.0617641687864765
282,1559952000,608,106,0,714,23,-0.16387112209638077,-0.03664723069507501
282,1559966400,108,26,0,134,23,-0.16387112209638077,-0.9750270392527465
282,1559980800,43,44,1,87,23,0.2506264220297588,-1.0510681616703508
282,1559995200,216,177,0,393,23,-0.16387112209638077,-0.5559919178450966
282,1560009600,610,299,0,909,23,-0.16387112209638077,0.2788425325269007
282,1560024000,617,295,0,912,23,-0.16387112209638077,0.2836962211918542
282,1560038400,317,140,0,457,23,-0.16387112209638077,-0.45244655965942254
282,1560052800,96,38,0,134,23,-0.16387112209638077,-0.9750270392527465
282,1560067200,28,25,0,53,23,-0.16387112209638077,-1.1060766332064902
282,1560081600,172,188,16,360,23,6.468089583921853,-0.6093824931595848
282,1560096000,502,297,0,799,23,-0.16387112209638077,0.1008739481452734
282,1560110400,664,192,0,856,23,-0.16387112209638077,0.19309403277938939
282,1560124800,327,103,0,430,23,-0.16387112209638077,-0.4961297576440038
282,1560139200,35,19,0,54,23,-0.16387112209638077,-1.104458736984839
282,1560153600,146,82,0,228,23,-0.16387112209638077,-0.8229447944175377
282,1560168000,629,305,0,934,23,-0.16387112209638077,0.3192899380681797
282,1560182400,887,154,0,1041,23,-0.16387112209638077,0.49240483378485356
282,1560196800,1992,187,0,2179,23,-0.16387112209638077,2.3335707340238714
282,1560211200,535,43,0,578,24,0.0,-0.38031923106079957
282,1560225600,44,26,0,70,24,0.0,-1.1201039200594447
282,1560240000,151,98,0,249,24,0.0,-0.8594317560225205
282,1560254400,629,290,0,919,24,0.0,0.11626852277490524
282,1560268800,842,193,0,1035,24,0.0,0.2851957352234148
282,1560283200,2055,218,0,2273,24,0.0,2.088056847389405
282,1560297600,656,49,0,705,24,0.0,-0.19537305881113823
282,1560312000,59,7,0,66,24,0.0,-1.1259289963507726
282,1560326400,156,85,0,241,24,0.0,-0.8710819086051764
282,1560328453,114,31,0,145,24,0.0,-1.0108837395970465
282,1560340800,558,288,0,846,24,0.0,0.009960880458170781
282,1560355200,956,186,0,1142,24,0.0,0.4410165260164365
282,1560369600,2095,209,0,2304,24,0.0,2.133201188647196
282,1560384000,659,44,0,703,24,0.0,-0.1982855969568022
282,1560398400,53,11,0,64,24,0.0,-1.1288415344964366
282,1560412800,142,106,0,248,24,0.0,-0.8608880250953526
282,1560427200,657,342,0,999,24,0.0,0.23277004860146355
282,1560441600,920,181,0,1101,24,0.0,0.3813094940303254
282,1560456000,1815,203,0,2018,24,0.0,1.7167082338172501
282,1560470400,706,62,0,768,24,0.0,-0.10362810722272357
282,1560484800,72,9,0,81,24,0.0,-1.104084960258293
282,1560499200,137,65,0,202,24,0.0,-0.9278764024456235
282,1560513600,614,279,0,893,24,0.0,0.07840552688127378
282,1560528000,1158,204,0,1362,24,0.0,0.7613957220394718
282,1560542400,1745,222,0,1967,24,0.0,1.6424385111028192
282,1561161600,5713,512,0,6225,25,-0.3280326688167687,3.840899939311528
282,1561176000,129,34,0,163,25,-0.3280326688167687,-0.548033444755208
282,1561190400,46,50,4,96,25,-0.08702907540036721,-0.5965419463606966
282,1561204800,211,281,70,492,25,3.889530215970257,-0.30983498164766
282,1561219200,592,290,0,882,25,-0.3280326688167687,-0.02747206185451796
282,1561233600,809,316,0,1125,25,-0.3280326688167687,0.148461757401209
282,1561248000,461,113,0,574,25,-0.3280326688167687,-0.25046636774243525
282,1561262400,89,34,0,123,25,-0.3280326688167687,-0.5769937442211713
282,1561276800,34,28,0,62,25,-0.3280326688167687,-0.6211582009067653
282,1561291200,196,220,24,416,25,1.1179888916816403,-0.36485955063299025
282,1561305600,521,296,0,817,25,-0.3280326688167687,-0.0745325484867083
282,1561320000,696,223,0,919,25,-0.3280326688167687,-0.0006837848485019201
282,1561334400,296,79,0,375,25,-0.3280326688167687,-0.3945438575856026
282,1561348800,41,10,0,51,25,-0.3280326688167687,-0.6291222832599053
282,1561363200,124,90,0,214,25,-0.3280326688167687,-0.5111090629361048
282,1561377600,558,349,0,907,25,-0.3280326688167687,-0.009371874688290906
282,1561392000,789,225,0,1014,25,-0.3280326688167687,0.06809692638316088
282,1561406400,1898,206,0,2104,25,-0.3280326688167687,0.8572650868306605
282,1561420800,559,41,0,600,26,-0.15617376188860604,-0.25790951284433505
282,1561435200,48,10,0,58,26,-0.15617376188860604,-1.1152477357398436
282,1561449600,140,108,0,248,26,-0.15617376188860604,-0.8147048162746285
282,1561464000,668,369,0,1037,26,-0.15617376188860604,0.43333920192565994
282,1561478400,817,206,0,1023,26,-0.15617376188860604,0.41119393417559147
282,1561492800,2057,180,0,2237,26,-0.15617376188860604,2.3315050090743874
282,1561507200,623,50,0,673,26,-0.15617376188860604,-0.1424377595761208
282,1561521600,76,6,0,82,26,-0.15617376188860604,-1.0772844195968692
282,1561536000,144,77,0,221,26,-0.15617376188860604,-0.8574135469354749
282,1561550400,735,345,0,1080,26,-0.15617376188860604,0.501356810015156
282,1561564800,939,161,0,1100,26,-0.15617376188860604,0.5329929068009681
282,1561579200,2014,187,0,2201,26,-0.15617376188860604,2.2745600348599258
282,1561593600,678,67,0,745,26,-0.15617376188860604,-0.02854781114719712
282,1561608000,63,6,0,69,26,-0.15617376188860604,-1.097847882507647
282,1561622400,149,89,0,238,26,-0.15617376188860604,-0.8305228646675346
282,1561636800,651,328,0,979,26,-0.15617376188860604,0.3415945212468048
282,1561651200,968,211,0,1179,26,-0.15617376188860604,0.6579554891049261
282,1561665600,1985,215,0,2200,26,-0.15617376188860604,2.272978230020635
282,1561680000,720,72,0,792,26,-0.15617376188860604,0.04579701629946138
282,1561694400,93,17,0,110,26,-0.15617376188860604,-1.032993884096732
282,1561708800,129,95,0,224,26,-0.15617376188860604,-0.8526681324176031
282,1561723200,615,342,0,957,26,-0.15617376188860604,0.30679481478241144
282,1561737600,1145,235,0,1380,26,-0.15617376188860604,0.975898261802338
282,1561752000,1715,241,0,1956,26,-0.15617376188860604,1.8870178492337273
282,1561766400,619,98,0,717,26,-0.15617376188860604,-0.0728383466473341
282,1561780800,112,19,0,131,26,-0.15617376188860604,-0.9997759824716295
282,1561795200,47,30,0,77,26,-0.15617376188860604,-1.0851934437933222
282,1561809600,239,180,0,419,26,-0.15617376188860604,-0.5442161887559348
282,1561824000,591,216,0,807,26,-0.15617376188860604,0.06952408888882047
282,1561838400,764,169,0,933,26,-0.15617376188860604,0.2688314986394369
282,1561852800,415,101,0,516,26,-0.15617376188860604,-0.39078111934474596
282,1561867200,70,18,0,88,26,-0.15617376188860604,-1.0677935905611255
282,1561881600,23,24,1,47,26,6.403124237432848,-1.1326475889720404
282,1561896000,169,160,0,329,26,-0.15617376188860604,-0.6865786242920894
282,1561910400,486,262,0,748,26,-0.15617376188860604,-0.023802396629325297
282,1561924800,840,150,0,990,26,-0.15617376188860604,0.35899437447900145
282,1561939200,430,66,0,496,26,-0.15617376188860604,-0.4224172161305581
282,1561953600,54,15,0,69,26,-0.15617376188860604,-1.097847882507647
282,1561968000,143,79,0,222,26,-0.15617376188860604,-0.8558317420961843
282,1561982400,577,330,0,907,26,-0.15617376188860604,0.22770457281788112
282,1561996800,838,226,0,1064,26,-0.15617376188860604,0.4760479325865063
282,1562011200,1885,214,0,2099,26,-0.15617376188860604,2.113215941252284
282,1562025600,588,57,0,645,27,-0.2496630554359972,0.09388996799883129
282,1562040000,58,11,0,69,27,-0.2496630554359972,-1.0146440026345138
282,1562054400,119,92,0,211,27,-0.2496630554359972,-0.7413595862630988
282,1562068800,595,262,0,857,27,-0.2496630554359972,0.5018920544124931
282,1562083200,891,227,0,1118,27,-0.2496630554359972,1.0041965098557275
282,1562097600,1956,216,0,2172,27,-0.2496630554359972,3.0326597130632718
282,1562112000,577,55,0,632,27,-0.2496630554359972,0.06887097213384259
282,1562126400,56,16,0,72,27,-0.2496630554359972,-1.0088703882041319
282,1562140800,109,90,0,199,27,-0.2496630554359972,-0.7644540439846269
282,1562155200,547,290,0,837,27,-0.2496630554359972,0.46340129154327964
282,1562169600,1208,183,0,1391,27,-0.2496630554359972,1.52959542302049
282,1562184000,1396,173,0,1569,27,-0.2496630554359972,1.872163212556489
282,1562198400,576,69,0,645,27,-0.2496630554359972,0.09388996799883129
282,1562212800,65,8,0,73,27,-0.2496630554359972,-1.0069458500606712
282,1562227200,42,22,0,64,27,-0.2496630554359972,-1.0242666933518172
282,1562241600,179,116,0,295,27,-0.2496630554359972,-0.5796983822124027
282,1562256000,416,176,0,592,27,-0.2496630554359972,-0.008110553604584153
282,1562270400,418,141,0,559,27,-0.2496630554359972,-0.07162031233878621
282,1562284800,237,128,0,365,27,-0.2496630554359972,-0.44498071217015595
282,1562299200,33,30,0,63,27,-0.2496630554359972,-1.026191231495278
282,1562313600,38,63,25,101,27,0.7433150059571736,-0.9530587820437724
282,1562328000,290,233,0,523,27,-0.2496630554359972,-0.1409036855033703
282,1562342400,682,243,0,925,27,-0.2496630554359972,0.6327606481678185
282,1562356800,958,212,0,1170,27,-0.2496630554359972,1.1042724933156822
282,1562371200,391,84,0,475,27,-0.2496630554359972,-0.23328151638948239
282,1562385600,88,15,0,103,27,-0.2496630554359972,-0.949209705756851
282,1562400000,36,44,8,80,27,0.06808992420981742,-0.9934740830564465
282,1562414400,169,315,146,484,27,5.5493288231001205,-0.21596067309833636
282,1562428800,504,373,0,877,27,-0.2496630554359972,0.5403828172817063
282,1562443200,586,287,0,873,27,-0.2496630554359972,0.5326846647078637
282,1562457600,318,132,0,450,27,-0.2496630554359972,-0.2813949699759991
282,1562472000,50,23,0,73,27,-0.2496630554359972,-1.0069458500606712
282,1562486400,20,26,6,46,27,-0.011348320701636232,-1.0589083799341092
282,1562500800,133,212,79,345,27,2.888147618566422,-0.48347147503936927
282,1562515200,373,342,0,715,27,-0.2496630554359972,0.2286076380410781
282,1562529600,584,248,0,832,27,-0.2496630554359972,0.4537786008259763
282,1562544000,293,77,0,370,27,-0.2496630554359972,-0.4353580214528526
282,1562558400,28,7,0,35,27,-0.2496630554359972,-1.0800782995121765
282,1562572800,138,97,0,235,27,-0.2496630554359972,-0.6951706708200428
282,1562587200,544,326,0,870,27,-0.2496630554359972,0.5269110502774818
282,1562601600,757,186,0,943,27,-0.2496630554359972,0.6674023347501106
282,1562616000,1901,187,0,2088,27,-0.2496630554359972,2.870998509012576
282,1562630400,499,60,0,559,28,-0.15617376188860604,-0.27851361142288594
282,1562644800,41,11,0,52,28,-0.15617376188860604,-1.0653875455663027
282,1562659200,147,79,0,226,28,-0.15617376188860604,-0.7953361362153076
282,1562673600,617,303,0,920,28,-0.15617376188860604,0.2817654620007304
282,1562688000,873,227,0,1100,28,-0.15617376188860604,0.561128988915553
282,1562702400,2030,204,0,2234,28,-0.15617376188860604,2.321119208478935
282,1562716800,663,75,0,738,28,-0.15617376188860604,-0.0007021041020346237
282,1562731200,55,14,0,69,28,-0.15617376188860604,-1.0390032124687918
282,1562745600,142,117,0,259,28,-0.15617376188860604,-0.7441194896142568
282,1562760000,669,376,0,1045,28,-0.15617376188860604,0.4757679112471349
282,1562774400,913,213,0,1126,28,-0.15617376188860604,0.601481498358805
282,1562788800,2017,201,0,2218,28,-0.15617376188860604,2.296286894975395
282,1562803200,590,69,0,659,28,-0.15617376188860604,-0.12331165202576229
282,1562817600,65,13,0,78,28,-0.15617376188860604,-1.0250350361230507
282,1562832000,156,71,0,227,28,-0.15617376188860604,-0.7937841166213364
282,1562846400,663,245,0,908,28,-0.15617376188860604,0.26314122687307556
282,1562860800,889,181,0,1070,28,-0.15617376188860604,0.5145684010964159
282,1562875200,1974,254,0,2228,28,-0.15617376188860604,2.3118070909151074
282,1562889600,616,60,0,676,28,-0.15617376188860604,-0.09692731892825128
282,1562904000,56,17,0,73,28,-0.15617376188860604,-1.0327951340929067
282,1562918400,134,101,0,235,28,-0.15617376188860604,-0.7813679598695665
282,1562932800,619,262,0,881,28,-0.15617376188860604,0.22123669783585218
282,1562947200,1084,193,0,1277,28,-0.15617376188860604,0.8358364570484618
282,1562961600,1859,181,0,2040,28,-0.15617376188860604,2.020027407248515
282,1562976000,586,101,0,687,28,-0.15617376188860604,-0.07985510339456768
282,1562990400,108,19,0,127,28,-0.15617376188860604,-0.94898607601846
282,1563004800,44,31,0,75,28,-0.15617376188860604,-1.0296910949049642
282,1563019200,215,203,0,418,28,-0.15617376188860604,-0.49734837417283023
282,1563033600,561,324,0,885,28,-0.15617376188860604,0.22744477621173712
282,1563048000,729,266,0,995,28,-0.15617376188860604,0.39816693154857313
282,1563062400,134,84,0,218,28,-0.15617376188860604,-0.8077522929670775
282,1563076800,47,21,0,68,28,-0.15617376188860604,-1.040555232062763
282,1563091200,24,22,0,46,28,-0.15617376188860604,-1.0746996631301302
282,1563105600,177,181,4,358,28,6.403124237432848,-0.5904695498111044
282,1563120000,453,275,0,728,28,-0.15617376188860604,-0.016222300041746986
282,1563134400,617,193,0,810,28,-0.15617376188860604,0.11104330666389439
282,1563148800,307,78,0,385,28,-0.15617376188860604,-0.548565020773881
282,1563163200,29,10,0,39,28,-0.15617376188860604,-1.0855638002879289
282,1563177600,127,80,0,207,28,-0.15617376188860604,-0.8248245085007611
282,1563192000,588,313,0,901,28,-0.15617376188860604,0.2522770897152769
282,1563206400,839,163,0,1002,28,-0.15617376188860604,0.40903106870637174
282,1563220800,1954,214,0,2168,28,-0.15617376188860604,2.2186859152768332
282,1563235200,563,70,0,633,29,-0.15617376188860604,-0.17109426095877758
282,1563249600,47,5,0,52,29,-0.15617376188860604,-1.0921271654185372
282,1563264000,164,68,0,232,29,-0.15617376188860604,-0.8067813430385772
282,1563278400,661,364,0,1025,29,-0.15617376188860604,0.450325530002024
282,1563292800,861,207,0,1068,29,-0.15617376188860604,0.5184914764594589
282,1563307200,2007,187,0,2194,29,-0.15617376188860604,2.3034881209029856
282,1563321600,623,63,0,686,29,-0.15617376188860604,-0.08707576881356716
282,1563336000,80,16,0,96,29,-0.15617376188860604,-1.0223759643923247
282,1563350400,176,70,0,246,29,-0.15617376188860604,-0.7845877790756913
282,1563364800,668,360,0,1028,29,-0.15617376188860604,0.45508129370835665
282,1563379200,926,177,0,1103,29,-0.15617376188860604,0.5739753863666733
282,1563393600,2016,178,0,2194,29,-0.15617376188860604,2.3034881209029856
282,1563408000,610,60,0,670,29,-0.15617376188860604,-0.11243984191400803
282,1563422400,60,19,0,79,29,-0.15617376188860604,-1.049325292061543
282,1563436800,155,91,0,246,29,-0.15617376188860604,-0.7845877790756913
282,1563451200,634,318,0,952,29,-0.15617376188860604,0.3346019464812625
282,1563465600,864,138,0,1002,29,-0.15617376188860604,0.41386467492014023
282,1563480000,1976,190,0,2166,29,-0.15617376188860604,2.2591009929772143
282,1563494400,575,57,0,632,29,-0.15617376188860604,-0.17267951552755512
282,1563508800,71,14,0,85,29,-0.15617376188860604,-1.0398137646488776
282,1563523200,137,72,0,209,29,-0.15617376188860604,-0.8432421981204609
282,1563537600,624,268,0,892,29,-0.15617376188860604,0.2394866723546092
282,1563552000,1093,187,0,1280,29,-0.15617376188860604,0.8545654450403005
282,1563566400,1892,170,0,2062,29,-0.15617376188860604,2.0942345178243484
282,1563580800,593,89,0,682,29,-0.15617376188860604,-0.09341678708867737
282,1563595200,112,24,0,136,29,-0.15617376188860604,-0.9589657816412225
282,1563609600,49,31,0,80,29,-0.15617376188860604,-1.0477400374927655
282,1563624000,232,216,0,448,29,-0.15617376188860604,-0.4643663561826253
282,1563638400,532,298,0,830,29,-0.15617376188860604,0.14120088909040077
282,1563652800,636,213,0,849,29,-0.15617376188860604,0.17132072589717431
282,1563667200,387,119,0,506,29,-0.15617376188860604,-0.3724215911935271
282,1563681600,101,22,0,123,29,-0.15617376188860604,-0.9795740910353307
282,1563696000,23,21,0,44,29,-0.15617376188860604,-1.1048092019687574
282,1563710400,145,200,55,345,29,6.403124237432848,-0.6276475767667135
282,1563724800,437,306,0,743,29,-0.15617376188860604,0.003283741606753481
282,1563739200,538,191,0,729,29,-0.15617376188860604,-0.01890982235613229
282,1563753600,268,45,0,313,29,-0.15617376188860604,-0.6783757229675952
282,1563768000,40,11,0,51,29,-0.15617376188860604,-1.0937124199873147
282,1563782400,146,90,0,236,29,-0.15617376188860604,-0.8004403247634669
282,1563796800,625,314,0,939,29,-0.15617376188860604,0.3139936370871543
282,1563811200,857,218,0,1075,29,-0.15617376188860604,0.5295882584409017
282,1563825600,1953,205,0,2158,29,-0.15617376188860604,2.246418956426994
282,1563840000,359,46,0,405,30,-0.15617376188860604,-0.49571996248035716
282,1563854400,64,7,0,71,30,-0.15617376188860604,-1.0218972955368382
282,1563868800,147,99,0,246,30,-0.15617376188860604,-0.7462055791150293
282,1563883200,635,361,0,996,30,-0.15617376188860604,0.4353303484070087
282,1563897600,875,185,0,1060,30,-0.15617376188860604,0.5361547475555559
282,1563912000,1945,201,0,2146,30,-0.15617376188860604,2.247018770607467
282,1563926400,432,50,0,482,30,-0.15617376188860604,-0.3744156072547613
282,1563940800,45,6,0,51,30,-0.15617376188860604,-1.0534049202707592
282,1563955200,153,91,0,244,30,-0.15617376188860604,-0.7493563415884213
282,1563969600,691,357,0,1048,30,-0.15617376188860604,0.5172501727152033
282,1563984000,910,184,0,1094,30,-0.15617376188860604,0.5897177096032217
282,1563998400,2035,228,0,2263,30,-0.15617376188860604,2.431338375300905
282,1564012800,493,44,0,537,30,-0.15617376188860604,-0.2877696392364785
282,1564027200,56,4,0,60,30,-0.15617376188860604,-1.0392264891404945
282,1564041600,140,81,0,221,30,-0.15617376188860604,-0.7855901100324305
282,1564056000,678,300,0,978,30,-0.15617376188860604,0.40697348614647977
282,1564070400,990,198,0,1188,30,-0.15617376188860604,0.7378035458526504
282,1564084800,1953,171,0,2124,30,-0.15617376188860604,2.2123603834001537
282,1564099200,499,36,0,535,30,-0.15617376188860604,-0.2909204017098706
282,1564113600,69,14,0,83,30,-0.15617376188860604,-1.0029927206964855
282,1564128000,131,71,0,202,30,-0.15617376188860604,-0.8155223535296554
282,1564142400,583,277,0,860,30,-0.15617376188860604,0.2210785002163458
282,1564156800,1115,199,0,1314,30,-0.15617376188860604,0.9363015816763528
282,1564171200,1684,217,0,1901,30,-0.15617376188860604,1.8610503676169345
282,1564185600,568,98,0,666,30,-0.15617376188860604,-0.08454545970268798
282,1564200000,92,23,0,115,30,-0.15617376188860604,-0.9525805211222118
282,1564214400,41,29,0,70,30,-0.15617376188860604,-1.023472676773534
282,1564228800,198,154,0,352,30,-0.15617376188860604,-0.5792151680252479
282,1564243200,554,200,0,754,30,-0.15617376188860604,0.05408808912656446
282,1564257600,758,167,0,925,30,-0.15617376188860604,0.3234782806015891
282,1564272000,419,70,0,489,30,-0.15617376188860604,-0.3633879385978889
282,1564286400,84,18,0,102,30,-0.15617376188860604,-0.9730604771992605
282,1564300800,19,25,6,44,30,6.4031242374328485,-1.0644325889276314
282,1564315200,170,143,0,313,30,-0.15617376188860604,-0.6406550362563939
282,1564329600,491,193,0,684,30,-0.15617376188860604,-0.05618859744215908
282,1564344000,598,139,0,737,30,-0.15617376188860604,0.027306608102731604
282,1564358400,326,67,0,393,30,-0.15617376188860604,-0.5146245373207098
282,1564372800,30,10,0,40,30,-0.15617376188860604,-1.0707341138744155
282,1564387200,147,81,0,228,30,-0.15617376188860604,-0.7745624413755581
282,1564401600,593,355,0,948,30,-0.15617376188860604,0.3597120490455983
282,1564416000,880,201,0,1081,30,-0.15617376188860604,0.569237753526173
282,1564430400,1971,205,0,2176,30,-0.15617376188860604,2.2942802077083484
282,1564444800,508,52,0,560,31,-0.16012815380508713,0.03783908060234941
282,1564459200,39,7,0,46,31,-0.16012815380508713,-0.7385795792622267
282,1564473600,174,86,0,260,31,-0.16012815380508713,-0.41532356134195575
282,1564488000,674,367,0,1041,31,-0.16012815380508713,0.7644098498530519
282,1564502400,888,224,0,1112,31,-0.16012815380508713,0.8716583417798709
282,1564516800,1970,179,0,2149,31,-0.16012815380508713,2.438090540767352
282,1564531200,541,65,0,606,31,-0.16012815380508713,0.10732401903380953
282,1564545600,47,17,0,64,31,-0.16012815380508713,-0.7113898207455684
282,1564559202,33,34,1,67,31,6.244997998398398,-0.7068581943261254
282,1564560000,155,92,0,247,31,-0.16012815380508713,-0.43496060915954227
282,1564574400,569,291,0,860,31,-0.16012815380508713,0.49100172254665453
282,1564588800,910,169,0,1079,31,-0.16012815380508713,0.8218104511659973
282,1564603200,1979,201,0,2180,31,-0.16012815380508713,2.484917347101597
282,1564617600,526,73,0,599,31,-0.16012815380508713,0.09675022405510908
282,1564632000,50,9,0,59,31,-0.16012815380508713,-0.7189425314446402
282,1564646400,159,102,0,261,31,-0.16012815380508713,-0.41381301920214136
282,1564660800,623,360,0,983,31,-0.16012815380508713,0.6767984057438197
282,1564675200,954,203,0,1157,31,-0.16012815380508713,0.9396327380715166
282,1564683528,622,37,0,659,31,-0.16012815380508713,0.1873827524439701
282,1564683608,8,0,0,8,31,-0.16012815380508713,-0.7959801805751721
282,1564683689,5,3,0,8,31,-0.16012815380508713,-0.7959801805751721
282,1564683769,10,0,0,10,31,-0.16012815380508713,-0.7929590962955433
282,1564683850,7,4,0,11,31,-0.16012815380508713,-0.791448554155729
282,1564683931,11,0,0,11,31,-0.16012815380508713,-0.791448554155729
282,1564684011,5,4,0,9,31,-0.16012815380508713,-0.7944696384353577
282,1564684091,12,2,0,14,31,-0.16012815380508713,-0.786916927736286
282,1564684172,11,0,0,11,31,-0.16012815380508713,-0.791448554155729
282,1564684253,10,2,0,12,31,-0.16012815380508713,-0.7899380120159146
282,1564684333,10,1,0,11,31,-0.16012815380508713,-0.791448554155729
282,1564684413,9,0,0,9,31,-0.16012815380508713,-0.7944696384353577
282,1564684494,8,0,0,8,31,-0.16012815380508713,-0.7959801805751721
282,1564684574,10,1,0,11,31,-0.16012815380508713,-0.791448554155729
282,1564684654,9,0,0,9,31,-0.16012815380508713,-0.7944696384353577
282,1564689600,1948,214,0,2162,31,-0.16012815380508713,2.457727588584939
282,1564704000,565,68,0,633,31,-0.16012815380508713,0.14810865680879698
282,1564718400,67,17,0,84,31,-0.16012815380508713,-0.6811789779492814
282,1564732800,130,88,0,218,31,-0.16012815380508713,-0.47876633121415846
282,1564747200,620,330,0,950,31,-0.16012815380508713,0.626950515129946
282,1564761600,1142,172,0,1314,31,-0.16012815380508713,1.1767878540223697
282,1564776000,1689,217,0,1906,31,-0.16012815380508713,2.0710288007924653
282,1565395200,9909,2321,0,12230,32,0.0,4.054353286491184
282,1565409600,68,19,0,87,32,0.0,-0.406302668214094
282,1565424000,42,29,0,71,32,0.0,-0.4121801692661639
282,1565438400,216,194,0,410,32,0.0,-0.2876506157254335
282,1565452800,617,249,0,866,32,0.0,-0.12014183574144216
282,1565467200,767,159,0,926,32,0.0,-0.09810120679618015
282,1565481600,356,92,0,448,32,0.0,-0.27369155072676754
282,1565496000,68,25,0,93,32,0.0,-0.4040986053195678
282,1565510400,23,14,0,37,32,0.0,-0.42466985900181237
282,1565524800,178,133,0,311,32,0.0,-0.3240176534851158
282,1565539200,442,142,0,584,32,0.0,-0.22373279178417363
282,1565553600,648,150,0,798,32,0.0,-0.1451212152127391
282,1565568000,264,55,0,319,32,0.0,-0.32107890295908087
282,1565582400,31,10,0,41,32,0.0,-0.4232004837387949
282,1565596800,137,100,0,237,32,0.0,-0.35120109585093895
282,1565611200,550,310,0,860,32,0.0,-0.12234589863596836
282,1565625600,870,217,0,1087,32,0.0,-0.038958852459727064
282,1565640000,1898,172,0,2070,32,0.0,0.32214011842681567
282,1565654400,483,79,0,562,33,-0.21160368475757946,-0.24549729730185701
282,1565668800,4,6,2,10,33,5.713299488454646,-1.1515159761694553
282,1565683200,155,92,0,247,33,-0.21160368475757946,-0.7625188260034756
282,1565697600,639,316,0,955,33,-0.21160368475757946,0.3995486099354006
282,1565712000,965,192,0,1157,33,-0.21160368475757946,0.7310989235789783
282,1565726400,1990,202,0,2192,33,-0.21160368475757946,2.4298839464557256
282,1565740800,499,55,0,554,33,-0.21160368475757946,-0.25862800279269177
282,1565755200,3,2,0,5,33,-0.21160368475757946,-1.159722667101227
282,1565769600,145,92,0,237,33,-0.21160368475757946,-0.7789322078670191
282,1565784000,645,349,0,994,33,-0.21160368475757946,0.46356079920322
282,1565798400,903,195,0,1098,33,-0.21160368475757946,0.6342599705840719
282,1565812800,1891,198,0,2089,33,-0.21160368475757946,2.260826113261228
282,1565827200,536,63,0,599,33,-0.21160368475757946,-0.18476778440674624
282,1565841600,4,3,0,7,33,-0.21160368475757946,-1.1564399907285186
282,1565856000,136,95,0,231,33,-0.21160368475757946,-0.7887802369851452
282,1565870400,644,377,0,1021,33,-0.21160368475757946,0.5078769302347873
282,1565884800,879,202,0,1081,33,-0.21160368475757946,0.6063572214160481
282,1565899200,1894,203,0,2097,33,-0.21160368475757946,2.2739568187520627
282,1565913600,541,67,0,608,33,-0.21160368475757946,-0.16999574072955714
282,1565928000,3,4,1,7,33,2.750847901848533,-1.1564399907285186
282,1565942400,106,62,0,168,33,-0.21160368475757946,-0.892184542725469
282,1565956800,560,296,0,856,33,-0.21160368475757946,0.23705612948632043
282,1565971200,1071,170,0,1241,33,-0.21160368475757946,0.8689713312327433
282,1565985600,1627,205,0,1832,33,-0.21160368475757946,1.8390021993681613
282,1566000000,495,66,0,561,33,-0.21160368475757946,-0.24713863548821136
282,1566014400,94,23,0,117,33,-0.21160368475757946,-0.9758927902295406
282,1566028800,46,34,0,80,33,-0.21160368475757946,-1.0366223031246513
282,1566043200,266,181,0,447,33,-0.21160368475757946,-0.43425118873260665
282,1566057600,626,227,0,853,33,-0.21160368475757946,0.23213211492725738
282,1566072000,811,162,0,973,33,-0.21160368475757946,0.4290926972897788
282,1566086400,468,87,0,555,33,-0.21160368475757946,-0.2569866646063374
282,1566100800,83,16,0,99,33,-0.21160368475757946,-1.0054368775839186
282,1566115200,27,26,0,53,33,-0.21160368475757946,-1.0809384341562187
282,1566129600,182,179,0,361,33,-0.21160368475757946,-0.5754062727590803
282,1566144000,520,241,0,761,33,-0.21160368475757946,0.08112900178265765
282,1566158400,662,167,0,829,33,-0.21160368475757946,0.19273999845475312
282,1566172800,299,59,0,358,33,-0.21160368475757946,-0.5803302873181434
282,1566187200,30,14,0,44,33,-0.21160368475757946,-1.0957104778334077
282,1566201600,138,81,0,219,33,-0.21160368475757946,-0.8084762952213973
282,1566216000,528,308,0,836,33,-0.21160368475757946,0.20422936575923353
282,1566230400,790,171,0,961,33,-0.21160368475757946,0.40939663905352663
282,1566244800,1760,171,0,1931,33,-0.21160368475757946,2.0014946798172413
282,1566259200,444,65,0,509,34,-0.2744106499742259,-0.3313923048577093
282,1566273600,5,3,0,8,34,-0.2744106499742259,-1.1758046176230181
282,1566288000,155,97,0,252,34,-0.2744106499742259,-0.7645539104079776
282,1566302400,595,325,0,920,34,-0.2744106499742259,0.36132917327910097
282,1566316800,844,183,0,1027,34,-0.2744106499742259,0.5416727211152048
282,1566331200,1836,224,0,2060,34,-0.2744106499742259,2.2827464119067495
282,1566345600,567,82,0,649,34,-0.2744106499742259,-0.09542878432448929
282,1566360000,1,3,2,4,34,2.0306388098092714,-1.182546432495396
282,1566374400,155,87,0,242,34,-0.2744106499742259,-0.7814084475889219
282,1566388800,613,332,0,945,34,-0.2744106499742259,0.40346551623146165
282,1566403200,879,170,0,1049,34,-0.2744106499742259,0.5787527029132823
282,1566417600,1861,174,0,2035,34,-0.2744106499742259,2.240610068954389
282,1566432000,513,50,0,563,34,-0.2744106499742259,-0.24037780408061019
282,1566446400,2,4,2,6,34,2.0306388098092714,-1.179175525059207
282,1566460800,134,81,0,215,34,-0.2744106499742259,-0.8269156979774714
282,1566475200,584,336,0,920,34,-0.2744106499742259,0.36132917327910097
282,1566489600,896,187,0,1083,34,-0.2744106499742259,0.6360581293284928
282,1566504000,1811,185,0,1996,34,-0.2744106499742259,2.174877373948706
282,1566518400,592,42,0,634,34,-0.2744106499742259,-0.12071059009590572
282,1566532800,1,2,1,3,34,0.8781140799175228,-1.1842318862134904
282,1566547200,97,96,0,193,34,-0.2744106499742259,-0.8639956797755489
282,1566561600,556,300,0,856,34,-0.2744106499742259,0.2534601353210575
282,1566576000,1030,212,0,1242,34,-0.2744106499742259,0.9040452705055071
282,1566590400,1615,192,0,1807,34,-0.2744106499742259,1.8563266212288592
282,1566604800,512,80,0,592,34,-0.2744106499742259,-0.19149964625587174
282,1566619200,118,25,0,143,34,-0.2744106499742259,-0.9482683656802703
282,1566633600,39,31,0,70,34,-0.2744106499742259,-1.0713064871011637
282,1566648000,239,217,0,456,34,-0.2744106499742259,-0.42072135191671406
282,1566662400,631,221,0,852,34,-0.2744106499742259,0.24671832044867978
282,1566676800,807,192,0,999,34,-0.2744106499742259,0.49448001700856087
282,1566691200,441,100,0,541,34,-0.2744106499742259,-0.27745778587868763
282,1566705600,81,23,0,104,34,-0.2744106499742259,-1.014001060685953
282,1566720000,21,26,5,47,34,5.488212999484517,-1.1100719226173354
282,1566734400,171,145,0,316,34,-0.2744106499742259,-0.6566848724499341
282,1566748800,524,235,0,759,34,-0.2744106499742259,0.08997112466589789
282,1566763200,749,192,0,941,34,-0.2744106499742259,0.39672370135908397
282,1566777600,353,70,0,423,34,-0.2744106499742259,-0.4763413246138302
282,1566792000,37,30,0,67,34,-0.2744106499742259,-1.076362848255447
282,1566806400,123,82,0,205,34,-0.2744106499742259,-0.8437702351584158
282,1566820800,557,304,0,861,34,-0.2744106499742259,0.26188740391152965
282,1566835200,814,207,0,1021,34,-0.2744106499742259,0.5315599988066383
282,1566849600,1850,171,0,2021,34,-0.2744106499742259,2.217013716901067
282,1566864000,482,51,0,533,35,-0.3487234437215328,0.5851842570277096
282,1566878400,8,5,0,13,35,-0.3487234437215328,-0.5323092631445587
282,1566892800,131,100,0,231,35,-0.3487234437215328,-0.06382159507233852
282,1566907200,600,288,0,888,35,-0.3487234437215328,1.3480884871453158
282,1566921600,843,198,0,1041,35,-0.3487234437215328,1.6768894651960025
282,1566936000,1906,184,0,2090,35,-0.3487234437215328,3.931217739543521
282,1566950400,522,48,0,570,35,-0.3487234437215328,0.6646982190399672
282,1566964800,8,5,0,13,35,-0.3487234437215328,-0.5323092631445587
282,1566979200,141,79,0,220,35,-0.3487234437215328,-0.08746088107598267
282,1566993600,641,328,0,969,35,-0.3487234437215328,1.5221595931721499
282,1567008000,850,212,0,1062,35,-0.3487234437215328,1.7220190112029594
282,1567022400,1934,195,0,2129,35,-0.3487234437215328,4.0150297535564405
282,1567036800,514,52,0,566,35,-0.3487234437215328,0.656102115038642
282,1567051200,1,1,0,2,35,-0.3487234437215328,-0.5559485491482029
282,1567065600,89,83,0,172,35,-0.3487234437215328,-0.19061412909188435
282,1567080000,606,344,0,950,35,-0.3487234437215328,1.4813280991658555
282,1567094400,944,202,0,1146,35,-0.3487234437215328,1.9025371952307875
282,1567108800,1738,160,0,1898,35,-0.3487234437215328,3.518604747479914
282,1567123200,559,68,0,627,35,-0.3487234437215328,0.7871927010588504
282,1567137600,4,2,0,6,35,-0.3487234437215328,-0.5473524451468778
282,1567152000,119,71,0,190,35,-0.3487234437215328,-0.1519316610859212
282,1567156628,173,75,0,248,35,-0.3487234437215328,-0.027288153066706674
282,1567156709,5,0,0,5,35,-0.3487234437215328,-0.549501471147209
282,1567156790,4,0,0,4,35,-0.3487234437215328,-0.5516504971475403
282,1567156882,2,5,3,7,35,1.9338300060921365,-0.5452034191465465
282,1567156963,3,7,4,10,35,2.6946811560300263,-0.5387563411455526
282,1567157040,68,41,0,109,35,-0.3487234437215328,-0.32600276711275533
282,1567157120,1,0,0,1,35,-0.3487234437215328,-0.5580975751485342
282,1567157201,2,3,1,5,35,0.412127706216357,-0.549501471147209
282,1567157281,1,0,0,1,35,-0.3487234437215328,-0.5580975751485342
282,1567157362,1,3,2,4,35,1.172978856154247,-0.5516504971475403
282,1567157442,2,0,0,2,35,-0.3487234437215328,-0.5559485491482029
282,1567157523,3,0,0,3,35,-0.3487234437215328,-0.5537995231478716
282,1567157603,3,1,0,4,35,-0.3487234437215328,-0.5516504971475403
282,1567157683,2,0,0,2,35,-0.3487234437215328,-0.5559485491482029
282,1567157763,2,3,1,5,35,0.412127706216357,-0.549501471147209
282,1567157844,0,0,0,0,35,-0.3487234437215328,-0.5602466011488655
282,1567157924,1,1,0,2,35,-0.3487234437215328,-0.5559485491482029
282,1567158004,2,0,0,2,35,-0.3487234437215328,-0.5559485491482029
282,1567158084,1,2,1,3,35,0.412127706216357,-0.5537995231478716
282,1567158165,1,2,1,3,35,0.412127706216357,-0.5537995231478716
282,1567158245,3,0,0,3,35,-0.3487234437215328,-0.5537995231478716
282,1567158326,4,0,0,4,35,-0.3487234437215328,-0.5516504971475403
282,1567158406,1,0,0,1,35,-0.3487234437215328,-0.5580975751485342
282,1567158486,2,0,0,2,35,-0.3487234437215328,-0.5559485491482029
282,1567158566,2,4,2,6,35,1.172978856154247,-0.5473524451468778
282,1567158647,2,1,0,3,35,-0.3487234437215328,-0.5537995231478716
282,1567158727,0,0,0,0,35,-0.3487234437215328,-0.5602466011488655
282,1567158808,2,0,0,2,35,-0.3487234437215328,-0.5559485491482029
282,1567158888,1,4,3,5,35,1.9338300060921365,-0.549501471147209
282,1567158968,3,3,0,6,35,-0.3487234437215328,-0.5473524451468778
282,1567159048,1,0,0,1,35,-0.3487234437215328,-0.5580975751485342
282,1567159128,0,0,0,0,35,-0.3487234437215328,-0.5602466011488655
282,1567159208,0,4,4,4,35,2.6946811560300263,-0.5516504971475403
282,1567159288,1,3,2,4,35,1.172978856154247,-0.5516504971475403
282,1567159369,2,4,2,6,35,1.172978856154247,-0.5473524451468778
282,1567159449,2,0,0,2,35,-0.3487234437215328,-0.5559485491482029
282,1567159529,1,0,0,1,35,-0.3487234437215328,-0.5580975751485342
282,1567159609,3,0,0,3,35,-0.3487234437215328,-0.5537995231478716
282,1567159689,0,0,0,0,35,-0.3487234437215328,-0.5602466011488655
282,1567159770,1,0,0,1,35,-0.3487234437215328,-0.5580975751485342
282,1567159850,0,0,0,0,35,-0.3487234437215328,-0.5602466011488655
282,1567159930,1,0,0,1,35,-0.3487234437215328,-0.5580975751485342
282,1567160010,3,12,9,15,35,6.498936905719475,-0.5280112111438962
282,1567160091,1,0,0,1,35,-0.3487234437215328,-0.5580975751485342
282,1567160172,97,71,0,168,35,-0.3487234437215328,-0.1992102330932095
282,1567160252,1,6,5,7,35,3.455532305967916,-0.5452034191465465
282,1567160332,1,2,1,3,35,0.412127706216357,-0.5537995231478716
282,1567160412,1,0,0,1,35,-0.3487234437215328,-0.5580975751485342
282,1567160493,3,6,3,9,35,1.9338300060921365,-0.5409053671458839
282,1567160573,4,0,0,4,35,-0.3487234437215328,-0.5516504971475403
282,1567160654,2,1,0,3,35,-0.3487234437215328,-0.5537995231478716
282,1567160734,4,0,0,4,35,-0.3487234437215328,-0.5516504971475403
282,1567160818,12,8,0,20,35,-0.3487234437215328,-0.5172660811422397
282,1567160899,3,1,0,4,35,-0.3487234437215328,-0.5516504971475403
282,1567166400,200,113,0,313,35,-0.3487234437215328,0.11239853695482688
282,1567180800,1116,228,0,1344,35,-0.3487234437215328,2.3280443432963818
282,1567195200,1277,155,0,1432,35,-0.3487234437215328,2.517158631325535
282,1567209600,289,50,0,339,35,-0.3487234437215328,0.16827321296344028
282,1567224000,48,5,0,53,35,-0.3487234437215328,-0.4463482231313073
282,1567238400,30,3,0,33,35,-0.3487234437215328,-0.489328743137933
282,1567252800,212,51,0,263,35,-0.3487234437215328,0.0049472369382626055
282,1567267200,549,112,0,661,35,-0.3487234437215328,0.8602595850701141
282,1567281600,690,69,0,759,35,-0.3487234437215328,1.07086413310258
282,1567296000,339,50,0,389,35,-0.3487234437215328,0.27572451298000455
282,1567310400,45,9,0,54,35,-0.3487234437215328,-0.44419919713097605
282,1567324800,19,3,0,22,35,-0.3487234437215328,-0.5129680291415771
282,1567339200,161,57,0,218,35,-0.3487234437215328,-0.09175893307664523
282,1567353600,488,79,0,567,35,-0.3487234437215328,0.6582511410389733
282,1567368000,611,80,0,691,35,-0.3487234437215328,0.9247303650800527
282,1567382400,261,40,0,301,35,-0.3487234437215328,0.08661022495085145
282,1567396800,34,3,0,37,35,-0.3487234437215328,-0.48073263913660785
282,1567411200,19,7,0,26,35,-0.3487234437215328,-0.504371925140252
282,1567425600,224,66,0,290,35,-0.3487234437215328,0.0629709389472073
282,1567440000,533,61,0,594,35,-0.3487234437215328,0.716274843047918
282,1567454400,556,55,0,611,35,-0.3487234437215328,0.7528082850535499
282,1567468800,229,33,0,262,36,-0.2624838291949793,-0.6976274528965329
282,1567483200,22,1,0,23,36,-0.2624838291949793,-1.0777312241518435
282,1567492009,13,26,13,39,36,2.8593983095282858,-1.0522849465782662
282,1567497600,125,81,0,206,36,-0.2624838291949793,-0.7866894244040534
282,1567512000,558,332,0,890,36,-0.2624838291949793,0.3011389418663754
282,1567526400,798,214,0,1012,36,-0.2624838291949793,0.4951668083649022
282,1567540800,1814,167,0,1981,36,-0.2624838291949793,2.0362569939146766
282,1567555200,466,48,0,514,36,-0.2624838291949793,-0.29684858111269075
282,1567569600,1,1,0,2,36,-0.2624838291949793,-1.1111294634671638
282,1567584000,148,94,0,242,36,-0.2624838291949793,-0.7294352998635045
282,1567598400,624,339,0,963,36,-0.2624838291949793,0.4172375832958217
282,1567612800,831,187,0,1018,36,-0.2624838291949793,0.5047091624549936
282,1567627200,1909,186,0,2095,36,-0.2624838291949793,2.2175617216264145
282,1567641600,561,49,0,610,36,-0.2624838291949793,-0.14417091567122706
282,1567656000,3,3,0,6,36,-0.2624838291949793,-1.1047678940737695
282,1567670400,159,105,0,264,36,-0.2624838291949793,-0.6944466681998358
282,1567684800,580,390,0,970,36,-0.2624838291949793,0.4283703297342618
282,1567699200,1038,160,0,1198,36,-0.2624838291949793,0.790979785157738
282,1567713600,1878,183,0,2061,36,-0.2624838291949793,2.163488381782563
282,1567728000,584,46,0,630,36,-0.2624838291949793,-0.11236306870425544
282,1567742400,3,3,0,6,36,-0.2624838291949793,-1.1047678940737695
282,1567756800,142,72,0,214,36,-0.2624838291949793,-0.7739662856172648
282,1567771200,585,392,0,977,36,-0.2624838291949793,0.43950307617270185
282,1567785600,1059,179,0,1238,36,-0.2624838291949793,0.8545954790916813
282,1567800000,1869,273,0,2142,36,-0.2624838291949793,2.292310161998798
282,1567814400,498,79,0,577,36,-0.2624838291949793,-0.1966538631667302
282,1567828800,74,46,0,120,36,-0.2624838291949793,-0.9234631663620313
282,1567843200,26,38,12,64,36,2.619253529626496,-1.012525137869552
282,1567857600,220,242,22,462,36,5.0207013286443924,-0.3795489832268169
282,1567872000,604,294,0,898,36,-0.2624838291949793,0.313862080653164
282,1567886400,795,211,0,1006,36,-0.2624838291949793,0.48562445427481066
282,1567900800,400,106,0,506,36,-0.2624838291949793,-0.3095717198994794
282,1567915200,80,20,0,100,36,-0.2624838291949793,-0.9552710133290029
282,1567929600,28,25,0,53,36,-0.2624838291949793,-1.0300194537013863
282,1567944000,163,149,0,312,36,-0.2624838291949793,-0.618107835479104
282,1567958400,482,202,0,684,36,-0.2624838291949793,-0.026481881893432115
282,1567972800,654,194,0,848,36,-0.2624838291949793,0.23434246323573502
282,1567987200,287,76,0,363,36,-0.2624838291949793,-0.5369978257133263
282,1568001600,22,11,0,33,36,-0.2624838291949793,-1.0618273006683578
282,1568016000,174,86,0,260,36,-0.2624838291949793,-0.7008082375932301
282,1568030400,599,413,0,1012,36,-0.2624838291949793,0.4951668083649022
282,1568044800,946,188,0,1134,36,-0.2624838291949793,0.6891946748634289
282,1568059200,1961,172,0,2133,36,-0.2624838291949793,2.2779966308636608
282,1568073600,549,65,0,614,37,-0.16947302607433967,-0.25846468594525024
282,1568088000,34,19,0,53,37,-0.16947302607433967,-1.1363578573798743
282,1568102400,169,85,0,254,37,-0.16947302607433967,-0.8218185927482176
282,1568116800,710,376,0,1086,37,-0.16947302607433967,0.4801548807519736
282,1568131200,907,178,0,1085,37,-0.16947302607433967,0.478590008788632
282,1568145600,1932,217,0,2149,37,-0.16947302607433967,2.143613777784069
282,1568160000,573,68,0,641,37,-0.16947302607433967,-0.2162131429350277
282,1568174400,45,10,0,55,37,-0.16947302607433967,-1.1332281134531912
282,1568188800,177,122,0,299,37,-0.16947302607433967,-0.7513993543978467
282,1568203200,668,379,0,1047,37,-0.16947302607433967,0.4191248741816521
282,1568217600,999,204,0,1203,37,-0.16947302607433967,0.6632449004629379
282,1568232000,1983,180,0,2163,37,-0.16947302607433967,2.165521985270851
282,1568246400,545,71,0,616,37,-0.16947302607433967,-0.2553349420185671
282,1568260800,46,22,0,68,37,-0.16947302607433967,-1.1128847779297506
282,1568275200,160,84,0,244,37,-0.16947302607433967,-0.8374673123816333
282,1568289600,650,326,0,976,37,-0.16947302607433967,0.3080189647844003
282,1568304000,1027,179,0,1206,37,-0.16947302607433967,0.6679395163529627
282,1568318400,1992,184,0,2176,37,-0.16947302607433967,2.1858653207942917
282,1568332800,600,87,0,687,37,-0.16947302607433967,-0.1442290326213152
282,1568347200,47,12,0,59,37,-0.16947302607433967,-1.1269686255998248
282,1568361600,145,94,0,239,37,-0.16947302607433967,-0.8452916721983412
282,1568376000,600,259,0,859,37,-0.16947302607433967,0.12492894507343587
282,1568390400,1030,155,0,1185,37,-0.16947302607433967,0.6350772051227896
282,1568404800,1865,271,0,2136,37,-0.16947302607433967,2.1232704422606283
282,1568419200,576,116,0,692,37,-0.16947302607433967,-0.1364046728046073
282,1568433600,81,27,0,108,37,-0.16947302607433967,-1.0502898993960876
282,1568448000,34,32,0,66,37,-0.16947302607433967,-1.116014521856434
282,1568462400,242,237,0,479,37,-0.16947302607433967,-0.469722400996363
282,1568476800,649,370,0,1019,37,-0.16947302607433967,0.37530845920808803
282,1568491200,913,231,0,1144,37,-0.16947302607433967,0.570917454625785
282,1568505600,497,142,0,639,37,-0.16947302607433967,-0.21934288686171083
282,1568520000,87,14,0,101,37,-0.16947302607433967,-1.0612440031394788
282,1568534400,34,40,6,74,37,0.39995634153544163,-1.1034955461497011
282,1568548800,182,251,69,433,37,6.378964701438144,-0.5417065113100755
282,1568563200,605,311,0,916,37,-0.16947302607433967,0.2141266469839057
282,1568577600,741,230,0,971,37,-0.16947302607433967,0.30019460496769235
282,1568592000,335,80,0,415,37,-0.16947302607433967,-0.5698742066502238
282,1568606400,36,10,0,46,37,-0.16947302607433967,-1.1473119611232654
282,1568620800,152,95,0,247,37,-0.16947302607433967,-0.8327726964916086
282,1568635200,600,319,0,919,37,-0.16947302607433967,0.21882126287393042
282,1568649600,962,213,0,1175,37,-0.16947302607433967,0.6194284854893739
282,1568664000,2006,175,0,2181,37,-0.16947302607433967,2.1936896806109996
282,1568678400,502,44,0,546,38,0.0,-0.28682717308280176
282,1568692800,47,18,0,65,38,0.0,-1.0134080571729285
282,1568707200,162,90,0,252,38,0.0,-0.730932744647245
282,1568721600,684,359,0,1043,38,0.0,0.46392272170470955
282,1568736000,1020,188,0,1208,38,0.0,0.713165644521489
282,1568750400,2062,191,0,2253,38,0.0,2.2917041556944255
282,1568764800,584,60,0,644,38,0.0,-0.13879198256132064
282,1568779200,40,19,0,59,38,0.0,-1.0224714361844476
282,1568793600,156,80,0,236,38,0.0,-0.7551017553446298
282,1568808000,672,361,0,1033,38,0.0,0.4488170900188441
282,1568822400,1008,191,0,1199,38,0.0,0.6995705760042101
282,1568836800,2026,222,0,2248,38,0.0,2.2841513398514928
282,1568851200,602,53,0,655,38,0.0,-0.12217578770686868
282,1568865600,34,11,0,45,38,0.0,-1.0436193205446591
282,1568880000,179,89,0,268,38,0.0,-0.7067637339498604
282,1568894400,659,324,0,983,38,0.0,0.37328893158951704
282,1568908800,1084,193,0,1277,38,0.0,0.8173945031539603
282,1568923200,1975,201,0,2176,38,0.0,2.1753907917132618
282,1568937600,598,68,0,666,38,0.0,-0.10555959285241671
282,1568952000,46,12,0,58,38,0.0,-1.0239819993530341
282,1568966400,133,76,0,209,38,0.0,-0.7958869608964664
282,1568980800,626,315,0,941,38,0.0,0.30984527850888227
282,1568995200,1064,186,0,1250,38,0.0,0.7766092976021237
282,1569009600,1870,198,0,2068,38,0.0,2.0122499695059153
282,1569024000,396,66,0,462,38,0.0,-0.41371447924407123
282,1569038400,72,7,0,79,38,0.0,-0.9922601728127168
282,1569052800,37,14,0,51,38,0.0,-1.03455594153314
282,1569067200,212,58,0,270,38,0.0,-0.7037426076126873
282,1569081600,602,172,0,774,38,0.0,0.057581229354929805
282,1569096000,812,101,0,913,38,0.0,0.26754950978845915
282,1569110400,291,41,0,332,38,0.0,-0.6100876911603217
282,1569124800,52,14,0,66,38,0.0,-1.011897494004342
282,1569139200,21,12,0,33,38,0.0,-1.0617460785676978
282,1569153600,173,54,0,227,38,0.0,-0.7686968238619086
282,1569168000,550,116,0,666,38,0.0,-0.10555959285241671
282,1569182400,676,81,0,757,38,0.0,0.03190165548895859
282,1569196800,275,22,0,297,38,0.0,-0.6629574020608506
282,1569211200,26,4,0,30,38,0.0,-1.0662777680734574
282,1569225600,152,102,0,254,38,0.0,-0.727911618310072
282,1569240000,623,369,0,992,38,0.0,0.3868840001067959
282,1569254400,964,191,0,1155,38,0.0,0.6331057965864022
282,1569268800,1978,189,0,2167,38,0.0,2.161795723195983
282,1569283200,529,53,0,582,39,0.0,-0.234103511894625
282,1569297600,33,17,0,50,39,0.0,-1.0583721645535442
282,1569312000,177,96,0,273,39,0.0,-0.7128610563901251
282,1569326400,642,351,0,993,39,0.0,0.4026905035993897
282,1569340800,976,198,0,1174,39,0.0,0.6831277707634205
282,1569355200,1998,195,0,2193,39,0.0,2.261943103581914
282,1569369600,610,59,0,669,39,0.0,-0.09930769839589196
282,1569384000,51,17,0,68,39,0.0,-1.0304833755538063
282,1569398400,190,111,0,301,39,0.0,-0.6694784957238662
282,1569412800,645,362,0,1007,39,0.0,0.42438178393251913
282,1569427200,1011,206,0,1217,39,0.0,0.749750988929461
282,1569441600,2048,172,0,2220,39,0.0,2.3037762870815213
282,1569456000,546,54,0,600,39,0.0,-0.20621472289488713
282,1569470400,40,18,0,58,39,0.0,-1.0459771472203274
282,1569484800,162,93,0,255,39,0.0,-0.740749845389863
282,1569499200,690,351,0,1041,39,0.0,0.4770606075986907
282,1569513600,1106,189,0,1295,39,0.0,0.8706024079283251
282,1569528000,2044,209,0,2253,39,0.0,2.3549057335810404
282,1569542400,608,48,0,656,39,0.0,-0.1194496015623693
282,1569556800,57,23,0,80,39,0.0,-1.0118908495539811
282,1569571200,142,80,0,222,39,0.0,-0.7918792918893824
282,1569585600,651,305,0,956,39,0.0,0.34536354843326184
282,1569600000,1074,168,0,1242,39,0.0,0.7884854180957636
282,1569614400,1876,211,0,2087,39,0.0,2.0977091239167915
282,1569628800,528,89,0,617,39,0.0,-0.17987531106180135
282,1569643200,72,32,0,104,39,0.0,-0.9747057975543306
282,1569657600,41,31,0,72,39,0.0,-1.024285866887198
282,1569672000,191,158,0,349,39,0.0,-0.5951083917245652
282,1569686400,503,225,0,728,39,0.0,-0.00789444556341783
282,1569700800,726,202,0,928,39,0.0,0.30198098776700294
282,1569715200,309,91,0,400,39,0.0,-0.5160901562253079
282,1569729600,44,19,0,63,39,0.0,-1.0382302613870669
282,1569744000,31,24,0,55,39,0.0,-1.0506252787202837
282,1569758400,121,112,0,233,39,0.0,-0.7748361430562093
282,1569772800,425,195,0,620,39,0.0,-0.17522717956184505
282,1569787200,551,134,0,685,39,0.0,-0.0745176637294583
282,1569801600,201,62,0,263,39,0.0,-0.7283548280566461
282,1569816000,22,17,0,39,39,0.0,-1.0754153133867175
282,1569830400,126,113,0,239,39,0.0,-0.7655398800562966
282,1569844800,572,357,0,929,39,0.0,0.30353036493365504
282,1569859200,754,208,0,962,39,0.0,0.3546598114331745
282,1569873600,1854,158,0,2012,39,0.0,1.9815058364178835
282,1569888000,450,44,0,494,40,-0.1615989050957144,-0.4246801024747411
282,1569902400,38,22,0,60,40,-0.1615989050957144,-1.1032450488202514
282,1569916800,135,97,0,232,40,-0.1615989050957144,-0.8343206922040584
282,1569931200,617,323,0,940,40,-0.1615989050957144,0.2726470082858524
282,1569945600,846,174,0,1020,40,-0.1615989050957144,0.3977281043864073
282,1569960000,1887,198,0,2085,40,-0.1615989050957144,2.062870196225044
282,1569974400,578,50,0,628,40,-0.1615989050957144,-0.21516926650631166
282,1569988800,46,22,0,68,40,-0.1615989050957144,-1.090736939210196
282,1570003200,175,104,0,279,40,-0.1615989050957144,-0.7608355482449823
282,1570017600,648,391,0,1039,40,-0.1615989050957144,0.42743486471028913
282,1570032000,980,184,0,1164,40,-0.1615989050957144,0.6228740773674061
282,1570046400,2048,195,0,2243,40,-0.1615989050957144,2.30990536102364
282,1570060800,558,49,0,607,40,-0.1615989050957144,-0.2480030542327073
282,1570075200,55,20,0,75,40,-0.1615989050957144,-1.0797923433013974
282,1570089600,152,99,0,251,40,-0.1615989050957144,-0.8046139318801766
282,1570104000,658,382,0,1040,40,-0.1615989050957144,0.42899837841154603
282,1570118400,940,225,0,1165,40,-0.1615989050957144,0.624437591068663
282,1570132800,2058,207,0,2265,40,-0.1615989050957144,2.344302662451293
282,1570147200,591,74,0,665,40,-0.1615989050957144,-0.157319259559805
282,1570161600,81,32,0,113,40,-0.1615989050957144,-1.0203788226536337
282,1570176000,147,83,0,230,40,-0.1615989050957144,-0.8374477196065723
282,1570190400,653,295,0,948,40,-0.1615989050957144,0.2851551178959079
282,1570204800,1116,168,0,1284,40,-0.1615989050957144,0.8104957215182385
282,1570219200,1866,191,0,2057,40,-0.1615989050957144,2.01909181258985
282,1570233600,540,68,0,608,40,-0.1615989050957144,-0.24643954053145037
282,1570248000,107,25,0,132,40,-0.1615989050957144,-0.990672062329752
282,1570262400,40,29,0,69,40,-0.1615989050957144,-1.089173425508939
282,1570276800,223,217,0,440,40,-0.1615989050957144,-0.5091098423426157
282,1570291200,744,318,0,1062,40,-0.1615989050957144,0.46339567983919866
282,1570305600,913,264,0,1177,40,-0.1615989050957144,0.6431997554837463
282,1570320000,456,111,0,567,40,-0.1615989050957144,-0.3105436022829848
282,1570334400,96,21,0,117,40,-0.1615989050957144,-1.014124767848606
282,1570348800,18,20,2,38,40,0.06463956203828575,-1.137642350247904
282,1570363200,175,233,58,408,40,6.39931664179029,-0.5591422807828376
282,1570377600,570,282,0,852,40,-0.1615989050957144,0.13505780257524205
282,1570392000,763,179,0,942,40,-0.1615989050957144,0.2757740356883663
282,1570406400,279,64,0,343,40,-0.1615989050957144,-0.6607706713645385
282,1570420800,26,24,0,50,40,-0.1615989050957144,-1.1188801858328208
282,1570435200,153,89,0,242,40,-0.1615989050957144,-0.818685555191489
282,1570449600,628,324,0,952,40,-0.1615989050957144,0.2914091727009357
282,1570464000,896,179,0,1075,40,-0.1615989050957144,0.48372135795553883
282,1570478400,1976,154,0,2130,40,-0.1615989050957144,2.1332283127816063
282,1570492800,403,32,0,435,41,-0.22939853564467677,-0.5029567933564243
282,1570507200,35,3,0,38,41,-0.22939853564467677,-1.1098242636817024
282,1570521600,181,112,0,293,41,-0.22939853564467677,-0.7200227399211333
282,1570536000,706,299,0,1005,41,-0.22939853564467677,0.368364259755436
282,1570550400,1048,215,0,1263,41,-0.22939853564467677,0.7627516837955413
282,1570564800,2115,227,0,2342,41,-0.22939853564467677,2.4121471510020274
282,1570579200,411,32,0,443,41,-0.22939853564467677,-0.490727725944328
282,1570593600,46,15,0,61,41,-0.22939853564467677,-1.0746656948719255
282,1570608000,143,97,0,240,41,-0.22939853564467677,-0.8010403115262712
282,1570622400,629,321,0,950,41,-0.22939853564467677,0.2842894212972741
282,1570636800,801,211,0,1012,41,-0.22939853564467677,0.37906469374102025
282,1570651200,1998,202,0,2200,41,-0.22939853564467677,2.1950812044373182
282,1570665600,363,36,0,399,41,-0.22939853564467677,-0.5579875967108575
282,1570680000,48,5,0,53,41,-0.22939853564467677,-1.086894762284022
282,1570694400,164,79,0,243,41,-0.22939853564467677,-0.7964544112467351
282,1570708800,722,315,0,1037,41,-0.22939853564467677,0.41728052940382115
282,1570723200,1048,195,0,1243,41,-0.22939853564467677,0.7321790152653005
282,1570737600,2099,193,0,2292,41,-0.22939853564467677,2.3357154796764257
282,1570752000,442,35,0,477,41,-0.22939853564467677,-0.4387541894429188
282,1570766400,42,11,0,53,41,-0.22939853564467677,-1.086894762284022
282,1570780800,126,98,0,224,41,-0.22939853564467677,-0.8254984463504638
282,1570795200,640,303,0,943,41,-0.22939853564467677,0.2735889873116898
282,1570809600,1128,182,0,1310,41,-0.22939853564467677,0.8345974548416069
282,1570824000,1924,224,0,2148,41,-0.22939853564467677,2.115592266258693
282,1570838400,531,81,0,612,41,-0.22939853564467677,-0.23238867686379397
282,1570852800,86,49,0,135,41,-0.22939853564467677,-0.961546821310035
282,1570867200,46,53,7,99,41,0.05882013734478893,-1.0165776246644682
282,1570881600,201,303,102,504,41,3.970359270773252,-0.39748108692709383
282,1570896000,676,375,0,1051,41,-0.22939853564467677,0.4386813973749897
282,1570910400,989,334,0,1323,41,-0.22939853564467677,0.8544696893862633
282,1570924800,417,147,0,564,41,-0.22939853564467677,-0.3057630813363717
282,1570939200,84,42,0,126,41,-0.22939853564467677,-0.9753045221486433
282,1570953600,42,25,0,67,41,-0.22939853564467677,-1.0654938943128534
282,1570968000,180,305,125,485,41,4.917363482024354,-0.4265251220308225
282,1570982400,599,374,0,973,41,-0.22939853564467677,0.3194479901070509
282,1570996800,891,285,0,1176,41,-0.22939853564467677,0.6297605756889941
282,1571011200,347,104,0,451,41,-0.22939853564467677,-0.4784986585322317
282,1571025600,38,19,0,57,41,-0.22939853564467677,-1.0807802285779737
282,1571040000,114,67,0,181,41,-0.22939853564467677,-0.8912296836904814
282,1571054400,481,318,0,799,41,-0.22939853564467677,0.05346577389395668
282,1571068800,760,217,0,977,41,-0.22939853564467677,0.325562523813099
282,1571083200,1662,143,0,1805,41,-0.22939853564467677,1.5912710009650644
282,1571097600,412,48,0,460,42,0.0,-0.46771048661061393
282,1571112000,33,21,0,54,42,0.0,-1.078010396136493
282,1571126400,161,95,0,256,42,0.0,-0.7743636431211542
282,1571140800,658,344,0,1002,42,0.0,0.3470248605889588
282,1571155200,936,205,0,1141,42,0.0,0.5559699035054544
282,1571169600,2110,186,0,2296,42,0.0,2.2921679219842486
282,1571184000,528,55,0,583,42,0.0,-0.2828166716557293
282,1571198400,42,16,0,58,42,0.0,-1.0719975891460904
282,1571212800,171,86,0,257,42,0.0,-0.7728604413735535
282,1571227200,627,403,0,1030,42,0.0,0.38911450952177806
282,1571241600,911,164,0,1075,42,0.0,0.456758588163809
282,1571256000,1892,211,0,2103,42,0.0,2.002049984697316
282,1571270400,556,42,0,598,42,0.0,-0.260268645441719
282,1571284800,44,18,0,62,42,0.0,-1.0659847821556876
282,1571299200,165,90,0,255,42,0.0,-0.7758668448687549
282,1571313600,685,325,0,1010,42,0.0,0.3590504745697643
282,1571328000,1026,206,0,1232,42,0.0,0.692761262537117
282,1571342400,2152,243,0,2395,42,0.0,2.4409848949967166
282,1571356800,615,83,0,698,42,0.0,-0.10994847068165026
282,1571371200,65,43,0,108,42,0.0,-0.996837501766056
282,1571385600,153,79,0,232,42,0.0,-0.8104404850635707
282,1571400000,604,325,0,929,42,0.0,0.2372911330141086
282,1571414400,1117,207,0,1324,42,0.0,0.8310558233163803
282,1571428800,2009,225,0,2234,42,0.0,2.198969413633006
282,1571443200,559,91,0,650,42,0.0,-0.18210215456648327
282,1571457600,85,23,0,108,42,0.0,-0.996837501766056
282,1571472000,46,29,0,75,42,0.0,-1.0464431594368786
282,1571486400,239,225,0,464,42,0.0,-0.4616976796202112
282,1571500800,696,322,0,1018,42,0.0,0.3710760885505698
282,1571515200,947,198,0,1145,42,0.0,0.5619827104958571
282,1571529600,457,85,0,542,42,0.0,-0.3444479433073575
282,1571544000,87,18,0,105,42,0.0,-1.001347107008858
282,1571558400,28,23,0,51,42,0.0,-1.0825200013792953
282,1571572800,184,143,0,327,42,0.0,-0.6676363190415053
282,1571587200,558,297,0,855,42,0.0,0.1260542036916577
282,1571601600,637,151,0,788,42,0.0,0.02533968660241164
282,1571616000,256,51,0,307,42,0.0,-0.6977003539935192
282,1571630400,36,17,0,53,42,0.0,-1.0795135978840937
282,1571644800,177,81,0,258,42,0.0,-0.7713572396259528
282,1571659200,620,338,0,958,42,0.0,0.28088398369452855
282,1571673600,960,172,0,1132,42,0.0,0.5424410877770482
282,1571688000,1943,217,0,2160,42,0.0,2.087732484310555
282,1571702400,520,49,0,569,43,0.0,-0.2413833606273026
282,1571716800,51,21,0,72,43,0.0,-0.9980489665342427
282,1571731200,165,98,0,263,43,0.0,-0.7072579590327828
282,1571745600,674,350,0,1024,43,0.0,0.4513386729494736
282,1571760000,998,164,0,1162,43,0.0,0.6614389820342981
282,1571774400,1988,180,0,2168,43,0.0,2.193039785942511
282,1571788800,536,53,0,589,43,0.0,-0.21093404047008166
282,1571803200,57,27,0,84,43,0.0,-0.9797793744399101
282,1571817600,176,70,0,246,43,0.0,-0.7331398811664206
282,1571832000,717,359,0,1076,43,0.0,0.5305069053582481
282,1571846400,1032,194,0,1226,43,0.0,0.758876806537405
282,1571860800,1978,236,0,2214,43,0.0,2.263073222304119
282,1571875200,615,67,0,682,43,0.0,-0.06934470173900432
282,1571889600,62,30,0,92,43,0.0,-0.9675996463770218
282,1571904000,152,87,0,239,43,0.0,-0.743797143221448
282,1571918400,689,302,0,991,43,0.0,0.40109729469005906
282,1571932800,1004,193,0,1197,43,0.0,0.7147252923094346
282,1571947200,2042,219,0,2261,43,0.0,2.334629124673588
282,1571961600,649,66,0,715,43,0.0,-0.019103323479589783
282,1571976000,95,37,0,132,43,0.0,-0.90670100606258
282,1571990400,151,98,0,249,43,0.0,-0.7285724831428375
282,1572004800,676,318,0,994,43,0.0,0.4056646927136422
282,1572019200,1081,198,0,1279,43,0.0,0.8395675049540404
282,1572033600,1802,202,0,2004,43,0.0,1.9433553606532992
282,1572048000,536,73,0,609,43,0.0,-0.18048472031286072
282,1572062400,85,12,0,97,43,0.0,-0.9599873163377165
282,1572076800,35,14,0,49,43,0.0,-1.0330656847150468
282,1572091200,197,75,0,272,43,0.0,-0.6935557649620334
282,1572105600,554,113,0,667,43,0.0,-0.09218169185692002
282,1572120000,760,110,0,870,43,0.0,0.21687890773887245
282,1572134400,313,46,0,359,43,0.0,-0.5611012222781223
282,1572148800,73,11,0,84,43,0.0,-0.9797793744399101
282,1572163200,23,8,0,31,43,0.0,-1.0604700728565457
282,1572177600,122,68,0,190,43,0.0,-0.8183979776066392
282,1572192000,311,111,0,422,43,0.0,-0.4651858637828764
282,1572206400,432,89,0,521,43,0.0,-0.3144617290046328
282,1572220800,207,26,0,233,43,0.0,-0.7529319392686142
282,1572235200,31,9,0,40,43,0.0,-1.0467678787857961
282,1572249600,146,69,0,215,43,0.0,-0.780336327410113
282,1572264000,665,332,0,997,43,0.0,0.41023209073722533
282,1572278400,959,216,0,1175,43,0.0,0.6812310401364916
282,1572292800,2027,171,0,2198,43,0.0,2.2387137661783423
282,1572307200,479,49,0,528,44,-0.1798148962519484,-0.3416170033237911
282,1572321600,39,4,0,43,44,-0.1798148962519484,-1.1017175692384036
282,1572336000,147,95,0,242,44,-0.1798148962519484,-0.7898412545641605
282,1572350400,722,381,0,1103,44,-0.1798148962519484,0.5595331521419866
282,1572364800,943,192,0,1135,44,-0.1798148962519484,0.6096841173157342
282,1572379200,2215,210,0,2425,44,-0.1798148962519484,2.6313949008824356
282,1572393600,559,47,0,606,44,-0.1798148962519484,-0.21937402571278125
282,1572408000,36,11,0,47,44,-0.1798148962519484,-1.0954486985916851
282,1572422400,154,84,0,238,44,-0.1798148962519484,-0.796110125210879
282,1572436800,705,314,0,1019,44,-0.1798148962519484,0.4278868685608991
282,1572451200,960,197,0,1157,44,-0.1798148962519484,0.6441629058726858
282,1572465600,2020,211,0,2231,44,-0.1798148962519484,2.3273546745165907
282,1572480000,576,56,0,632,44,-0.1798148962519484,-0.1786263665091113
282,1572494400,53,14,0,67,44,-0.1798148962519484,-1.064104345358093
282,1572508800,141,95,0,236,44,-0.1798148962519484,-0.7992445605342382
282,1572523200,686,318,0,1004,44,-0.1798148962519484,0.4043786036357049
282,1572537600,1012,160,0,1172,44,-0.1798148962519484,0.66767117079788
282,1572552000,838,618,0,1456,44,-0.1798148962519484,1.1127609867148902
282,1572566400,195,290,95,485,44,6.378612346508848,-0.40900736277601446
282,1572580800,86,24,0,110,44,-0.1798148962519484,-0.9967139859058695
282,1572595200,147,67,0,214,44,-0.1798148962519484,-0.8337233490911897
282,1572609600,608,336,0,944,44,-0.1798148962519484,0.3103455439349281
282,1572624000,1086,207,0,1293,44,-0.1798148962519484,0.8573045078611131
282,1572638400,1972,227,0,2199,44,-0.1798148962519484,2.2772037093428428
282,1572652800,556,93,0,649,44,-0.1798148962519484,-0.15198366626055787
282,1572667200,127,35,0,162,44,-0.1798148962519484,-0.9152186674985295
282,1572681600,28,45,17,73,44,0.9937983998210361,-1.0547010393880152
282,1572696000,214,170,0,384,44,-0.1798148962519484,-0.5672963466056554
282,1572710400,656,228,0,884,44,-0.1798148962519484,0.21631248423415128
282,1572724800,874,226,0,1100,44,-0.1798148962519484,0.5548314991569477
282,1572739200,410,97,0,507,44,-0.1798148962519484,-0.374528574219063
282,1572750000,109,17,0,126,44,-0.1798148962519484,-0.9716385033189957
282,1572764400,19,18,0,37,44,-0.1798148962519484,-1.1111208752084814
282,1572778800,175,128,0,303,44,-0.1798148962519484,-0.6942409772017041
282,1572793200,477,252,0,729,44,-0.1798148962519484,-0.026606253326188795
282,1572807600,750,191,0,941,44,-0.1798148962519484,0.30564389094988925
282,1572822000,334,58,0,392,44,-0.1798148962519484,-0.5547586053122185
282,1572836400,72,19,0,91,44,-0.1798148962519484,-1.026491121477782
282,1572850800,55,54,0,109,44,-0.1798148962519484,-0.9982812035675491
282,1572865200,653,297,0,950,44,-0.1798148962519484,0.3197488499050058
282,1572879600,701,201,0,902,44,-0.1798148962519484,0.24452240214438434
282,1572894000,2136,163,0,2299,44,-0.1798148962519484,2.4339254755108044
282,1572908400,775,78,0,853,44,-0.1798148962519484,0.16772873672208327
282,1572922800,108,19,0,127,45,-0.22205704442946247,-1.0054099313930152
282,1572937200,43,50,7,93,45,0.16424337605729475,-1.0568917652294043
282,1572951600,658,345,0,1003,45,-0.22205704442946247,0.32100437568572165
282,1572966000,724,246,0,970,45,-0.22205704442946247,0.27103671343275554
282,1572980400,2001,201,0,2202,45,-0.22205704442946247,2.136496104210157
282,1572994800,838,92,0,930,45,-0.22205704442946247,0.21046985009582694
282,1573009200,124,26,0,150,45,-0.22205704442946247,-0.9705839849742811
282,1573023600,59,42,0,101,45,-0.22205704442946247,-1.0447783925620187
282,1573038000,679,286,0,965,45,-0.22205704442946247,0.2634658555156395
282,1573052400,724,225,0,949,45,-0.22205704442946247,0.23923911018086805
282,1573066800,2074,204,0,2278,45,-0.22205704442946247,2.2515731445503215
282,1573081200,852,109,0,961,45,-0.22205704442946247,0.2574091691819466
282,1573095600,124,21,0,145,45,-0.22205704442946247,-0.9781548428913972
282,1573110000,46,48,2,94,45,-0.11168549571896041,-1.0553775936459813
282,1573124400,684,317,0,1001,45,-0.22205704442946247,0.31797603251887524
282,1573138800,802,184,0,986,45,-0.22205704442946247,0.295263458767527
282,1573153200,2182,215,0,2397,45,-0.22205704442946247,2.431759562977684
282,1573167600,887,85,0,972,45,-0.22205704442946247,0.274065056599602
282,1573182000,114,25,0,139,45,-0.22205704442946247,-0.9872398723919364
282,1573196400,52,40,0,92,45,-0.22205704442946247,-1.0584059368128276
282,1573210800,600,297,0,897,45,-0.22205704442946247,0.16050218784286083
282,1573225200,841,200,0,1041,45,-0.22205704442946247,0.37854289585580386
282,1573239600,2120,260,0,2380,45,-0.22205704442946247,2.4060186460594895
282,1573254000,784,105,0,889,45,-0.22205704442946247,0.14838881517547511
282,1573268400,159,43,0,202,45,-0.22205704442946247,-0.8918470626362739
282,1573282800,26,24,0,50,45,-0.22205704442946247,-1.1220011433166026
282,1573297200,153,268,115,421,45,6.124307006424407,-0.5602434858665897
282,1573311600,518,450,0,968,45,-0.22205704442946247,0.2680083702659091
282,1573326000,894,434,0,1328,45,-0.22205704442946247,0.8131101402982667
282,1573340400,473,246,0,719,45,-0.22205704442946247,-0.10902035400647152
282,1573354800,168,43,0,211,45,-0.22205704442946247,-0.878219518385465
282,1573369200,22,35,13,57,45,0.49535802218880093,-1.1114019422326402
282,1573383600,145,177,32,322,45,1.5438877349385705,-0.710146472625488
282,1573398000,525,390,0,915,45,-0.22205704442946247,0.18775727634447872
282,1573412400,796,288,0,1084,45,-0.22205704442946247,0.4436522739430021
282,1573426800,388,124,0,512,45,-0.22205704442946247,-0.4224538717750771
282,1573441200,71,28,0,99,45,-0.22205704442946247,-1.0478067357288652
282,1573455600,43,40,0,83,45,-0.22205704442946247,-1.0720334810636365
282,1573470000,582,304,0,886,45,-0.22205704442946247,0.14384630042520546
282,1573484400,639,269,0,908,45,-0.22205704442946247,0.17715807526051622
282,1573498800,1765,194,0,1959,45,-0.22205704442946247,1.7685524094383156
282,1573513200,647,89,0,736,45,-0.22205704442946247,-0.08327943708827686
282,1573527600,88,21,0,109,46,-0.237758517182737,-0.9715474111998871
282,1573542000,51,63,12,114,46,5.7537561158222355,-0.9643525402208704
282,1573556400,637,330,0,967,46,-0.237758517182737,0.26309244879937704
282,1573570800,715,204,0,919,46,-0.237758517182737,0.1940216874008168
282,1573585200,2137,181,0,2318,46,-0.237758517182737,2.207146587329687
282,1573599600,813,74,0,887,46,-0.237758517182737,0.14797451313510998
282,1573614000,100,28,0,128,46,-0.237758517182737,-0.9442069014796236
282,1573628400,52,42,0,94,46,-0.237758517182737,-0.9931320241369371
282,1573642800,646,375,0,1021,46,-0.237758517182737,0.3407970553727573
282,1573657200,718,209,0,927,46,-0.237758517182737,0.2055334809672435
282,1573671600,2004,195,0,2199,46,-0.237758517182737,2.0359086580290895
282,1573686000,893,70,0,963,46,-0.237758517182737,0.2573365520161637
282,1573700400,160,27,0,187,46,-0.237758517182737,-0.8593074239272267
282,1573714800,42,42,0,84,46,-0.237758517182737,-1.0075217660949705
282,1573729200,641,356,0,997,46,-0.237758517182737,0.30626167467347715
282,1573743600,688,232,0,920,46,-0.237758517182737,0.19546066159662015
282,1573758000,2213,197,0,2410,46,-0.237758517182737,2.339532213343594
282,1573772400,915,93,0,1008,46,-0.237758517182737,0.3220903908273139
282,1573786800,122,16,0,138,46,-0.237758517182737,-0.9298171595215903
282,1573801200,47,50,3,97,46,1.2601201410685061,-0.9888151015495271
282,1573815600,200,168,0,368,46,-0.237758517182737,-0.5988530944868224
282,1573830000,1424,541,0,1965,46,-0.237758517182737,1.6991886962111087
282,1573844400,2033,241,0,2274,46,-0.237758517182737,2.14383172271434
282,1573858800,803,101,0,904,46,-0.237758517182737,0.17243707446376674
282,1573873200,150,26,0,176,46,-0.237758517182737,-0.8751361400810633
282,1573887600,30,17,0,47,46,-0.237758517182737,-1.060763811339694
282,1573902000,177,175,0,352,46,-0.237758517182737,-0.6218766816196759
282,1573916400,608,249,0,857,46,-0.237758517182737,0.10480528726100985
282,1573930800,917,224,0,1141,46,-0.237758517182737,0.5134739588691578
282,1573945200,522,136,0,658,46,-0.237758517182737,-0.18155057770385444
282,1573959600,157,36,0,193,46,-0.237758517182737,-0.8506735787524067
282,1573974000,24,22,0,46,46,-0.237758517182737,-1.0622027855354974
282,1573988400,102,107,5,209,46,2.2587059132360015,-0.8276499916195532
282,1574002800,498,196,0,694,46,-0.237758517182737,-0.12974750665493426
282,1574017200,802,212,0,1014,46,-0.237758517182737,0.3307242360021339
282,1574031600,358,70,0,428,46,-0.237758517182737,-0.5125146427386222
282,1574046000,72,25,0,97,46,-0.237758517182737,-0.9888151015495271
282,1574060400,45,45,0,90,46,-0.237758517182737,-0.9988879209201504
282,1574074800,642,345,0,987,46,-0.237758517182737,0.2918719327154438
282,1574089200,722,210,0,932,46,-0.237758517182737,0.2127283519462602
282,1574103600,1978,210,0,2188,46,-0.237758517182737,2.020079941875253
282,1574118000,724,104,0,828,46,-0.237758517182737,0.06307503558271305
282,1574132400,90,16,0,106,47,-0.2483777776608204,-0.9316026238349504
282,1574146800,49,58,9,107,47,1.5230712781088045,-0.930122155024134
282,1574161200,637,346,0,983,47,-0.2483777776608204,0.3667685232510748
282,1574175600,707,208,0,915,47,-0.2483777776608204,0.26609664411555634
282,1574190000,2063,169,0,2232,47,-0.2483777776608204,2.2158740679608186
282,1574204400,854,88,0,942,47,-0.2483777776608204,0.3060693020076004
282,1574218800,101,17,0,118,47,-0.2483777776608204,-0.9138369981051531
282,1574233200,53,63,10,116,47,1.7198989509720959,-0.9167979357267859
282,1574247600,221,252,31,473,47,5.853280081101221,-0.38827057026531386
282,1574262000,1351,544,0,1895,47,-0.2483777776608204,1.7169560787156757
282,1574276400,2039,185,0,2224,47,-0.2483777776608204,2.2040303174742872
282,1574290800,857,78,0,935,47,-0.2483777776608204,0.2957060203318853
282,1574305200,96,26,0,122,47,-0.2483777776608204,-0.9079151228618872
282,1574319600,58,33,0,91,47,-0.2483777776608204,-0.9538096559971971
282,1574334000,685,355,0,1040,47,-0.2483777776608204,0.4511552454676124
282,1574348400,736,230,0,966,47,-0.2483777776608204,0.3416005534671952
282,1574362800,2030,242,0,2272,47,-0.2483777776608204,2.2750928203934766
282,1574377200,929,88,0,1017,47,-0.2483777776608204,0.41710446281883407
282,1574391600,118,24,0,142,47,-0.2483777776608204,-0.8783057466455583
282,1574406000,62,53,0,115,47,-0.2483777776608204,-0.9182784045376023
282,1574420400,649,291,0,940,47,-0.2483777776608204,0.30310836438596755
282,1574434800,792,193,0,985,47,-0.2483777776608204,0.3697294608727077
282,1574449200,1928,260,0,2188,47,-0.2483777776608204,2.150733440284895
282,1574463600,789,125,0,914,47,-0.2483777776608204,0.26461617530473985
282,1574478000,160,34,0,194,47,-0.2483777776608204,-0.801321368483103
282,1574492400,33,19,0,52,47,-0.2483777776608204,-1.0115479396190385
282,1574506800,141,82,0,223,47,-0.2483777776608204,-0.7583877729694259
282,1574521200,472,110,0,582,47,-0.2483777776608204,-0.22689946988632098
282,1574535600,757,85,0,842,47,-0.2483777776608204,0.1580224209259556
282,1574550000,389,39,0,428,47,-0.2483777776608204,-0.45489166675205406
282,1574564400,162,31,0,193,47,-0.2483777776608204,-0.8028018372939194
282,1574578800,19,22,3,41,47,0.34210524092905453,-1.0278330965380196
282,1574593200,101,64,0,165,47,-0.2483777776608204,-0.84425496399678
282,1574607600,359,111,0,470,47,-0.2483777776608204,-0.3927119766977632
282,1574622000,538,91,0,629,47,-0.2483777776608204,-0.1573174357779479
282,1574636400,307,53,0,360,47,-0.2483777776608204,-0.5555635458875725
282,1574650800,71,18,0,89,47,-0.2483777776608204,-0.95677059361883
282,1574665200,43,39,0,82,47,-0.2483777776608204,-0.9671338752945452
282,1574679600,561,319,0,880,47,-0.2483777776608204,0.21428023573698063
282,1574694000,737,202,0,939,47,-0.2483777776608204,0.3016278955751511
282,1574708400,1898,184,0,2082,47,-0.2483777776608204,1.9938037463383516
282,1574722800,722,70,0,792,47,-0.2483777776608204,0.08399898038513318
282,1574737200,107,24,0,131,48,-0.2520488114091409,-0.7709703266662365
282,1574751600,46,48,2,94,48,0.24032561087848328,-0.8420397232517942
282,1574766000,599,278,0,877,48,-0.2520488114091409,0.6619423720587915
282,1574780400,783,191,0,974,48,-0.2520488114091409,0.8482594387830913
282,1574794800,2033,212,0,2245,48,-0.2520488114091409,3.2895892512221137
282,1574809200,758,71,0,829,48,-0.2520488114091409,0.5697442359477977
282,1574823600,131,26,0,157,48,-0.2520488114091409,-0.7210296696061149
282,1574838000,50,42,0,92,48,-0.2520488114091409,-0.8458813122564189
282,1574852400,496,189,0,685,48,-0.2520488114091409,0.2931498276148164
282,1574866800,1034,156,0,1190,48,-0.2520488114091409,1.2631510512825632
282,1574881200,1517,174,0,1691,48,-0.2520488114091409,2.225469096941061
282,1574895600,516,62,0,578,48,-0.2520488114091409,0.08762481586739282
282,1574910000,108,19,0,127,48,-0.2520488114091409,-0.778653504675486
282,1574924400,38,6,0,44,48,-0.2520488114091409,-0.9380794483674127
282,1574938800,178,69,0,247,48,-0.2520488114091409,-0.5481581643980016
282,1574953200,278,116,0,394,48,-0.2520488114091409,-0.2658013725580832
282,1574967600,264,88,0,352,48,-0.2520488114091409,-0.34647474165520276
282,1574982000,136,46,0,182,48,-0.2520488114091409,-0.6730098070483057
282,1574996400,59,19,0,78,48,-0.2520488114091409,-0.8727724352887921
282,1575010800,19,39,20,58,48,4.671695411467101,-0.9111883253350396
282,1575025200,148,148,0,296,48,-0.2520488114091409,-0.4540392337846955
282,1575039600,537,245,0,782,48,-0.2520488114091409,0.47946689433911627
282,1575054000,950,207,0,1157,48,-0.2520488114091409,1.199764832706255
282,1575068400,495,80,0,575,48,-0.2520488114091409,0.08186243236045572
282,1575082800,119,29,0,148,48,-0.2520488114091409,-0.7383168201269262
282,1575097200,23,18,0,41,48,-0.2520488114091409,-0.9438418318743498
282,1575111600,103,79,0,182,48,-0.2520488114091409,-0.6730098070483057
282,1575126000,413,125,0,538,48,-0.2520488114091409,0.010793035774898027
282,1575140400,697,127,0,824,48,-0.2520488114091409,0.5601402634362358
282,1575154800,406,64,0,470,48,-0.2520488114091409,-0.11982099038234313
282,1575169200,134,21,0,155,48,-0.2520488114091409,-0.7248712586107396
282,1575183600,19,22,3,41,48,0.4865128220222954,-0.9438418318743498
282,1575198000,95,61,0,156,48,-0.2520488114091409,-0.7229504641084272
282,1575212400,370,152,0,522,48,-0.2520488114091409,-0.01993967626209989
282,1575226800,491,85,0,576,48,-0.2520488114091409,0.08378322686276808
282,1575241200,269,43,0,312,48,-0.2520488114091409,-0.42330652174769756
282,1575255600,55,27,0,82,48,-0.2520488114091409,-0.8650892572795427
282,1575270000,41,59,18,100,48,4.179320989179477,-0.83051495623792
282,1575284400,555,335,0,890,48,-0.2520488114091409,0.6869127005888522
282,1575298800,681,186,0,867,48,-0.2520488114091409,0.6427344270356677
282,1575313200,1813,184,0,1997,48,-0.2520488114091409,2.813232214648646
282,1575327600,563,61,0,624,48,-0.2520488114091409,0.17598136297376185
282,1575342000,101,4,0,105,49,-0.25749052383148724,-0.982553633478004
282,1575356400,38,52,14,90,49,4.330522446256831,-1.0047244353795493
282,1575370800,615,341,0,956,49,-0.25749052383148724,0.27526986106966134
282,1575385200,682,229,0,911,49,-0.25749052383148724,0.20875745536502568
282,1575399600,2441,219,0,2660,49,-0.25749052383148724,2.793872957085198
282,1575414000,1108,100,0,1208,49,-0.25749052383148724,0.647739333015621
282,1575428400,129,10,0,139,49,-0.25749052383148724,-0.9322998158345015
282,1575442800,37,51,14,88,49,4.330522446256831,-1.0076805422997552
282,1575457200,619,346,0,965,49,-0.25749052383148724,0.2885723422105885
282,1575471600,686,201,0,887,49,-0.25749052383148724,0.17328417232255333
282,1575486000,2035,189,0,2224,49,-0.25749052383148724,2.1494416484802836
282,1575500400,733,74,0,807,49,-0.25749052383148724,0.055039895514312175
282,1575514800,121,11,0,132,49,-0.25749052383148724,-0.9426461900552227
282,1575529200,47,38,0,85,49,-0.25749052383148724,-1.0121147026800643
282,1575543600,665,342,0,1007,49,-0.25749052383148724,0.35065058753491507
282,1575558000,719,174,0,893,49,-0.25749052383148724,0.1821524930831714
282,1575572400,2048,199,0,2247,49,-0.25749052383148724,2.183436878062653
282,1575586800,733,74,0,807,49,-0.25749052383148724,0.055039895514312175
282,1575601200,159,5,0,164,49,-0.25749052383148724,-0.8953484793319262
282,1575615600,38,43,5,81,49,1.3810855369143409,-1.0180269165204763
282,1575630000,598,275,0,873,49,-0.25749052383148724,0.15259142388111113
282,1575644400,671,211,0,882,49,-0.25749052383148724,0.16589390502203827
282,1575658800,2014,228,0,2242,49,-0.25749052383148724,2.176046610762138
282,1575673200,845,106,0,951,49,-0.25749052383148724,0.2678795937691463
282,1575687600,167,40,0,207,49,-0.25749052383148724,-0.8317921805474965
282,1575702000,23,17,0,40,49,-0.25749052383148724,-1.0786271083846999
282,1575716400,158,139,0,297,49,-0.25749052383148724,-0.6987673691382252
282,1575730800,623,246,0,869,49,-0.25749052383148724,0.14667921004069906
282,1575745200,908,188,0,1096,49,-0.25749052383148724,0.4821973454840834
282,1575759600,615,141,0,756,49,-0.25749052383148724,-0.020340830950941566
282,1575774000,171,32,0,203,49,-0.25749052383148724,-0.8377043943879086
282,1575788400,25,21,0,46,49,-0.25749052383148724,-1.069758787624082
282,1575802800,155,100,0,255,49,-0.25749052383148724,-0.7608456144625518
282,1575817200,536,234,0,770,49,-0.25749052383148724,0.0003519174905006377
282,1575831600,839,151,0,990,49,-0.25749052383148724,0.32552367871316384
282,1575846000,389,67,0,456,49,-0.25749052383148724,-0.4637568689818459
282,1575860400,71,15,0,86,49,-0.25749052383148724,-1.0106366492199612
282,1575874800,47,43,0,90,49,-0.25749052383148724,-1.0047244353795493
282,1575889200,611,308,0,919,49,-0.25749052383148724,0.2205818830458498
282,1575903600,680,154,0,834,49,-0.25749052383148724,0.09494733893709356
282,1575918000,1958,176,0,2134,49,-0.25749052383148724,2.0164168370710125
282,1575932400,811,67,0,878,49,-0.25749052383148724,0.1599816911816262
282,1575946800,96,13,0,109,50,0.0,-0.9689113389937353
282,1575961200,53,52,0,105,50,0.0,-0.9748015906655626
282,1575975600,657,438,0,1095,50,0.0,0.483035698111695
282,1575990000,742,204,0,946,50,0.0,0.26362382333612794
282,1576004400,2218,247,0,2465,50,0.0,2.5004468957125465
282,1576018800,897,87,0,984,50,0.0,0.3195812142184873
282,1576033200,118,16,0,134,50,0.0,-0.9320972660448147
282,1576047600,50,49,0,99,50,0.0,-0.9836369681733036
282,1576062000,671,321,0,992,50,0.0,0.33136171756214194
282,1576076400,778,172,0,950,50,0.0,0.2695140750079552
282,1576090800,2037,253,0,2290,50,0.0,2.242748385070102
282,1576105200,892,93,0,985,50,0.0,0.3210537771364441
282,1576119600,139,22,0,161,50,0.0,-0.8923380672599803
282,1576134000,49,46,0,95,50,0.0,-0.9895272198451308
282,1576148400,693,366,0,1059,50,0.0,0.43002343306524926
282,1576162800,766,162,0,928,50,0.0,0.23711769081290507
282,1576177200,1956,181,0,2137,50,0.0,2.0174462586227078
282,1576191600,933,94,0,1027,50,0.0,0.38290141969063085
282,1576206000,162,27,0,189,50,0.0,-0.8511063055571892
282,1576220400,45,39,0,84,50,0.0,-1.005725411942656
282,1576234800,632,280,0,912,50,0.0,0.21355668412559586
282,1576249200,818,217,0,1035,50,0.0,0.39468192303428545
282,1576263600,2147,215,0,2362,50,0.0,2.3487729151629937
282,1576278000,866,114,0,980,50,0.0,0.31369096254666
282,1576292400,220,27,0,247,50,0.0,-0.7656976563156933
282,1576306800,27,5,0,32,50,0.0,-1.0822986836764108
282,1576321200,154,50,0,204,50,0.0,-0.8290178617878369
282,1576335600,561,133,0,694,50,0.0,-0.10746203198899218
282,1576350000,907,120,0,1027,50,0.0,0.38290141969063085
282,1576364400,500,52,0,552,50,0.0,-0.31656596633886147
282,1576378800,162,21,0,183,50,0.0,-0.8599416830649301
282,1576393200,13,7,0,20,50,0.0,-1.0999694386918928
282,1576407600,128,52,0,180,50,0.0,-0.8643593718188006
282,1576422000,494,148,0,642,50,0.0,-0.18403530372274712
282,1576436400,792,100,0,892,50,0.0,0.18410542576645933
282,1576450800,365,30,0,395,50,0.0,-0.5477583444580831
282,1576465200,66,7,0,73,50,0.0,-1.0219236040401811
282,1576479600,55,36,0,91,50,0.0,-0.9954174715169581
282,1576494000,611,311,0,922,50,0.0,0.2282823133051641
282,1576508400,747,192,0,939,50,0.0,0.25331588291043017
282,1576522800,2031,192,0,2223,50,0.0,2.144086669566995
282,1576537200,692,82,0,774,50,0.0,0.010343001447553887
282,1576551600,158,5,0,163,51,-0.15617376188860604,-0.8393127526644708
282,1576566000,47,39,0,86,51,-0.15617376188860604,-0.9656197532283097
282,1576580400,646,285,0,931,51,-0.15617376188860604,0.42047655166057213
282,1576594800,728,201,0,929,51,-0.15617376188860604,0.4171958503472256
282,1576609200,1954,206,0,2160,51,-0.15617376188860604,2.4364675087119756
282,1576623600,771,77,0,848,51,-0.15617376188860604,0.2843274471566938
282,1576638000,138,11,0,149,51,-0.15617376188860604,-0.862277661857896
282,1576652400,47,31,0,78,51,-0.15617376188860604,-0.9787425584816956
282,1576666800,637,375,0,1012,51,-0.15617376188860604,0.553344954851104
282,1576681200,826,174,0,1000,51,-0.15617376188860604,0.5336607469710252
282,1576695600,1984,225,0,2209,51,-0.15617376188860604,2.516844690888964
282,1576710000,778,74,0,852,51,-0.15617376188860604,0.2908888497833867
282,1576724400,37,6,0,43,51,-0.15617376188860604,-1.0361548314652587
282,1576738800,47,33,0,80,51,-0.15617376188860604,-0.9754618571683491
282,1576753200,609,321,0,930,51,-0.15617376188860604,0.4188362010038989
282,1576767600,746,221,0,967,51,-0.15617376188860604,0.4795291753008085
282,1576782000,1924,190,0,2114,51,-0.15617376188860604,2.361011378505007
282,1576796400,690,66,0,756,51,-0.15617376188860604,0.13341518674275635
282,1576810800,149,5,0,154,51,-0.15617376188860604,-0.8540759085745299
282,1576825200,51,26,0,77,51,-0.15617376188860604,-0.9803829091383688
282,1576839600,542,328,0,870,51,-0.15617376188860604,0.3204151616035049
282,1576854000,930,254,0,1184,51,-0.15617376188860604,0.8354852677989001
282,1576868400,1744,246,0,1990,51,-0.15617376188860604,2.157607897077526
282,1576882800,601,97,0,698,51,-0.15617376188860604,0.03827484865570883
282,1576897200,168,16,0,184,51,-0.15617376188860604,-0.8048653888743329
282,1576911600,22,2,0,24,51,-0.15617376188860604,-1.0673214939420501
282,1576926000,155,41,0,196,51,-0.15617376188860604,-0.7851811809942542
282,1576940400,468,100,0,568,51,-0.15617376188860604,-0.17497073671181146
282,1576954800,805,65,0,870,51,-0.15617376188860604,0.3204151616035049
282,1576969200,485,44,0,529,51,-0.15617376188860604,-0.23894441232206753
282,1576983600,154,23,0,177,51,-0.15617376188860604,-0.8163478434710455
282,1576998000,12,4,0,16,51,-0.15617376188860604,-1.080444299195436
282,1577012400,107,27,0,134,51,-0.15617376188860604,-0.8868829217079945
282,1577026800,395,91,0,486,51,-0.15617376188860604,-0.3094794905590166
282,1577041200,646,83,0,729,51,-0.15617376188860604,0.08912571901257905
282,1577055600,356,33,0,389,51,-0.15617376188860604,-0.4685935042563201
282,1577070000,91,6,0,97,51,-0.15617376188860604,-0.9475758960049042
282,1577084400,25,37,12,62,51,6.4031242374328485,-1.0049881689884672
282,1577098800,365,191,0,556,51,-0.15617376188860604,-0.19465494459189026
282,1577113200,745,214,0,959,51,-0.15617376188860604,0.46640637004742264
282,1577127600,1382,219,0,1601,51,-0.15617376188860604,1.5195114916316381
282,1577142000,427,52,0,479,51,-0.15617376188860604,-0.3209619451557292
282,1577156400,109,5,0,114,52,-0.2782074420373286,-0.7460023032470666
282,1577170800,18,30,12,48,52,1.7248861406314375,-0.9115483453237483
282,1577185200,249,123,0,372,52,-0.2782074420373286,-0.09886777512912936
282,1577199600,682,177,0,859,52,-0.2782074420373286,1.1226613535275973
282,1577214000,793,119,0,912,52,-0.2782074420373286,1.2555998418619023
282,1577228400,216,40,0,256,52,-0.2782074420373286,-0.3898274854457213
282,1577242800,46,9,0,55,52,-0.2782074420373286,-0.8939904317701609
282,1577257200,11,11,0,22,52,-0.2782074420373286,-0.9767634528085016
282,1577271600,56,30,0,86,52,-0.2782074420373286,-0.8162339574614165
282,1577286000,165,74,0,239,52,-0.2782074420373286,-0.43246813264729084
282,1577300400,238,77,0,315,52,-0.2782074420373286,-0.24183935692262715
282,1577314800,142,34,0,176,52,-0.2782074420373286,-0.5904893546295779
282,1577329200,29,18,0,47,52,-0.2782074420373286,-0.9140566186885465
282,1577343600,16,44,28,60,52,4.395677584189792,-0.8814490649461698
282,1577358000,189,175,0,364,52,-0.2782074420373286,-0.11893396204751501
282,1577372400,605,240,0,845,52,-0.2782074420373286,1.0875455264204223
282,1577386800,1114,161,0,1275,52,-0.2782074420373286,2.1661030732836513
282,1577401200,395,48,0,443,52,-0.2782074420373286,0.07921963377154331
282,1577415600,91,11,0,102,52,-0.2782074420373286,-0.7761015836246451
282,1577430000,31,31,0,62,52,-0.2782074420373286,-0.8764325182165734
282,1577444400,247,163,0,410,52,-0.2782074420373286,-0.003553387266797507
282,1577458800,673,217,0,890,52,-0.2782074420373286,1.2004178278363418
282,1577473200,1210,195,0,1405,52,-0.2782074420373286,2.492178610707418
282,1577487600,464,53,0,517,52,-0.2782074420373286,0.2648318627666106
