remote_unit_id,time_stamp,entries,exits,num_people_exited,sum_exit_entry,week_num,z_score_num_people_exited,z_score_sum_exit_entry
257,1546311600,191,174,0,365,1,-0.36071769755364747,-0.5660717364207518
257,1546326000,66,57,0,123,1,-0.36071769755364747,-1.1263008629037627
257,1546340400,256,185,0,441,1,-0.36071769755364747,-0.39013201074840126
257,1546354800,337,242,0,579,1,-0.36071769755364747,-0.07066250886965957
257,1546369200,388,292,0,680,1,-0.36071769755364747,0.16315212656333256
257,1546383600,200,300,100,500,1,2.1475841728525107,-0.2535472237132871
257,1546398000,63,95,32,158,1,0.4419389009763231,-1.0452759892388643
257,1546412400,176,169,0,345,1,-0.36071769755364747,-0.6123716642292651
257,1546426800,828,446,0,1274,1,-0.36071769755364747,1.5382599824761773
257,1546441200,607,378,0,985,1,-0.36071769755364747,0.8692260256431603
257,1546455600,823,502,0,1325,1,-0.36071769755364747,1.6563247983878864
257,1546470000,246,380,134,626,1,3.000406808790604,0.03814232148034668
257,1546484400,60,33,0,93,1,-0.36071769755364747,-1.1957507546165327
257,1546498800,183,157,0,340,1,-0.36071769755364747,-0.6239466461813934
257,1546513200,814,454,0,1268,1,-0.36071769755364747,1.5243700041336234
257,1546527600,590,361,0,951,1,-0.36071769755364747,0.7905161483686877
257,1546542000,850,619,0,1469,1,-0.36071769755364747,1.989684278609182
257,1546556400,271,424,153,695,1,3.4769841641677743,0.19787707241971753
257,1546570800,78,44,0,122,1,-0.36071769755364747,-1.1286158592941884
257,1546585200,173,170,0,343,1,-0.36071769755364747,-0.6170016570101164
257,1546599600,908,482,0,1390,1,-0.36071769755364747,1.8067995637655545
257,1546614000,655,319,0,974,1,-0.36071769755364747,0.843761065348478
257,1546628400,811,548,0,1359,1,-0.36071769755364747,1.735034675662359
257,1546642800,349,387,38,736,1,0.5924370132006925,0.2927919244271698
257,1546657200,72,46,0,118,1,-0.36071769755364747,-1.137875844855891
257,1546671600,74,28,0,102,1,-0.36071769755364747,-1.1749157871027016
257,1546686000,363,129,0,492,1,-0.36071769755364747,-0.2720671948366924
257,1546700400,343,119,0,462,1,-0.36071769755364747,-0.34151708654946233
257,1546714800,366,96,0,462,1,-0.36071769755364747,-0.34151708654946233
257,1546729200,189,108,0,297,1,-0.36071769755364747,-0.723491490969697
257,1546743600,63,45,0,108,1,-0.36071769755364747,-1.1610258087601477
257,1546758000,62,25,0,87,1,-0.36071769755364747,-1.2096407329590866
257,1546772400,277,105,0,382,1,-0.36071769755364747,-0.5267167977835155
257,1546786800,373,188,0,561,1,-0.36071769755364747,-0.11233244389732153
257,1546801200,334,126,0,460,1,-0.36071769755364747,-0.34614707933031363
257,1546815600,165,105,0,270,1,-0.36071769755364747,-0.78599639351119
257,1546830000,62,28,0,90,1,-0.36071769755364747,-1.2026957437878096
257,1546844400,204,153,0,357,1,-0.36071769755364747,-0.5845917075441571
257,1546858800,938,424,0,1362,1,-0.36071769755364747,1.7419796648336359
257,1546873200,595,278,0,873,1,-0.36071769755364747,0.6099464299154859
257,1546887600,812,519,0,1331,1,-0.36071769755364747,1.6702147767304403
257,1546902000,249,396,147,645,1,3.3264860519434047,0.08212725289843431
257,1546916400,64,84,20,148,2,0.022272870633440627,-1.363839020452527
257,1546930800,192,170,0,362,2,-0.4574504968560506,-0.8804339760552042
257,1546945200,900,456,0,1356,2,-0.4574504968560506,1.3649146881080616
257,1546959600,623,379,0,1002,2,-0.4574504968560506,0.5652633529835183
257,1546974000,825,472,0,1297,2,-0.4574504968560506,1.2316394655873044
257,1546988400,313,455,142,768,2,2.9485854123193374,0.036680267053735324
257,1547002800,78,108,30,186,2,0.2621345543781862,-1.278000741540853
257,1547017200,208,168,0,376,2,-0.4574504968560506,-0.8488093469824822
257,1547031600,926,452,0,1378,2,-0.4574504968560506,1.4146105337937676
257,1547046000,660,374,0,1034,2,-0.4574504968560506,0.6375482194354544
257,1547060400,839,500,0,1339,2,-0.4574504968560506,1.3265133528054704
257,1547074800,369,454,85,823,2,1.5813738149742873,0.16091988126800053
257,1547089200,78,87,9,165,2,-0.24157498148577955,-1.325437685149936
257,1547103600,180,168,0,348,2,-0.4574504968560506,-0.9120586051279262
257,1547118000,970,445,0,1415,2,-0.4574504968560506,1.4981899106288188
257,1547132400,646,427,0,1073,2,-0.4574504968560506,0.7256454004237515
257,1547146800,865,532,0,1397,2,-0.4574504968560506,1.4575296732496048
257,1547161200,308,500,192,808,2,4.147893831043065,0.12703635011865547
257,1547175600,76,100,24,176,2,0.11821754413133888,-1.300589762307083
257,1547190000,178,173,0,351,2,-0.4574504968560506,-0.9052818988980573
257,1547204400,846,487,0,1333,2,-0.4574504968560506,1.3129599403457324
257,1547218800,635,338,0,973,2,-0.4574504968560506,0.4997551927614511
257,1547233200,807,542,0,1349,2,-0.4574504968560506,1.3491023735717005
257,1547247600,374,509,135,883,2,2.7806822336980153,0.2964540058653808
257,1547262000,102,112,10,214,2,-0.21758881311130499,-1.2147514833954087
257,1547276400,76,76,0,152,2,-0.4574504968560506,-1.354803412146035
257,1547290800,361,272,0,633,2,-0.4574504968560506,-0.2682715132903702
257,1547305200,466,379,0,845,2,-0.4574504968560506,0.21061572695370662
257,1547319600,449,459,10,908,2,-0.21758881311130499,0.3529265577809559
257,1547334000,313,354,41,667,2,0.5259824064974065,-0.19146884268518807
257,1547348400,117,130,13,247,2,-0.14563030798788132,-1.1402077148668497
257,1547362800,58,66,8,124,2,-0.26556114986025414,-1.418052670291479
257,1547377200,290,212,0,502,2,-0.4574504968560506,-0.5641876853279837
257,1547391600,386,385,0,771,2,-0.4574504968560506,0.04345697328360433
257,1547406000,358,359,1,717,2,-0.43346432848157607,-0.07852373885403788
257,1547420400,203,218,15,421,2,-0.09765797123893218,-0.747158753534447
257,1547434800,62,79,17,141,2,-0.04968563448998306,-1.3796513349888881
257,1547449200,183,210,27,393,2,0.19017604925476256,-0.8104080116798911
257,1547463600,980,472,0,1452,2,-0.4574504968560506,1.58176928746387
257,1547478000,633,321,0,954,2,-0.4574504968560506,0.45683605330561405
257,1547492400,851,550,0,1401,2,-0.4574504968560506,1.4665652815560968
257,1547506800,335,357,22,692,2,0.07024520738238975,-0.13499629076961298
257,1547521200,58,111,53,169,3,0.37663318581605565,-1.2345738254625336
257,1547535600,173,170,0,343,3,-0.6062337211318222,-0.8310374842656377
257,1547550000,947,502,0,1449,3,-0.6062337211318222,1.7339693741468143
257,1547564400,599,309,0,908,3,-0.6062337211318222,0.47929603743692584
257,1547578800,850,516,0,1366,3,-0.6062337211318222,1.5414779010471455
257,1547593200,299,452,153,751,3,2.231099047981863,0.11518566060984178
257,1547607600,62,105,43,167,3,0.1911865995994749,-1.239212174211923
257,1547622000,199,152,0,351,3,-0.6062337211318222,-0.8124840892680794
257,1547636400,968,445,0,1413,3,-0.6062337211318222,1.6504790966578013
257,1547650800,589,352,0,941,3,-0.6062337211318222,0.5558287918018543
257,1547665200,877,529,0,1406,3,-0.6062337211318222,1.6342448760349377
257,1547679600,334,554,220,888,3,3.4735911756329534,0.4329125499430298
257,1547694000,78,101,23,179,3,-0.17970657283368655,-1.2113820817155854
257,1547708400,190,164,0,354,3,-0.6062337211318222,-0.805526566143995
257,1547722800,933,527,0,1460,3,-0.6062337211318222,1.759480292268457
257,1547737200,633,384,0,1017,3,-0.6062337211318222,0.7320860442786593
257,1547751600,909,541,0,1450,3,-0.6062337211318222,1.736288548521509
257,1547766000,314,518,204,832,3,3.176876637686424,0.3030387849601208
257,1547780400,69,117,48,186,3,0.2839098927077653,-1.1951478610927218
257,1547794800,182,192,10,374,3,-0.4207871349152415,-0.7591430786500989
257,1547809200,900,432,0,1332,3,-0.6062337211318222,1.4626259723075223
257,1547823600,631,340,0,971,3,-0.6062337211318222,0.6254040230426984
257,1547838000,764,630,0,1394,3,-0.6062337211318222,1.6064147835386
257,1547852400,330,444,114,774,3,1.507857361737198,0.16852667122782225
257,1547866800,103,141,38,244,3,0.09846330649118454,-1.0606357473604233
257,1547881200,75,89,14,164,3,-0.3466085004286092,-1.2461696973360075
257,1547895600,360,254,0,614,3,-0.6062337211318222,-0.2025412287233462
257,1547910000,413,419,6,832,3,-0.49496576940187376,0.3030387849601208
257,1547924400,430,476,46,906,3,0.24682057546444913,0.4746576886875362
257,1547938800,267,344,77,611,3,0.8217049927358494,-0.2094987518474306
257,1547953200,90,126,36,216,3,0.061373989247868396,-1.1255726298518778
257,1547967600,49,53,4,102,3,-0.53205508664519,-1.3899585085670854
257,1547982000,239,199,0,438,3,-0.6062337211318222,-0.6107159186696315
257,1547996400,306,293,0,599,3,-0.6062337211318222,-0.23732884434376825
257,1548010800,360,374,14,734,3,-0.3466085004286092,0.07575969624003014
257,1548025200,181,260,79,441,3,0.8587943099791655,-0.6037583955455471
257,1548039600,56,98,42,154,3,0.17264194097781682,-1.2693614410829555
257,1548054000,119,157,38,276,3,0.09846330649118454,-0.9864221673701896
257,1548068400,398,317,0,715,3,-0.6062337211318222,0.03169538312082888
257,1548082800,360,327,0,687,3,-0.6062337211318222,-0.03324149937062559
257,1548097200,416,387,0,803,3,-0.6062337211318222,0.23578272809397155
257,1548111600,167,278,111,445,3,1.4522233858722238,-0.5944816980467679
257,1548126000,56,80,24,136,4,-0.11211427324930298,-1.3849909508620393
257,1548140400,184,174,0,358,4,-0.4766664907825205,-0.8776977537439667
257,1548154800,808,481,0,1289,4,-0.4766664907825205,1.249734527863806
257,1548169200,558,301,0,859,4,-0.4766664907825205,0.2671395965089808
257,1548183600,789,580,0,1369,4,-0.4766664907825205,1.432542887185634
257,1548198000,255,478,223,733,4,2.910631197130292,-0.020783569422898246
257,1548212400,55,141,86,196,4,0.8296456220448423,-1.2478846813706683
257,1548226800,188,152,0,340,4,-0.4766664907825205,-0.918829634591378
257,1548241200,910,496,0,1406,4,-0.4766664907825205,1.5170917533719794
257,1548255600,662,345,0,1007,4,-0.4766664907825205,0.6053350612543624
257,1548270000,830,522,0,1352,4,-0.4766664907825205,1.3936961108297454
257,1548284400,295,465,170,760,4,2.1055783834111033,0.04091425184821869
257,1548298800,69,89,20,158,4,-0.1728729761715059,-1.3347186520485366
257,1548313200,184,174,0,358,4,-0.4766664907825205,-0.8776977537439667
257,1548327600,847,473,0,1320,4,-0.4766664907825205,1.3205727671010143
257,1548342000,542,387,0,929,4,-0.4766664907825205,0.4270969109155802
257,1548356400,794,542,0,1336,4,-0.4766664907825205,1.3571344389653799
257,1548370800,329,546,217,875,4,2.8194931427469876,0.3037012683733464
257,1548385200,69,109,40,178,4,0.13092053843950868,-1.2890165622180796
257,1548399600,183,168,0,351,4,-0.4766664907825205,-0.8936934851846267
257,1548414000,856,505,0,1361,4,-0.4766664907825205,1.4142620512534512
257,1548428400,656,414,0,1070,4,-0.4766664907825205,0.749296644220302
257,1548442800,770,598,0,1368,4,-0.4766664907825205,1.4302577826941112
257,1548457200,395,566,171,961,4,2.1207680591416542,0.5002202546443114
257,1548471600,102,141,39,243,4,0.11573086270895795,-1.1404847702690943
257,1548486000,87,63,0,150,4,-0.4766664907825205,-1.3529994879807195
257,1548500400,402,272,0,674,4,-0.4766664907825205,-0.15560473442274636
257,1548514800,452,293,0,745,4,-0.4766664907825205,0.006637684475375945
257,1548529200,440,425,0,865,4,-0.4766664907825205,0.2808502234581179
257,1548543600,296,341,45,637,4,0.20686891709226232,-0.24015360060909177
257,1548558000,93,137,44,230,4,0.1916792413617116,-1.1701911286588915
257,1548572400,63,55,0,118,4,-0.4766664907825205,-1.4261228317094505
257,1548586800,319,191,0,510,4,-0.4766664907825205,-0.5303618710324937
257,1548601200,353,290,0,643,4,-0.4766664907825205,-0.2264429736599547
257,1548615600,416,377,0,793,4,-0.4766664907825205,0.11632270006847271
257,1548630000,242,226,0,468,4,-0.4766664907825205,-0.6263362596764533
257,1548644400,63,72,9,135,4,-0.3399594092075639,-1.3872760553535621
257,1548658800,183,174,0,357,4,-0.4766664907825205,-0.8799828582354896
257,1548673200,922,496,0,1418,4,-0.4766664907825205,1.5445130072702535
257,1548687600,603,363,0,966,4,-0.4766664907825205,0.5116457771019256
257,1548702000,801,575,0,1376,4,-0.4766664907825205,1.4485386186262939
257,1548716400,270,500,230,770,4,3.016958927244147,0.06376529676344718
257,1548730800,63,104,41,167,5,0.0991470916386013,-1.3651760854081005
257,1548745200,199,218,19,417,5,-0.21245805351128852,-0.7840381264044091
257,1548759600,1001,509,0,1510,5,-0.48157158795892063,1.7566970303597302
257,1548774000,671,361,0,1032,5,-0.48157158795892063,0.6455612527446721
257,1548788400,933,405,0,1338,5,-0.48157158795892063,1.3568741145651906
257,1548802800,283,495,212,778,5,2.5211689016672905,0.055125086396921485
257,1548817200,64,138,74,202,5,0.566554809363436,-1.2838167711475839
257,1548831600,191,205,14,396,5,-0.283277404681718,-0.8328537149607191
257,1548846000,978,437,0,1415,5,-0.48157158795892063,1.5358646059383276
257,1548860400,627,349,0,976,5,-0.48157158795892063,0.5153863499278452
257,1548874800,815,504,0,1319,5,-0.48157158795892063,1.31270762968091
257,1548889200,258,497,239,755,5,2.90359339798761,0.0016603941685818626
257,1548903600,61,108,47,169,5,0.18413031304311672,-1.360526981736071
257,1548918000,188,163,0,351,5,-0.48157158795892063,-0.9374585475813837
257,1548932400,927,387,0,1314,5,-0.48157158795892063,1.3010848705008362
257,1548946800,531,306,0,837,5,-0.48157158795892063,0.19227364472179267
257,1548961200,820,511,0,1331,5,-0.48157158795892063,1.3406022517130871
257,1548975600,239,475,236,714,5,2.861101787285352,-0.09364623110802354
257,1548990000,58,108,50,166,5,0.22662192374537443,-1.3675006372441154
257,1549004400,187,160,0,347,5,-0.48157158795892063,-0.9467567549254428
257,1549018800,852,410,0,1262,5,-0.48157158795892063,1.1802081750280684
257,1549033200,578,332,0,910,5,-0.48157158795892063,0.36196592875087064
257,1549047600,722,506,0,1228,5,-0.48157158795892063,1.1011734126035662
257,1549062000,370,156,0,526,5,-0.48157158795892063,-0.5306619762787996
257,1549076400,336,609,273,945,5,3.3851649859465303,0.4433252430113874
257,1549090800,69,75,6,144,5,-0.3965883665544052,-1.4186407776364403
257,1549105200,369,264,0,633,5,-0.48157158795892063,-0.2819349298252196
257,1549119600,419,320,0,739,5,-0.48157158795892063,-0.035532435207654395
257,1549134000,530,400,0,930,5,-0.48157158795892063,0.40845696547116594
257,1549148400,336,337,1,673,5,-0.46740771772483475,-0.18895285638462897
257,1549162800,88,164,76,252,5,0.5948825498316078,-1.1675891793468456
257,1549177200,65,53,0,118,5,-0.48157158795892063,-1.4790791253728242
257,1549191600,295,180,0,475,5,-0.48157158795892063,-0.6492141199155527
257,1549206000,379,325,0,704,5,-0.48157158795892063,-0.11689174946817121
257,1549220400,503,330,0,833,5,-0.48157158795892063,0.1829754373777336
257,1549234800,238,263,25,501,5,-0.1274748321067731,-0.5887757721791688
257,1549249200,67,116,49,183,5,0.21245805351128852,-1.3279832560318643
257,1549263600,196,189,0,385,5,-0.48157158795892063,-0.8584237851568817
257,1549278000,787,422,0,1209,5,-0.48157158795892063,1.0570069277192857
257,1549292400,626,374,0,1000,5,-0.48157158795892063,0.5711755939921995
257,1549306800,931,747,0,1678,5,-0.48157158795892063,2.147221738810211
257,1549321200,376,442,66,818,5,0.45324384749074886,0.14810715983751213
257,1549335600,86,108,22,194,6,1.443659022949118,-1.169253909329555
257,1549350000,131,165,34,296,6,2.363512559695459,-0.9500188013302635
257,1549364400,741,378,0,1119,6,-0.24273912775250658,0.8189076092914715
257,1549378800,672,409,0,1081,6,-0.24273912775250658,0.7372317847427159
257,1549393200,926,551,0,1477,6,-0.24273912775250658,1.5883798510929068
257,1549407600,411,286,0,697,6,-0.24273912775250658,-0.08812391596049957
257,1549422000,81,70,0,151,6,-0.24273912775250658,-1.261676552897884
257,1549436400,122,95,0,217,6,-0.24273912775250658,-1.1198185418395188
257,1549450800,788,338,0,1126,6,-0.24273912775250658,0.8339531559188739
257,1549465200,651,336,0,987,6,-0.24273912775250658,0.5351915871747412
257,1549479600,990,467,0,1457,6,-0.24273912775250658,1.5453925750146142
257,1549494000,390,369,0,759,6,-0.24273912775250658,0.04513663988220709
257,1549508400,65,56,0,121,6,-0.24273912775250658,-1.3261574670153227
257,1549522800,151,95,0,246,6,-0.24273912775250658,-1.0574869915259948
257,1549537200,1015,413,0,1428,6,-0.24273912775250658,1.4830610247010902
257,1549551600,662,340,0,1002,6,-0.24273912775250658,0.5674320442334606
257,1549566000,1052,530,0,1582,6,-0.24273912775250658,1.8140630505039421
257,1549580400,459,333,0,792,6,-0.24273912775250658,0.11606564541138967
257,1549594800,87,57,0,144,6,-0.24273912775250658,-1.2767220995252864
257,1549609200,150,103,0,253,6,-0.24273912775250658,-1.0424414448985924
257,1549623600,865,536,0,1401,6,-0.24273912775250658,1.4250282019953953
257,1549638000,669,282,0,951,6,-0.24273912775250658,0.45781449023381476
257,1549652400,1010,556,0,1566,6,-0.24273912775250658,1.7796732296413083
257,1549666800,533,337,0,870,6,-0.24273912775250658,0.2837160221167303
257,1549681200,113,93,0,206,6,-0.24273912775250658,-1.1434615436825797
257,1549695600,66,49,0,115,6,-0.24273912775250658,-1.3390536498388104
257,1549710000,428,259,0,687,6,-0.24273912775250658,-0.10961755399964579
257,1549724400,685,330,0,1015,6,-0.24273912775250658,0.5953737736843507
257,1549738800,740,351,0,1091,6,-0.24273912775250658,0.7587254227818621
257,1549753200,437,242,0,679,6,-0.24273912775250658,-0.12681246443096278
257,1549767600,146,72,0,218,6,-0.24273912775250658,-1.1176691780356043
257,1549782000,46,29,0,75,6,-0.24273912775250658,-1.4250282019953953
257,1549796400,316,212,0,528,6,-0.24273912775250658,-0.4513663988220709
257,1549810800,524,307,0,831,6,-0.24273912775250658,0.19989083376405997
257,1549825200,567,259,0,826,6,-0.24273912775250658,0.18914401474448686
257,1549839600,310,213,0,523,6,-0.24273912775250658,-0.46211321784164405
257,1549854000,61,58,0,119,6,-0.24273912775250658,-1.330456194623152
257,1549868400,164,86,0,250,6,-0.24273912775250658,-1.0488895363103363
257,1549882800,773,401,0,1174,6,-0.24273912775250658,0.9371226185067758
257,1549897200,560,327,0,887,6,-0.24273912775250658,0.3202552067832789
257,1549911600,713,517,0,1230,6,-0.24273912775250658,1.0574869915259948
257,1549926000,274,351,77,625,6,5.65965439970318,-0.24287810984235245
257,1549940400,50,27,0,77,7,-0.4965005614367162,-1.4822265205976934
257,1549954800,179,169,0,348,7,-0.4965005614367162,-0.8022578672809005
257,1549969200,765,392,0,1157,7,-0.4965005614367162,1.2276116549821454
257,1549983600,473,323,0,796,7,-0.4965005614367162,0.3218231537003659
257,1549998000,698,548,0,1246,7,-0.4965005614367162,1.4509223935252988
257,1550012400,269,347,78,616,7,1.6550018714557206,-0.12981654222960723
257,1550026800,53,19,0,72,7,-0.4965005614367162,-1.4947720677068594
257,1550041200,183,125,0,308,7,-0.4965005614367162,-0.902622244154228
257,1550055600,889,413,0,1302,7,-0.4965005614367162,1.5914325211479572
257,1550070000,593,346,0,939,7,-0.4965005614367162,0.6806258010225112
257,1550084400,734,535,0,1269,7,-0.4965005614367162,1.5086319102274621
257,1550098800,338,488,150,826,7,3.6410041172025855,0.39709643635536146
257,1550113200,64,35,0,99,7,-0.4965005614367162,-1.4270261133173634
257,1550127600,183,163,0,346,7,-0.4965005614367162,-0.8072760861245669
257,1550142000,894,430,0,1324,7,-0.4965005614367162,1.6466329284282872
257,1550156400,615,364,0,979,7,-0.4965005614367162,0.7809901778958386
257,1550170800,759,562,0,1321,7,-0.4965005614367162,1.6391056001627877
257,1550185200,363,492,129,855,7,3.0617534621930833,0.46986060958852377
257,1550199600,72,46,0,118,7,-0.4965005614367162,-1.3793530343025329
257,1550214000,192,188,0,380,7,-0.4965005614367162,-0.7219663657822387
257,1550228400,841,459,0,1300,7,-0.4965005614367162,1.5864143023042907
257,1550242800,582,330,0,912,7,-0.4965005614367162,0.6128798466330153
257,1550257200,708,525,0,1233,7,-0.4965005614367162,1.4183039710414673
257,1550271600,400,485,85,885,7,1.8480854231255548,0.5451338922435193
257,1550286000,93,117,24,210,7,0.16550018714557208,-1.14851496749388
257,1550300400,93,70,0,163,7,-0.4965005614367162,-1.2664431103200398
257,1550314800,372,221,0,593,7,-0.4965005614367162,-0.18752605893177046
257,1550329200,407,336,0,743,7,-0.4965005614367162,0.18884035434320717
257,1550343600,440,384,0,824,7,-0.4965005614367162,0.3920782175116951
257,1550358000,300,340,40,640,7,0.6068340195337643,-0.06959791610561081
257,1550372400,97,128,31,225,7,0.3585837388154061,-1.1108783261663822
257,1550386800,71,44,0,115,7,-0.4965005614367162,-1.3868803625680326
257,1550401200,306,194,0,500,7,-0.4965005614367162,-0.4208732351622566
257,1550415600,368,431,63,799,7,1.2412514035917905,0.32935048196586547
257,1550430000,526,306,0,832,7,-0.4965005614367162,0.41215109288636054
257,1550444400,247,278,31,525,7,0.3585837388154061,-0.358145499616427
257,1550458800,61,108,47,169,7,0.7999175712035983,-1.2513884537890405
257,1550473200,110,55,0,165,7,-0.4965005614367162,-1.2614248914763733
257,1550487600,520,254,0,774,7,-0.4965005614367162,0.26662274642003586
257,1550502000,426,295,0,721,7,-0.4965005614367162,0.1336399470628771
257,1550516400,474,341,0,815,7,-0.4965005614367162,0.36949623271519644
257,1550530800,223,301,78,524,7,1.6550018714557206,-0.3606546090382602
257,1550545200,56,95,39,151,8,-0.0573030382679026,-1.5635596472768762
257,1550559600,167,193,26,360,8,-0.2378944315970502,-1.0616194750694643
257,1550574000,797,483,0,1280,8,-0.5990772182553454,1.1478779336904352
257,1550588400,536,413,0,949,8,-0.5990772182553454,0.35293919206051483
257,1550602800,719,573,0,1292,8,-0.5990772182553454,1.1766974651090425
257,1550617200,330,488,158,818,8,1.5958027929758332,0.03832597407405088
257,1550631600,62,132,70,194,8,0.37333797659391094,-1.460289659693533
257,1550646000,160,174,14,334,8,-0.4045941792854942,-1.1240617931431136
257,1550660400,813,436,0,1249,8,-0.5990772182553454,1.0734274775256993
257,1550674800,572,329,0,901,8,-0.5990772182553454,0.2376610663860853
257,1550689200,684,520,0,1204,8,-0.5990772182553454,0.9653542347059217
257,1550703600,285,433,148,718,8,1.4568863365687965,-0.20183678774767733
257,1550718000,60,106,46,166,8,0.03993848121702303,-1.527535233003617
257,1550732400,176,188,12,364,8,-0.4323774705669015,-1.0520129645965952
257,1550746800,852,382,0,1234,8,-0.5990772182553454,1.0374030632524402
257,1550761200,529,326,0,855,8,-0.5990772182553454,0.12718619594809033
257,1550775600,817,441,0,1258,8,-0.5990772182553454,1.095042126089655
257,1550790000,282,542,260,824,8,3.0127506483276068,0.05273573978335458
257,1550804400,68,126,58,194,8,0.206638228905467,-1.460289659693533
257,1550818800,187,184,0,371,8,-0.5990772182553454,-1.035201571269074
257,1550833200,823,490,0,1313,8,-0.5990772182553454,1.2271316450916054
257,1550847600,602,413,0,1015,8,-0.5990772182553454,0.5114466148628555
257,1550862000,739,518,0,1257,8,-0.5990772182553454,1.0926404984714377
257,1550876400,372,576,204,948,8,2.2348184924482015,0.35053756444229756
257,1551495600,9633,3847,0,13480,9,-0.36717491773932054,4.103216193130166
257,1551510000,93,77,0,170,9,-0.36717491773932054,-0.3793470660300226
257,1551524400,393,273,0,666,9,-0.36717491773932054,-0.21230338634982326
257,1551538800,452,320,0,772,9,-0.36717491773932054,-0.17660453545042581
257,1551553200,454,354,0,808,9,-0.36717491773932054,-0.16448039740912102
257,1551567600,262,321,59,583,9,0.5130502800917368,-0.24025626016727597
257,1551582000,123,132,9,255,9,-0.2329032773922101,-0.35072062898805295
257,1551596400,67,56,0,123,9,-0.36717491773932054,-0.3951758018061705
257,1551610800,318,155,0,473,9,-0.36717491773932054,-0.27730223751570726
257,1551625200,361,270,0,631,9,-0.36717491773932054,-0.2240907427788696
257,1551639600,428,318,0,746,9,-0.36717491773932054,-0.18536085736914595
257,1551654000,213,254,41,467,9,0.24450699939751594,-0.27932292718925805
257,1551668400,48,91,43,139,9,0.27434514169687385,-0.38978729601003503
257,1551682800,151,137,0,288,9,-0.36717491773932054,-0.3396068357835236
257,1551697200,707,329,0,1036,9,-0.36717491773932054,-0.08769418981419068
257,1551711600,466,293,0,759,9,-0.36717491773932054,-0.18098269640978587
257,1551726000,708,450,0,1158,9,-0.36717491773932054,-0.04660683311865778
257,1551740400,245,536,291,781,9,3.974274786817251,-0.17357350094009963
257,1551754800,63,106,43,169,10,0.22573494830459248,-1.4283280768114395
257,1551769200,207,173,0,380,10,-0.4573811227513675,-0.929704735491309
257,1551783600,994,463,0,1457,10,-0.4573811227513675,1.6154011346593093
257,1551798000,586,351,0,937,10,-0.4573811227513675,0.3865663598419263
257,1551812400,853,523,0,1376,10,-0.4573811227513675,1.4239864870435246
257,1551826800,312,531,219,843,10,3.0217449135568937,0.16443084285570703
257,1551841200,68,104,36,172,10,0.11453000650478505,-1.4212386454182622
257,1551855600,210,158,0,368,10,-0.4573811227513675,-0.9580624610640178
257,1551863846,664,284,0,948,10,-0.4573811227513675,0.41256094161690937
257,1551870000,475,348,0,823,10,-0.4573811227513675,0.11716796690119229
257,1551884400,580,370,0,950,10,-0.4573811227513675,0.41728722921236083
257,1551898800,819,526,0,1345,10,-0.4573811227513675,1.3507290293140268
257,1551913200,266,516,250,782,10,3.5142239415274696,0.02027907119443709
257,1551927600,66,107,41,173,10,0.19396210779036177,-1.4188755016205366
257,1551942000,205,186,0,391,10,-0.4573811227513675,-0.9037101537163259
257,1551946712,358,161,0,519,10,-0.4573811227513675,-0.6012277476074316
257,1551956400,576,340,0,916,10,-0.4573811227513675,0.33694034008968576
257,1551970800,584,346,0,930,10,-0.4573811227513675,0.3700243532578461
257,1551985200,848,782,0,1630,10,-0.4573811227513675,2.0242250116658616
257,1551999600,461,654,193,1115,10,2.6086979868718947,0.8072059558371074
257,1552014000,82,119,37,201,10,0.1304164267619004,-1.3527074752842159
257,1552028400,182,229,47,411,10,0.2892806293330539,-0.8564472777618112
257,1552042800,901,463,0,1364,10,-0.4573811227513675,1.3956287614708158
257,1552057200,618,531,0,1149,10,-0.4573811227513675,0.8875528449597824
257,1552071600,855,568,0,1423,10,-0.4573811227513675,1.5350542455366343
257,1552086000,366,575,209,941,10,2.8628807109857406,0.3960189350328292
257,1552100400,117,164,47,281,10,0.2892806293330539,-1.163655971466157
257,1552114800,95,93,0,188,10,-0.4573811227513675,-1.3834283446546505
257,1552129200,414,323,0,737,10,-0.4573811227513675,-0.08606239970322105
257,1552143600,495,468,0,963,10,-0.4573811227513675,0.4480080985827954
257,1552158000,562,543,0,1105,10,-0.4573811227513675,0.78357451785985
257,1552172400,372,410,38,782,10,0.14630284701901575,0.02027907119443709
257,1552190400,116,150,34,266,10,0.08275716599055435,-1.199103128432043
257,1552204800,93,100,7,193,10,-0.34617618095156005,-1.3716126256660217
257,1552219200,302,242,0,544,10,-0.4573811227513675,-0.5421491526642882
257,1552233600,427,400,0,827,10,-0.4573811227513675,0.12662054209209522
257,1552248000,416,361,0,777,10,-0.4573811227513675,0.008463352205808409
257,1552262400,216,253,37,469,10,0.1304164267619004,-0.7193849374937185
257,1552276800,41,35,0,76,10,-0.4573811227513675,-1.648100449999933
257,1552291200,436,312,0,748,10,-0.4573811227513675,-0.060067817928237954
257,1552305600,836,395,0,1231,10,-0.4573811227513675,1.0813306363732929
257,1552320000,682,363,0,1045,10,-0.4573811227513675,0.6417858899963058
257,1552334400,724,588,0,1312,10,-0.4573811227513675,1.2727452839890774
257,1552348800,228,393,165,621,11,2.7693257755240204,-0.38019771114802425
257,1552363200,47,64,17,111,11,-0.11556261406158552,-1.623531294780189
257,1552377600,443,338,0,781,11,-0.44693492908155374,0.009867726854223503
257,1552392000,878,361,0,1239,11,-0.44693492908155374,1.1264300431356578
257,1552406400,668,396,0,1064,11,-0.44693492908155374,0.6997959703206992
257,1552420800,715,638,0,1353,11,-0.44693492908155374,1.4043516677122592
257,1552435200,223,400,177,623,11,3.0032356449498803,-0.37532189317299613
257,1552449600,51,63,12,114,11,-0.21302505965569382,-1.6162175678176467
257,1552464000,444,331,0,775,11,-0.44693492908155374,-0.004759727070860788
257,1552478400,839,399,0,1238,11,-0.44693492908155374,1.1239921341481436
257,1552492800,718,422,0,1140,11,-0.44693492908155374,0.8850770533717669
257,1552507200,730,624,0,1354,11,-0.44693492908155374,1.4067895766997733
257,1552521600,244,426,182,670,11,3.1006980905439887,-0.26074017075983585
257,1552536000,38,58,20,96,11,-0.05708514670512055,-1.6600999295928995
257,1552550400,457,296,0,753,11,-0.44693492908155374,-0.05839372479616985
257,1552564800,847,368,0,1215,11,-0.44693492908155374,1.0679202274353206
257,1552579200,713,424,0,1137,11,-0.44693492908155374,0.8777633264092247
257,1552593600,790,625,0,1415,11,-0.44693492908155374,1.5555020249381302
257,1552608000,282,406,124,688,11,1.970133721652332,-0.216857808984583
257,1552622400,53,89,36,142,11,0.254794679196026,-1.5479561161672535
257,1552636800,430,284,0,714,11,-0.44693492908155374,-0.15347217530921775
257,1552651200,808,452,0,1260,11,-0.44693492908155374,1.1776261318734527
257,1552665600,725,413,0,1138,11,-0.44693492908155374,0.8802012353967388
257,1552680000,662,627,0,1289,11,-0.44693492908155374,1.24832549251136
257,1552694400,322,459,137,781,11,2.2235360801970137,0.009867726854223503
257,1552708800,66,85,19,151,11,-0.07657763582394221,-1.526014935279627
257,1552723200,169,128,0,297,11,-0.44693492908155374,-1.170080223102576
257,1552737600,499,274,0,773,11,-0.44693492908155374,-0.009635545045888884
257,1552752000,498,344,0,842,11,-0.44693492908155374,0.15858017509258046
257,1552766400,546,401,0,947,11,-0.44693492908155374,0.41456061878155553
257,1552780800,313,302,0,615,11,-0.44693492908155374,-0.39482516507310855
257,1552795200,75,84,9,159,11,-0.2715025270121588,-1.5065116633795146
257,1552809600,123,110,0,233,11,-0.44693492908155374,-1.326106398303475
257,1552824000,431,214,0,645,11,-0.44693492908155374,-0.32168789544768706
257,1552838400,414,238,0,652,11,-0.44693492908155374,-0.30462253253508875
257,1552852800,396,330,0,726,11,-0.44693492908155374,-0.12421726745904915
257,1552867200,200,265,65,465,11,0.8200768636418541,-0.7605115132002158
257,1552881600,47,35,0,82,11,-0.44693492908155374,-1.6942306554180964
257,1552896000,439,263,0,702,11,-0.44693492908155374,-0.18272708315938632
257,1552910400,785,460,0,1245,11,-0.44693492908155374,1.1410574970607419
257,1552924800,656,399,0,1055,11,-0.44693492908155374,0.6778547894330728
257,1552939200,711,621,0,1332,11,-0.44693492908155374,1.3531555789744643
257,1552953600,211,436,225,647,12,2.951490286628039,-0.34147693969187015
257,1552968000,40,69,29,109,12,-0.0776417467246623,-1.606811955972208
257,1552982400,469,322,0,791,12,-0.5258296496186844,-0.00279990931200277
257,1552996800,784,489,0,1273,12,-0.5258296496186844,1.13082737293172
257,1553011200,687,373,0,1060,12,-0.5258296496186844,0.6298675988281661
257,1553025600,801,592,0,1393,12,-0.5258296496186844,1.4130582315816096
257,1553040000,225,447,222,672,12,2.905126020811416,-0.28267884413980987
257,1553054400,47,62,15,109,12,-0.2940083205355695,-1.606811955972208
257,1553068800,445,298,0,743,12,-0.5258296496186844,-0.11569225277195856
257,1553083200,757,491,0,1248,12,-0.5258296496186844,1.0720292773796598
257,1553097600,686,423,0,1109,12,-0.5258296496186844,0.7451118661102044
257,1553112000,780,575,0,1355,12,-0.5258296496186844,1.3236851263424778
257,1553126400,271,417,146,688,12,1.7305646201236338,-0.24504806298649126
257,1553140800,54,75,21,129,12,-0.20127978890232356,-1.5597734795305598
257,1553155200,447,318,0,765,12,-0.5258296496186844,-0.06394992868614549
257,1553169600,792,452,0,1244,12,-0.5258296496186844,1.06262158209133
257,1553184000,700,426,0,1126,12,-0.5258296496186844,0.7850945710856054
257,1553198400,725,618,0,1343,12,-0.5258296496186844,1.2954620404774888
257,1553212800,259,484,225,743,12,2.951490286628039,-0.11569225277195856
257,1553227200,47,84,37,131,12,0.04599629545299896,-1.555069631886395
257,1553241600,433,328,0,761,12,-0.5258296496186844,-0.07335762397447514
257,1553256000,764,509,0,1273,12,-0.5258296496186844,1.13082737293172
257,1553270400,685,438,0,1123,12,-0.5258296496186844,0.7780387996193582
257,1553284800,626,720,94,1346,12,0.9269173459688355,1.3025178119437362
257,1553299200,305,386,81,691,12,0.7260055274301359,-0.237992291520244
257,1553313600,50,110,60,160,12,0.4014556667137751,-1.486863841046005
257,1553328000,182,117,0,299,12,-0.5258296496186844,-1.1599464297765496
257,1553342400,428,312,0,740,12,-0.5258296496186844,-0.1227480242382058
257,1553356800,481,330,0,811,12,-0.5258296496186844,0.04423856712964548
257,1553371200,437,398,0,835,12,-0.5258296496186844,0.10068473885962338
257,1553385600,229,382,153,611,12,1.8387479070290873,-0.426146197286837
257,1553400000,53,94,41,147,12,0.10781531654182959,-1.5174388507330763
257,1553414400,100,92,0,192,12,-0.5258296496186844,-1.4116022787393678
257,1553428800,370,255,0,625,12,-0.5258296496186844,-0.39321926377768324
257,1553443200,421,346,0,767,12,-0.5258296496186844,-0.05924608104198067
257,1553457600,396,382,0,778,12,-0.5258296496186844,-0.03337491899907413
257,1553472000,192,267,75,459,12,0.6332769957968899,-0.7836386182433637
257,1553486400,37,42,5,79,12,-0.44855587325764606,-1.6773696706346803
257,1553500800,490,319,0,809,12,-0.5258296496186844,0.03953471948548065
257,1553515200,976,484,0,1460,12,-0.5258296496186844,1.570637127661131
257,1553529600,951,179,0,1130,12,-0.5258296496186844,0.7945022663739351
257,1553544000,1074,424,0,1498,12,-0.5258296496186844,1.6600102329002628
257,1553558400,287,236,0,523,13,-0.4025499592269909,-0.5160335776827801
257,1553572800,43,476,433,519,13,5.316804383352741,-0.5253906895069256
257,1553587200,486,303,0,789,13,-0.4025499592269909,0.10621435862288854
257,1553601600,796,437,0,1233,13,-0.4025499592269909,1.1448537711030273
257,1553616000,647,400,0,1047,13,-0.4025499592269909,0.7097480712802664
257,1553630400,697,709,12,1406,13,-0.2440459127813632,1.5495488574973155
257,1553644800,278,423,145,701,13,1.5127072686576766,-0.09964210150831013
257,1553659200,41,69,28,110,13,-0.03270718418719299,-1.482155373525792
257,1553673600,440,277,0,717,13,-0.4025499592269909,-0.06221365421172855
257,1553688000,826,468,0,1294,13,-0.4025499592269909,1.2875497264212445
257,1553702400,678,412,0,1090,13,-0.4025499592269909,0.8103370233898294
257,1553716800,782,666,0,1448,13,-0.4025499592269909,1.6477985316508421
257,1553731200,280,419,139,699,13,1.4334552454348628,-0.10432065742038282
257,1553745600,36,71,35,107,13,0.059753509572756484,-1.489173207393901
257,1553760000,479,324,0,803,13,-0.4025499592269909,0.13896425000739743
257,1553774400,827,435,0,1262,13,-0.4025499592269909,1.2126928318280814
257,1553788800,662,410,0,1072,13,-0.4025499592269909,0.7682300201811751
257,1553803200,775,623,0,1398,13,-0.4025499592269909,1.5308346338490249
257,1553817600,262,420,158,682,13,1.68441998564044,-0.14408838267300075
257,1553832000,45,71,26,116,13,-0.059124525261464264,-1.468119705789574
257,1553846400,431,284,0,715,13,-0.4025499592269909,-0.06689221012380124
257,1553860800,847,430,0,1277,13,-0.4025499592269909,1.2477820011686267
257,1553875200,697,421,0,1118,13,-0.4025499592269909,0.8758368061588472
257,1553889600,700,600,0,1300,13,-0.4025499592269909,1.3015853941574627
257,1553904000,268,385,117,653,13,1.1428644936178787,-0.21192744339805486
257,1553918400,60,90,30,150,13,-0.006289843112921711,-1.3885842552843382
257,1553932800,136,95,0,231,13,-0.4025499592269909,-1.1991027408453938
257,1553947200,350,288,0,638,13,-0.4025499592269909,-0.24701661273860007
257,1553961600,323,301,0,624,13,-0.4025499592269909,-0.27976650412310894
257,1553976000,311,318,7,629,13,-0.3100892654670414,-0.2680701143429272
257,1553990400,201,277,76,478,13,0.6013090015953176,-0.6213010857044158
257,1554004800,61,68,7,129,13,-0.3100892654670414,-1.4377090923611016
257,1554019200,71,70,0,141,13,-0.4025499592269909,-1.4096377568886653
257,1554033600,232,163,0,395,13,-0.4025499592269909,-0.8154611560554328
257,1554048000,244,235,0,479,13,-0.4025499592269909,-0.6189618077483795
257,1554062400,257,202,0,459,13,-0.4025499592269909,-0.6657473668691064
257,1554076800,119,179,60,298,13,0.38997027300114745,-1.0423711177909585
257,1554091200,32,39,7,71,13,-0.3100892654670414,-1.5733872138112097
257,1554105600,447,306,0,753,13,-0.4025499592269909,0.022000352205579995
257,1554120000,774,479,0,1253,13,-0.4025499592269909,1.1916393302237542
257,1554134400,702,374,0,1076,13,-0.4025499592269909,0.7775871320053206
257,1554148800,758,590,0,1348,13,-0.4025499592269909,1.4138707360472074
257,1554163200,122,195,73,317,14,1.948078451244562,-0.9262941761827921
257,1554177600,2,4,2,6,14,-0.38117974507110913,-1.6099065005683295
257,1554192000,443,381,0,824,14,-0.44679265200957874,0.1881477802913801
257,1554206400,832,389,0,1221,14,-0.44679265200957874,1.060797596307645
257,1554220800,630,443,0,1073,14,-0.44679265200957874,0.7354772618733699
257,1554235200,756,602,0,1358,14,-0.44679265200957874,1.3619387166961294
257,1554249600,139,186,47,325,14,1.095110661044457,-0.9087092932403988
257,1554264000,2,2,0,4,14,-0.44679265200957874,-1.6143027213039278
257,1554278400,443,338,0,781,14,-0.44679265200957874,0.09362903447601639
257,1554292800,792,445,0,1237,14,-0.44679265200957874,1.0959673621924315
257,1554307200,709,357,0,1066,14,-0.44679265200957874,0.7200904892987758
257,1554321600,725,664,0,1389,14,-0.44679265200957874,1.4300801380979034
257,1554336000,146,237,91,383,14,2.538594613690788,-0.7812188919080477
257,1554350400,1,5,4,6,14,-0.3155668381326395,-1.6099065005683295
257,1554364800,449,289,0,738,14,-0.44679265200957874,-0.000889711339347325
257,1554379200,793,493,0,1286,14,-0.44679265200957874,1.2036747702145902
257,1554393600,744,423,0,1167,14,-0.44679265200957874,0.9420996364464906
257,1554408000,742,721,0,1463,14,-0.44679265200957874,1.5927403053150408
257,1554422400,140,204,64,344,14,1.6528203700214488,-0.8669451962522148
257,1554436800,2,4,2,6,14,-0.38117974507110913,-1.6099065005683295
257,1554451200,424,306,0,730,14,-0.44679265200957874,-0.018474594281740572
257,1554465600,798,440,0,1238,14,-0.44679265200957874,1.0981654725602308
257,1554480000,674,434,0,1108,14,-0.44679265200957874,0.8124111247463405
257,1554494400,675,690,15,1365,14,0.045304150028943314,1.3773254892707236
257,1554508800,269,406,137,675,14,4.04769147327559,-0.13937066451069416
257,1554523200,70,54,0,124,14,-0.44679265200957874,-1.3505294771680292
257,1554537600,152,123,0,275,14,-0.44679265200957874,-1.0186148116303566
257,1554552000,454,365,0,819,14,-0.44679265200957874,0.17715722845238432
257,1554566400,510,338,0,848,14,-0.44679265200957874,0.24090242911855986
257,1554580800,502,348,0,850,14,-0.44679265200957874,0.24529864985415817
257,1554595200,282,356,74,638,14,1.9808849047137966,-0.22070074811926294
257,1554609600,83,79,0,162,14,-0.44679265200957874,-1.2670012831916613
257,1554624000,137,80,0,217,14,-0.44679265200957874,-1.1461052129627076
257,1554638400,366,226,0,592,14,-0.44679265200957874,-0.32181382503802414
257,1554652800,368,324,0,692,14,-0.44679265200957874,-0.1020027882581085
257,1554667200,384,323,0,707,14,-0.44679265200957874,-0.06903113274112116
257,1554681600,180,226,46,406,14,1.0623042075752223,-0.7306623534486671
257,1554696000,35,52,17,87,14,0.11091705696741293,-1.431859560776598
257,1554710400,432,317,0,749,14,-0.44679265200957874,0.023289502706443393
257,1554724800,835,417,0,1252,14,-0.44679265200957874,1.128939017709419
257,1554739200,717,391,0,1108,14,-0.44679265200957874,0.8124111247463405
257,1554753600,743,634,0,1377,14,-0.44679265200957874,1.4037028136843135
257,1554768000,193,224,31,417,15,0.9139959594056299,-0.5441606461355228
257,1554782400,2,2,0,4,15,-0.327957775444222,-1.4499389678827113
257,1554796800,448,327,0,775,15,-0.327957775444222,0.24099344390199143
257,1554811200,805,480,0,1285,15,-0.327957775444222,1.3595090470280593
257,1554825600,702,359,0,1061,15,-0.327957775444222,0.8682394487922962
257,1554840000,692,641,0,1333,15,-0.327957775444222,1.4647811037928657
257,1554854400,125,199,74,324,15,2.636705978713489,-0.7481252561173353
257,1554868800,0,1,1,1,15,-0.28789475173938806,-1.4565184714305115
257,1554883200,460,335,0,795,15,-0.327957775444222,0.2848568008873274
257,1554897600,805,449,0,1254,15,-0.327957775444222,1.2915208437007886
257,1554912000,717,345,0,1062,15,-0.327957775444222,0.8704326166415629
257,1554926400,742,579,0,1321,15,-0.327957775444222,1.4384630896016641
257,1554940800,154,258,104,412,15,3.838596689858507,-0.5551264853818569
257,1554955200,3,7,4,10,15,-0.16770568062488625,-1.4367799607871103
257,1554969600,436,318,0,754,15,-0.327957775444222,0.19493691906738864
257,1554984000,840,413,0,1253,15,-0.327957775444222,1.2893276758515217
257,1554998400,751,439,0,1190,15,-0.327957775444222,1.1511581013477132
257,1555012800,736,720,0,1456,15,-0.327957775444222,1.734540749252682
257,1555027200,136,244,108,380,15,3.998848784677843,-0.6253078565583945
257,1555041600,0,3,3,3,15,-0.2077687043297202,-1.452132135731978
257,1555056000,440,322,0,762,15,-0.327957775444222,0.21248226186152303
257,1555059786,339,111,0,450,15,-0.327957775444222,-0.47178610710971847
257,1555070400,489,326,0,815,15,-0.327957775444222,0.3287201578726634
257,1555084800,508,364,0,872,15,-0.327957775444222,0.453730725280871
257,1555099200,703,696,0,1399,15,-0.327957775444222,1.6095301818444745
257,1555113600,305,332,27,637,15,0.7537438645862943,-0.06166371929682694
257,1555128000,35,25,0,60,15,-0.327957775444222,-1.3271215683237705
257,1555142400,178,59,0,237,15,-0.327957775444222,-0.9389308590035469
257,1555156800,434,118,0,552,15,-0.327957775444222,-0.2480829864845049
257,1555171200,438,132,0,570,15,-0.327957775444222,-0.20860596519770253
257,1555185600,364,172,0,536,15,-0.327957775444222,-0.2831736720727737
257,1555200000,192,117,0,309,15,-0.327957775444222,-0.7810227738563372
257,1555214400,59,20,0,79,15,-0.327957775444222,-1.2854513791877011
257,1555228800,113,46,0,159,15,-0.327957775444222,-1.1099979512463571
257,1555243200,338,135,0,473,15,-0.327957775444222,-0.4213432465765821
257,1555257600,350,137,0,487,15,-0.327957775444222,-0.3906388966868469
257,1555272000,306,136,0,442,15,-0.327957775444222,-0.4893314499038529
257,1555286400,145,70,0,215,15,-0.327957775444222,-0.9871805516874165
257,1555300800,32,12,0,44,15,-0.327957775444222,-1.3622122539120392
257,1555315200,429,312,0,741,15,-0.327957775444222,0.16642573702692023
257,1555329600,752,608,0,1360,15,-0.327957775444222,1.5239966357230692
257,1555344000,666,404,0,1070,15,-0.327957775444222,0.8879779594356974
257,1555358400,707,534,0,1241,15,-0.327957775444222,1.2630096616603201
257,1555372800,218,302,84,520,16,2.318000356738904,-0.37702268965726293
257,1555387200,28,50,22,78,16,0.31266051323454974,-1.391671748920445
257,1555401600,480,286,0,766,16,-0.3989116892992532,0.1876914926475851
257,1555416000,832,464,0,1296,16,-0.3989116892992532,1.4043521293206318
257,1555430400,732,446,0,1178,16,-0.3989116892992532,1.133472968702859
257,1555444800,794,483,0,1277,16,-0.3989116892992532,1.3607359932889564
257,1555459200,256,332,76,588,16,2.059246828544793,-0.2209228343860041
257,1555473600,41,56,15,97,16,0.08625117606470337,-1.34805561288877
257,1555488000,477,272,0,749,16,-0.3989116892992532,0.1486665288297704
257,1555502400,815,418,0,1233,16,-0.3989116892992532,1.2597302045840242
257,1555516800,701,359,0,1060,16,-0.3989116892992532,0.8625938080850865
257,1555531200,743,613,0,1356,16,-0.3989116892992532,1.5420872957364482
257,1555545600,252,397,145,649,16,4.290996009218993,-0.08089208186325723
257,1555560000,46,53,7,99,16,-0.1725023521294068,-1.3434644406749094
257,1555574400,433,303,0,736,16,-0.3989116892992532,0.11882390943967683
257,1555588800,917,434,0,1351,16,-0.3989116892992532,1.530609365201797
257,1555603200,675,414,0,1089,16,-0.3989116892992532,0.9291658051860645
257,1555617600,710,605,0,1315,16,-0.3989116892992532,1.447968265352307
257,1555632000,315,404,89,719,16,2.4797213118602226,0.07979894562186211
257,1555646400,47,67,20,114,16,0.2479721311860222,-1.3090306490709551
257,1555660800,325,231,0,556,16,-0.3989116892992532,-0.29438158980777296
257,1555675200,706,477,0,1183,16,-0.3989116892992532,1.1449508992375104
257,1555689600,654,385,0,1039,16,-0.3989116892992532,0.8143864998395506
257,1555704000,606,594,0,1200,16,-0.3989116892992532,1.1839758630553252
257,1555718400,236,296,60,532,16,1.5417397721565729,-0.3494756563740996
257,1555732800,43,27,0,70,16,-0.3989116892992532,-1.4100364377758874
257,1555747200,134,56,0,190,16,-0.3989116892992532,-1.1345661049442541
257,1555761600,356,115,0,471,16,-0.3989116892992532,-0.4895064088968465
257,1555776000,407,128,0,535,16,-0.3989116892992532,-0.3425888980533088
257,1555790400,335,148,0,483,16,-0.3989116892992532,-0.46195937561368317
257,1555804800,170,111,0,281,16,-0.3989116892992532,-0.9256677692135991
257,1555819200,42,23,0,65,16,-0.3989116892992532,-1.4215143683105387
257,1555833600,103,37,0,140,16,-0.3989116892992532,-1.249345410290768
257,1555848000,338,106,0,444,16,-0.3989116892992532,-0.5514872337839639
257,1555862400,319,131,0,450,16,-0.3989116892992532,-0.5377137171423823
257,1555876800,277,159,0,436,16,-0.3989116892992532,-0.5698519226394062
257,1555891200,152,98,0,250,16,-0.3989116892992532,-0.9968309385284376
257,1555905600,37,24,0,61,16,-0.3989116892992532,-1.43069671273826
257,1555920000,359,290,0,649,16,-0.3989116892992532,-0.08089208186325723
257,1555934400,754,429,0,1183,16,-0.3989116892992532,1.1449508992375104
257,1555948800,623,387,0,1010,16,-0.3989116892992532,0.7478145027385726
257,1555963200,621,619,0,1240,16,-0.3989116892992532,1.2757993073325362
257,1555977600,225,348,123,573,17,3.3914458941017833,-0.28757599600199824
257,1555992000,33,38,5,71,17,-0.3247277950605092,-1.5994382233212912
257,1556006400,371,304,0,675,17,-0.4821927818894199,-0.02102231634748057
257,1556020800,835,359,0,1194,17,-0.4821927818894199,1.3352655242475653
257,1556035200,641,364,0,1005,17,-0.4821927818894199,0.841357235475959
257,1556049600,672,627,0,1299,17,-0.4821927818894199,1.6096590180095687
257,1556064000,268,321,53,589,17,1.1869360784970335,-0.24576365409540724
257,1556078400,36,65,29,101,17,0.43110414171826217,-1.521040082246433
257,1556092800,375,261,0,636,17,-0.4821927818894199,-0.12293989974479615
257,1556107200,755,446,0,1201,17,-0.4821927818894199,1.3535584238316989
257,1556121600,612,361,0,973,17,-0.4821927818894199,0.757732551662777
257,1556136000,635,617,0,1252,17,-0.4821927818894199,1.4868352636589577
257,1556150400,285,287,2,572,17,-0.41920678715785564,-0.2901892673711602
257,1556164800,44,60,16,104,17,0.02169517596309434,-1.5132002681389471
257,1556179200,378,258,0,636,17,-0.4821927818894199,-0.12293989974479615
257,1556193600,755,382,0,1137,17,-0.4821927818894199,1.1863090562053347
257,1556208000,684,384,0,1068,17,-0.4821927818894199,1.005993331733161
257,1556222400,724,551,0,1275,17,-0.4821927818894199,1.5469405051496823
257,1556236800,244,365,121,609,17,3.328459899370219,-0.1934982267121685
257,1556251200,46,60,14,106,17,-0.04129081876846994,-1.5079737254006234
257,1556265600,326,275,0,601,17,-0.4821927818894199,-0.21440439766546399
257,1556266313,43,13,0,56,17,-0.4821927818894199,-1.6386372938587201
257,1556272576,429,209,0,638,17,-0.4821927818894199,-0.11771335700647227
257,1556280000,405,275,0,680,17,-0.4821927818894199,-0.00795595950167088
257,1556294400,602,320,0,922,17,-0.4821927818894199,0.6244557118355181
257,1556308800,625,623,0,1248,17,-0.4821927818894199,1.4763821781823099
257,1556323200,266,375,109,641,17,2.9505439309808335,-0.10987354289898646
257,1556337600,69,86,17,155,17,0.05318817332887649,-1.3799234283116883
257,1556352000,140,168,28,308,17,0.39961114435248,-0.9800929088299118
257,1556366400,444,349,0,793,17,-0.4821927818894199,0.2873437052136281
257,1556380800,564,392,0,956,17,-0.4821927818894199,0.713306938387024
257,1556395200,509,340,0,849,17,-0.4821927818894199,0.4336869018866966
257,1556409600,228,297,69,525,17,1.690824036349548,-0.4130130217217713
257,1556424000,60,87,27,147,17,0.36811814698669787,-1.4008295992649837
257,1556438400,111,85,0,196,17,-0.4821927818894199,-1.272779302176049
257,1556452800,358,263,0,621,17,-0.4821927818894199,-0.1621389702822252
257,1556467200,388,392,4,780,17,-0.35622079242629134,0.2533711774145229
257,1556481600,358,303,0,661,17,-0.4821927818894199,-0.0576081155157477
257,1556496000,208,266,58,474,17,1.3444010653259444,-0.5462898615490301
257,1556510400,33,47,14,80,17,-0.04129081876846994,-1.5759187809988338
257,1556524800,470,296,0,766,17,-0.4821927818894199,0.2167853782462558
257,1556526894,203,73,0,276,17,-0.4821927818894199,-1.0637175926430937
257,1556539200,620,316,0,936,17,-0.4821927818894199,0.6610415110037853
257,1556553600,675,373,0,1048,17,-0.4821927818894199,0.9537279043499223
257,1556568000,726,578,0,1304,17,-0.4821927818894199,1.6227253748553785
257,1556582400,227,308,81,535,18,1.931076744325833,-0.5711703473766617
257,1556596800,30,44,14,74,18,-0.07980783436457878,-1.6849580157277682
257,1556611200,456,281,0,737,18,-0.49999267170287376,-0.08313323456337869
257,1556625600,841,396,0,1237,18,-0.49999267170287376,1.1248794209150448
257,1556640000,641,383,0,1024,18,-0.49999267170287376,0.6102660296812363
257,1556654400,752,540,0,1292,18,-0.49999267170287376,1.2577608130176712
257,1556668800,277,380,103,657,18,2.5913672030002965,-0.27641525943992645
257,1556683200,41,45,4,86,18,-0.37993986103478944,-1.6559657119962858
257,1556697600,439,328,0,767,18,-0.49999267170287376,-0.010652475234673294
257,1556712000,825,415,0,1240,18,-0.49999267170287376,1.1321274968479151
257,1556726400,664,362,0,1026,18,-0.49999267170287376,0.61509808030315
257,1556740800,734,649,0,1383,18,-0.49999267170287376,1.4776191163147443
257,1556755200,284,373,89,657,18,2.1711823656620015,-0.27641525943992645
257,1556769600,38,35,0,73,18,-0.49999267170287376,-1.687374041038725
257,1556784000,486,287,0,773,18,-0.49999267170287376,0.0038436766310677856
257,1556793603,633,327,0,960,18,-0.49999267170287376,0.45564040977999815
257,1556798400,465,258,0,723,18,-0.49999267170287376,-0.11695758891677455
257,1556812800,683,395,0,1078,18,-0.49999267170287376,0.7407313964729061
257,1556827200,717,558,0,1275,18,-0.49999267170287376,1.2166883827314048
257,1556841600,292,441,149,733,18,3.9719745256832657,-0.09279733580720609
257,1556856000,41,76,35,117,18,0.5504694216428636,-1.5810689273566236
257,1556870400,426,293,0,719,18,-0.49999267170287376,-0.12662169016060193
257,1556878267,539,339,0,878,18,-0.49999267170287376,0.2575263342815367
257,1556884800,454,353,0,807,18,-0.49999267170287376,0.08598853720360057
257,1556899200,844,528,0,1372,18,-0.49999267170287376,1.451042837894219
257,1556913600,954,748,0,1702,18,-0.49999267170287376,2.2483311905099783
257,1556928000,360,423,63,783,18,1.3908390963194537,0.028003929740636254
257,1556942400,52,87,35,139,18,0.5504694216428636,-1.5279163705155732
257,1556956800,196,162,0,358,18,-0.49999267170287376,-0.9988068274160237
257,1556971200,458,488,30,946,18,0.40040340830775834,0.4218160554266023
257,1556985600,641,542,0,1183,18,-0.49999267170287376,0.9944140541233749
257,1557000000,502,406,0,908,18,-0.49999267170287376,0.3300070936102421
257,1557014400,316,320,4,636,18,-0.37993986103478944,-0.32715179097002023
257,1557028800,59,80,21,139,18,0.1302845843045687,-1.5279163705155732
257,1557043200,102,74,0,176,18,-0.49999267170287376,-1.4385234340101698
257,1557057600,335,212,0,547,18,-0.49999267170287376,-0.5421780436451796
257,1557072000,378,368,0,746,18,-0.49999267170287376,-0.06138900676476708
257,1557086400,357,329,0,686,18,-0.49999267170287376,-0.20635052542217788
257,1557100800,166,230,64,396,18,1.4208522989864747,-0.9069978655996634
257,1557115200,38,79,41,117,18,0.7305486376449901,-1.5810689273566236
257,1557129600,463,281,0,744,18,-0.49999267170287376,-0.06622105738668077
257,1557144000,750,417,0,1167,18,-0.49999267170287376,0.9557576491480654
257,1557158400,682,299,0,981,18,-0.49999267170287376,0.5063769413100919
257,1557172800,728,637,0,1365,18,-0.49999267170287376,1.434130660717521
257,1557187200,243,325,82,568,19,1.870846531553734,-0.4022164893256367
257,1557201600,43,53,10,96,19,-0.1849432055125959,-1.5501115079205006
257,1557216000,457,329,0,786,19,-0.47046955788291944,0.127955362483008
257,1557226517,359,214,0,573,19,-0.47046955788291944,-0.39005658446764024
257,1557227120,9,7,0,16,19,-0.47046955788291944,-1.7446699856484436
257,1557230400,829,429,0,1258,19,-0.47046955788291944,1.2758503810778719
257,1557244800,705,360,0,1065,19,-0.47046955788291944,0.8064780535592092
257,1557259200,740,569,0,1309,19,-0.47046955788291944,1.3998814106294355
257,1557273600,298,343,45,641,19,0.8143990277835366,-0.2246818783988887
257,1557288000,53,54,1,107,19,-0.4419169226458871,-1.5233597172329083
257,1557302400,462,257,0,719,19,-0.47046955788291944,-0.03498736261414427
257,1557316800,810,467,0,1277,19,-0.47046955788291944,1.3220580195382583
257,1557331200,738,360,0,1098,19,-0.47046955788291944,0.8867334256219858
257,1557345600,727,618,0,1345,19,-0.47046955788291944,1.4874327256070097
257,1557360000,303,374,71,677,19,1.5567675439463777,-0.13713056342131436
257,1557374400,43,68,25,111,19,0.24334632304288942,-1.513631793346511
257,1557388800,436,350,0,786,19,-0.47046955788291944,0.127955362483008
257,1557403200,778,425,0,1203,19,-0.47046955788291944,1.142091427639911
257,1557417600,691,407,0,1098,19,-0.47046955788291944,0.8867334256219858
257,1557432000,746,624,0,1370,19,-0.47046955788291944,1.548232249896992
257,1557446400,251,412,161,663,19,4.12650471527929,-0.17117829702370438
257,1557460800,37,77,40,114,19,0.6716358515983747,-1.5063358504317133
257,1557475200,443,308,0,751,19,-0.47046955788291944,0.04283602847703293
257,1557489600,802,460,0,1262,19,-0.47046955788291944,1.2855783049642688
257,1557504000,707,395,0,1102,19,-0.47046955788291944,0.8964613495083829
257,1557518400,680,570,0,1250,19,-0.47046955788291944,1.2563945333050774
257,1557532800,369,392,23,761,19,0.1862410525688247,0.06715583819302581
257,1557547200,78,93,15,171,19,-0.04218002932743414,-1.367712935050554
257,1557561600,170,136,0,306,19,-0.47046955788291944,-1.03939550388465
257,1557576000,476,309,0,785,19,-0.47046955788291944,0.1255233815114087
257,1557590400,522,287,0,809,19,-0.47046955788291944,0.1838909248297916
257,1557604800,441,367,0,808,19,-0.47046955788291944,0.18145894385819233
257,1557619200,248,367,119,615,19,2.927294035323931,-0.2879133836604702
257,1557633600,57,93,36,150,19,0.5574253106502454,-1.4187845354541389
257,1557648000,107,88,0,195,19,-0.47046955788291944,-1.309345391732171
257,1557662400,319,196,0,515,19,-0.47046955788291944,-0.5311114808203989
257,1557676800,328,309,0,637,19,-0.47046955788291944,-0.23440980228528585
257,1557691200,303,288,0,591,19,-0.47046955788291944,-0.3462809269788531
257,1557705600,167,254,87,421,19,2.0136097077388957,-0.7597176921507319
257,1557720000,30,40,10,70,19,-0.1849432055125959,-1.6133430131820818
257,1557734400,454,291,0,745,19,-0.47046955788291944,0.028244142647437208
257,1557748800,824,325,0,1149,19,-0.47046955788291944,1.0107644551735493
257,1557763200,698,328,0,1026,19,-0.47046955788291944,0.7116307956668371
257,1557777600,687,583,0,1270,19,-0.47046955788291944,1.3050341527370632
257,1557792000,196,326,130,522,20,2.890091877083062,-0.6387772589155551
257,1557806400,34,53,19,87,20,0.013574300020458492,-1.7203769364305868
257,1557820800,459,308,0,767,20,-0.478802582539807,-0.0296004290507672
257,1557835200,792,501,0,1293,20,-0.478802582539807,1.2782649281283285
257,1557849600,689,389,0,1078,20,-0.478802582539807,0.7436811794714737
257,1557864000,724,602,0,1326,20,-0.478802582539807,1.360317317457055
257,1557878400,240,407,167,647,20,3.8489310694372634,-0.3279727538825
257,1557892800,44,53,9,97,20,-0.24557142764283915,-1.6955125760279424
257,1557907200,476,305,0,781,20,-0.478802582539807,0.005209675512934964
257,1557921600,824,476,0,1300,20,-0.478802582539807,1.2956699804101794
257,1557936000,764,341,0,1105,20,-0.478802582539807,0.8108149525586137
257,1557950400,751,562,0,1313,20,-0.478802582539807,1.3279936489336173
257,1557964800,329,417,88,746,20,1.801679820897212,-0.08181558589632044
257,1557979200,53,54,1,107,20,-0.45288800977347726,-1.670648215625298
257,1557993600,462,312,0,774,20,-0.478802582539807,-0.012195376768916119
257,1558008000,816,379,0,1195,20,-0.478802582539807,1.0345941961824132
257,1558022400,679,423,0,1102,20,-0.478802582539807,0.8033556444378204
257,1558036800,760,542,0,1302,20,-0.478802582539807,1.3006428524907083
257,1558051200,290,363,73,653,20,1.4129612294022658,-0.3130541376409134
257,1558065600,48,78,30,126,20,0.2986346004500859,-1.6234059308602735
257,1558080000,449,313,0,762,20,-0.478802582539807,-0.0420326092520894
257,1558094400,800,464,0,1264,20,-0.478802582539807,1.2061582829606596
257,1558108800,717,414,0,1131,20,-0.478802582539807,0.8754622896054891
257,1558123200,723,588,0,1311,20,-0.478802582539807,1.3230207768530884
257,1558137600,352,460,108,812,20,2.319971276223807,0.08228919276113261
257,1558152000,63,115,52,178,20,0.8687552013093407,-1.4941112567665227
257,1558166400,207,153,0,360,20,-0.478802582539807,-1.0415798974383945
257,1558180800,503,324,0,827,20,-0.478802582539807,0.11958573336509923
257,1558195200,509,360,0,869,20,-0.478802582539807,0.22401604705620573
257,1558209600,490,342,0,832,20,-0.478802582539807,0.13201791356642142
257,1558224000,294,329,35,623,20,0.42820746428173473,-0.3876472188488466
257,1558238400,69,97,28,166,20,0.24680545491742636,-1.523948489249696
257,1558252800,152,75,0,227,20,-0.478802582539807,-1.372275890793565
257,1558267200,375,215,0,590,20,-0.478802582539807,-0.46969960817757317
257,1558281600,391,357,0,748,20,-0.478802582539807,-0.07684271381579157
257,1558296000,439,381,0,820,20,-0.478802582539807,0.10218068108324814
257,1558310400,231,267,36,498,20,0.4541220370480645,-0.6984517238819017
257,1558324800,40,37,0,77,20,-0.478802582539807,-1.7452412968332311
257,1558339200,470,291,0,761,20,-0.478802582539807,-0.04451904529235384
257,1558353600,806,386,0,1192,20,-0.478802582539807,1.02713488806162
257,1558368000,663,422,0,1085,20,-0.478802582539807,0.7610862317533248
257,1558382400,701,559,0,1260,20,-0.478802582539807,1.1962125387996019
257,1558396800,261,353,92,614,21,2.98555474043353,-0.240948228390415
257,1558411200,55,50,0,105,21,-0.6004519481070855,-1.5664735054182823
257,1558425600,475,307,0,782,21,-0.6004519481070855,0.19655323829068855
257,1558440000,803,424,0,1227,21,-0.6004519481070855,1.3554112899162307
257,1558454400,707,355,0,1062,21,-0.6004519481070855,0.9257223494258611
257,1558468800,773,538,0,1311,21,-0.6004519481070855,1.5741620232567823
257,1558483200,315,383,68,698,21,2.0500747347272825,-0.022197495049863233
257,1558497600,41,79,38,120,21,0.8807247275944731,-1.5274108744646124
257,1558512000,472,305,0,777,21,-0.6004519481070855,0.18353236130613187
257,1558526400,809,399,0,1208,21,-0.6004519481070855,1.3059319573749153
257,1558540800,710,454,0,1164,21,-0.6004519481070855,1.1913482399108168
257,1558555200,710,606,0,1316,21,-0.6004519481070855,1.5871829002413391
257,1558569600,312,392,80,704,21,2.5178147375804065,-0.006572442668395249
257,1558584000,41,61,20,102,21,0.17911472331478745,-1.5742860316090164
257,1558598400,456,298,0,754,21,-0.6004519481070855,0.12363632717717128
257,1558612800,776,450,0,1226,21,-0.6004519481070855,1.3528071145193192
257,1558627200,704,343,0,1047,21,-0.6004519481070855,0.8866597184721912
257,1558641600,743,561,0,1304,21,-0.6004519481070855,1.555932795478403
257,1558656000,321,343,22,664,21,0.25707139045697475,-0.11073945854484847
257,1558670400,49,76,27,125,21,0.45196305831244293,-1.5143899974800556
257,1558684800,460,283,0,743,21,-0.6004519481070855,0.09499039781114664
257,1558699200,748,438,0,1186,21,-0.6004519481070855,1.248640098642866
257,1558713600,800,366,0,1166,21,-0.6004519481070855,1.1965565907046396
257,1558728000,668,539,0,1207,21,-0.6004519481070855,1.303327781978004
257,1558742400,313,392,79,705,21,2.4788364040093125,-0.003968267271483918
257,1558756800,55,95,40,150,21,0.9586813947366604,-1.4492856125572724
257,1558771200,158,124,0,282,21,-0.6004519481070855,-1.1055344601649768
257,1558785600,426,210,0,636,21,-0.6004519481070855,-0.18365636965836574
257,1558800000,428,319,0,747,21,-0.6004519481070855,0.10540709939879196
257,1558814400,412,386,0,798,21,-0.6004519481070855,0.23822004464126983
257,1558828800,229,279,50,508,21,1.3484647304475967,-0.516990820463016
257,1558843200,57,86,29,143,21,0.5299197254546303,-1.4675148403356517
257,1558857600,111,86,0,197,21,-0.6004519481070855,-1.32688936890244
257,1558872000,365,182,0,547,21,-0.6004519481070855,-0.41542797998347414
257,1558886400,418,288,0,706,21,-0.6004519481070855,-0.0013640918745725877
257,1558900800,351,373,22,724,21,0.25707139045697475,0.04551106526983136
257,1558915200,216,266,50,482,21,1.3484647304475967,-0.5846993807827107
257,1558929600,52,82,30,134,21,0.5688980590257239,-1.4909524189078538
257,1558944000,171,89,0,260,21,-0.6004519481070855,-1.162826318897026
257,1558958400,403,233,0,636,21,-0.6004519481070855,-0.18365636965836574
257,1558972800,434,269,0,703,21,-0.6004519481070855,-0.009176618065306579
257,1558987200,352,352,0,704,21,-0.6004519481070855,-0.006572442668395249
257,1559001600,209,291,82,500,22,2.8691667355696207,-0.6194507933159604
257,1559016000,51,44,0,95,22,-0.5370415502979332,-1.6741913332863791
257,1559030400,433,320,0,753,22,-0.5370415502979332,0.03943650696185685
257,1559044800,730,372,0,1102,22,-0.5370415502979332,0.9483363796771067
257,1559059200,748,367,0,1115,22,-0.5370415502979332,0.9821922488613424
257,1559073600,651,624,0,1275,22,-0.5370415502979332,1.3988798695903968
257,1559088000,285,308,23,593,22,0.4183583347624783,-0.3772511137671975
257,1559102400,41,62,21,103,22,0.3352800838876599,-1.6533569522499265
257,1559116800,462,280,0,742,22,-0.5370415502979332,0.010789233036734359
257,1559131200,792,423,0,1215,22,-0.5370415502979332,1.2426220118170013
257,1559145600,655,321,0,976,22,-0.5370415502979332,0.6201948783529764
257,1559160000,653,568,0,1221,22,-0.5370415502979332,1.258247797594341
257,1559174400,261,326,65,587,22,2.1630016031336643,-0.3928768995445371
257,1559188800,45,55,10,100,22,-0.12165029592384122,-1.6611698451385963
257,1559203200,444,345,0,789,22,-0.5370415502979332,0.13319122162589409
257,1559217600,788,375,0,1163,22,-0.5370415502979332,1.1071985350800586
257,1559232000,651,371,0,1022,22,-0.5370415502979332,0.7399925693125795
257,1559246400,702,645,0,1347,22,-0.5370415502979332,1.5863892989184711
257,1559260800,270,297,27,567,22,0.5845148365121151,-0.44496285213566883
257,1559275200,50,61,11,111,22,-0.08011117048643203,-1.6325225712134739
257,1559289600,452,276,0,728,22,-0.5370415502979332,-0.025670933777057897
257,1559304000,757,346,0,1103,22,-0.5370415502979332,0.9509406773066633
257,1559318400,747,381,0,1128,22,-0.5370415502979332,1.016048118045578
257,1559332800,712,588,0,1300,22,-0.5370415502979332,1.4639873103293115
257,1559347200,324,381,57,705,22,1.830688599634391,-0.08556977925685946
257,1559361600,69,114,45,183,22,1.3322190943854806,-1.4450131418853993
257,1559376000,201,138,0,339,22,-0.5370415502979332,-1.0387427116745713
257,1559390400,476,268,0,744,22,-0.5370415502979332,0.01599782829584754
257,1559404800,492,313,0,805,22,-0.5370415502979332,0.17485998369879951
257,1559419200,411,369,0,780,22,-0.5370415502979332,0.10975254295988478
257,1559433600,251,340,89,591,22,3.159940613631485,-0.3824597090263107
257,1559448000,72,114,42,186,22,1.207601718073253,-1.4372002489967295
257,1559462400,137,71,0,208,22,-0.5370415502979332,-1.3799057011464846
257,1559476800,380,220,0,600,22,-0.5370415502979332,-0.3590210303603014
257,1559491200,398,294,0,692,22,-0.5370415502979332,-0.11942564844109513
257,1559505600,388,352,0,740,22,-0.5370415502979332,0.0055806377776211795
257,1559520000,220,278,58,498,22,1.8722277250718,-0.6246593885750735
257,1559534400,39,52,13,91,22,0.0029670803883863604,-1.6846085238046056
257,1559548800,436,297,0,733,22,-0.5370415502979332,-0.012649445629274949
257,1559563200,802,374,0,1176,22,-0.5370415502979332,1.1410544042642943
257,1559577600,699,317,0,1016,22,-0.5370415502979332,0.72436678353524
257,1559592000,741,527,0,1268,22,-0.5370415502979332,1.3806497861835005
257,1559606400,279,412,133,691,23,3.365512204754987,-0.2066946691967417
257,1559620800,40,55,15,95,23,-0.06789217704116685,-1.7169051068303784
257,1559635200,389,309,0,698,23,-0.5043418865915255,-0.18895729828493726
257,1559649600,766,396,0,1162,23,-0.5043418865915255,0.9867770021546726
257,1559664000,646,353,0,999,23,-0.5043418865915255,0.5737496509226545
257,1559678400,686,610,0,1296,23,-0.5043418865915255,1.3263209596092151
257,1559692800,303,357,54,660,23,1.0668770677897654,-0.2852458832347329
257,1559707200,50,68,18,118,23,0.01939776486890486,-1.6586251738344495
257,1559721600,455,297,0,752,23,-0.5043418865915255,-0.05212615125101715
257,1559736000,821,406,0,1227,23,-0.5043418865915255,1.1514811606214284
257,1559750400,705,321,0,1026,23,-0.5043418865915255,0.6421652244396145
257,1559764800,673,659,0,1332,23,-0.5043418865915255,1.4175417242984951
257,1559779200,299,307,8,606,23,-0.2715687081646675,-0.422077030268653
257,1559793600,40,78,38,118,23,0.6013307109360496,-1.6586251738344495
257,1559808000,410,322,0,732,23,-0.5043418865915255,-0.10280435385617274
257,1559822400,771,533,0,1304,23,-0.5043418865915255,1.3465922406512774
257,1559836800,677,462,0,1139,23,-0.5043418865915255,0.9284970691587436
257,1559851200,733,623,0,1356,23,-0.5043418865915255,1.4783555674246818
257,1559865600,322,420,98,742,23,2.3471295491374837,-0.07746525255359495
257,1559880000,55,87,32,142,23,0.4267508271159062,-1.5978113307082629
257,1559894400,453,323,0,776,23,-0.5043418865915255,0.008687691875169571
257,1559908800,793,470,0,1263,23,-0.5043418865915255,1.2427019253107083
257,1559923200,739,407,0,1146,23,-0.5043418865915255,0.9462344400705481
257,1559937600,686,619,0,1305,23,-0.5043418865915255,1.349126150781535
257,1559952000,363,350,0,713,23,-0.5043418865915255,-0.15094864633107055
257,1559966400,68,96,28,164,23,0.31036423790247725,-1.5420653078425917
257,1559980800,187,123,0,310,23,-0.5043418865915255,-1.1721144288249559
257,1559995200,487,258,0,745,23,-0.5043418865915255,-0.0698635221628216
257,1560009600,498,313,0,811,23,-0.5043418865915255,0.09737454643419187
257,1560024000,421,407,0,828,23,-0.5043418865915255,0.14045101864857412
257,1560038400,224,372,148,596,23,3.801961914305345,-0.4474161315712308
257,1560052800,64,107,43,171,23,0.7468139474528358,-1.5243279369307872
257,1560067200,133,98,0,231,23,-0.5043418865915255,-1.3722933291153205
257,1560081600,369,397,28,766,23,0.31036423790247725,-0.016651409427408226
257,1560096000,626,352,0,978,23,-0.5043418865915255,0.5205375381872411
257,1560110400,384,294,0,678,23,-0.5043418865915255,-0.23963550089009286
257,1560124800,226,267,41,493,23,0.6886206528461213,-0.7084088749877822
257,1560139200,26,70,44,96,23,0.7759105947561931,-1.7143711967001207
257,1560153600,469,286,0,755,23,-0.5043418865915255,-0.0445244208602438
257,1560168000,788,381,0,1169,23,-0.5043418865915255,1.004514373066477
257,1560182400,646,406,0,1052,23,-0.5043418865915255,0.7080468878263168
257,1560196800,636,571,0,1207,23,-0.5043418865915255,1.1008029580162726
257,1560211200,239,315,76,554,24,1.224696169577085,-0.7548169080881139
257,1560225600,45,68,23,113,24,0.024531664413716625,-1.8132406170447377
257,1560240000,470,325,0,795,24,-0.4962944416005754,-0.17640395149277066
257,1560254400,786,420,0,1206,24,-0.4962944416005754,0.8100181446096612
257,1560268800,655,332,0,987,24,-0.4962944416005754,0.28440637077405884
257,1560283200,706,561,0,1267,24,-0.4962944416005754,0.9564214240798518
257,1560297600,294,450,156,744,24,3.036265233974623,-0.29880669334489723
257,1560312000,51,52,1,103,24,-0.4736498282956062,-1.8372411546628018
257,1560326400,479,295,0,774,24,-0.4962944416005754,-0.22680508049070514
257,1560340800,801,482,0,1283,24,-0.4962944416005754,0.9948222842687542
257,1560355200,689,396,0,1085,24,-0.4962944416005754,0.5196116394310863
257,1560369600,833,560,0,1393,24,-0.4962944416005754,1.2588281980674587
257,1560384000,279,407,128,686,24,2.4022160614354844,-0.4380098115296686
257,1560398400,46,55,9,101,24,-0.2924929218558524,-1.8420412621864146
257,1560412800,470,310,0,780,24,-0.4962944416005754,-0.2124047579198667
257,1560427200,779,442,0,1221,24,-0.4962944416005754,0.8460189510367572
257,1560441600,710,397,0,1107,24,-0.4962944416005754,0.5724128221908272
257,1560456000,740,631,0,1371,24,-0.4962944416005754,1.2060270153077177
257,1560470400,285,386,101,671,24,1.7908115022013156,-0.4740106179567647
257,1560484800,51,83,32,134,24,0.2283331841584396,-1.7628394880468032
257,1560499200,440,286,0,726,24,-0.4962944416005754,-0.3420076610574125
257,1560513600,784,472,0,1256,24,-0.4962944416005754,0.9300208326999814
257,1560528000,803,384,0,1187,24,-0.4962944416005754,0.7644171231353395
257,1560542400,701,599,0,1300,24,-0.4962944416005754,1.035623198219463
257,1561161600,9659,4259,0,13918,25,-0.4397417465591836,4.0969665833621285
257,1561176000,67,99,32,166,25,0.4983739794337414,-0.39708971351786937
257,1561190400,198,127,0,325,25,-0.4397417465591836,-0.3451296385321277
257,1561204800,508,284,0,792,25,-0.4397417465591836,-0.1925173428192889
257,1561219200,549,324,0,873,25,-0.4397417465591836,-0.16604711593976013
257,1561233600,456,375,0,831,25,-0.4397417465591836,-0.17977241876618244
257,1561248000,257,397,140,654,25,3.6645145546598634,-0.23761476639181942
257,1561262400,71,107,36,178,25,0.615638445182857,-0.3931681984246059
257,1561276800,132,96,0,228,25,-0.4397417465591836,-0.3768285522026745
257,1561291200,380,226,0,606,25,-0.4397417465591836,-0.25330082676487353
257,1561305600,438,260,0,698,25,-0.4397417465591836,-0.22323587771651984
257,1561320000,390,323,0,713,25,-0.4397417465591836,-0.21833398384994043
257,1561334400,219,274,55,493,25,1.1726446574911562,-0.2902284272264384
257,1561348800,39,46,7,85,25,-0.23452893149823126,-0.42355994039739814
257,1561363200,409,272,0,681,25,-0.4397417465591836,-0.22879135743197648
257,1561377600,810,428,0,1238,25,-0.4397417465591836,-0.046767698519661276
257,1561392000,729,414,0,1143,25,-0.4397417465591836,-0.07781302634133083
257,1561406400,656,582,0,1238,25,-0.4397417465591836,-0.046767698519661276
257,1561420800,272,366,94,638,26,1.792827921911483,-0.3357120620822366
257,1561435200,49,43,0,92,26,-0.5210277942397217,-1.719347757206221
257,1561449600,396,322,0,718,26,-0.5210277942397217,-0.13298155730216563
257,1561464000,831,422,0,1253,26,-0.5210277942397217,1.222778693414559
257,1561478400,660,380,0,1040,26,-0.5210277942397217,0.6830087244376201
257,1561492800,739,570,0,1309,26,-0.5210277942397217,1.3646900467606087
257,1561507200,268,354,86,622,26,1.5959040311752104,-0.37625816303825077
257,1561521600,53,81,28,134,26,0.16820582333723297,-1.6129142421966838
257,1561536000,385,313,0,698,26,-0.5210277942397217,-0.18366418349718336
257,1561550400,851,431,0,1282,26,-0.5210277942397217,1.2962685013973347
257,1561564800,701,369,0,1070,26,-0.5210277942397217,0.7590326637301467
257,1561579200,836,664,0,1500,26,-0.5210277942397217,1.848709126923028
257,1561593600,396,337,0,733,26,-0.5210277942397217,-0.09496958765590231
257,1561608000,54,86,32,140,26,0.26666776870536935,-1.5977094543381785
257,1561622400,371,293,0,664,26,-0.5210277942397217,-0.26982464802871353
257,1561636800,856,432,0,1288,26,-0.5210277942397217,1.31147328925584
257,1561651200,671,410,0,1081,26,-0.5210277942397217,0.7869081081374064
257,1561665600,730,492,0,1222,26,-0.5210277942397217,1.1442206228122815
257,1561680000,341,412,71,753,26,1.226671736044699,-0.044286961460884566
257,1561694400,50,67,17,117,26,-0.10256452642514209,-1.6559944744624489
257,1561708800,356,311,0,667,26,-0.5210277942397217,-0.26222225409946087
257,1561723200,757,371,0,1128,26,-0.5210277942397217,0.9060122796956981
257,1561737600,699,397,0,1096,26,-0.5210277942397217,0.8249200777836697
257,1561752000,660,679,19,1339,26,-0.0533335537410739,1.4407139860531353
257,1561766400,340,393,53,733,26,0.7835929818880853,-0.09496958765590231
257,1561780800,66,136,70,202,26,1.202056249702665,-1.4405933131336235
257,1561795200,157,144,0,301,26,-0.5210277942397217,-1.1897143134682855
257,1561809600,485,249,0,734,26,-0.5210277942397217,-0.09243545634615143
257,1561824000,489,403,0,892,26,-0.5210277942397217,0.30795729059448873
257,1561838400,429,361,0,790,26,-0.5210277942397217,0.04947589699989826
257,1561852800,224,402,178,626,26,3.8605287746423476,-0.3661216377992472
257,1561867200,67,109,42,176,26,0.5128226321257103,-1.5064807271871465
257,1561881600,129,97,0,226,26,-0.5210277942397217,-1.379774161699602
257,1561896000,408,263,0,671,26,-0.5210277942397217,-0.2520857288604573
257,1561910400,517,337,0,854,26,-0.5210277942397217,0.21166030082395504
257,1561924800,385,343,0,728,26,-0.5210277942397217,-0.10764024420465675
257,1561939200,221,362,141,583,26,2.9497557799870857,-0.4750892841185354
257,1561953600,49,107,58,156,26,0.9066704135982557,-1.5571633533821643
257,1561968000,336,298,0,634,26,-0.5210277942397217,-0.34584858732124013
257,1561982400,766,445,0,1211,26,-0.5210277942397217,1.1163451784050218
257,1561996800,616,371,0,987,26,-0.5210277942397217,0.5486997650208231
257,1562011200,654,618,0,1272,26,-0.5210277942397217,1.2709271882998259
257,1562025600,231,332,101,563,27,1.251952422011782,-0.35665631323434027
257,1562040000,47,73,26,120,27,0.001163524555773004,-1.4925777495829355
257,1562054400,384,313,0,697,27,-0.4324432932289768,-0.013059309914449124
257,1562068800,771,467,0,1238,27,-0.4324432932289768,1.3741494870710815
257,1562083200,653,395,0,1048,27,-0.4324432932289768,0.8869597062443703
257,1562097600,697,581,0,1278,27,-0.4324432932289768,1.4767157567188103
257,1562112000,252,372,120,624,27,1.5688189427006376,-0.200242752021554
257,1562126400,52,78,26,130,27,0.001163524555773004,-1.4669361821710034
257,1562140800,340,324,0,664,27,-0.4324432932289768,-0.0976764823738253
257,1562143375,81,83,2,164,27,-0.3990889226301499,-1.379754852970434
257,1562155200,803,430,0,1233,27,-0.4324432932289768,1.3613287033651156
257,1562169600,637,426,0,1063,27,-0.4324432932289768,0.9254220573622685
257,1562184000,645,543,0,1188,27,-0.4324432932289768,1.2459416500114207
257,1562198400,258,374,116,632,27,1.5021102015029837,-0.17972949809200828
257,1562212800,60,61,1,121,27,-0.4157661079295633,-1.4900135928417424
257,1562227200,169,109,0,278,27,-0.4324432932289768,-1.0874409844744073
257,1562241600,455,238,0,693,27,-0.4324432932289768,-0.023315936879221993
257,1562256000,472,298,0,770,27,-0.4324432932289768,0.17412413219265577
257,1562270400,375,706,331,1081,27,5.087705040876876,0.9715768787037464
257,1562284800,884,638,0,1522,27,-0.4324432932289768,2.1023700015699553
257,1562299200,101,101,0,202,27,-0.4324432932289768,-1.2823168968050918
257,1562313600,264,251,0,515,27,-0.4324432932289768,-0.4797358368116147
257,1562328000,576,396,0,972,27,-0.4324432932289768,0.6920837939136857
257,1562342400,545,420,0,965,27,-0.4324432932289768,0.6741346967253332
257,1562356800,563,560,0,1123,27,-0.4324432932289768,1.0792714618338615
257,1562371200,243,375,132,618,27,1.768945166293599,-0.2156276924687133
257,1562385600,50,94,44,144,27,0.30135285994521516,-1.4310379877942985
257,1562400000,160,119,0,279,27,-0.4324432932289768,-1.0848768277332141
257,1562414400,414,288,0,702,27,-0.4324432932289768,-0.00023852620848303577
257,1562428800,415,358,0,773,27,-0.4324432932289768,0.1818166024162354
257,1562443200,424,384,0,808,27,-0.4324432932289768,0.271562088357998
257,1562457600,240,339,99,579,27,1.218598051412955,-0.3156298053752488
257,1562472000,54,101,47,155,27,0.35138441584345553,-1.402832263641173
257,1562486400,133,96,0,229,27,-0.4324432932289768,-1.213084664792875
257,1562500800,369,258,0,627,27,-0.4324432932289768,-0.19255028179797434
257,1562515200,380,276,0,656,27,-0.4324432932289768,-0.11818973630337104
257,1562529600,386,358,0,744,27,-0.4324432932289768,0.1074560569216321
257,1562544000,263,317,54,580,27,0.4681247129393497,-0.31306564863405556
257,1562558400,50,66,16,116,27,-0.16560832843836154,-1.5028343765477086
257,1562572800,402,286,0,688,27,-0.4324432932289768,-0.03613672058518808
257,1562587200,744,492,0,1236,27,-0.4324432932289768,1.3690211735886952
257,1562601600,633,395,0,1028,27,-0.4324432932289768,0.8356765714205059
257,1562616000,715,629,0,1344,27,-0.4324432932289768,1.6459501016375626
257,1562630400,271,352,81,623,28,2.438651767826138,-0.32670143863368356
257,1562644800,59,68,9,127,28,-0.20547980116139922,-1.5353401119806729
257,1562659200,402,350,0,752,28,-0.5359962472848414,-0.012357912702712553
257,1562673600,773,510,0,1283,28,-0.5359962472848414,1.2815677638038425
257,1562688000,622,431,0,1053,28,-0.5359962472848414,0.7211103144695532
257,1562702400,674,654,0,1328,28,-0.5359962472848414,1.3912224821518557
257,1562716800,308,378,70,686,28,2.0346872225641532,-0.17318483294646517
257,1562731200,51,69,18,120,28,0.12503664496204295,-1.5523975126125862
257,1562745600,385,286,0,671,28,-0.5359962472848414,-0.2097364057291362
257,1562760000,842,369,0,1211,28,-0.5359962472848414,1.1061202144470215
257,1562774400,659,396,0,1055,28,-0.5359962472848414,0.7259838575072427
257,1562788800,737,622,0,1359,28,-0.5359962472848414,1.4667623992360426
257,1562803200,313,287,0,600,28,-0.5359962472848414,-0.3827471835671125
257,1562817600,61,68,7,129,28,-0.2789279002999419,-1.5304665689429835
257,1562832000,343,385,42,728,28,1.0064138346245552,-0.07084042915498623
257,1562846400,839,420,0,1259,28,-0.5359962472848414,1.223085247351569
257,1562860800,700,379,0,1079,28,-0.5359962472848414,0.7844663739595163
257,1562875200,692,705,13,1397,28,-0.05858360288431381,1.5593597169521425
257,1562889600,289,367,78,656,28,2.328479619118324,-0.24628797851180728
257,1562904000,54,66,12,120,28,-0.09530765245358516,-1.5523975126125862
257,1562918400,354,307,0,661,28,-0.5359962472848414,-0.2341041209175836
257,1562932800,782,480,0,1262,28,-0.5359962472848414,1.230395561908103
257,1562947200,734,365,0,1099,28,-0.5359962472848414,0.8332018043364111
257,1562961600,705,583,0,1288,28,-0.5359962472848414,1.2937516213980662
257,1562976000,328,445,117,773,28,3.7607175523199063,0.038814289193026916
257,1562990400,75,127,52,202,28,1.3736543303172688,-1.3525822480673177
257,1563004800,183,155,0,338,28,-0.5359962472848414,-1.0211813215044334
257,1563019200,483,341,0,824,28,-0.5359962472848414,0.16308963665410847
257,1563033600,568,343,0,911,28,-0.5359962472848414,0.3750887587936006
257,1563048000,426,295,0,721,28,-0.5359962472848414,-0.08789782978689939
257,1563062400,161,166,5,327,28,-0.35237599943848463,-1.0479858082117257
257,1563076800,49,74,25,123,28,0.3821049919469424,-1.5450871980560519
257,1563091200,112,84,0,196,28,-0.5359962472848414,-1.3672028771803861
257,1563105600,412,195,0,607,28,-0.5359962472848414,-0.3656897829351994
257,1563120000,442,243,0,685,28,-0.5359962472848414,-0.17562160446530992
257,1563134400,357,360,3,717,28,-0.4258240985770273,-0.09764491586227833
257,1563148800,202,250,48,452,28,1.2267581320401835,-0.7433893683561336
257,1563163200,36,45,9,81,28,-0.20547980116139922,-1.6474316018475308
257,1563177600,340,364,24,704,28,0.34538094237767103,-0.1293229456072599
257,1563192000,773,450,0,1223,28,-0.5359962472848414,1.1353614726731585
257,1563206400,657,368,0,1025,28,-0.5359962472848414,0.6528807119419006
257,1563220800,707,635,0,1342,28,-0.5359962472848414,1.425337283415682
257,1563235200,263,351,88,614,29,2.116945481289898,-0.3279708567697231
257,1563249600,36,62,26,98,29,0.2602509601451036,-1.5853181781766645
257,1563264000,385,339,0,724,29,-0.5183628713027133,-0.05993169910545263
257,1563278400,793,478,0,1271,29,-0.5183628713027133,1.2729539303705106
257,1563292800,592,405,0,997,29,-0.5183628713027133,0.6052927558249641
257,1563307200,718,491,0,1209,29,-0.5183628713027133,1.1218773142324672
257,1563321600,270,371,101,641,29,2.506252397013806,-0.26217942716122034
257,1563336000,44,76,32,120,29,0.43993107509459983,-1.5317103466438104
257,1563350400,366,299,0,665,29,-0.5183628713027133,-0.2036981563981068
257,1563364800,825,468,0,1293,29,-0.5183628713027133,1.3265617619033647
257,1563379200,669,390,0,1059,29,-0.5183628713027133,0.7563693719630075
257,1563393600,867,619,0,1486,29,-0.5183628713027133,1.796848647623403
257,1563408000,321,438,117,759,29,2.985399370212463,0.025353487424087974
257,1563422400,63,48,0,111,29,-0.5183628713027133,-1.553640823179978
257,1563436800,557,361,0,918,29,-0.5183628713027133,0.4127919062297153
257,1563451200,1055,504,0,1559,29,-0.5183628713027133,1.9747291795278732
257,1563465600,641,386,0,1027,29,-0.5183628713027133,0.678394344278856
257,1563480000,724,596,0,1320,29,-0.5183628713027133,1.3923531915118674
257,1563494400,302,378,76,680,29,1.7575852513909054,-0.16714736217116083
257,1563508800,54,67,13,121,29,-0.12905595557880484,-1.5292736270286809
257,1563523200,317,297,0,614,29,-0.5183628713027133,-0.3279708567697231
257,1563537600,690,488,0,1178,29,-0.5183628713027133,1.0463390061634454
257,1563552000,682,412,0,1094,29,-0.5183628713027133,0.8416545584925481
257,1563566400,620,556,0,1176,29,-0.5183628713027133,1.041465566933186
257,1563580800,321,304,0,625,29,-0.5183628713027133,-0.30116694100329605
257,1563595200,57,97,40,154,29,0.6795045616939281,-1.4488618797293997
257,1563609600,169,139,0,308,29,-0.5183628713027133,-1.073607058999421
257,1563624000,419,263,0,682,29,-0.5183628713027133,-0.16227392294090137
257,1563638400,430,320,0,750,29,-0.5183628713027133,0.00342301088792039
257,1563652800,366,294,0,660,29,-0.5183628713027133,-0.21588175447375546
257,1563667200,239,315,76,554,29,1.7575852513909054,-0.474174033677507
257,1563681600,54,82,28,136,29,0.3201443317949357,-1.4927228328017348
257,1563696000,119,93,0,212,29,-0.5183628713027133,-1.3075321420518753
257,1563710400,331,221,0,552,29,-0.5183628713027133,-0.47904747290776645
257,1563724800,415,300,0,715,29,-0.5183628713027133,-0.08186217564162021
257,1563739200,367,315,0,682,29,-0.5183628713027133,-0.16227392294090137
257,1563753600,181,288,107,469,29,2.6859325119633026,-0.6812952009635342
257,1563768000,39,62,23,101,29,0.17041090267035552,-1.5780080193312755
257,1563782400,364,314,0,678,29,-0.5183628713027133,-0.1720208014014203
257,1563796800,814,393,0,1207,29,-0.5183628713027133,1.1170038750022078
257,1563811200,591,379,0,970,29,-0.5183628713027133,0.5395013262164613
257,1563825600,707,545,0,1252,29,-0.5183628713027133,1.2266562576830458
257,1563840000,198,288,90,486,30,1.9566393214816171,-0.6175906912687171
257,1563854400,37,54,17,91,30,-0.07777301045968671,-1.6149074711887743
257,1563868800,335,334,0,669,30,-0.5515402658432781,-0.15554266411588052
257,1563883200,751,442,0,1193,30,-0.5515402658432781,1.1674801021578156
257,1563897600,548,446,0,994,30,-0.5515402658432781,0.6650344332866982
257,1563912000,690,580,0,1270,30,-0.5515402658432781,1.361893752927042
257,1563926400,275,362,87,637,30,1.873033335237454,-0.2363379475524421
257,1563940800,51,55,4,106,30,-0.44006561751772716,-1.5770346820778862
257,1563955200,384,288,0,672,30,-0.5515402658432781,-0.14796810629370286
257,1563969600,755,477,0,1232,30,-0.5515402658432781,1.265949353846125
257,1563984000,600,403,0,1003,30,-0.5515402658432781,0.6877581067532311
257,1563998400,713,588,0,1301,30,-0.5515402658432781,1.4401641837562111
257,1564012800,290,394,104,684,30,2.3468005906210454,-0.11766987500499226
257,1564027200,42,77,35,119,30,0.42386290700529233,-1.544211598181783
257,1564041600,353,338,0,691,30,-0.5515402658432781,-0.09999590675324442
257,1564046796,173,171,0,344,30,-0.5515402658432781,-0.9761197615184593
257,1564056000,788,476,0,1264,30,-0.5515402658432781,1.3467446372826868
257,1564070400,634,440,0,1074,30,-0.5515402658432781,0.8670226418781022
257,1564084800,714,566,0,1280,30,-0.5515402658432781,1.3871422790009675
257,1564099200,276,408,132,684,30,3.1271231288999015,-0.11766987500499226
257,1564113600,39,85,46,124,30,0.7304181899005573,-1.5315873351448202
257,1564128000,375,340,0,715,30,-0.5515402658432781,-0.039399444175823216
257,1564142400,754,454,0,1208,30,-0.5515402658432781,1.205352891268704
257,1564156800,712,385,0,1097,30,-0.5515402658432781,0.9250942518481309
257,1564171200,676,563,0,1239,30,-0.5515402658432781,1.283623322097873
257,1564185600,284,399,115,683,30,2.6533558735163103,-0.12019472761238481
257,1564200000,59,96,37,155,30,0.4796002311680678,-1.453316904315651
257,1564214400,170,151,0,321,30,-0.5515402658432781,-1.0341913714884878
257,1564228800,431,298,0,729,30,-0.5515402658432781,-0.00405150767232752
257,1564243200,540,261,0,801,30,-0.5515402658432781,0.17773788005993607
257,1564257600,411,360,0,771,30,-0.5515402658432781,0.10199230183815958
257,1564272000,232,285,53,517,30,0.9254988244702713,-0.5393202604395481
257,1564286400,64,120,56,184,30,1.0091048107144345,-1.3800961787012673
257,1564300800,117,77,0,194,30,-0.5515402658432781,-1.3548476526273416
257,1564315200,365,219,0,584,30,-0.5515402658432781,-0.37015513574424724
257,1564329600,436,279,0,715,30,-0.5515402658432781,-0.039399444175823216
257,1564344000,375,313,0,688,30,-0.5515402658432781,-0.10757046457542206
257,1564358400,213,276,63,489,30,1.2041854452841485,-0.6100161334465395
257,1564372800,43,55,12,98,30,-0.21711632086662536,-1.5972335029370266
257,1564387200,378,260,0,638,30,-0.5515402658432781,-0.23381309494504957
257,1564401600,802,470,0,1272,30,-0.5515402658432781,1.3669434581418272
257,1564416000,641,389,0,1030,30,-0.5515402658432781,0.75592912715283
257,1564430400,745,625,0,1370,30,-0.5515402658432781,1.614379013666297
257,1564444800,352,334,0,686,31,-0.471849131160472,-0.3995237411751393
257,1564459200,53,57,4,110,31,-0.3341667099099999,-1.8296159726627432
257,1564473600,399,347,0,746,31,-0.471849131160472,-0.25055580039518055
257,1564488000,815,431,0,1246,31,-0.471849131160472,0.9908437061044757
257,1564502400,602,383,0,985,31,-0.471849131160472,0.3428331637116552
257,1564516800,678,611,0,1289,31,-0.471849131160472,1.097604063663446
257,1564531200,310,366,56,676,31,1.4557047663461369,-0.42435173130513243
257,1564545600,58,71,13,129,31,-0.024381262096437782,-1.7824427914157563
257,1564560000,380,312,0,692,31,-0.471849131160472,-0.3846269470971434
257,1564574400,804,397,0,1201,31,-0.471849131160472,0.8791177505195067
257,1564588800,648,402,0,1050,31,-0.471849131160472,0.5042150995566105
257,1564603200,653,606,0,1259,31,-0.471849131160472,1.0231200932734668
257,1564617600,265,364,99,629,31,2.9357907947887116,-0.5410432849161001
257,1564632000,50,70,20,120,31,0.21656297509188832,-1.8047879825327502
257,1564646400,375,310,0,685,31,-0.471849131160472,-0.4020065401881386
257,1564660800,819,431,0,1250,31,-0.471849131160472,1.000774902156473
257,1564675200,663,400,0,1063,31,-0.471849131160472,0.5364914867256015
257,1564689600,753,597,0,1350,31,-0.471849131160472,1.2490548034564042
257,1564704000,306,405,99,711,31,2.9357907947887116,-0.33745376585015646
257,1564718400,55,93,38,148,31,0.8361338707190126,-1.7352696101687695
257,1564732800,354,308,0,662,31,-0.471849131160472,-0.4591109174871228
257,1564747200,770,439,0,1209,31,-0.471849131160472,0.8989801426235011
257,1564761600,678,419,0,1097,31,-0.471849131160472,0.6209066531675782
257,1564776000,733,600,0,1333,31,-0.471849131160472,1.206847220235416
257,1565395200,8552,4454,0,13006,32,-0.321530404518004,4.094086495341938
257,1565409600,88,94,6,182,32,0.16755809812910066,-0.4043768375127103
257,1565424000,162,115,0,277,32,-0.321530404518004,-0.37105228849359057
257,1565438400,440,284,0,724,32,-0.321530404518004,-0.21425151574046927
257,1565452800,498,310,0,808,32,-0.321530404518004,-0.18478559871303707
257,1565467200,626,384,0,1010,32,-0.321530404518004,-0.113927083956593
257,1565481600,385,290,0,675,32,-0.321530404518004,-0.2314399673398047
257,1565496000,69,122,53,191,32,3.998751368864754,-0.40121977497405686
257,1565510400,122,97,0,219,32,-0.321530404518004,-0.3913978026315795
257,1565524800,365,267,0,632,32,-0.321530404518004,-0.24652371058003786
257,1565539200,449,278,0,727,32,-0.321530404518004,-0.21319916156091812
257,1565553600,466,339,0,805,32,-0.321530404518004,-0.18583795289258823
257,1565568000,286,276,0,562,32,-0.321530404518004,-0.27107864143623134
257,1565582400,49,61,12,110,32,0.6566466007762053,-0.4296333378219379
257,1565596800,344,288,0,632,32,-0.321530404518004,-0.24652371058003786
257,1565611200,741,472,0,1213,32,-0.321530404518004,-0.04271778447363187
257,1565625600,600,393,0,993,32,-0.321530404518004,-0.11989042430738285
257,1565640000,671,589,0,1260,32,-0.321530404518004,-0.026230902327330528
257,1565654400,230,287,57,517,33,1.483177359284414,-0.5282090108005151
257,1565668800,40,73,33,113,33,0.6134607925836056,-1.5703776730404146
257,1565683200,374,293,0,667,33,-0.5823994866300055,-0.14126520056292854
257,1565697600,740,462,0,1202,33,-0.5823994866300055,1.2388343892844633
257,1565712000,626,408,0,1034,33,-0.5823994866300055,0.8054573218183665
257,1565726400,628,645,17,1273,33,0.03364974811640026,1.421987792796921
257,1565740800,263,325,62,588,33,1.6643683106804157,-0.34505560728805745
257,1565755200,52,64,12,116,33,-0.14754120327960143,-1.562638796835663
257,1565769600,368,264,0,632,33,-0.5823994866300055,-0.2315520896183654
257,1565784000,742,492,0,1234,33,-0.5823994866300055,1.3213824021351486
257,1565798400,586,352,0,938,33,-0.5823994866300055,0.5578132832663111
257,1565812800,644,651,7,1295,33,-0.3287321546756031,1.478739551631767
257,1565827200,271,346,75,617,33,2.13546478431002,-0.27024647064212404
257,1565841600,44,55,11,99,33,-0.18377939355880177,-1.6064924286625895
257,1565856000,374,301,0,675,33,-0.5823994866300055,-0.12062819735025727
257,1565870400,752,460,0,1212,33,-0.5823994866300055,1.2646306433003025
257,1565884800,628,395,0,1023,33,-0.5823994866300055,0.7770814424009435
257,1565899200,748,555,0,1303,33,-0.5823994866300055,1.4993765548444382
257,1565913600,294,373,79,667,33,2.2804175454268214,-0.14126520056292854
257,1565928000,54,83,29,137,33,0.4685080314668043,-1.5084666634024009
257,1565942400,300,294,0,594,33,-0.5823994866300055,-0.329577854878554
257,1565956800,695,429,0,1124,33,-0.5823994866300055,1.0376236079609185
257,1565971200,782,557,0,1339,33,-0.5823994866300055,1.592243069301459
257,1565985600,634,535,0,1169,33,-0.5823994866300055,1.1537067510321943
257,1566000000,304,362,58,666,33,1.5194155495636144,-0.14384482596451245
257,1566014400,58,79,21,137,33,0.17860250923320162,-1.5084666634024009
257,1566028800,176,129,0,305,33,-0.5823994866300055,-1.075089595936304
257,1566043200,424,281,0,705,33,-0.5823994866300055,-0.043239435302739965
257,1566057600,501,303,0,804,33,-0.5823994866300055,0.21214347945406714
257,1566072000,397,339,0,736,33,-0.5823994866300055,0.036728952146361245
257,1566086400,223,333,110,556,33,3.4038014440820317,-0.4276036201387426
257,1566100800,67,90,23,157,33,0.2510788897916023,-1.4568741553707227
257,1566115200,113,105,0,218,33,-0.5823994866300055,-1.2995170058741041
257,1566129600,346,230,0,576,33,-0.5823994866300055,-0.3760111121070644
257,1566144000,437,337,0,774,33,-0.5823994866300055,0.13475471740654982
257,1566158400,372,310,0,682,33,-0.5823994866300055,-0.1025708195391699
257,1566172800,186,255,69,441,33,1.918035642634818,-0.7242605413208922
257,1566187200,37,49,12,86,33,-0.14754120327960143,-1.6400275588831803
257,1566201600,352,284,0,636,33,-0.5823994866300055,-0.22123358801202977
257,1566216000,694,442,0,1136,33,-0.5823994866300055,1.0685791127799253
257,1566230400,643,354,0,997,33,-0.5823994866300055,0.7100111819597618
257,1566244800,590,544,0,1134,33,-0.5823994866300055,1.0634198619767574
257,1566259200,204,337,133,541,34,3.315567606401627,-0.055122432592619085
257,1566273600,46,63,17,109,34,-0.028271852186337203,-1.065955351580862
257,1566288000,354,283,0,637,34,-0.5183172900828491,0.16950710496032376
257,1566302400,742,433,0,1175,34,-0.5183172900828491,1.4283684716632743
257,1566316800,567,366,0,933,34,-0.5183172900828491,0.8621148457485642
257,1566331200,631,608,0,1239,34,-0.5183172900828491,1.5781214966985695
257,1566345600,253,359,106,612,34,2.537260146213049,0.11100982955591157
257,1566360000,48,77,29,125,34,0.3176425745641418,-1.0285170953220382
257,1566370170,31,36,5,67,34,-0.3741862789368162,-1.1642307742602744
257,1566370252,2,0,0,2,34,-0.5183172900828491,-1.3163236903117461
257,1566370332,3,0,0,3,34,-0.5183172900828491,-1.3139837992955696
257,1566370413,1,0,0,1,34,-0.5183172900828491,-1.3186635813279226
257,1566370493,3,0,0,3,34,-0.5183172900828491,-1.3139837992955696
257,1566370573,1,2,1,3,34,-0.4894910878536426,-1.3139837992955696
257,1566370654,1,3,2,4,34,-0.46066488562443597,-1.3116439082793931
257,1566370734,1,1,0,2,34,-0.5183172900828491,-1.3163236903117461
257,1566370814,1,2,1,3,34,-0.4894910878536426,-1.3139837992955696
257,1566370895,1,1,0,2,34,-0.5183172900828491,-1.3163236903117461
257,1566374400,345,296,0,641,34,-0.5183172900828491,0.1788666690250297
257,1566388800,722,403,0,1125,34,-0.5183172900828491,1.31137392085445
257,1566403200,638,367,0,1005,34,-0.5183172900828491,1.0305869989132714
257,1566417600,628,647,19,1275,34,0.029380552272075967,1.6623575732809233
257,1566432000,256,326,70,582,34,1.4995168659616118,0.04081309907061692
257,1566446400,40,70,30,110,34,0.3464687767933484,-1.0636154605646855
257,1566460800,355,292,0,647,34,-0.5183172900828491,0.19290601512208866
257,1566475200,803,404,0,1207,34,-0.5183172900828491,1.503244984180922
257,1566489600,603,381,0,984,34,-0.5183172900828491,0.9814492875735651
257,1566504000,687,586,0,1273,34,-0.5183172900828491,1.6576777912485703
257,1566518400,270,357,87,627,34,1.9895623038581238,0.14610819479855888
257,1566532800,50,84,34,134,34,0.46177358571017474,-1.0074580761764498
257,1566547200,348,258,0,606,34,-0.5183172900828491,0.09697048345885263
257,1566561600,692,421,0,1113,34,-0.5183172900828491,1.283295228660332
257,1566576000,651,370,0,1021,34,-0.5183172900828491,1.0680252551720952
257,1566590400,608,567,0,1175,34,-0.5183172900828491,1.4283684716632743
257,1566604800,274,400,126,674,34,3.1137841907971806,0.2560830725588538
257,1566619200,55,100,45,155,34,0.7788618102314472,-0.9583203648367434
257,1566633600,194,137,0,331,34,-0.5183172900828491,-0.5464995459896815
257,1566648000,433,236,0,669,34,-0.5183172900828491,0.24438361747797138
257,1566662400,455,339,0,794,34,-0.5183172900828491,0.5368699945000324
257,1566676800,413,319,0,732,34,-0.5183172900828491,0.39179675149709015
257,1566691200,209,307,98,516,34,2.306650528379396,-0.11361970799703129
257,1566705600,62,105,43,167,34,0.721209405773034,-0.9302416726426256
257,1566720000,110,90,0,200,34,-0.5183172900828491,-0.8530252691088015
257,1566734400,335,209,0,544,34,-0.5183172900828491,-0.04810275954408962
257,1566748800,390,268,0,658,34,-0.5183172900828491,0.21864481630003002
257,1566763200,375,309,0,684,34,-0.5183172900828491,0.2794819827206187
257,1566777600,192,260,68,452,34,1.4418644615031988,-0.2633727330323265
257,1566792000,32,53,21,85,34,0.08703295673048914,-1.1221127359690977
257,1566806400,342,199,0,541,34,-0.5183172900828491,-0.055122432592619085
257,1566820800,688,435,0,1123,34,-0.5183172900828491,1.306694138822097
257,1566835200,584,335,0,919,34,-0.5183172900828491,0.8293563715220934
257,1566849600,572,555,0,1127,34,-0.5183172900828491,1.316053702886803
257,1566864000,231,324,93,555,35,2.046006870632655,-0.25460734436647325
257,1566878400,48,49,1,97,35,-0.4862706912265952,-1.5683484592359682
257,1566892800,368,282,0,650,35,-0.5137954473337609,0.017893541905583524
257,1566907200,767,440,0,1207,35,-0.5137954473337609,1.6156092645743798
257,1566921600,574,333,0,907,35,-0.5137954473337609,0.7550801500310425
257,1566936000,570,607,37,1177,35,0.5046205286313723,1.529556353120046
257,1566950400,262,325,63,587,35,1.220264187417682,-0.1628175721485173
257,1566964800,40,64,24,104,35,0.14679869923821737,-1.5482694465632902
257,1566979200,394,267,0,661,35,-0.5137954473337609,0.04944627610550589
257,1566993600,737,376,0,1113,35,-0.5137954473337609,1.345976808684134
257,1567008000,512,329,0,841,35,-0.5137954473337609,0.5657637448315083
257,1567022400,619,626,7,1245,35,-0.3211221545836006,1.7246096190832025
257,1567036800,292,373,81,665,35,1.715709797346666,0.06091999763275039
257,1567051200,47,90,43,137,35,0.6697690652743669,-1.4536112439635231
257,1567065600,350,302,0,652,35,-0.5137954473337609,0.023630402669205772
257,1567080000,820,364,0,1184,35,-0.5137954473337609,1.5496353657927238
257,1567094400,587,372,0,959,35,-0.5137954473337609,0.9042385298852209
257,1567108800,602,589,0,1191,35,-0.5137954473337609,1.5697143784654017
257,1567123200,259,370,111,629,35,2.541452480561639,-0.042343496112450085
257,1567137600,43,78,35,121,35,0.4495710164170408,-1.4995061300725012
257,1567152000,331,305,0,636,35,-0.5137954473337609,-0.022264483439772213
257,1567166400,715,427,0,1142,35,-0.5137954473337609,1.4291612897566566
257,1567180800,655,361,0,1016,35,-0.5137954473337609,1.067739061648455
257,1567195200,559,520,0,1079,35,-0.5137954473337609,1.248450175702556
257,1567209600,249,422,173,671,35,4.247987359205917,0.07813057992361713
257,1567224000,63,107,44,170,35,0.6972938213815326,-1.358953041363756
257,1567238400,162,111,0,273,35,-0.5137954473337609,-1.0635047120372103
257,1567252800,449,215,0,664,35,-0.5137954473337609,0.05805156725093926
257,1567267200,409,298,0,707,35,-0.5137954473337609,0.1813940736688176
257,1567281600,407,354,0,761,35,-0.5137954473337609,0.3362893142866183
257,1567296000,239,238,0,477,35,-0.5137954473337609,-0.47834491414774094
257,1567310400,52,65,13,117,35,-0.15597361794060602,-1.5109798515997457
257,1567324800,122,69,0,191,35,-0.5137954473337609,-1.2987160033457226
257,1567339200,373,210,0,583,35,-0.5137954473337609,-0.1742912936757618
257,1567353600,363,329,0,692,35,-0.5137954473337609,0.13836761794165073
257,1567368000,310,323,13,633,35,-0.15597361794060602,-0.030869774585205588
257,1567382400,210,244,34,454,35,0.422046260309875,-0.5443188129293969
257,1567396800,53,65,12,118,35,-0.1834983740477718,-1.5081114212179345
257,1567411200,134,78,0,212,35,-0.5137954473337609,-1.2384789653276889
257,1567425600,342,180,0,522,35,-0.5137954473337609,-0.3492655469662404
257,1567440000,374,218,0,592,35,-0.5137954473337609,-0.14847542023946167
257,1567454400,353,293,0,646,35,-0.5137954473337609,0.006419820378339027
257,1567468800,160,264,104,424,36,2.5835409004163563,-0.7986760075023358
257,1567483200,52,47,0,99,36,-0.5792692601830395,-1.623392514228025
257,1567497600,366,279,0,645,36,-0.5792692601830395,-0.23786878292886715
257,1567512000,790,436,0,1226,36,-0.5792692601830395,1.2364705721715188
257,1567526400,647,363,0,1010,36,-0.5792692601830395,0.6883512938553684
257,1567540800,666,612,0,1278,36,-0.5792692601830395,1.3684252132476291
257,1567555200,232,340,108,572,36,2.7051874450547944,-0.42311279828571424
257,1567569600,49,81,32,130,36,0.3939030969244669,-1.5447272474326517
257,1567584000,398,306,0,704,36,-0.5792692601830395,-0.08815101709251126
257,1567598400,765,408,0,1173,36,-0.5792692601830395,1.1019783418439448
257,1567612800,561,352,0,913,36,-0.5792692601830395,0.4422051364633935
257,1567627200,584,609,25,1193,36,0.18102164380719984,1.152730126873218
257,1567641600,243,340,97,583,36,2.370659447299089,-0.395199316519614
257,1567656000,42,90,48,132,36,0.8804892754782201,-1.5396520689297242
257,1567670400,425,331,0,756,36,-0.5792692601830395,0.043803623983599015
257,1567684800,825,425,0,1250,36,-0.5792692601830395,1.2973727142066467
257,1567699200,702,397,0,1099,36,-0.5792692601830395,0.9141967372356341
257,1567713600,677,710,33,1387,36,0.42431473308407647,1.645022441657168
257,1567728000,276,390,114,666,36,2.887657262012452,-0.1845794086481303
257,1567742400,59,65,6,124,36,-0.3967994432253821,-1.5599527829414335
257,1567756800,465,300,0,765,36,-0.5792692601830395,0.06664192724677194
257,1567771200,795,436,0,1231,36,-0.5792692601830395,1.2491585184288372
257,1567785600,734,391,0,1125,36,-0.5792692601830395,0.9801740577736893
257,1567800000,605,674,69,1279,36,1.519133634830021,1.3709628024990927
257,1567814400,329,361,32,690,36,0.3939030969244669,-0.12367726661300249
257,1567828800,59,83,24,142,36,0.15061000764759028,-1.5142761764150876
257,1567843200,180,112,0,292,36,-0.5792692601830395,-1.1336377886955389
257,1567857600,466,234,0,700,36,-0.5792692601830395,-0.0983013740983659
257,1567872000,451,351,0,802,36,-0.5792692601830395,0.16053272955092734
257,1567886400,416,344,0,760,36,-0.5792692601830395,0.05395398098945365
257,1567900800,312,321,9,633,36,-0.3055645347465533,-0.26831985394643104
257,1567915200,72,113,41,185,36,0.6676078223609531,-1.4051598386021504
257,1567929600,120,93,0,213,36,-0.5792692601830395,-1.3341073395611678
257,1567944000,394,261,0,655,36,-0.5792692601830395,-0.21249289041423056
257,1567958400,417,286,0,703,36,-0.5792692601830395,-0.09068860634397492
257,1567972800,340,319,0,659,36,-0.5792692601830395,-0.2023425334083759
257,1567987200,189,239,50,428,36,0.9413125477974392,-0.7885256504964812
257,1568001600,42,50,8,92,36,-0.33597617090616294,-1.6411556389882707
257,1568016000,494,276,0,770,36,-0.5792692601830395,0.07932987350409024
257,1568030400,813,392,0,1205,36,-0.5792692601830395,1.183181197890782
257,1568044800,703,333,0,1036,36,-0.5792692601830395,0.7543286143934236
257,1568059200,705,593,0,1298,36,-0.5792692601830395,1.4191769982769022
257,1568073600,210,379,169,589,37,4.560525775643242,-0.45790597459498183
257,1568088000,42,69,27,111,37,0.32062309038427156,-1.584765541396754
257,1568102400,503,276,0,779,37,-0.48555558920722286,-0.009991084025239735
257,1568116800,867,440,0,1307,37,-0.48555558920722286,1.2347408224001488
257,1568131200,684,421,0,1105,37,-0.48555558920722286,0.7585365703207388
257,1568145600,774,651,0,1425,37,-0.48555558920722286,1.5129195439118834
257,1568160000,341,360,19,701,37,0.08175533346827323,-0.19387193383808124
257,1568174400,38,60,22,98,37,0.17133074231177262,-1.6154123496988944
257,1568188800,487,299,0,786,37,-0.48555558920722286,0.006511043522066554
257,1568203200,912,372,0,1284,37,-0.48555558920722286,1.1805195461732854
257,1568217600,652,402,0,1054,37,-0.48555558920722286,0.6383067839046501
257,1568232000,695,722,27,1417,37,0.32062309038427156,1.4940599695721049
257,1568246400,270,365,95,635,37,2.3509990241702576,-0.3494634221412548
257,1568260800,47,67,20,114,37,0.11161380308277302,-1.5776932010193372
257,1568275200,496,333,0,829,37,-0.48555558920722286,0.10788125559837661
257,1568289600,860,420,0,1280,37,-0.48555558920722286,1.171089759003396
257,1568304000,716,416,0,1132,37,-0.48555558920722286,0.8221876337174917
257,1568318400,688,684,0,1372,37,-0.48555558920722286,1.38797486391085
257,1568332800,278,340,62,618,37,1.3656695268917645,-0.3895400176132844
257,1568347200,44,69,25,113,37,0.260906151155272,-1.5800506478118095
257,1568361600,441,318,0,759,37,-0.48555558920722286,-0.057140019874686275
257,1568376000,860,390,0,1250,37,-0.48555558920722286,1.1003663552292262
257,1568390400,735,400,0,1135,37,-0.48555558920722286,0.8292599740949086
257,1568404800,703,717,14,1420,37,-0.06753701460422575,1.5011323099495217
257,1568419200,352,436,84,788,37,2.02255585841076,0.011225937107011207
257,1568433600,81,92,11,173,37,-0.15711242344772514,-1.4386038402634698
257,1568448000,189,121,0,310,37,-0.48555558920722286,-1.115633629694761
257,1568462400,493,286,0,779,37,-0.48555558920722286,-0.009991084025239735
257,1568476800,455,362,0,817,37,-0.48555558920722286,0.07959189408870869
257,1568491200,412,406,0,818,37,-0.48555558920722286,0.08194934088118101
257,1568505600,274,285,11,559,37,-0.15711242344772514,-0.5286293783691517
257,1568520000,84,88,4,172,37,-0.36612171074922367,-1.440961287055942
257,1568534400,121,61,0,182,37,-0.48555558920722286,-1.417386819131219
257,1568548800,368,255,0,623,37,-0.48555558920722286,-0.37775278365092274
257,1568563200,399,261,0,660,37,-0.48555558920722286,-0.29052725232944665
257,1568577600,370,311,0,681,37,-0.48555558920722286,-0.24102086968752776
257,1568592000,195,270,75,465,37,1.7538296318802618,-0.7502293768615503
257,1568606400,37,55,18,92,37,0.05189686385377343,-1.6295570304537284
257,1568620800,486,312,0,798,37,-0.48555558920722286,0.034800405031734476
257,1568635200,799,411,0,1210,37,-0.48555558920722286,1.006068483530333
257,1568649600,692,346,0,1038,37,-0.48555558920722286,0.600587635225093
257,1568664000,709,709,0,1418,37,-0.48555558920722286,1.4964174163645771
257,1568678400,238,323,85,561,38,2.033926647895032,-0.4959058650212189
257,1568692800,43,55,12,98,38,-0.0987748235297861,-1.638622472581667
257,1568707200,467,314,0,781,38,-0.44935588732564663,0.047069628851996205
257,1568721600,868,415,0,1283,38,-0.44935588732564663,1.2860409830536053
257,1568736000,704,353,0,1057,38,-0.44935588732564663,0.7282570666202115
257,1568750400,718,553,0,1271,38,-0.44935588732564663,1.256424137933248
257,1568764800,298,376,78,674,38,1.8294210273474467,-0.21701390680452204
257,1568779200,45,57,12,102,38,-0.0987748235297861,-1.6287501908748814
257,1568793600,480,297,0,777,38,-0.44935588732564663,0.037197347145210474
257,1568808000,815,438,0,1253,38,-0.44935588732564663,1.2119988702527122
257,1568822400,655,386,0,1041,38,-0.44935588732564663,0.6887679397930686
257,1568836800,706,655,0,1361,38,-0.44935588732564663,1.478550476335927
257,1568851200,264,382,118,646,38,2.998024573333648,-0.28611987875202216
257,1568865600,38,79,41,117,38,0.7484627473102101,-1.5917291344744349
257,1568880000,484,292,0,776,38,-0.44935588732564663,0.03472927671851404
257,1568894400,818,452,0,1270,38,-0.44935588732564663,1.2539560675065515
257,1568908800,604,388,0,992,38,-0.44935588732564663,0.5678324888849434
257,1568923200,780,579,0,1359,38,-0.44935588732564663,1.473614335482534
257,1568937600,244,400,156,644,38,4.10819794202054,-0.291056019605415
257,1568952000,41,75,34,116,38,0.5439571267626249,-1.5941972049011313
257,1568966400,467,247,0,714,38,-0.44935588732564663,-0.11829108973666476
257,1568980800,842,426,0,1268,38,-0.44935588732564663,1.2490199266531588
257,1568995200,669,367,0,1036,38,-0.44935588732564663,0.6764275876595864
257,1569009600,656,636,0,1292,38,-0.44935588732564663,1.308253616893873
257,1569024000,392,412,20,804,38,0.13494588566745422,0.10383524866601415
257,1569038400,69,97,28,166,38,0.36866659486469455,-1.4707936835663096
257,1569052800,167,120,0,287,38,-0.44935588732564663,-1.1721571619360414
257,1569067200,479,275,0,754,38,-0.44935588732564663,-0.01956827266880747
257,1569081600,474,349,0,823,38,-0.44935588732564663,0.15072858677324635
257,1569096000,435,415,0,850,38,-0.44935588732564663,0.21736648829405003
257,1569110400,285,210,0,495,38,-0.44935588732564663,-0.6587985131831834
257,1569124800,81,81,0,162,38,-0.44935588732564663,-1.4806659652730954
257,1569139200,135,95,0,230,38,-0.44935588732564663,-1.312837176257738
257,1569153600,368,211,0,579,38,-0.44935588732564663,-0.45148059734068313
257,1569168000,424,294,0,718,38,-0.44935588732564663,-0.10841880802987904
257,1569182400,360,324,0,684,38,-0.44935588732564663,-0.19233320253755773
257,1569196800,187,244,57,431,38,1.2159041657046907,-0.8167550204917551
257,1569211200,50,54,4,104,38,-0.3324955327270264,-1.6238140500214884
257,1569225600,457,322,0,779,38,-0.44935588732564663,0.042133487998603336
257,1569240000,897,371,0,1268,38,-0.44935588732564663,1.2490199266531588
257,1569254400,676,417,0,1093,38,-0.44935588732564663,0.8171076019812831
257,1569268800,642,643,1,1285,38,-0.4201407986759916,1.290977123906998
257,1569283200,266,402,136,668,39,3.0900227872378783,-0.20077625492942613
257,1569297600,30,35,5,65,39,-0.3229376756074096,-1.6668217390367455
257,1569312000,529,299,0,828,39,-0.4532033421282221,0.18822420519855249
257,1569326400,768,435,0,1203,39,-0.4532033421282221,1.0999440336235025
257,1569340800,633,404,0,1037,39,-0.4532033421282221,0.6963560562407245
257,1569355200,720,636,0,1356,39,-0.4532033421282221,1.4719257236208818
257,1569369600,225,341,116,566,39,2.5689601211546282,-0.44876404826101246
257,1569384000,49,71,22,120,39,0.11996559056335294,-1.5331028308677528
257,1569398400,490,265,0,755,39,-0.4532033421282221,0.010742745265162244
257,1569412800,853,382,0,1235,39,-0.4532033421282221,1.1777441256490981
257,1569427200,690,398,0,1088,39,-0.4532033421282221,0.8203499529065177
257,1569441600,713,754,41,1467,39,0.6149751233424404,1.741794792834667
257,1569456000,279,373,94,652,39,1.995791188463053,-0.23967630094222397
257,1569470400,48,49,1,97,39,-0.4271502088240596,-1.5890216470111498
257,1569484800,473,274,0,747,39,-0.4532033421282221,-0.008707277741236686
257,1569499200,842,418,0,1260,39,-0.4532033421282221,1.2385254475440948
257,1569513600,744,360,0,1104,39,-0.4532033421282221,0.8592499989193156
257,1569528000,727,680,0,1407,39,-0.4532033421282221,1.595919620286675
257,1569542400,244,409,165,653,39,3.8455636530585906,-0.23724504806642413
257,1569556800,60,64,4,124,39,-0.3489908089115721,-1.5233778193645533
257,1569571200,469,309,0,778,39,-0.4532033421282221,0.06666156140855917
257,1569585600,831,494,0,1325,39,-0.4532033421282221,1.396556884471086
257,1569600000,691,315,0,1006,39,-0.4532033421282221,0.6209872170909286
257,1569614400,702,719,17,1421,39,-0.010300075957459565,1.629957160547873
257,1569628800,363,386,23,749,39,0.14601872386751544,-0.003844771989636953
257,1569643200,92,84,0,176,39,-0.4532033421282221,-1.3969526698229604
257,1569657600,172,122,0,294,39,-0.4532033421282221,-1.110064830478576
257,1569672000,470,304,0,774,39,-0.4532033421282221,0.05693654990535971
257,1569686400,488,336,0,824,39,-0.4532033421282221,0.17849919369535303
257,1569700800,433,432,0,865,39,-0.4532033421282221,0.2781805616031475
257,1569715200,251,304,53,555,39,0.9276127229923906,-0.475507829894811
257,1569729600,75,90,15,165,39,-0.06240634256578457,-1.423696451456759
257,1569744000,117,83,0,200,39,-0.4532033421282221,-1.3386026008037635
257,1569758400,378,189,0,567,39,-0.4532033421282221,-0.44633279538521264
257,1569772800,391,275,0,666,39,-0.4532033421282221,-0.20563876068102585
257,1569787200,367,308,0,675,39,-0.4532033421282221,-0.18375748479882706
257,1569801600,194,241,47,435,39,0.7712939231674155,-0.767258174990795
257,1569816000,44,53,9,97,39,-0.21872514239075957,-1.5890216470111498
257,1569830400,388,197,0,585,39,-0.4532033421282221,-0.402570243620815
257,1569837949,215,180,0,395,39,-0.4532033421282221,-0.8645082900227896
257,1569844800,733,426,0,1159,39,-0.4532033421282221,0.9929689070883082
257,1569859200,632,362,0,994,39,-0.4532033421282221,0.5918121825813303
257,1569873600,654,484,0,1138,39,-0.4532033421282221,0.9419125966965111
257,1569888000,194,374,180,568,40,2.853243978899198,-0.47469120994592606
257,1569902400,26,59,33,85,40,0.1376700116225449,-1.651614442036253
257,1569916800,361,276,0,637,40,-0.47194863409262205,-0.306559319647308
257,1569931200,758,453,0,1211,40,-0.47194863409262205,1.092103072112211
257,1569945600,641,396,0,1037,40,-0.47194863409262205,0.6681183052722174
257,1569960000,706,627,0,1333,40,-0.47194863409262205,1.3893797477126661
257,1569974400,264,369,105,633,40,1.4677470568192728,-0.3163060958965032
257,1569988800,37,53,16,90,40,-0.17637595738223805,-1.6394309717247588
257,1570003200,440,264,0,704,40,-0.47194863409262205,-0.14330081747328746
257,1570017600,920,463,0,1383,40,-0.47194863409262205,1.5112144508276069
257,1570032000,694,422,0,1116,40,-0.47194863409262205,0.8606171361938236
257,1570046400,704,618,0,1322,40,-0.47194863409262205,1.3625761130273792
257,1570060800,232,423,191,655,40,3.056450194137587,-0.2626988265259293
257,1570075200,58,50,0,108,40,-0.47194863409262205,-1.5955704786033802
257,1570089600,458,293,0,751,40,-0.47194863409262205,-0.028776196545243236
257,1570104000,877,396,0,1273,40,-0.47194863409262205,1.2431781039747374
257,1570118400,734,387,0,1121,40,-0.47194863409262205,0.8728006065053178
257,1570132800,725,573,0,1298,40,-0.47194863409262205,1.3040954555322077
257,1570147200,251,430,179,681,40,2.834770686604799,-0.19934478090616017
257,1570161600,35,60,25,95,40,-0.010116326732647068,-1.6272475014132648
257,1570176000,485,299,0,784,40,-0.47194863409262205,0.051634707510617606
257,1570190400,889,415,0,1304,40,-0.47194863409262205,1.3187156199060006
257,1570204800,716,400,0,1116,40,-0.47194863409262205,0.8606171361938236
257,1570219200,718,639,0,1357,40,-0.47194863409262205,1.4478604052078377
257,1570233600,283,456,173,739,40,2.723930932838405,-0.058016525292828997
257,1570248000,76,109,33,185,40,0.1376700116225449,-1.4079450358063716
257,1570262400,183,144,0,327,40,-0.47194863409262205,-1.06193447895994
257,1570276800,497,253,0,750,40,-0.47194863409262205,-0.031212890607542048
257,1570291200,484,389,0,873,40,-0.47194863409262205,0.268500479055212
257,1570305600,446,308,0,754,40,-0.47194863409262205,-0.021466114358346795
257,1570320000,258,310,52,568,40,0.4886625652161259,-0.47469120994592606
257,1570334400,69,103,34,172,40,0.15614330391694392,-1.4396220586162563
257,1570348800,109,92,0,201,40,-0.47194863409262205,-1.3689579308095907
257,1570363200,405,245,0,650,40,-0.47194863409262205,-0.2748822968374234
257,1570377600,442,363,0,805,40,-0.47194863409262205,0.10280528281889269
257,1570392000,372,295,0,667,40,-0.47194863409262205,-0.23345849777834357
257,1570406400,185,224,39,409,40,0.2485097653889389,-0.8621255658514374
257,1570420800,43,56,13,99,40,-0.23179583426543504,-1.6175007251640696
257,1570435200,479,244,0,723,40,-0.47194863409262205,-0.09700363028961001
257,1570449600,863,378,0,1241,40,-0.47194863409262205,1.1652038939811753
257,1570464000,647,338,0,985,40,-0.47194863409262205,0.5414102140326791
257,1570478400,696,532,0,1228,40,-0.47194863409262205,1.1335268711712907
257,1570492800,265,378,113,643,41,1.91740700736052,-0.08416938026713106
257,1570507200,47,26,0,73,41,-0.553205734290174,-1.5010591538573648
257,1570519594,86,59,0,145,41,-0.553205734290174,-1.3220836035091246
257,1570521600,474,297,0,771,41,-0.553205734290174,0.2340093759075179
257,1570536000,857,395,0,1252,41,-0.553205734290174,1.429665483095066
257,1570550400,655,369,0,1024,41,-0.553205734290174,0.8629095736589725
257,1570564800,678,675,0,1353,41,-0.553205734290174,1.680728407889125
257,1570579200,247,415,168,662,41,3.1199176338276726,-0.0369397211474566
257,1570593600,52,18,0,70,41,-0.553205734290174,-1.5085164684552081
257,1570608000,356,185,0,541,41,-0.553205734290174,-0.33771807659380443
257,1570622400,748,358,0,1106,41,-0.553205734290174,1.066742839333357
257,1570636800,484,382,0,866,41,-0.553205734290174,0.47015767150589016
257,1570651200,584,663,79,1247,41,1.174036801908099,1.4172366254319937
257,1570665600,238,339,101,577,41,1.6550410524949597,-0.2482303014196844
257,1570680000,45,22,0,67,41,-0.553205734290174,-1.5159737830530513
257,1570694400,495,266,0,761,41,-0.553205734290174,0.20915166058137347
257,1570708800,891,405,0,1296,41,-0.553205734290174,1.5390394305301016
257,1570723200,603,380,0,983,41,-0.553205734290174,0.7609929408217803
257,1570737600,721,593,0,1314,41,-0.553205734290174,1.5837833181171614
257,1570752000,287,431,144,718,41,2.5951857240965515,0.10226348467895233
257,1570766400,67,32,0,99,41,-0.553205734290174,-1.4364290940093891
257,1570780800,441,272,0,713,41,-0.553205734290174,0.0898346270158801
257,1570795200,863,351,0,1214,41,-0.553205734290174,1.335206164855717
257,1570809600,693,438,0,1131,41,-0.553205734290174,1.128887127648718
257,1570824000,700,648,0,1348,41,-0.553205734290174,1.6682995502260527
257,1570838400,272,364,92,636,41,1.4582665863457893,-0.10156978099543217
257,1570852800,47,97,50,144,41,0.539985744316328,-1.324569375041739
257,1570867200,146,126,0,272,41,-0.553205734290174,-1.0063906188670901
257,1570881600,384,257,0,641,41,-0.553205734290174,-0.08914092333235994
257,1570896000,373,265,0,638,41,-0.553205734290174,-0.09659823793020328
257,1570910400,310,361,51,671,41,0.5618495738884579,-0.014567777353926593
257,1570924800,180,305,125,485,41,2.1797729622260804,-0.47692128242021337
257,1570939200,49,78,29,127,41,0.08084532330159715,-1.3668274910961846
257,1570953600,79,79,0,158,41,-0.553205734290174,-1.289768573585137
257,1570968000,268,173,0,441,41,-0.553205734290174,-0.586295229855249
257,1570982400,314,292,0,606,41,-0.553205734290174,-0.17614292697386552
257,1570996800,274,267,0,541,41,-0.553205734290174,-0.33771807659380443
257,1571011200,147,211,64,358,41,0.8460793583261483,-0.7926142670622479
257,1571025600,34,33,0,67,41,-0.553205734290174,-1.5159737830530513
257,1571040000,276,209,0,485,41,-0.553205734290174,-0.47692128242021337
257,1571054400,644,320,0,964,41,-0.553205734290174,0.7137632817021058
257,1571068800,556,277,0,833,41,-0.553205734290174,0.3881272109296135
257,1571083200,496,568,72,1064,41,1.0209899949031886,0.9623404349635503
257,1571097600,227,321,94,548,42,1.403016052166469,-0.5263804155069084
257,1571112000,36,47,11,83,42,-0.29095021650136854,-1.6591945806194512
257,1571126400,488,306,0,794,42,-0.5154517701802386,0.07291482023004968
257,1571140800,865,462,0,1327,42,-0.5154517701802386,1.3713878309934588
257,1571155200,662,391,0,1053,42,-0.5154517701802386,0.7038801294002617
257,1571169600,725,628,0,1353,42,-0.5154517701802386,1.4347279778599666
257,1571184000,256,332,76,588,42,1.035649873419227,-0.4289340357122811
257,1571198400,36,76,40,112,42,0.30091751592474336,-1.5885459552683463
257,1571212800,442,333,0,775,42,-0.5154517701802386,0.026627789827601694
257,1571227200,818,451,0,1269,42,-0.5154517701802386,1.2300905802912492
257,1571241600,686,363,0,1049,42,-0.5154517701802386,0.6941354914207989
257,1571256000,678,687,9,1365,42,-0.3317686808066176,1.4639618917983548
257,1571270400,201,430,229,631,42,4.158262392770783,-0.3241791774330567
257,1571284800,36,43,7,79,42,-0.3725871451118667,-1.6689392185989138
257,1571299200,426,322,0,748,42,-0.5154517701802386,-0.03914851653377176
257,1571313600,909,422,0,1331,42,-0.5154517701802386,1.3811324689729216
257,1571328000,743,350,0,1093,42,-0.5154517701802386,0.801326509194889
257,1571342400,736,568,0,1304,42,-0.5154517701802386,1.3153561626115482
257,1571356800,251,408,157,659,42,2.688797677781815,-0.25596671157681755
257,1571371200,36,66,30,102,42,0.09682519439849788,-1.6129075502170032
257,1571385600,462,315,0,777,42,-0.5154517701802386,0.03150010881733306
257,1571397081,727,384,0,1111,42,-0.5154517701802386,0.8451773801024713
257,1571400000,407,254,0,661,42,-0.5154517701802386,-0.2510943925870862
257,1571414400,678,452,0,1130,42,-0.5154517701802386,0.8914644105049193
257,1571428800,704,664,0,1368,42,-0.5154517701802386,1.471270370282952
257,1571443200,279,380,101,659,42,1.5458806772348408,-0.25596671157681755
257,1571457600,55,94,39,149,42,0.2805082837721188,-1.498408053958316
257,1571472000,172,134,0,306,42,-0.5154517701802386,-1.1159310132644038
257,1571486400,460,274,0,734,42,-0.5154517701802386,-0.07325474946189132
257,1571500800,504,323,0,827,42,-0.5154517701802386,0.15330808356061723
257,1571515200,425,422,0,847,42,-0.5154517701802386,0.2020312734579309
257,1571529600,277,314,37,591,42,0.2396898194668697,-0.421625557227684
257,1571544000,65,108,43,173,42,0.362145212382617,-1.4399402260815397
257,1571558400,108,78,0,186,42,-0.5154517701802386,-1.4082701526482857
257,1571572800,370,273,0,643,42,-0.5154517701802386,-0.2949452634946685
257,1571587200,448,432,0,880,42,-0.5154517701802386,0.28242453678849844
257,1571601600,320,423,103,743,42,1.5866991415400897,-0.051329314008100174
257,1571616000,149,252,103,401,42,1.5866991415400897,-0.8844958612521638
257,1571630400,45,52,7,97,42,-0.3725871451118667,-1.6250883476913316
257,1571644800,460,248,0,708,42,-0.5154517701802386,-0.13659489632839908
257,1571659200,846,429,0,1275,42,-0.5154517701802386,1.2447075372604435
257,1571673600,668,366,0,1034,42,-0.5154517701802386,0.6575930989978137
257,1571688000,764,528,0,1292,42,-0.5154517701802386,1.28612224867316
257,1571702400,257,328,71,585,43,1.1808871516496207,-0.4637387751221391
257,1571716800,276,72,0,348,43,-0.4653987231606499,-1.0379464834895695
257,1571731200,494,308,0,802,43,-0.4653987231606499,0.06201258654761775
257,1571745600,884,440,0,1324,43,-0.4653987231606499,1.3267232353568947
257,1571760000,669,389,0,1058,43,-0.4653987231606499,0.6822538242778379
257,1571774400,713,643,0,1356,43,-0.4653987231606499,1.4042533900731722
257,1571788800,254,281,27,535,43,0.1606536517671994,-0.5848796418663228
257,1571803200,35,48,13,83,43,-0.16396609819538913,-1.6799930772337426
257,1571817600,504,311,0,815,43,-0.4653987231606499,0.09350921190110549
257,1571832000,940,430,0,1370,43,-0.4653987231606499,1.4381728327615437
257,1571846400,669,345,0,1014,43,-0.4653987231606499,0.5756498615429563
257,1571860800,696,625,0,1321,43,-0.4653987231606499,1.3194547833522436
257,1571875200,234,451,217,685,43,4.566207401259472,-0.22145704163377192
257,1571889600,36,56,20,92,43,-0.0016562232140948747,-1.6581877212197895
257,1571904000,471,306,0,777,43,-0.4653987231606499,0.001442153175525943
257,1571918400,865,426,0,1291,43,-0.4653987231606499,1.2467702633057336
257,1571932800,694,436,0,1130,43,-0.4653987231606499,0.8566966723894622
257,1571947200,717,700,0,1417,43,-0.4653987231606499,1.5520452475010762
257,1571961600,276,438,162,714,43,3.2909155264064456,-0.15119533892214543
257,1571976000,37,65,28,102,43,0.18384077676452715,-1.633959547870953
257,1571990400,421,279,0,700,43,-0.4653987231606499,-0.18511478161051684
257,1572004800,839,427,0,1266,43,-0.4653987231606499,1.1861998299336418
257,1572019200,675,422,0,1097,43,-0.4653987231606499,0.7767437003383011
257,1572033600,656,601,0,1257,43,-0.4653987231606499,1.1643944739196888
257,1572048000,338,404,66,742,43,1.0649515266629819,-0.0833564535454026
257,1572062400,83,101,18,184,43,-0.048030473208750375,-1.4352885264104918
257,1572076800,161,142,0,303,43,-0.4653987231606499,-1.1469732635593348
257,1572091200,463,275,0,738,43,-0.4653987231606499,-0.09304772288493728
257,1572105600,492,375,0,867,43,-0.4653987231606499,0.21949571331505646
257,1572120000,419,467,48,886,43,0.6475832767110822,0.2655292426778462
257,1572134400,265,328,63,593,43,0.9953901516709985,-0.44435623644306976
257,1572148800,74,106,32,180,43,0.27658927675383815,-1.4449797957500266
257,1572163200,128,79,0,207,43,-0.4653987231606499,-1.3795637277081674
257,1572177600,325,214,0,539,43,-0.4653987231606499,-0.5751883725267881
257,1572192000,345,291,0,636,43,-0.4653987231606499,-0.34017509104307186
257,1572206400,363,315,0,678,43,-0.4653987231606499,-0.2384167629779576
257,1572220800,200,226,26,426,43,0.13746652676987164,-0.8489667313686431
257,1572235200,41,50,9,91,43,-0.25671459818470016,-1.6606105385546732
257,1572249600,468,262,0,730,43,-0.4653987231606499,-0.11243026156400666
257,1572264000,826,446,0,1272,43,-0.4653987231606499,1.2007367339429438
257,1572278400,653,368,0,1021,43,-0.4653987231606499,0.592609582887142
257,1572292800,667,710,43,1377,43,0.5316476517244434,1.4551325541057294
257,1572307200,232,369,137,601,44,2.0365228030844356,-0.43918953288598367
257,1572321600,29,51,22,80,44,-0.09979566557329332,-1.6426096778523112
257,1572336000,474,287,0,761,44,-0.508482676968685,-0.06961712752204431
257,1572350400,903,412,0,1315,44,-0.508482676968685,1.2100273260505956
257,1572364800,663,437,0,1100,44,-0.508482676968685,0.7134144063428022
257,1572379200,730,717,0,1447,44,-0.508482676968685,1.5149245604758457
257,1572393600,253,389,136,642,44,2.0179461207482814,-0.3444866040114742
257,1572408000,37,37,0,74,44,-0.508482676968685,-1.656468643053459
257,1572422400,459,260,0,719,44,-0.508482676968685,-0.16662988393007838
257,1572436800,896,436,0,1332,44,-0.508482676968685,1.2492943941205141
257,1572451200,692,421,0,1113,44,-0.508482676968685,0.7434421642786222
257,1572465600,714,669,0,1383,44,-0.508482676968685,1.36709559833027
257,1572480000,276,383,107,659,44,1.4792223329998107,-0.30521953594155565
257,1572494400,41,29,0,70,44,-0.508482676968685,-1.6657079531875574
257,1572508800,435,272,0,707,44,-0.508482676968685,-0.19434781433237383
257,1572523200,817,431,0,1248,44,-0.508482676968685,1.055268881304446
257,1572537600,701,385,0,1086,44,-0.508482676968685,0.6810768208734574
257,1572552000,720,639,0,1359,44,-0.508482676968685,1.3116597375256789
257,1572566400,216,378,162,594,44,2.50093986148829,-0.455358325620656
257,1572580800,46,37,0,83,44,-0.508482676968685,-1.6356801952517372
257,1572595200,425,315,0,740,44,-0.508482676968685,-0.11812350572606135
257,1572609600,820,453,0,1273,44,-0.508482676968685,1.1130145696425615
257,1572624000,704,438,0,1142,44,-0.508482676968685,0.8104271627508363
257,1572638400,680,688,8,1368,44,-0.3598692182794516,1.3324481853274006
257,1572652800,325,457,132,782,44,1.943639391403665,-0.021110749318027276
257,1572667200,61,124,63,185,44,0.6618483102090275,-1.400077786832226
257,1572681600,173,146,0,319,44,-0.508482676968685,-1.0905608973399268
257,1572696000,441,392,0,833,44,-0.508482676968685,0.0966904548917284
257,1572710400,487,355,0,842,44,-0.508482676968685,0.11747890269344997
257,1572724800,516,478,0,994,44,-0.508482676968685,0.46857268778919237
257,1572739200,260,342,82,602,44,1.0148052745959566,-0.436879705352459
257,1572750000,73,101,28,174,44,0.011664428443631672,-1.4254858897009968
257,1572764400,67,43,0,110,44,-0.508482676968685,-1.5733148518465725
257,1572778800,392,258,0,650,44,-0.508482676968685,-0.3260079837432772
257,1572793200,448,384,0,832,44,-0.508482676968685,0.09438062735820377
257,1572807600,448,452,4,900,44,-0.4341759476240683,0.251448899637878
257,1572822000,278,316,38,594,44,0.19743125180517332,-0.455358325620656
257,1572836400,65,100,35,165,44,0.14170120479671083,-1.4462743375027183
257,1572850800,201,182,0,383,44,-0.508482676968685,-0.9427319351943511
257,1572865200,989,466,0,1455,44,-0.508482676968685,1.5334031807440427
257,1572879600,633,419,0,1052,44,-0.508482676968685,0.6025426847336204
257,1572894000,816,588,0,1404,44,-0.508482676968685,1.4156019765342869
257,1572908400,312,535,223,847,44,3.634117483993694,0.12902804036107307
257,1572922800,65,105,40,170,45,0.0920480085441526,-1.2031075547145447
257,1572937200,189,150,0,339,45,-0.5862004754653926,-0.8300664301573264
257,1572951600,891,435,0,1326,45,-0.5862004754653926,1.3485820310141192
257,1572966000,557,359,0,916,45,-0.5862004754653926,0.44357101877471417
257,1572980400,624,585,0,1209,45,-0.5862004754653926,1.0903227909360451
257,1572994800,287,483,196,770,45,2.737217096181379,0.12129880466019437
257,1573009200,59,126,67,185,45,0.5498657352505956,-1.1699973957301761
257,1573023600,210,180,0,390,45,-0.5862004754653926,-0.7174918896104736
257,1573038000,1033,498,0,1531,45,-0.5862004754653926,1.8010875371338215
257,1573052400,619,444,0,1063,45,-0.5862004754653926,0.7680505768215252
257,1573066800,804,638,0,1442,45,-0.5862004754653926,1.604633927159902
257,1573081200,306,471,165,777,45,2.2115745210739814,0.13675021218623298
257,1573095600,79,111,32,190,45,-0.04360168825775644,-1.1589606760687199
257,1573110000,215,157,0,372,45,-0.5862004754653926,-0.7572240803917158
257,1573124400,1025,485,0,1510,45,-0.5862004754653926,1.7547333145557058
257,1573138800,599,381,0,980,45,-0.5862004754653926,0.584841030441353
257,1573153200,816,621,0,1437,45,-0.5862004754653926,1.593597207498446
257,1573167600,367,550,183,917,45,2.5167863388782767,0.44577836270700544
257,1573182000,70,120,50,190,45,0.2616101295465389,-1.1589606760687199
257,1573196400,217,154,0,371,45,-0.5862004754653926,-0.759431424324007
257,1573210800,1000,487,0,1487,45,-0.5862004754653926,1.7039644041130073
257,1573225200,621,434,0,1055,45,-0.5862004754653926,0.7503918253631954
257,1573239600,790,633,0,1423,45,-0.5862004754653926,1.5626943924463685
257,1573254000,333,555,222,888,45,3.1780786107875834,0.3817653886705597
257,1573268400,85,131,46,216,45,0.19378528114558438,-1.101569733829148
257,1573282800,63,63,0,126,45,-0.5862004754653926,-1.3002306877353587
257,1573297200,350,250,0,600,45,-0.5862004754653926,-0.253949663829315
257,1573311600,336,302,0,638,45,-0.5862004754653926,-0.1700705944022482
257,1573326000,367,308,0,675,45,-0.5862004754653926,-0.08839886890747263
257,1573340400,189,293,104,482,45,1.1772455829594248,-0.5144162478396803
257,1573354800,63,147,84,210,45,0.8381213409546523,-1.1148137974228953
257,1573369200,51,47,0,98,45,-0.5862004754653926,-1.3620363178395132
257,1573383600,228,154,0,382,45,-0.5862004754653926,-0.7351506410688035
257,1573398000,251,270,19,521,45,-0.26403244556085864,-0.4283298344803223
257,1573412400,275,304,29,579,45,-0.09447032455847233,-0.3003038864074309
257,1573426800,144,194,50,338,45,0.2616101295465389,-0.8322737740896177
257,1573441200,46,90,44,136,45,0.1598728569451071,-1.2781572484124464
257,1573455600,166,100,0,266,45,-0.5862004754653926,-0.9912025372145864
257,1573470000,769,334,0,1103,45,-0.5862004754653926,0.8563443341131745
257,1573484400,541,338,0,879,45,-0.5862004754653926,0.36189929327993864
257,1573498800,571,580,9,1151,45,-0.4335945665632449,0.9622968428631536
257,1573513200,291,403,112,694,45,1.3128952797613338,-0.04645933419393923
257,1573527600,56,108,52,164,46,0.3420115698953612,-1.146004492511422
257,1573542000,206,169,0,375,46,-0.42725029277350474,-0.7077215729258781
257,1573556400,966,474,0,1440,46,-0.42725029277350474,1.504464727351867
257,1573570800,610,387,0,997,46,-0.42725029277350474,0.5842783132457251
257,1573585200,820,536,0,1356,46,-0.42725029277350474,1.3299824276116503
257,1573599600,271,518,247,789,46,3.2267435549036083,0.152226904365189
257,1573614000,69,104,35,173,46,0.0905221147920781,-1.1273099603963987
257,1573628400,223,146,0,369,46,-0.42725029277350474,-0.7201845943358935
257,1573642800,962,424,0,1386,46,-0.42725029277350474,1.3922975346617277
257,1573657200,581,395,0,976,46,-0.42725029277350474,0.540657738310671
257,1573671600,757,704,0,1461,46,-0.42725029277350474,1.548085302286921
257,1573686000,314,584,270,898,46,3.5669939941609914,0.3786384599804699
257,1573700400,62,113,51,175,46,0.32721807253634455,-1.1231556199263935
257,1573714800,196,160,0,356,46,-0.42725029277350474,-0.747187807390927
257,1573729200,1018,502,0,1520,46,-0.42725029277350474,1.670638346152073
257,1573743600,607,358,0,965,46,-0.42725029277350474,0.5178088657256427
257,1573758000,836,614,0,1450,46,-0.42725029277350474,1.5252364297018928
257,1573772400,352,540,188,892,46,2.353927210721626,0.3661754385704545
257,1573786800,70,133,63,203,46,0.5047400408445444,-1.0649948533463214
257,1573801200,215,133,0,348,46,-0.42725029277350474,-0.7638051692709477
257,1573815600,1004,492,0,1496,46,-0.42725029277350474,1.6207862605120111
257,1573830000,612,393,0,1005,46,-0.42725029277350474,0.6008956751257457
257,1573844400,838,644,0,1482,46,-0.42725029277350474,1.5917058772219752
257,1573858800,405,528,123,933,46,1.3923498823855436,0.4513394182055601
257,1573873200,97,102,5,199,46,-0.35328280597842143,-1.0733035342863317
257,1573887600,96,31,0,127,46,-0.42725029277350474,-1.2228597912065173
257,1573902000,449,138,0,587,46,-0.42725029277350474,-0.26736148310533164
257,1573916400,454,156,0,610,46,-0.42725029277350474,-0.21958656770027238
257,1573930800,427,151,0,578,46,-0.42725029277350474,-0.28605601522035484
257,1573945200,214,116,0,330,46,-0.42725029277350474,-0.8011942335009941
257,1573959600,82,47,0,129,46,-0.42725029277350474,-1.218705450736512
257,1573974000,64,14,0,78,46,-0.42725029277350474,-1.3246411327216436
257,1573988400,311,105,0,416,46,-0.42725029277350474,-0.6225575932907724
257,1574002800,380,148,0,528,46,-0.42725029277350474,-0.38991452697048373
257,1574017200,278,133,0,411,46,-0.42725029277350474,-0.6329434444657853
257,1574031600,164,94,0,258,46,-0.42725029277350474,-0.9507504904211797
257,1574046000,42,30,0,72,46,-0.42725029277350474,-1.337104154131659
257,1574060400,151,121,0,272,46,-0.42725029277350474,-0.9216701071311435
257,1574074800,908,471,0,1379,46,-0.42725029277350474,1.3777573430167096
257,1574089200,611,350,0,961,46,-0.42725029277350474,0.5095001847856323
257,1574103600,770,445,0,1215,46,-0.42725029277350474,1.037101424476287
257,1574118000,261,440,179,701,46,2.220785734490476,-0.030564076315037825
257,1574132400,58,80,22,138,47,0.02729010482768876,-0.9982695387533421
257,1574146800,203,135,0,338,47,-0.42754497563379046,-0.6034781368893296
257,1574161200,997,478,0,1475,47,-0.42754497563379046,1.6409109827075816
257,1574175600,602,363,0,965,47,-0.42754497563379046,0.6341929079543497
257,1574190000,909,509,0,1418,47,-0.42754497563379046,1.528395433176338
257,1574204400,324,466,142,790,47,2.508208725526666,0.2887504313233387
257,1574218800,67,95,28,162,47,0.15133603586263764,-0.9508945705296605
257,1574233200,203,152,0,355,47,-0.42754497563379046,-0.5699208677308885
257,1574247600,960,459,0,1419,47,-0.42754497563379046,1.530369390185658
257,1574262000,605,336,0,941,47,-0.42754497563379046,0.5868179397306681
257,1574276400,833,600,0,1433,47,-0.42754497563379046,1.558004788316139
257,1574290800,312,446,134,758,47,2.342814150813401,0.2255838070250967
257,1574305200,67,97,30,164,47,0.19268467954095395,-0.9469466565110205
257,1574319600,214,157,0,371,47,-0.42754497563379046,-0.5383375555817675
257,1574334000,970,457,0,1427,47,-0.42754497563379046,1.5461610462602184
257,1574348400,612,351,0,963,47,-0.42754497563379046,0.6302449939357095
257,1574362800,876,547,0,1423,47,-0.42754497563379046,1.5382652182229384
257,1574377200,342,432,90,774,47,1.4331439898904426,0.2571671191742177
257,1574391600,75,122,47,197,47,0.5441481508066425,-0.8818060752034584
257,1574406000,195,152,0,347,47,-0.42754497563379046,-0.585712523805449
257,1574420400,985,521,0,1506,47,-0.42754497563379046,1.7021036499965034
257,1574434800,586,434,0,1020,47,-0.42754497563379046,0.7427605434669531
257,1574449200,785,613,0,1398,47,-0.42754497563379046,1.4889162929899367
257,1574463600,345,537,192,882,47,3.5419248174845737,0.47035447618078446
257,1574478000,132,144,12,276,47,-0.1794531135638927,-0.7258634714671734
257,1574492400,97,69,0,166,47,-0.42754497563379046,-0.9429987424923804
257,1574506800,439,301,0,740,47,-0.42754497563379046,0.19005258085733556
257,1574521200,448,309,0,757,47,-0.42754497563379046,0.22360985001577663
257,1574535600,438,433,0,871,47,-0.42754497563379046,0.44864094907826374
257,1574550000,352,373,21,725,47,0.006615782988530613,0.16044322571753464
257,1574564400,113,135,22,248,47,0.02729010482768876,-0.7811342677281352
257,1574578800,60,47,0,107,47,-0.42754497563379046,-1.059462206042264
257,1574593200,302,203,0,505,47,-0.42754497563379046,-0.27382731633287916
257,1574607600,367,354,0,721,47,-0.42754497563379046,0.15254739768025438
257,1574622000,388,348,0,736,47,-0.42754497563379046,0.1821567528200553
257,1574636400,265,303,38,568,47,0.3580792542542191,-0.1494680247457152
257,1574650800,53,89,36,142,47,0.3167306105759028,-0.9903737107160618
257,1574652051,1,2,1,3,47,-0.40687065379463233,-1.2647537350115505
257,1574652131,0,0,0,0,47,-0.42754497563379046,-1.2706756060395108
257,1574652211,1,0,0,1,47,-0.42754497563379046,-1.2687016490301906
257,1574652291,0,1,1,1,47,-0.40687065379463233,-1.2687016490301906
257,1574652372,0,0,0,0,47,-0.42754497563379046,-1.2706756060395108
257,1574652454,0,0,0,0,47,-0.42754497563379046,-1.2706756060395108
257,1574652548,0,0,0,0,47,-0.42754497563379046,-1.2706756060395108
257,1574652628,0,1,1,1,47,-0.40687065379463233,-1.2687016490301906
257,1574665200,199,145,0,344,47,-0.42754497563379046,-0.5916343948334092
257,1574679600,995,498,0,1493,47,-0.42754497563379046,1.6764422088753426
257,1574694000,569,311,0,880,47,-0.42754497563379046,0.4664065621621443
257,1574708400,777,641,0,1418,47,-0.42754497563379046,1.528395433176338
257,1574722800,301,518,217,819,47,4.058782863463527,0.3459951845936205
257,1574737200,64,111,47,175,48,0.5541001517496394,-1.0349227883444612
257,1574751600,205,176,0,381,48,-0.4268807447111573,-0.5527130858964953
257,1574766000,994,585,0,1579,48,-0.4268807447111573,2.2515938244562386
257,1574780400,614,389,0,1003,48,-0.4268807447111573,0.9032793166405668
257,1574794800,899,567,0,1466,48,-0.4268807447111573,1.9870807352493445
257,1574809200,332,486,154,818,48,2.7873970862454955,0.47022691395671395
257,1574823600,76,109,33,185,48,0.2618930762081256,-1.0115145503615504
257,1574838000,211,147,0,358,48,-0.4268807447111573,-0.6065520332571905
257,1574852400,897,516,0,1413,48,-0.4268807447111573,1.8630170739399166
257,1574866800,602,362,0,964,48,-0.4268807447111573,0.8119871885072141
257,1574881200,736,531,0,1267,48,-0.4268807447111573,1.5212567993894164
257,1574895600,259,430,171,689,48,3.1422199636887624,0.16826064397716248
257,1574910000,76,136,60,212,48,0.8254352933239025,-0.9483123078076906
257,1574924400,82,67,0,149,48,-0.4268807447111573,-1.0957842071000297
257,1574938800,338,237,0,575,48,-0.4268807447111573,-0.09859326902802255
257,1574953200,406,315,0,721,48,-0.4268807447111573,0.24316700552247755
257,1574967600,493,315,0,808,48,-0.4268807447111573,0.446818675973803
257,1574982000,246,245,0,491,48,-0.4268807447111573,-0.29522246808447467
257,1574996400,64,118,54,182,48,0.7002036895203966,-1.0185370217564236
257,1575010800,135,85,0,220,48,-0.4268807447111573,-0.9295857174213619
257,1575025200,511,353,0,864,48,-0.4268807447111573,0.5779048086781043
257,1575039600,550,363,0,913,48,-0.4268807447111573,0.6926051747943681
257,1575054000,550,544,0,1094,48,-0.4268807447111573,1.1162942822850566
257,1575068400,254,404,150,658,48,2.7039093503764917,0.09569510623013847
257,1575082800,71,93,22,164,48,0.03230180256836463,-1.0606718501256633
257,1575097200,78,26,0,104,48,-0.4268807447111573,-1.201121278023129
257,1575111600,380,140,0,520,48,-0.4268807447111573,-0.22733857793403286
257,1575126000,504,155,0,659,48,-0.4268807447111573,0.09803593002842956
257,1575140400,413,133,0,546,48,-0.4268807447111573,-0.16647715917846437
257,1575154800,223,119,0,342,48,-0.4268807447111573,-0.6440052140298481
257,1575169200,70,48,0,118,48,-0.4268807447111573,-1.1683497448470537
257,1575183600,65,20,0,85,48,-0.4268807447111573,-1.24559693019066
257,1575198000,286,121,0,407,48,-0.4268807447111573,-0.4918516671409268
257,1575212400,307,95,0,402,48,-0.4268807447111573,-0.5035557861323823
257,1575226800,305,118,0,423,48,-0.4268807447111573,-0.45439848636826924
257,1575241200,141,95,0,236,48,-0.4268807447111573,-0.8921325366487043
257,1575255600,55,29,0,84,48,-0.4268807447111573,-1.2479377539889511
257,1575270000,196,138,0,334,48,-0.4268807447111573,-0.6627318044161769
257,1575284400,980,473,0,1453,48,-0.4268807447111573,1.9566500258715602
257,1575298800,606,360,0,966,48,-0.4268807447111573,0.8166688361037963
257,1575313200,738,527,0,1265,48,-0.4268807447111573,1.516575151792834
257,1575327600,229,397,168,626,48,3.07960416178701,0.020788744684823373
257,1575342000,64,111,47,175,49,0.18115286458347732,-1.3406900659562133
257,1575356400,191,142,0,333,49,-0.5255581130603648,-1.0062986024635638
257,1575370800,1018,505,0,1523,49,-0.5255581130603648,1.512219382069682
257,1575385200,602,340,0,942,49,-0.5255581130603648,0.2825900131505091
257,1575399600,859,608,0,1467,49,-0.5255581130603648,1.3937008886798823
257,1575414000,276,530,254,806,49,3.2936884469723138,-0.005240613653290479
257,1575428400,60,108,48,168,49,0.19618926836313352,-1.3555048776299383
257,1575442800,188,180,0,368,49,-0.5255581130603648,-0.9322245440949389
257,1575457200,1053,444,0,1497,49,-0.5255581130603648,1.4571929387101321
257,1575471600,609,390,0,999,49,-0.5255581130603648,0.40322490820798385
257,1575486000,847,662,0,1509,49,-0.5255581130603648,1.482589758722232
257,1575500400,299,565,266,864,49,3.4741252923281882,0.11751068307185931
257,1575514800,68,126,58,194,49,0.34655330615969565,-1.3004784342703883
257,1575529200,204,162,0,366,49,-0.5255581130603648,-0.936457347430289
257,1575543600,1038,573,0,1611,49,-0.5255581130603648,1.6984627288250818
257,1575558000,624,407,0,1031,49,-0.5255581130603648,0.47094976157358376
257,1575572400,904,561,0,1465,49,-0.5255581130603648,1.3894680853445323
257,1575586800,410,537,127,947,49,1.3840651669559745,0.29317202148888405
257,1575601200,73,119,46,192,49,0.1661164608038211,-1.3047112376057384
257,1575615600,192,177,0,369,49,-0.5255581130603648,-0.930108142427264
257,1575630000,1031,487,0,1518,49,-0.5255581130603648,1.5016373737313071
257,1575644400,662,481,0,1143,49,-0.5255581130603648,0.7079867483531833
257,1575658800,827,637,0,1464,49,-0.5255581130603648,1.3873516836768574
257,1575673200,391,533,142,924,49,1.6096112236508178,0.24449478313235912
257,1575687600,125,197,72,322,49,0.5570629590748827,-1.029579020807989
257,1575702000,100,89,0,189,49,-0.5255581130603648,-1.3110604426087633
257,1575716400,445,311,0,756,49,-0.5255581130603648,-0.1110606970370403
257,1575730800,490,396,0,886,49,-0.5255581130603648,0.16407151976070924
257,1575745200,569,474,0,1043,49,-0.5255581130603648,0.49634658158568373
257,1575759600,324,419,95,743,49,0.9029002460069756,-0.13857391871681526
257,1575774000,134,171,37,305,49,0.030788826786915156,-1.0655578491584639
257,1575788400,73,58,0,131,49,-0.5255581130603648,-1.4338117393339131
257,1575802800,352,222,0,574,49,-0.5255581130603648,-0.49624580055388967
257,1575817200,411,316,0,727,49,-0.5255581130603648,-0.17243634539961522
257,1575831600,464,398,0,862,49,-0.5255581130603648,0.11327787973650932
257,1575846000,262,325,63,587,49,0.42173532505797673,-0.46873257887411474
257,1575860400,75,100,25,175,49,-0.14964801856895943,-1.3406900659562133
257,1575874800,191,154,0,345,49,-0.5255581130603648,-0.9809017824514639
257,1575889200,968,451,0,1419,49,-0.5255581130603648,1.2921136086314824
257,1575903600,564,346,0,910,49,-0.5255581130603648,0.21486515978490917
257,1575918000,768,599,0,1367,49,-0.5255581130603648,1.1820607219123827
257,1575932400,276,464,188,740,49,2.3012857975150034,-0.14492312371984026
257,1575946800,73,128,55,201,50,0.24797446582257343,-1.292209710628654
257,1575961200,194,144,0,338,50,-0.5476102786915161,-1.0062007605591357
257,1575975600,996,546,0,1542,50,-0.5476102786915161,1.5073377495408677
257,1575990000,557,450,0,1007,50,-0.5476102786915161,0.39044148467084966
257,1576004400,825,626,0,1451,50,-0.5476102786915161,1.3173610016844721
257,1576018800,329,589,260,918,50,3.21333578628418,0.20464004995415505
257,1576033200,57,143,86,200,50,0.6963949581850603,-1.2942973671985047
257,1576047600,192,131,0,323,50,-0.5476102786915161,-1.037515609106893
257,1576062000,1071,527,0,1598,50,-0.5476102786915161,1.6242465174524958
257,1576076400,601,376,0,977,50,-0.5476102786915161,0.32781178757533463
257,1576090800,795,585,0,1380,50,-0.5476102786915161,1.1691373852250866
257,1576105200,345,564,219,909,50,2.6202635221918587,0.18585114082550055
257,1576119600,80,135,55,215,50,0.24797446582257343,-1.262982518650747
257,1576134000,198,131,0,329,50,-0.5476102786915161,-1.02498966968779
257,1576148400,1014,522,0,1536,50,-0.5476102786915161,1.4948118101217647
257,1576162800,640,390,0,1030,50,-0.5476102786915161,0.4384575857774112
257,1576177200,824,633,0,1457,50,-0.5476102786915161,1.3298869411035752
257,1576191600,393,560,167,953,50,1.8680743091967194,0.27770802989892257
257,1576206000,88,165,77,253,50,0.5662083636282093,-1.1836515689964282
257,1576220400,184,158,0,342,50,-0.5476102786915161,-0.9978501342797336
257,1576234800,978,620,0,1598,50,-0.5476102786915161,1.6242465174524958
257,1576249200,655,494,0,1149,50,-0.5476102786915161,0.6868887175896208
257,1576263600,941,503,0,1444,50,-0.5476102786915161,1.3027474056955186
257,1576278000,382,585,203,967,50,2.3888206874241233,0.3069352218768296
257,1576292400,142,199,57,341,50,0.27690482016854034,-0.999937790849584
257,1576306800,92,70,0,162,50,-0.5476102786915161,-1.3736283168528238
257,1576321200,454,253,0,707,50,-0.5476102786915161,-0.23585548628430067
257,1576335600,502,395,0,897,50,-0.5476102786915161,0.16079926198729452
257,1576350000,514,517,3,1031,50,-0.5042147471725659,0.44054524234726167
257,1576364400,287,342,55,629,50,0.24797446582257343,-0.39869269873263974
257,1576378800,117,175,58,292,50,0.29136999734152375,-1.1022329627722587
257,1576393200,71,52,0,123,50,-0.5476102786915161,-1.4550469230769933
257,1576407600,367,215,0,582,50,-0.5476102786915161,-0.4968125575156133
257,1576422000,440,353,0,793,50,-0.5476102786915161,-0.056317021277157576
257,1576436400,479,387,0,866,50,-0.5476102786915161,0.096081908321929
257,1576450800,256,321,65,577,50,0.3926262375524079,-0.5072508403648658
257,1576465200,64,88,24,152,50,-0.20044602653991345,-1.3945048825513287
257,1576479600,205,144,0,349,50,-0.5476102786915161,-0.9832365382907801
257,1576494000,955,508,0,1463,50,-0.5476102786915161,1.342412880522678
257,1576508400,636,372,0,1008,50,-0.5476102786915161,0.39252914124070015
257,1576522800,835,655,0,1490,50,-0.5476102786915161,1.3987796079086416
257,1576537200,327,533,206,860,50,2.432216218943074,0.08355596890282599
257,1576551600,69,128,59,197,51,0.558404345198896,-1.2749313562260438
257,1576566000,186,147,0,333,51,-0.6112710287680222,-0.9641158245673515
257,1576580400,936,461,0,1397,51,-0.6112710287680222,1.4675586289977123
257,1576594800,575,348,0,923,51,-0.6112710287680222,0.3842750848343286
257,1576609200,792,542,0,1334,51,-0.6112710287680222,1.323577904773465
257,1576623600,336,462,126,798,51,1.886679769873193,0.09859904470685402
257,1576638000,79,132,53,211,51,0.439454307168362,-1.2429356397317666
257,1576652400,213,172,0,385,51,-0.6112710287680222,-0.8452745918743221
257,1576666800,998,535,0,1533,51,-0.6112710287680222,1.7783741606564045
257,1576681200,616,397,0,1013,51,-0.6112710287680222,0.5899618337261103
257,1576695600,835,692,0,1527,51,-0.6112710287680222,1.7646617107302858
257,1576710000,366,544,178,910,51,2.9175800994711545,0.3545647766610712
257,1576724400,81,150,69,231,51,0.7566544085831195,-1.1972274733113708
257,1576738800,193,143,0,336,51,-0.6112710287680222,-0.9572595996042921
257,1576753200,924,466,0,1390,51,-0.6112710287680222,1.4515607707505738
257,1576767600,582,440,0,1022,51,-0.6112710287680222,0.6105305086152885
257,1576782000,820,685,0,1505,51,-0.6112710287680222,1.7143827276678503
257,1576796400,350,513,163,863,51,2.6202050043948195,0.2471505855731408
257,1576810800,73,138,65,211,51,0.6773543832294301,-1.2429356397317666
257,1576825200,194,130,0,324,51,-0.6112710287680222,-0.9846844994565297
257,1576839600,943,414,0,1357,51,-0.6112710287680222,1.3761422961569203
257,1576854000,600,416,0,1016,51,-0.6112710287680222,0.5968180586891697
257,1576868400,839,528,0,1367,51,-0.6112710287680222,1.3989963793671183
257,1576882800,345,499,154,844,51,2.4417799473490187,0.20372782747376467
257,1576897200,91,181,90,272,51,1.1729795416899886,-1.103525732149559
257,1576911600,86,73,0,159,51,-0.6112710287680222,-1.361776872424796
257,1576926000,410,250,0,660,51,-0.6112710287680222,-0.21678730359387793
257,1576940400,478,340,0,818,51,-0.6112710287680222,0.14430721112724995
257,1576954800,501,327,0,828,51,-0.6112710287680222,0.16716129433744792
257,1576969200,297,367,70,664,51,0.7764794149215418,-0.20764567030979875
257,1576983600,104,154,50,258,51,0.37997928815309495,-1.1355214486438363
257,1576998000,82,64,0,146,51,-0.6112710287680222,-1.3914871805980535
257,1577012400,338,189,0,527,51,-0.6112710287680222,-0.5207466102895109
257,1577026800,438,267,0,705,51,-0.6112710287680222,-0.11394392914798708
257,1577041200,429,295,0,724,51,-0.6112710287680222,-0.07052117104861094
257,1577055600,239,315,76,554,51,0.8954294529520759,-0.4590405856219764
257,1577070000,66,103,37,169,51,0.12225420575360448,-1.338922789214598
257,1577084400,161,123,0,284,51,-0.6112710287680222,-1.0761008322973216
257,1577098800,690,444,0,1134,51,-0.6112710287680222,0.8664962405695057
257,1577113200,561,384,0,945,51,-0.6112710287680222,0.43455406789676415
257,1577127600,696,475,0,1171,51,-0.6112710287680222,0.9510563484472382
257,1577142000,277,382,105,659,51,1.4703546367663238,-0.21907271191489774
257,1577156400,74,137,63,211,52,0.8395052555767671,-1.1810075123183745
257,1577170800,132,121,0,253,52,-0.5372105214645255,-1.066209482191381
257,1577185200,594,434,0,1028,52,-0.5372105214645255,1.0520875022948062
257,1577199600,592,351,0,943,52,-0.5372105214645255,0.8197581556092245
257,1577214000,529,527,0,1056,52,-0.5372105214645255,1.1286195223794686
257,1577228400,256,334,78,590,52,1.1672947263008844,-0.14509195474383896
257,1577242800,90,100,10,190,52,-0.31868420764844735,-1.2384065273818712
257,1577257200,60,51,0,111,52,-0.5372105214645255,-1.4543361554778824
257,1577271600,277,219,0,496,52,-0.5372105214645255,-0.4020208793137765
257,1577286000,333,352,19,685,52,-0.12201052521397697,0.11457025625769368
257,1577300400,370,333,0,703,52,-0.5372105214645255,0.16376941202640513
257,1577314800,219,257,38,476,52,0.2931894710365716,-0.4566866079456781
257,1577329200,66,86,20,152,52,-0.10015789383236914,-1.342271411782484
257,1577343600,153,108,0,261,52,-0.5372105214645255,-1.0443431907386205
257,1577358000,596,471,0,1067,52,-0.5372105214645255,1.1586856731270143
257,1577372400,488,395,0,883,52,-0.5372105214645255,0.6557609697135196
257,1577386800,625,512,0,1137,52,-0.5372105214645255,1.35001572333867
257,1577401200,238,426,188,664,52,3.5710841782777445,0.057171241194196996
257,1577415600,67,123,56,190,52,0.6865368359055124,-1.2384065273818712
257,1577430000,143,116,0,259,52,-0.5372105214645255,-1.0498097636018107
257,1577444400,620,483,0,1103,52,-0.5372105214645255,1.2570839846644373
257,1577458800,531,479,0,1010,52,-0.5372105214645255,1.002888346526095
257,1577473200,673,555,0,1228,52,-0.5372105214645255,1.5987447886138224
257,1577487600,310,428,118,738,52,2.0413999815651973,0.25943443713223296
