remote_unit_id,time_stamp,entries,exits,num_people_exited,sum_exit_entry,week_num,z_score_num_people_exited,z_score_sum_exit_entry
34,1546311600,90,194,104,284,1,1.4720696424115385,-0.708520184019703
34,1546326000,40,84,44,124,1,0.20078263114454836,-1.1766869132834596
34,1546340400,97,93,0,190,1,-0.7314945104512443,-0.98356813746216
34,1546354800,273,221,0,494,1,-0.7314945104512443,-0.09405135186102244
34,1546369200,269,377,108,646,1,1.5568221098293378,0.35070704093954636
34,1546383600,132,238,106,370,1,1.514445876120438,-0.4568805670404338
34,1546398000,29,76,47,105,1,0.26434698170789783,-1.2322817123835306
34,1546412400,78,80,2,158,1,-0.6891182767423445,-1.0772014833149113
34,1546426800,460,374,0,834,1,-0.7314945104512443,0.9008029478244604
34,1546441200,376,275,0,651,1,-0.7314945104512443,0.3653372512290387
34,1546455600,690,549,0,1239,1,-0.7314945104512443,2.0858499812733444
34,1546470000,187,343,156,530,1,2.5738517188429295,0.011286162223322798
34,1546484400,45,101,56,146,1,0.45504003339794635,-1.112313988009693
34,1546498800,103,95,0,198,1,-0.7314945104512443,-0.9601598009989721
34,1546513200,548,381,0,929,1,-0.7314945104512443,1.1787769433248159
34,1546527600,382,305,0,687,1,-0.7314945104512443,0.470674765313384
34,1546542000,632,585,0,1217,1,-0.7314945104512443,2.021477055999578
34,1546556400,225,377,152,602,1,2.4890992514251304,0.22196119039201326
34,1546570800,53,104,51,157,1,0.3490994491256972,-1.0801275253728098
34,1546585200,92,95,3,187,1,-0.6679301598878947,-0.9923462636358554
34,1546599600,498,410,0,908,1,-0.7314945104512443,1.1173300601089478
34,1546614000,386,353,0,739,1,-0.7314945104512443,0.6228289523241048
34,1546628400,557,527,0,1084,1,-0.7314945104512443,1.63231346229908
34,1546642800,261,292,31,553,1,-0.07466288796329944,0.07858512955498781
34,1546657200,71,143,72,214,1,0.7940499030691436,-0.9133431280725964
34,1546671600,55,63,8,118,1,-0.5619895756156456,-1.1942431656308505
34,1546686000,194,221,27,415,1,-0.15941535538109877,-0.32520867443500223
34,1546700400,359,328,0,687,1,-0.7314945104512443,0.470674765313384
34,1546714800,398,392,0,790,1,-0.7314945104512443,0.7720570972769273
34,1546729200,238,293,55,531,1,0.43385191654349653,0.014212204281221278
34,1546743600,67,131,64,198,1,0.624544968233545,-0.9601598009989721
34,1546758000,41,38,0,79,1,-0.7314945104512443,-1.308358805888891
34,1546772400,171,150,0,321,1,-0.7314945104512443,-0.6002566278774593
34,1546786800,385,327,0,712,1,-0.7314945104512443,0.543825816760846
34,1546801200,340,433,93,773,1,1.23900035701259,0.7223143822926531
34,1546815600,162,281,119,443,1,1.7898913952282858,-0.24327949681384484
34,1546830000,52,75,23,127,1,-0.2441678227988981,-1.1679087871097642
34,1546844400,105,91,0,196,1,-0.7314945104512443,-0.9660118851147691
34,1546858800,546,449,0,995,1,-0.7314945104512443,1.3718957191461154
34,1546873200,322,328,6,650,1,-0.6043658093245452,0.3624112091711402
34,1546887600,745,553,0,1298,1,-0.7314945104512443,2.2584864626893544
34,1546902000,198,321,123,519,1,1.874643862646085,-0.020900300413560467
34,1546916400,49,94,45,143,2,0.4440231049175523,-1.1815627158180864
34,1546930800,102,99,0,201,2,-0.5882077293926246,-1.031737783449503
34,1546945200,556,518,0,1074,2,-0.5882077293926246,1.2233857675465907
34,1546959600,355,317,0,672,2,-0.5882077293926246,0.18494399492296001
34,1546974000,566,551,0,1117,2,-0.5882077293926246,1.3344628725784717
34,1546988400,234,404,170,638,2,3.311330978001377,0.09711558629310069
34,1547002800,51,122,71,173,2,1.0404231425189878,-1.1040670611446812
34,1547017200,101,104,3,205,2,-0.5193923404386128,-1.0214050294930488
34,1547031600,616,478,0,1094,2,-0.5882077293926246,1.275049537328861
34,1547046000,379,338,0,717,2,-0.5882077293926246,0.3011874769330679
34,1547060400,782,586,0,1368,2,-0.5882077293926246,1.9828431833459625
34,1547074800,254,394,140,648,2,2.6231770884612593,0.12294747118423578
34,1547089200,47,106,59,153,2,0.7651615867029408,-1.1557308309269514
34,1547103600,91,99,8,190,2,-0.4047000255152598,-1.0601528568297516
34,1547118000,577,507,0,1084,2,-0.5882077293926246,1.2492176524377259
34,1547132400,349,330,0,679,2,-0.5882077293926246,0.20302631434675458
34,1547146800,733,531,0,1264,2,-0.5882077293926246,1.7141915804781576
34,1547161200,258,346,88,604,2,1.430377013258388,0.00928717766324137
34,1547175600,43,111,68,154,2,0.9716077535649761,-1.1531476424378377
34,1547190000,95,104,9,199,2,-0.38176156253058924,-1.0369041604277298
34,1547204400,589,464,0,1053,2,-0.5882077293926246,1.169138809275207
34,1547218800,379,354,0,733,2,-0.5882077293926246,0.3425184927588841
34,1547233200,715,625,0,1340,2,-0.5882077293926246,1.9105139056507843
34,1547247600,346,378,32,724,2,0.14582308611683453,0.3192697963568625
34,1547262000,68,132,64,200,2,0.8798539016262937,-1.0343209719386164
34,1547276400,44,43,0,87,2,-0.5882077293926246,-1.326221271208443
34,1547290800,232,186,0,418,2,-0.5882077293926246,-0.4711858813118714
34,1547305200,433,337,0,770,2,-0.5882077293926246,0.43809646685608394
34,1547319600,399,407,8,806,2,-0.4047000255152598,0.5310912524641702
34,1547334000,238,268,30,506,2,0.09994616014749333,-0.24386529426988254
34,1547348400,63,132,69,195,2,0.9945462165496467,-1.047236914384184
34,1547362800,43,37,0,80,2,-0.5882077293926246,-1.3443035906322376
34,1547377200,201,131,0,332,2,-0.5882077293926246,-0.6933400913756331
34,1547391600,353,319,0,672,2,-0.5882077293926246,0.18494399492296001
34,1547406000,360,341,0,701,2,-0.5882077293926246,0.2598564611072518
34,1547420400,189,225,36,414,2,0.2375769380555169,-0.4815186352683254
34,1547434800,43,59,16,102,2,-0.22119232163789504,-1.2874734438717403
34,1547449200,90,98,8,188,2,-0.4047000255152598,-1.0653192338079784
34,1547463600,562,445,0,1007,2,-0.5882077293926246,1.0503121387759857
34,1547478000,375,321,0,696,2,-0.5882077293926246,0.24694051866168423
34,1547492400,668,531,0,1199,2,-0.5882077293926246,1.5462843286857795
34,1547506800,232,385,153,617,2,2.9213771072619767,0.042868628021716995
34,1547521200,50,112,62,162,3,0.8295963945113312,-1.064275114550976
34,1547535600,98,100,2,198,3,-0.48440920836016765,-0.9713768364536964
34,1547550000,573,469,0,1042,3,-0.5282093951225509,1.206571683382523
34,1547564400,341,312,0,653,3,-0.5282093951225509,0.2027541783869195
34,1547578800,762,590,0,1352,3,-0.5282093951225509,2.0065290781090965
34,1547593200,262,359,97,621,3,1.5960996628530388,0.12017793118933773
34,1547607600,46,91,45,137,3,0.45729480703107317,-1.1287878076740867
34,1547622000,103,94,0,197,3,-0.5282093951225509,-0.9739573441786209
34,1547636400,608,466,0,1074,3,-0.5282093951225509,1.2891479305801048
34,1547650800,355,316,0,671,3,-0.5282093951225509,0.24920331743555926
34,1547665200,793,532,0,1325,3,-0.5282093951225509,1.936855369536137
34,1547679600,253,419,166,672,3,3.1072061061552625,0.2517838251604837
34,1547694000,47,93,46,140,3,0.4791949004122648,-1.1210462844993134
34,1547708400,77,94,17,171,3,-0.15590780764229295,-1.041050545026656
34,1547722800,599,510,0,1109,3,-0.5282093951225509,1.3794657009524598
34,1547737200,374,306,0,680,3,-0.5282093951225509,0.27242788695987913
34,1547751600,753,587,0,1340,3,-0.5282093951225509,1.9755629854100034
34,1547766000,256,472,216,728,3,4.202210775214844,0.3962922577562518
34,1547780400,68,123,55,191,3,0.6762957408429896,-0.9894403905281675
34,1547794800,86,90,4,176,3,-0.44060902159778437,-1.0281480064020339
34,1547809200,583,467,0,1050,3,-0.5282093951225509,1.2272157451819186
34,1547823600,449,352,0,801,3,-0.5282093951225509,0.5846693216757353
34,1547838000,742,612,0,1354,3,-0.5282093951225509,2.0116900935589452
34,1547852400,351,389,38,740,3,0.3039941533627316,0.427258350455345
34,1547866800,73,163,90,236,3,1.4427990091846972,-0.873317542906568
34,1547881200,48,41,0,89,3,-0.5282093951225509,-1.2526521784704594
34,1547895600,257,166,0,423,3,-0.5282093951225509,-0.39076259834569954
34,1547910000,431,341,0,772,3,-0.5282093951225509,0.5098345976529267
34,1547924400,430,382,0,812,3,-0.5282093951225509,0.613054906649904
34,1547938800,323,271,0,594,3,-0.5282093951225509,0.0505042226163781
34,1547953200,49,108,59,157,3,0.7638961143677562,-1.077177653175598
34,1547967600,40,29,0,69,3,-0.5282093951225509,-1.304262332968948
34,1547982000,187,130,0,317,3,-0.5282093951225509,-0.6642964171876892
34,1547996400,306,308,2,614,3,-0.48440920836016765,0.10211437711486672
34,1548010800,355,363,8,718,3,-0.35300864807301774,0.3704871805070075
34,1548025200,198,222,24,420,3,-0.002607153973951416,-0.3985041215204728
34,1548039600,42,79,37,121,3,0.28209405998153997,-1.1700759312728777
34,1548054000,53,45,0,98,3,-0.5282093951225509,-1.2294276089461396
34,1548068400,241,207,0,448,3,-0.5282093951225509,-0.3262499052225888
34,1548082800,289,271,0,560,3,-0.5282093951225509,-0.037233040031052544
34,1548097200,408,313,0,721,3,-0.5282093951225509,0.3782287036817808
34,1548111600,164,209,45,373,3,0.45729480703107317,-0.5197879845919211
34,1548126000,33,75,42,108,4,0.43723989593169804,-1.1943040628605215
34,1548140400,79,72,0,151,4,-0.6107747962625665,-1.0903559863616668
34,1548154800,590,475,0,1065,4,-0.6107747962625665,1.1191449885209692
34,1548169200,376,351,0,727,4,-0.6107747962625665,0.3020647592974124
34,1548183600,799,532,0,1331,4,-0.6107747962625665,1.7621726245371412
34,1548198000,231,389,158,620,4,3.3317566648491908,0.0434032666142154
34,1548212400,41,97,56,138,4,0.7865781266631195,-1.121782149024111
34,1548226800,83,90,7,173,4,-0.43610568089685575,-1.037173249548299
34,1548241200,641,510,0,1151,4,-0.6107747962625665,1.327041141518679
34,1548255600,472,389,0,861,4,-0.6107747962625665,0.6259959744333786
34,1548270000,810,567,0,1377,4,-0.6107747962625665,1.873372892419637
34,1548284400,296,350,54,646,4,0.7366726651300594,0.10625559193910437
34,1548298800,49,90,41,139,4,0.41228716516516795,-1.1193647518962309
34,1548313200,91,110,19,201,4,-0.13667291169849444,-0.9694861299676494
34,1548327600,651,450,0,1101,4,-0.6107747962625665,1.2061712851246615
34,1548342000,474,326,0,800,4,-0.6107747962625665,0.4785347496326776
34,1548356400,766,554,0,1320,4,-0.6107747962625665,1.7355812561304573
34,1548370800,323,405,82,728,4,1.4353491265929024,0.3044821564252927
34,1548385200,47,121,74,168,4,1.2357272804606616,-1.0492602351877007
34,1548399600,90,92,2,182,4,-0.5608693347295063,-1.015416675397376
34,1548407672,380,347,0,727,4,-0.6107747962625665,0.3020647592974124
34,1548408312,28,21,0,49,4,-0.6107747962625665,-1.336930493405462
34,1548414000,199,168,0,367,4,-0.6107747962625665,-0.568198206739512
34,1548428400,457,397,0,854,4,-0.6107747962625665,0.6090741945382162
34,1548442800,772,590,0,1362,4,-0.6107747962625665,1.8371119355014318
34,1548457200,346,409,63,755,4,0.9612472420288304,0.36975187887806205
34,1548471600,69,162,93,231,4,1.7098291650247337,-0.896964216131239
34,1548486000,51,52,1,103,4,-0.5858220654960364,-1.2063910484999232
34,1548500400,256,203,0,459,4,-0.6107747962625665,-0.34579767097452024
34,1548514800,443,344,0,787,4,-0.6107747962625665,0.4471085869702331
34,1548529200,491,412,0,903,4,-0.6107747962625665,0.7275266538043532
34,1548543600,273,276,3,549,4,-0.5359166039629761,-0.12823192946528914
34,1548558000,54,145,91,199,4,1.6599237034916736,-0.9743209242234101
34,1548572400,40,28,0,68,4,-0.6107747962625665,-1.2909999479757353
34,1548586800,164,143,0,307,4,-0.6107747962625665,-0.7132420344123328
34,1548601200,356,297,0,653,4,-0.6107747962625665,0.1231773718342668
34,1548615600,361,346,0,707,4,-0.6107747962625665,0.25371681673980545
34,1548630000,141,265,124,406,4,2.483363818787167,-0.47391971875217853
34,1548644400,38,79,41,117,4,0.41228716516516795,-1.1725474887095984
34,1548658800,72,90,18,162,4,-0.16162564246502456,-1.063764617954983
34,1548673200,636,483,0,1119,4,-0.6107747962625665,1.2496844334265078
34,1548687600,375,328,0,703,4,-0.6107747962625665,0.24404722822828406
34,1548702000,752,572,0,1324,4,-0.6107747962625665,1.7452508446419788
34,1548716400,242,350,108,592,4,2.084120126522685,-0.02428385296643428
34,1548730800,42,65,23,107,5,0.14909782332761734,-1.2005410557491263
34,1548745200,97,93,0,190,5,-0.5151262634787501,-1.0089590737250427
34,1548759600,679,488,0,1167,5,-0.5151262634787501,1.2461685941970029
34,1548774000,408,308,0,716,5,-0.5151262634787501,0.2051628846444517
34,1548788400,831,614,0,1445,5,-0.5151262634787501,1.8878528231451388
34,1548802800,233,352,119,585,5,2.921511403041151,-0.0972134966224756
34,1548817200,38,58,20,96,5,0.0624598989615694,-1.2259314389089446
34,1548831600,80,89,9,169,5,-0.25521249038060634,-1.0574316233937868
34,1548846000,697,513,0,1210,5,-0.5151262634787501,1.3454219101853837
34,1548860400,364,339,0,703,5,-0.5151262634787501,0.17515606818284823
34,1548862331,86,60,0,146,5,-0.5151262634787501,-1.110520606364316
34,1548874800,661,565,0,1226,5,-0.5151262634787501,1.382353376599665
34,1548889200,235,344,109,579,5,2.6327183218209913,-0.11106279652783103
34,1548903600,36,57,21,93,5,0.09133920708358538,-1.2328560888616225
34,1548918000,79,67,0,146,5,-0.5151262634787501,-1.110520606364316
34,1548932400,492,459,0,951,5,-0.5151262634787501,0.7475937976042067
34,1548946800,362,287,0,649,5,-0.5151262634787501,0.0505123690346492
34,1548961200,723,523,0,1246,5,-0.5151262634787501,1.4285177096175163
34,1548975600,281,306,25,587,5,0.2068564395716493,-0.09259706332069044
34,1548990000,35,66,31,101,5,0.3801322883037452,-1.2143903556544817
34,1549004400,74,76,2,150,5,-0.45736764723471823,-1.1012877397607457
34,1549018800,667,490,0,1157,5,-0.5151262634787501,1.2230864276880773
34,1549033200,470,378,0,848,5,-0.5151262634787501,0.5098474825622716
34,1549047600,844,589,0,1433,5,-0.5151262634787501,1.860154223334428
34,1549062000,375,387,12,762,5,-0.16857456601455842,0.31134085058551014
34,1549076400,73,129,56,202,5,1.1021149913541446,-0.9812604739143318
34,1549090800,38,40,2,78,5,-0.45736764723471823,-1.267479338625011
34,1549105200,245,178,0,423,5,-0.5151262634787501,-0.4711445940670727
34,1549119600,487,325,0,812,5,-0.5151262634787501,0.4267516831301389
34,1549134000,527,448,0,975,5,-0.5151262634787501,0.8029909972256286
34,1549148400,349,343,0,692,5,-0.5151262634787501,0.14976568502302992
34,1549162800,77,166,89,243,5,2.0551321593806717,-0.8866235912277362
34,1549177200,29,36,7,65,5,-0.31297110662463834,-1.2974861550866146
34,1549191600,220,134,0,354,5,-0.5151262634787501,-0.6304115429786604
34,1549206000,463,322,0,785,5,-0.5151262634787501,0.36442983355603936
34,1549220400,547,435,0,982,5,-0.5151262634787501,0.8191485137818766
34,1549234800,209,246,37,455,5,0.553408137035841,-0.39728166123851033
34,1549249200,44,111,67,155,5,1.4197873806963204,-1.0897466565062828
34,1549263600,98,90,0,188,5,-0.5151262634787501,-1.0135755070268277
34,1549278000,686,447,0,1133,5,-0.5151262634787501,1.1676892280666553
34,1549292400,447,311,0,758,5,-0.5151262634787501,0.30210798398193983
34,1549306800,733,651,0,1384,5,-0.5151262634787501,1.7470516074406917
34,1549321200,341,479,138,820,5,3.4702182573594547,0.4452174163372795
34,1549335600,41,139,98,180,6,1.8973439609757692,-1.1138840057178323
34,1549350000,82,98,16,180,6,-0.22715105534705143,-1.1138840057178323
34,1549364400,615,438,0,1053,6,-0.6416866682880896,0.7799559186737481
34,1549378800,362,354,0,716,6,-0.6416866682880896,0.04888598222476467
34,1549393200,818,586,0,1404,6,-0.6416866682880896,1.5413967130167547
34,1549407600,337,470,133,807,6,2.8041406142842904,0.2462965585359145
34,1549422000,40,135,95,175,6,1.8196185335493247,-1.1247307406799834
34,1549436400,87,102,15,189,6,-0.2530595311558663,-1.0943598827859602
34,1549450800,750,498,0,1248,6,-0.6416866682880896,1.2029785821976406
34,1549465200,497,378,0,875,6,-0.6416866682880896,0.3938121540211693
34,1549479600,898,656,0,1554,6,-0.6416866682880896,1.8667987618812873
34,1549494000,334,458,124,792,6,2.5709643320049564,0.21375635364946124
34,1549508400,35,121,86,156,6,1.5864422512699907,-1.1659483335361573
34,1549522800,100,103,3,203,6,-0.5639612408616449,-1.0639890248919373
34,1549527096,204,174,0,378,6,-0.6416866682880896,-0.6843533012166491
34,1549537200,527,330,0,857,6,-0.6416866682880896,0.3547639081574254
34,1549551600,484,347,0,831,6,-0.6416866682880896,0.29836088635423974
34,1549566000,903,714,0,1617,6,-0.6416866682880896,2.0034676224043912
34,1549580400,410,458,48,868,6,0.6019201705350249,0.3786267250741578
34,1549594800,52,113,61,165,6,0.9387303560496185,-1.1464242106042855
34,1549609200,93,95,2,188,6,-0.5898697166704598,-1.0965292297783904
34,1549623600,678,503,0,1181,6,-0.6416866682880896,1.0576323337048161
34,1549638000,538,443,0,981,6,-0.6416866682880896,0.6237629352187725
34,1549652400,922,777,0,1699,6,-0.6416866682880896,2.181354075783669
34,1549666800,352,395,43,747,6,0.4723777914909505,0.11613573899010142
34,1549681200,87,138,51,225,6,0.6796455979614696,-1.0162633910584724
34,1549695600,47,46,0,93,6,-0.6416866682880896,-1.3026171940592612
34,1549710000,257,232,0,489,6,-0.6416866682880896,-0.44355578505689486
34,1549724400,491,428,0,919,6,-0.6416866682880896,0.48926342168809894
34,1549738800,581,445,0,1026,6,-0.6416866682880896,0.7213835498781322
34,1549753200,306,408,102,714,6,2.0009778642110287,0.044547288239904226
34,1549767600,71,132,61,203,6,0.9387303560496185,-1.0639890248919373
34,1549782000,31,44,13,75,6,-0.3048764827734961,-1.341665439923005
34,1549796400,209,162,0,371,6,-0.6416866682880896,-0.6995387301636605
34,1549810800,509,398,0,907,6,-0.6416866682880896,0.4632312577789363
34,1549825200,489,469,0,958,6,-0.6416866682880896,0.5738679543928774
34,1549839600,233,305,72,538,6,1.2237235899465821,-0.3372577824278141
34,1549854000,44,68,24,112,6,-0.019883248876532342,-1.261399601203087
34,1549868400,93,78,0,171,6,-0.6416866682880896,-1.1334081286497042
34,1549882800,613,543,0,1156,6,-0.6416866682880896,1.0033986588940607
34,1549897200,440,360,0,800,6,-0.6416866682880896,0.23111112958890298
34,1549911600,728,624,0,1352,6,-0.6416866682880896,1.4285906694103834
34,1549926000,324,342,18,666,6,-0.17533410372942165,-0.059581367396746236
34,1549940400,56,78,22,134,7,-0.07181602517584638,-1.211937661897772
34,1549954800,85,85,0,170,7,-0.5561810416903138,-1.1249308842144032
34,1549969200,525,484,0,1009,7,-0.5561810416903138,0.9028104067952207
34,1549983600,351,293,0,644,7,-0.5561810416903138,0.020658355283286623
34,1549998000,675,527,0,1202,7,-0.5561810416903138,1.3692634093755036
34,1550012400,288,358,70,646,7,0.9849803744920826,0.02549206515458489
34,1550026800,45,75,30,120,7,0.10431670810214178,-1.24577363099686
34,1550041200,90,83,0,173,7,-0.5561810416903138,-1.1176803194074558
34,1550055600,663,566,0,1229,7,-0.5561810416903138,1.4345184926380303
34,1550070000,466,384,0,850,7,-0.5561810416903138,0.5185304720270083
34,1550084400,722,555,0,1277,7,-0.5561810416903138,1.5505275295491887
34,1550098800,311,550,239,861,7,4.705784364989583,0.5451158763191488
34,1550113200,62,132,70,194,7,0.9849803744920826,-1.066926365758824
34,1550127600,93,112,19,205,7,-0.13786580015509195,-1.0403409614666834
34,1550142000,847,517,0,1364,7,-0.5561810416903138,1.7607939089506635
34,1550156400,476,327,0,803,7,-0.5561810416903138,0.404938290051499
34,1550170800,850,648,0,1498,7,-0.5561810416903138,2.0846524703276477
34,1550185200,393,443,50,836,7,0.5446485412971122,0.48469450292792043
34,1550199600,65,150,85,215,7,1.3152292493883104,-1.016172412110192
34,1550214000,89,84,0,173,7,-0.5561810416903138,-1.1176803194074558
34,1550228400,672,475,0,1147,7,-0.5561810416903138,1.2363363879148013
34,1550242800,442,347,0,789,7,-0.5561810416903138,0.37110232095241114
34,1550257200,886,531,0,1417,7,-0.5561810416903138,1.8888872205400675
34,1550271600,432,420,0,852,7,-0.5561810416903138,0.5233641818983066
34,1550286000,100,175,75,275,7,1.0950633327908252,-0.871161115971244
34,1550300400,52,49,0,101,7,-0.5561810416903138,-1.2916938747741935
34,1550314800,230,179,0,409,7,-0.5561810416903138,-0.54730255459426
34,1550329200,463,330,0,793,7,-0.5561810416903138,0.3807697406950077
34,1550343600,421,413,0,834,7,-0.5561810416903138,0.47986079305662216
34,1550358000,273,359,86,632,7,1.337245841048059,-0.008343903944502991
34,1550372400,62,165,103,227,7,1.711527899263784,-0.9871701528824025
34,1550386800,33,34,1,67,7,-0.5341644500305653,-1.373866942586264
34,1550401200,177,171,0,348,7,-0.5561810416903138,-0.6947307056688572
34,1550415600,408,276,0,684,7,-0.5561810416903138,0.11733255270925201
34,1550430000,456,342,0,798,7,-0.5561810416903138,0.3928540153732533
34,1550444400,226,273,47,499,7,0.47859876631786663,-0.32978561038583787
34,1550458800,35,87,52,122,7,0.5886817246166093,-1.2409399211255616
34,1550473200,70,48,0,118,7,-0.5561810416903138,-1.2506073408681582
34,1550487600,291,336,45,627,7,0.4345655829983696,-0.020428178622748663
34,1550502000,404,335,0,739,7,-0.5561810416903138,0.2502595741699544
34,1550516400,608,435,0,1043,7,-0.5561810416903138,0.9849834746072913
34,1550530800,249,316,67,565,7,0.9189305995128371,-0.170273184632995
34,1550545200,44,70,26,114,8,0.11008473511141692,-1.3682496458861935
34,1550559600,89,75,0,164,8,-0.6447820199382989,-1.2559369312638915
34,1550574000,672,433,0,1105,8,-0.6447820199382989,0.857788357927831
34,1550588400,493,321,0,814,8,-0.6447820199382989,0.20412835882603378
34,1550602800,785,570,0,1355,8,-0.6447820199382989,1.4193519310393408
34,1550617200,303,390,87,693,8,1.881118275804981,-0.06766841055993691
34,1550631600,45,89,44,134,8,0.6326847962996817,-1.3233245600372727
34,1550646000,85,90,5,175,8,-0.49961533627489196,-1.231228134046985
34,1550660400,653,435,0,1088,8,-0.6447820199382989,0.8196020349562484
34,1550674800,419,357,0,776,8,-0.6447820199382989,0.11877069571308431
34,1550689200,747,520,0,1267,8,-0.6447820199382989,1.2216815533040895
34,1550703600,302,367,65,669,8,1.2423848676859905,-0.12157851357864186
34,1550718000,45,125,80,170,8,1.6778849186762113,-1.2424594055092153
34,1550732400,75,84,9,159,8,-0.38348198934416644,-1.2671682027261217
34,1550746800,758,441,0,1199,8,-0.6447820199382989,1.0689362614177587
34,1550761200,506,335,0,841,8,-0.6447820199382989,0.2647772247220768
34,1550775600,818,564,0,1382,8,-0.6447820199382989,1.4800007969353839
34,1550790000,364,456,92,820,8,2.026284959468388,0.21760588458071
34,1550804400,55,157,102,212,8,2.3166183267952016,-1.1481167252264817
34,1550818800,84,107,23,191,8,0.02298472491337279,-1.1952880653678484
34,1550833200,627,417,0,1044,8,-0.6447820199382989,0.7207668460886227
34,1550847600,450,336,0,786,8,-0.6447820199382989,0.1412332386375447
34,1550862000,816,595,0,1411,8,-0.6447820199382989,1.545142171416319
34,1550876400,419,367,0,786,8,-0.6447820199382989,0.1412332386375447
34,1551510000,60,55,0,115,9,-0.5735247448981331,-1.4030543943865221
34,1551524400,333,188,0,521,9,-0.5735247448981331,0.03457645924408586
34,1551538800,331,287,0,618,9,-0.5735247448981331,0.37804984053021634
34,1551553200,378,365,0,743,9,-0.5735247448981331,0.8206701772391474
34,1551567600,278,297,19,575,9,-0.008742755257593462,0.22578844470234408
34,1551582000,77,192,115,269,9,2.8448925608209223,-0.8577461395611191
34,1551596400,38,36,0,74,9,-0.5735247448981331,-1.5482338648270515
34,1551610800,202,150,0,352,9,-0.5735247448981331,-0.5638462359863889
34,1551625200,368,262,0,630,9,-0.5735247448981331,0.4205413928542737
34,1551639600,332,338,6,670,9,-0.39517253764322585,0.5621799006011317
34,1551654000,219,290,71,509,9,1.5369763742849358,-0.00791509307997152
34,1551668400,31,95,64,126,9,1.3288987991542107,-1.3641038047561362
34,1551682800,85,79,0,164,9,-0.5735247448981331,-1.2295472223966213
34,1551697200,544,368,0,912,9,-0.5735247448981331,1.4190928724696221
34,1551711600,380,310,0,690,9,-0.5735247448981331,0.6329991544745607
34,1551726000,641,453,0,1094,9,-0.5735247448981331,2.063548082717826
34,1551740400,288,341,53,629,9,1.0019197525202141,0.4170004301606023
34,1551754800,41,95,54,136,10,0.3303756859265213,-1.176042225672935
34,1551769200,110,96,0,206,10,-0.75005528695578,-1.010361821800889
34,1551783600,664,531,0,1195,10,-0.75005528695578,1.330465598619877
34,1551798000,408,339,0,747,10,-0.75005528695578,0.27011101383878183
34,1551812400,798,656,0,1454,10,-0.75005528695578,1.9434830929464477
34,1551826800,382,456,74,838,10,0.7305353055125589,0.4854955388724418
34,1551841200,46,100,54,146,10,0.3303756859265213,-1.152373596548357
34,1551855600,93,95,2,188,10,-0.7100393249971763,-1.0529653542251294
34,1551870000,733,533,0,1266,10,-0.75005528695578,1.498512865404381
34,1551884400,388,338,0,726,10,-0.75005528695578,0.22040689267716798
34,1551898800,762,644,0,1406,10,-0.75005528695578,1.8298736731484733
34,1551913200,310,404,94,714,10,1.1306949250985963,0.19200453772767437
34,1551927600,74,106,32,180,10,-0.10979989561812,-1.0719002575247918
34,1551942000,103,108,5,211,10,-0.6500153820592707,-0.9985275072386
34,1551956400,634,527,0,1161,10,-0.75005528695578,1.2499922595963118
34,1551970800,387,327,0,714,10,-0.75005528695578,0.19200453772767437
34,1551985200,690,650,0,1340,10,-0.75005528695578,1.6736607209262584
34,1551999600,325,476,151,801,10,2.2711498409188033,0.39792161111150315
34,1552014000,59,169,110,228,10,1.4508226207674264,-0.9582908377268173
34,1552028400,110,117,7,227,10,-0.6099994201006669,-0.9606577006392751
34,1552042800,514,484,0,998,10,-0.75005528695578,0.8641936048656901
34,1552057200,404,406,2,810,10,-0.7100393249971763,0.41922337732362336
34,1552071600,691,603,0,1294,10,-0.75005528695578,1.5647850269531993
34,1552086000,386,435,49,821,10,0.2303357810300119,0.44525886936065917
34,1552100400,66,192,126,258,10,1.7709503164362563,-0.8872849503530833
34,1552114800,60,56,0,116,10,-0.75005528695578,-1.223379483922091
34,1552129200,188,221,33,409,10,-0.08979191463881811,-0.5298886505719552
34,1552143600,255,373,118,628,10,1.6108864686018414,-0.011545672743696587
34,1552158000,274,418,144,692,10,2.13109397406369,0.13993355365360272
34,1552172400,278,270,0,548,10,-0.75005528695578,-0.20089470574032073
34,1552190400,58,187,129,245,10,1.830974259374162,-0.9180541682150347
34,1552204800,40,52,12,92,10,-0.5099595152041575,-1.2801841938210783
34,1552219200,89,123,34,212,10,-0.06978393365951624,-0.9961606443261422
34,1552233600,199,234,35,433,10,-0.04977595268021436,-0.47308394067296794
34,1552248000,171,292,121,463,10,1.670910411539747,-0.4020780532992339
34,1552262400,111,235,124,346,10,1.7309343544776528,-0.6790010140567967
34,1552276800,28,54,26,82,10,-0.22984778149393126,-1.3038528229456563
34,1552291200,226,223,0,449,10,-0.75005528695578,-0.4352141340736431
34,1552305600,571,458,0,1029,10,-0.75005528695578,0.9375663551518819
34,1552320000,413,414,1,827,10,-0.7300473059764782,0.459460046835406
34,1552334400,700,612,0,1312,10,-0.75005528695578,1.6073885593774397
34,1552348800,187,317,130,504,11,3.5071850847170456,-0.4132616415952747
34,1552363200,39,72,33,111,11,0.5092262019773804,-1.4948054272574922
34,1552377600,233,201,0,434,11,-0.5106979540062169,-0.6059030283544483
34,1552392000,639,400,0,1039,11,-0.5106979540062169,1.0590689572069807
34,1552406400,508,358,0,866,11,-0.5106979540062169,0.5829695299307374
34,1552420800,650,585,0,1235,11,-0.5106979540062169,1.5984648401326667
34,1552435200,281,377,96,658,11,2.4563541361278847,0.01054940927490723
34,1552449600,36,85,49,121,11,1.0037348836663973,-1.4672852291490388
34,1552464000,307,220,0,527,11,-0.5106979540062169,-0.3499651859458319
34,1552478400,604,419,0,1023,11,-0.5106979540062169,1.0150366402334552
34,1552492800,496,374,0,870,11,-0.5106979540062169,0.5939776091741187
34,1552507200,687,603,0,1290,11,-0.5106979540062169,1.7498259297291603
34,1552521600,263,356,93,619,11,2.363633758311194,-0.09677936334806092
34,1552536000,26,67,41,93,11,0.7564805428218889,-1.5443417838527083
34,1552550400,278,225,0,503,11,-0.5106979540062169,-0.41601366140612
34,1552564800,584,387,0,971,11,-0.5106979540062169,0.8719316100694977
34,1552579200,540,349,0,889,11,-0.5106979540062169,0.6462659855801801
34,1552593600,684,549,0,1233,11,-0.5106979540062169,1.592960800510976
34,1552608000,277,376,99,653,11,2.5490745139445754,-0.003210689779319456
34,1552622400,50,61,11,111,11,-0.1707232353450178,-1.4948054272574922
34,1552636800,287,204,0,491,11,-0.5106979540062169,-0.4490378991362641
34,1552651200,593,393,0,986,11,-0.5106979540062169,0.9132119072321778
34,1552665600,582,381,0,963,11,-0.5106979540062169,0.8499154515827351
34,1552680000,705,597,0,1302,11,-0.5106979540062169,1.7828501674593042
34,1552694400,277,311,34,588,11,0.5401329945829441,-0.18209197748426637
34,1552708800,72,106,34,178,11,0.5401329945829441,-1.3104200999308546
34,1552723200,112,76,0,188,11,-0.5106979540062169,-1.2828999018224012
34,1552737600,345,212,0,557,11,-0.5106979540062169,-0.2674045916204718
34,1552752000,478,348,0,826,11,-0.5106979540062169,0.4728887374969239
34,1552766400,493,391,0,884,11,-0.5106979540062169,0.6325058865259534
34,1552780800,284,288,4,572,11,-0.3870707835839627,-0.22612429445779175
34,1552795200,47,102,55,149,11,1.1891756392997788,-1.3902286744453694
34,1552809600,78,49,0,127,11,-0.5106979540062169,-1.4507731102839667
34,1552824000,291,183,0,474,11,-0.5106979540062169,-0.4958222359206348
34,1552838400,365,282,0,647,11,-0.5106979540062169,-0.01972280864439148
34,1552852800,371,357,0,728,11,-0.5106979540062169,0.20319079603408083
34,1552867200,230,214,0,444,11,-0.5106979540062169,-0.5783828302459949
34,1552881600,35,50,15,85,11,-0.04709606492276357,-1.566357942339471
34,1552896000,271,204,0,475,11,-0.5106979540062169,-0.49307021610978946
34,1552910400,593,399,0,992,11,-0.5106979540062169,0.9297240260972498
34,1552924800,526,330,0,856,11,-0.5106979540062169,0.555449331822284
34,1552939200,668,545,0,1213,11,-0.5106979540062169,1.5379204042940693
34,1552953600,243,265,22,508,12,1.0034464556448925,-0.37239324362822934
34,1552968000,29,39,10,68,12,0.18774159492710893,-1.5481709887588762
34,1552982400,303,227,0,530,12,-0.4920124556710441,-0.313604356371697
34,1552996800,608,369,0,977,12,-0.4920124556710441,0.8808789437951193
34,1553011200,557,360,0,917,12,-0.4920124556710441,0.7205456149136674
34,1553025600,682,574,0,1256,12,-0.4920124556710441,1.6264289230938704
34,1553040000,245,268,23,513,12,1.071421860704708,-0.35903213288810837
34,1553054400,36,44,8,80,12,0.05179078480747833,-1.516104322982586
34,1553068800,306,212,0,518,12,-0.4920124556710441,-0.34567102214798734
34,1553083200,588,401,0,989,12,-0.4920124556710441,0.9129456095714097
34,1553097600,455,383,0,838,12,-0.4920124556710441,0.5094400652197558
34,1553112000,665,608,0,1273,12,-0.4920124556710441,1.6718566996102817
34,1553126400,263,248,0,511,12,-0.4920124556710441,-0.3643765771841567
34,1553140800,17,46,29,63,12,1.4792742910635999,-1.5615320994989972
34,1553155200,211,204,0,415,12,-0.4920124556710441,-0.6209099033944797
34,1553169600,476,437,0,913,12,-0.4920124556710441,0.7098567263215707
34,1553184000,577,399,0,976,12,-0.4920124556710441,0.8782067216470951
34,1553198400,730,575,0,1305,12,-0.4920124556710441,1.757367808347056
34,1553212800,240,234,0,474,12,-0.4920124556710441,-0.46324879666105206
34,1553227200,42,37,0,79,12,-0.4920124556710441,-1.5187765451306101
34,1553241600,239,203,0,442,12,-0.4920124556710441,-0.5487599053978264
34,1553256000,529,366,0,895,12,-0.4920124556710441,0.6617567276571351
34,1553270400,497,395,0,892,12,-0.4920124556710441,0.6537400612130625
34,1553284800,675,545,0,1220,12,-0.4920124556710441,1.5302289257649992
34,1553299200,299,294,0,593,12,-0.4920124556710441,-0.14525436104617254
34,1553313600,47,100,53,147,12,3.110684012499167,-1.3370654390649646
34,1553328000,118,70,0,188,12,-0.4920124556710441,-1.2275043309959726
34,1553342400,329,251,0,580,12,-0.4920124556710441,-0.1799932489704871
34,1553356800,416,331,0,747,12,-0.4920124556710441,0.26626784974955386
34,1553371200,430,428,0,858,12,-0.4920124556710441,0.5628845081802398
34,1553385600,283,312,29,595,12,1.4792742910635999,-0.13990991675012415
34,1553400000,55,111,56,166,12,3.314610227678613,-1.2862932182525049
34,1553414400,78,49,0,127,12,-0.4920124556710441,-1.3905098820254487
34,1553428800,306,231,0,537,12,-0.4920124556710441,-0.2948988013355276
34,1553443200,482,386,0,868,12,-0.4920124556710441,0.5896067296604818
34,1553457600,367,412,45,779,12,2.5668807720206446,0.35177895848632823
34,1553472000,213,223,10,436,12,0.18774159492710893,-0.5647932382859716
34,1553486400,26,45,19,71,12,0.7995202404654468,-1.5401543223148038
34,1553500800,283,234,0,517,12,-0.4920124556710441,-0.34834324429601154
34,1553515200,590,483,0,1073,12,-0.4920124556710441,1.1374122700054423
34,1553529600,532,441,0,973,12,-0.4920124556710441,0.8701900552030225
34,1553544000,680,602,0,1282,12,-0.4920124556710441,1.6959066989424996
34,1553558400,251,330,79,581,13,1.1534172535756722,-0.11747404252190326
34,1553572800,32,61,29,93,13,0.04629772571071631,-1.435343760928542
34,1553587200,286,228,0,514,13,-0.5958316004509581,-0.2984110735326508
34,1553601600,591,448,0,1039,13,-0.5958316004509581,1.1193790948351472
34,1553616000,511,340,0,851,13,-0.5958316004509581,0.6116751869243928
34,1553630400,707,592,0,1299,13,-0.5958316004509581,1.8215227972649137
34,1553644800,249,409,160,658,13,2.9469508887169003,0.09046851550537377
34,1553659200,24,77,53,101,13,0.577715099085895,-1.4137393393153186
34,1553673600,256,218,0,474,13,-0.5958316004509581,-0.40643318159876873
34,1553688000,533,450,0,983,13,-0.5958316004509581,0.968148143542582
34,1553702400,516,414,0,930,13,-0.5958316004509581,0.8250188503549758
34,1553716800,654,581,0,1235,13,-0.5958316004509581,1.648687424359125
34,1553731200,214,373,159,587,13,2.924808498159601,-0.10127072631198557
34,1553745600,24,83,59,107,13,0.7105694424296898,-1.3975360231054008
34,1553760000,244,220,0,464,13,-0.5958316004509581,-0.4334387086152982
34,1553774400,605,452,0,1057,13,-0.5958316004509581,1.1679890434649003
34,1553788800,563,341,0,904,13,-0.5958316004509581,0.7548044801119991
34,1553803200,647,564,0,1211,13,-0.5958316004509581,1.5838741595194543
34,1553817600,238,413,175,651,13,3.279086747076387,0.07156464659380313
34,1553832000,36,99,63,135,13,0.7991390046588863,-1.3219205474591182
34,1553846400,227,221,0,448,13,-0.5958316004509581,-0.4766475518417454
34,1553853035,365,218,0,583,13,-0.5958316004509581,-0.11207293711859737
34,1553857399,106,105,0,211,13,-0.5958316004509581,-1.1166785421334942
34,1553860800,99,65,0,164,13,-0.5958316004509581,-1.2436045191111826
34,1553875200,504,420,0,924,13,-0.5958316004509581,0.808815534145058
34,1553889600,749,663,0,1412,13,-0.5958316004509581,2.126685252551697
34,1553904000,339,360,21,699,13,-0.1308413987476766,0.20119117627314465
34,1553918400,49,141,92,190,13,1.4412683308205607,-1.1733901488682061
34,1553932800,100,64,0,164,13,-0.5958316004509581,-1.2436045191111826
34,1553947200,307,235,0,542,13,-0.5958316004509581,-0.22279559788636824
34,1553961600,494,325,0,819,13,-0.5958316004509581,0.5252575004714984
34,1553976000,441,486,45,927,13,0.40057597462750216,0.8169171922500169
34,1553990400,274,326,52,600,13,0.555572708528596,-0.06616354119049724
34,1554004800,60,126,66,186,13,0.8655661763307836,-1.1841923596748178
34,1554019200,61,51,0,112,13,-0.5958316004509581,-1.384033259597136
34,1554033600,250,204,0,454,13,-0.5958316004509581,-0.4604442356318277
34,1554048000,348,317,0,665,13,-0.5958316004509581,0.10937238441694441
34,1554062400,287,328,41,615,13,0.3120064123983057,-0.02565525066570301
34,1554076800,188,234,46,422,13,0.42271836518480127,-0.5468619220847221
34,1554091200,29,52,23,81,13,-0.08655661763307838,-1.4677503933483775
34,1554105600,234,203,0,437,13,-0.5958316004509581,-0.5063536315599279
34,1554120000,529,396,0,925,13,-0.5958316004509581,0.811516086846711
34,1554134400,381,402,21,783,13,-0.1308413987476766,0.4280376032119923
34,1554148800,668,573,0,1241,13,-0.5958316004509581,1.6648907405690427
34,1554163200,185,255,70,440,14,1.6654046968226277,-0.5216516216121604
34,1554177600,18,25,7,43,14,-0.3532214267654039,-1.5902043413616886
34,1554192000,245,240,0,485,14,-0.5775132182751852,-0.40053103625012315
34,1554206400,537,424,0,961,14,-0.5775132182751852,0.8806556000238704
34,1554220800,455,402,0,857,14,-0.5775132182751852,0.6007324694093844
34,1554235200,645,634,0,1279,14,-0.5775132182751852,1.7365744032489334
34,1554249600,231,250,19,481,14,0.031278787251364,-0.41129731050452645
34,1554264000,16,35,19,51,14,0.031278787251364,-1.568671792852882
34,1554278400,260,196,0,456,14,-0.5775132182751852,-0.47858652459454715
34,1554292800,525,437,0,962,14,-0.5775132182751852,0.8833471685874713
34,1554307200,495,402,0,897,14,-0.5775132182751852,0.7083952119534175
34,1554321600,661,585,0,1246,14,-0.5775132182751852,1.6477526406501062
34,1554336000,248,263,15,511,14,-0.09688795075422531,-0.33055025359650164
34,1554350400,14,31,17,45,14,-0.03280458175143065,-1.584821204234487
34,1554364800,243,206,0,449,14,-0.5775132182751852,-0.49742750453975293
34,1554379200,491,449,0,940,14,-0.5775132182751852,0.824132660188253
34,1554393600,456,378,0,834,14,-0.5775132182751852,0.5388263924465654
34,1554408000,679,638,0,1317,14,-0.5775132182751852,1.8388540086657648
34,1554422400,253,317,64,570,14,1.4731545898142437,-0.17174770834405287
34,1554436800,26,41,15,67,14,-0.09688795075422531,-1.5256066958352688
34,1554451200,231,202,0,433,14,-0.5775132182751852,-0.5404926015573661
34,1554465600,514,442,0,956,14,-0.5775132182751852,0.8671977572058663
34,1554480000,458,415,0,873,14,-0.5775132182751852,0.6437975664269977
34,1554494400,678,606,0,1284,14,-0.5775132182751852,1.7500322460669375
34,1554508800,274,344,70,618,14,1.6654046968226277,-0.04255241729121319
34,1554523200,52,102,50,154,14,1.0245710067946812,-1.2914402308019968
34,1554537600,113,74,0,187,14,-0.5775132182751852,-1.2026184682031695
34,1554552000,362,225,0,587,14,-0.5775132182751852,-0.12599104276283882
34,1554566400,497,329,0,826,14,-0.5775132182751852,0.5172938439377588
34,1554580800,430,442,12,872,14,-0.19301300425841728,0.6411059978633968
34,1554595200,225,338,113,563,14,3.043197130382713,-0.19058868828925868
34,1554609600,58,161,103,219,14,2.7227802853687395,-1.1164882741679432
34,1554624000,72,54,0,126,14,-0.5775132182751852,-1.3668041505828201
34,1554638400,273,207,0,480,14,-0.5775132182751852,-0.4139888790681273
34,1554652800,394,309,0,703,14,-0.5775132182751852,0.1862309106148571
34,1554667200,319,401,82,720,14,2.0499049108393956,0.23198757619607116
34,1554681600,188,264,76,452,14,1.8576548038310117,-0.48935279884895044
34,1554696000,27,52,25,79,14,0.22352889425974795,-1.4933078730720588
34,1554710400,257,209,0,466,14,-0.5775132182751852,-0.4516708389585389
34,1554724800,522,507,0,1029,14,-0.5775132182751852,1.0636822623487268
34,1554739200,470,418,0,888,14,-0.5775132182751852,0.68417109488101
34,1554753600,649,565,0,1214,14,-0.5775132182751852,1.5616224466148796
34,1554768000,193,312,119,505,15,2.5307548878205037,-0.3680898554714707
34,1554782400,18,60,42,78,15,0.49532556496263025,-1.5060528735761693
34,1554796800,233,229,0,462,15,-0.6149086111416643,-0.4826856629152694
34,1554811200,537,475,0,1012,15,-0.6149086111416643,0.9830746648542488
34,1554825600,447,390,0,837,15,-0.6149086111416643,0.5166963787457657
34,1554840000,668,590,0,1258,15,-0.6149086111416643,1.6386692841838877
34,1554854400,223,329,106,552,15,2.1871109761691745,-0.24283397291662095
34,1554868800,22,58,36,80,15,0.33672068266201677,-1.5007228360206437
34,1554883200,234,220,0,454,15,-0.6149086111416643,-0.5040058131373715
34,1554897600,576,453,0,1029,15,-0.6149086111416643,1.0283799840762156
34,1554912000,448,436,0,884,15,-0.6149086111416643,0.6419522613006154
34,1554926400,632,617,0,1249,15,-0.6149086111416643,1.614684115184023
34,1554940800,230,326,96,556,15,1.922769505668152,-0.2321738978055699
34,1554955200,20,69,49,89,15,0.6803645943133461,-1.476737667020779
34,1554969600,215,212,0,427,15,-0.6149086111416643,-0.575961320136966
34,1554984000,572,440,0,1012,15,-0.6149086111416643,0.9830746648542488
34,1554998400,444,386,0,830,15,-0.6149086111416643,0.4980412473014264
34,1555012800,693,539,0,1232,15,-0.6149086111416643,1.569378795962056
34,1555027200,233,321,88,554,15,1.711296329267334,-0.23750393536109543
34,1555041600,36,67,31,103,15,0.2045499474115055,-1.4394274041321002
34,1555056000,248,196,0,444,15,-0.6149086111416643,-0.5306560009149991
34,1555070400,524,440,0,964,15,-0.6149086111416643,0.8551537635216363
34,1555084800,529,397,0,926,15,-0.6149086111416643,0.7538830499666513
34,1555099200,757,600,0,1357,15,-0.6149086111416643,1.902506143182401
34,1555113600,245,350,105,595,15,2.160676829119072,-0.12823816547282227
34,1555128000,53,94,41,147,15,0.46889141791252803,-1.322166577910539
34,1555142400,89,74,0,163,15,-0.6149086111416643,-1.2795262774663347
34,1555156800,330,219,0,549,15,-0.6149086111416643,-0.25082902924990924
34,1555171200,480,380,0,860,15,-0.6149086111416643,0.5779918106343092
34,1555185600,467,472,5,939,15,-0.4827378758911531,0.7885282940775672
34,1555200000,235,342,107,577,15,2.213545123219277,-0.17620850347255196
34,1555214400,70,103,33,173,15,0.25741824151171,-1.252876089688707
34,1555228800,53,56,3,109,15,-0.5356061699913576,-1.4234372914655238
34,1555243200,297,204,0,501,15,-0.6149086111416643,-0.3787499305825217
34,1555257600,390,355,0,745,15,-0.6149086111416643,0.27151465119159174
34,1555272000,375,372,0,747,15,-0.6149086111416643,0.27684468874711726
34,1555286400,167,257,90,424,15,1.7641646233675385,-0.5839563764702542
34,1555300800,20,46,26,66,15,0.07237921216099424,-1.5380330989093225
34,1555315200,215,192,0,407,15,-0.6149086111416643,-0.6292616956922212
34,1555329600,546,470,0,1016,15,-0.6149086111416643,0.9937347399652998
34,1555344000,489,382,0,871,15,-0.6149086111416643,0.6073070171896996
34,1555358400,678,550,0,1228,15,-0.6149086111416643,1.558718720851005
34,1555372800,326,287,0,613,16,-0.529284556817363,-0.044828338006482414
34,1555387200,31,50,19,81,16,0.043807812708085675,-1.4676186567804026
34,1555401600,312,232,0,544,16,-0.529284556817363,-0.2293631725843029
34,1555416000,622,469,0,1091,16,-0.529284556817363,1.2335434145761
34,1555430400,538,347,0,885,16,-0.529284556817363,0.6826133287350707
34,1555444800,704,606,0,1310,16,-0.529284556817363,1.8192409330187476
34,1555459200,290,313,23,603,16,0.16445883787133803,-0.07157251693080423
34,1555473600,45,55,10,100,16,-0.2276569939092321,-1.416804716824191
34,1555488000,303,225,0,528,16,-0.529284556817363,-0.2721538588632178
34,1555502400,662,530,0,1192,16,-0.529284556817363,1.5036596217117502
34,1555516800,581,415,0,996,16,-0.529284556817363,0.9794737147950429
34,1555531200,727,558,0,1285,16,-0.529284556817363,1.752380485707943
34,1555545600,307,365,58,672,16,1.220155308049796,0.11296231764701625
34,1555560000,38,70,32,108,16,0.4359236444886558,-1.3954093736847337
34,1555574400,293,212,0,505,16,-0.529284556817363,-0.33366547038915795
34,1555588800,593,440,0,1033,16,-0.529284556817363,1.0784271768150335
34,1555603200,526,400,0,926,16,-0.529284556817363,0.7922644623247902
34,1555617600,691,569,0,1260,16,-0.529284556817363,1.6855200383971385
34,1555632000,354,351,0,705,16,-0.529284556817363,0.20121810809727822
34,1555646400,49,104,55,153,16,1.1296670391773567,-1.2750605685252856
34,1555660800,188,161,0,349,16,-0.529284556817363,-0.7508746616085782
34,1555675200,541,396,0,937,16,-0.529284556817363,0.8216830591415442
34,1555689600,576,418,0,994,16,-0.529284556817363,0.9741248790101785
34,1555704000,683,512,0,1195,16,-0.529284556817363,1.5116828753890468
34,1555718400,319,363,44,682,16,0.7978767199784128,0.13970649657133807
34,1555732800,47,115,68,162,16,1.5217828709579269,-1.250990807493396
34,1555747200,102,51,0,153,16,-0.529284556817363,-1.2750605685252856
34,1555761600,281,163,0,444,16,-0.529284556817363,-0.496804961827521
34,1555776000,400,268,0,668,16,-0.529284556817363,0.10226464607728752
34,1555790400,360,332,0,692,16,-0.529284556817363,0.16645067549565987
34,1555804800,156,314,158,470,16,4.236430937131105,-0.4272700966242843
34,1555819200,29,107,78,136,16,1.8234104338660577,-1.3205256726966326
34,1555833600,52,47,0,99,16,-0.529284556817363,-1.4194791347166233
34,1555848000,220,144,0,364,16,-0.529284556817363,-0.7107583932220954
34,1555862400,288,237,0,525,16,-0.529284556817363,-0.2801771125405143
34,1555876800,212,263,51,475,16,1.0090160140141042,-0.4138980071621234
34,1555891200,134,221,87,355,16,2.0948752404833755,-0.7348281542539851
34,1555905600,16,70,54,86,16,1.0995042828865436,-1.4542465673182416
34,1555920000,188,187,0,375,16,-0.529284556817363,-0.6813397964053415
34,1555934400,453,394,0,847,16,-0.529284556817363,0.5809854488226479
34,1555948800,387,378,0,765,16,-0.529284556817363,0.36168318164320906
34,1555963200,563,524,0,1087,16,-0.529284556817363,1.2228457430063713
34,1555977600,200,321,121,521,17,2.6967519368448722,-0.32870059608249663
34,1555992000,29,67,38,96,17,0.38411300650262753,-1.4887056652941542
34,1556006400,204,181,0,385,17,-0.6746855399191231,-0.699902218230227
34,1556020800,516,445,0,961,17,-0.6746855399191231,0.8722458285131017
34,1556035200,541,355,0,896,17,-0.6746855399191231,0.6948332885160248
34,1556049600,712,568,0,1280,17,-0.6746855399191231,1.7429319863449106
34,1556064000,235,316,81,551,17,1.5822271511377664,-0.2468178853146149
34,1556078400,41,114,73,155,17,1.3593221939963451,-1.3276696674506534
34,1556092800,211,224,13,435,17,-0.31246498456431365,-0.5634310336170908
34,1556107200,500,424,0,924,17,-0.6746855399191231,0.771257151899381
34,1556121600,483,374,0,857,17,-0.6746855399191231,0.5883857645177785
34,1556136000,678,549,0,1227,17,-0.6746855399191231,1.5982725306549863
34,1556150400,280,375,95,655,17,1.9723108261352533,0.037042178680708346
34,1556164800,32,85,53,117,17,0.8020598011427923,-1.431387767756637
34,1556179200,189,183,0,372,17,-0.6746855399191231,-0.7353847262296425
34,1556193600,578,439,0,1017,17,-0.6746855399191231,1.0250935552798144
34,1556208000,531,394,0,925,17,-0.6746855399191231,0.7739865755916437
34,1556222400,685,595,0,1280,17,-0.6746855399191231,1.7429319863449106
34,1556236800,337,355,18,692,17,-0.17314938635092542,0.13803085529442913
34,1556251200,38,87,49,125,17,0.6906073225720817,-1.409552378218535
34,1556265600,191,169,0,360,17,-0.6746855399191231,-0.7681378105367951
34,1556280000,615,386,0,1001,17,-0.6746855399191231,0.9814227762036107
34,1556294400,505,375,0,880,17,-0.6746855399191231,0.6511625094398211
34,1556308800,759,523,0,1282,17,-0.6746855399191231,1.748390833729436
34,1556323200,338,388,50,726,17,0.7184704422147593,0.2308312608313617
34,1556337600,49,123,74,172,17,1.3871853136390229,-1.2812694646821872
34,1556352000,83,70,0,153,17,-0.6746855399191231,-1.3331285148351788
34,1556366400,295,220,0,515,17,-0.6746855399191231,-0.34507713823607294
34,1556380800,437,351,0,788,17,-0.6746855399191231,0.4000555297516506
34,1556395200,479,428,0,907,17,-0.6746855399191231,0.7248569491309147
34,1556409600,268,323,55,591,17,0.8577860404281475,-0.13764093762410595
34,1556424000,44,118,74,162,17,1.3871853136390229,-1.3085637016048144
34,1556438400,57,43,0,100,17,-0.6746855399191231,-1.4777879705251034
34,1556452800,255,208,0,463,17,-0.6746855399191231,-0.4870071702337346
34,1556467200,370,280,0,650,17,-0.6746855399191231,0.02339506021939473
34,1556481600,329,396,67,725,17,1.1921434761402794,0.228101837139099
34,1556496000,145,261,116,406,17,2.557436338631484,-0.6425843206927099
34,1556510400,23,63,40,86,17,0.43983924578798284,-1.5159999022167814
34,1556524800,253,239,0,492,17,-0.6746855399191231,-0.4078538831581156
34,1556539200,507,419,0,926,17,-0.6746855399191231,0.7767159992839064
34,1556553600,438,404,0,842,17,-0.6746855399191231,0.5474444091338376
34,1556568000,689,553,0,1242,17,-0.6746855399191231,1.6392138860389271
34,1556582400,207,320,113,527,18,2.2309449517364,-0.3174986041129739
34,1556596800,31,65,34,96,18,0.2768067917941151,-1.4560405477843401
34,1556611200,245,213,0,458,18,-0.564214694763324,-0.4997709802459768
34,1556625600,523,457,0,980,18,-0.564214694763324,0.8791591696297844
34,1556640000,471,400,0,871,18,-0.564214694763324,0.5912216479124319
34,1556654400,694,567,0,1261,18,-0.564214694763324,1.6214568173598398
34,1556668800,218,329,111,547,18,2.181473099585962,-0.2646660313207992
34,1556683200,33,74,41,107,18,0.44995827432064667,-1.426982632748644
34,1556697600,250,236,0,486,18,-0.564214694763324,-0.42580537833693216
34,1556712000,524,447,0,971,18,-0.564214694763324,0.8553845118733058
34,1556726400,504,396,0,900,18,-0.564214694763324,0.6678288784610854
34,1556740800,719,577,0,1296,18,-0.564214694763324,1.7139138197461457
34,1556755200,231,365,134,596,18,2.7503993993159948,-0.135226227979971
34,1556769600,25,61,36,86,18,0.3262786439445527,-1.4824568341804274
34,1556784000,271,223,0,494,18,-0.564214694763324,-0.4046723492200623
34,1556798400,598,422,0,1020,18,-0.564214694763324,0.9848243152141339
34,1556812800,524,358,0,882,18,-0.564214694763324,0.620279562948128
34,1556827200,716,612,0,1328,18,-0.564214694763324,1.7984459362136251
34,1556841600,267,414,147,681,18,3.071966438293839,0.08931220638677173
34,1556856000,40,82,42,122,18,0.47469420039586546,-1.3873582031545129
34,1556870400,251,213,0,464,18,-0.564214694763324,-0.4839212084083244
34,1556884800,511,362,0,873,18,-0.564214694763324,0.5965049051916494
34,1556899200,517,401,0,918,18,-0.564214694763324,0.7153781939740427
34,1556913600,747,661,0,1408,18,-0.564214694763324,2.009776227382324
34,1556928000,350,359,9,709,18,-0.3415913600863548,0.1632778082958164
34,1556942400,47,103,56,150,18,0.8209971654489285,-1.3133926012454682
34,1556956800,85,58,0,143,18,-0.564214694763324,-1.3318840017227294
34,1556971200,322,244,0,566,18,-0.564214694763324,-0.21447508716823313
34,1556985600,521,333,0,854,18,-0.564214694763324,0.5463139610390834
34,1557000000,437,400,0,837,18,-0.564214694763324,0.5014062741657349
34,1557014400,211,252,41,463,18,0.44995827432064667,-0.4865628370479331
34,1557028800,45,127,82,172,18,1.4641312434046172,-1.255276771174076
34,1557043200,55,36,0,91,18,-0.564214694763324,-1.4692486909823836
34,1557057600,239,172,0,411,18,-0.564214694763324,-0.6239275263075875
34,1557072000,353,332,0,685,18,-0.564214694763324,0.09987872094520668
34,1557086400,323,298,0,621,18,-0.564214694763324,-0.06918551198975255
34,1557100800,151,239,88,390,18,1.61254679985593,-0.679401727739371
34,1557115200,20,44,24,64,18,0.02944753104192712,-1.5405726642518196
34,1557129600,265,224,0,489,18,-0.564214694763324,-0.417880492418106
34,1557144000,585,462,0,1047,18,-0.564214694763324,1.0561482884835698
34,1557158400,485,417,0,902,18,-0.564214694763324,0.6731121357403028
34,1557172800,674,542,0,1216,18,-0.564214694763324,1.5025835285774465
34,1557187200,254,317,63,571,19,1.2473902452591408,-0.21291334351792435
34,1557201600,24,60,36,84,19,0.4273667448974796,-1.493021964421988
34,1557216000,243,234,0,477,19,-0.6659979222514021,-0.4599979643905773
34,1557230400,583,436,0,1019,19,-0.6659979222514021,0.9646814453219535
34,1557244800,520,360,0,880,19,-0.6659979222514021,0.5993116336060093
34,1557259200,751,618,0,1369,19,-0.6659979222514021,1.8846773741031082
34,1557273600,291,356,65,647,19,1.3081327267674119,-0.013142798982587923
34,1557288000,26,67,41,93,19,0.5792229486681576,-1.4693649262533297
34,1557302400,311,250,0,561,19,-0.6659979222514021,-0.2391989414831002
34,1557316800,584,433,0,1017,19,-0.6659979222514021,0.9594243257289183
34,1557331200,543,389,0,932,19,-0.6659979222514021,0.7359967430249237
34,1557345600,726,563,0,1289,19,-0.6659979222514021,1.6743925903817014
34,1557360000,226,366,140,592,19,3.5859757833275823,-0.15771358779105507
34,1557374400,27,76,49,103,19,0.8221928747012425,-1.443079328288154
34,1557388800,240,252,12,492,19,-0.3015430332017749,-0.42056956744281354
34,1557403200,566,421,0,987,19,-0.6659979222514021,0.8805675318333908
34,1557417600,514,429,0,943,19,-0.6659979222514021,0.764910900786617
34,1557432000,730,637,0,1367,19,-0.6659979222514021,1.8794202545100729
34,1557446400,261,373,112,634,19,2.7355810422117854,-0.04731407633731652
34,1557460800,36,88,52,124,19,0.9133065969636492,-1.3878795725612847
34,1557475200,242,262,20,504,19,-0.05857310716869005,-0.3890268498846025
34,1557489600,571,434,0,1005,19,-0.6659979222514021,0.9278816081707073
34,1557504000,504,406,0,910,19,-0.6659979222514021,0.6781684275015368
34,1557518400,715,548,0,1263,19,-0.6659979222514021,1.6060500356722442
34,1557532800,331,379,48,710,19,0.7918216339471068,0.1524564681980199
34,1557547200,45,112,67,157,19,1.3688752082756832,-1.3011370992762044
34,1557561600,78,74,0,152,19,-0.6659979222514021,-1.3142798982587922
34,1557576000,287,232,0,519,19,-0.6659979222514021,-0.3495984529368387
34,1557590400,424,363,0,787,19,-0.6659979222514021,0.35485557252987393
34,1557604800,469,470,1,939,19,-0.6356266814972665,0.7543966616005467
34,1557619200,271,317,46,588,19,0.7310791524388356,-0.1682278269771254
34,1557633600,40,89,49,129,19,0.8221928747012425,-1.3747367735786966
34,1557648000,56,46,0,102,19,-0.6659979222514021,-1.4457078880846714
34,1557662400,232,191,0,423,19,-0.6659979222514021,-0.6019401934025268
34,1557676800,282,290,8,572,19,-0.42302799621831727,-0.21028478372140677
34,1557691200,259,294,35,553,19,0.396995504143344,-0.2602274198552409
34,1557705600,147,210,63,357,19,1.2473902452591408,-0.7754251399726875
34,1557720000,26,40,14,66,19,-0.24080055169350367,-1.5403360407593045
34,1557734400,247,212,0,459,19,-0.6659979222514021,-0.5073120407278938
34,1557748800,565,435,0,1000,19,-0.6659979222514021,0.9147388091881195
34,1557763200,444,368,0,812,19,-0.6659979222514021,0.42056956744281354
34,1557777600,625,571,0,1196,19,-0.6659979222514021,1.429936529305566
34,1557792000,177,325,148,502,20,2.116053293865184,-0.35187268218569145
34,1557806400,37,42,5,79,20,-0.5533472696622883,-1.50377429849507
34,1557820800,235,244,9,479,20,-0.4786787224307506,-0.41450563059022033
34,1557835200,459,499,40,958,20,0.10000251861366649,0.8898935992258371
34,1557849600,273,523,250,796,20,4.020101248269395,0.448739788724373
34,1557864000,686,548,0,1234,20,-0.6466829537017104,1.6414889800801833
34,1557878400,219,343,124,562,20,1.6680420104759581,-0.188482381999964
34,1557892800,27,68,41,95,20,0.1186696554215509,-1.4602035517788758
34,1557907200,221,233,12,454,20,-0.4226773120070973,-0.4825849223342734
34,1557921600,472,392,0,864,20,-0.6466829537017104,0.6339154622681974
34,1557936000,375,331,0,706,20,-0.6466829537017104,0.20365433844578182
34,1557950400,812,561,0,1373,20,-0.6466829537017104,2.0200098421771187
34,1557964800,234,351,117,585,20,1.537372052820767,-0.12584943359543516
34,1557979200,27,77,50,104,20,0.2866738866925107,-1.4356950067510168
34,1557993600,262,244,0,506,20,-0.6466829537017104,-0.340979995506643
34,1558008000,514,385,0,899,20,-0.6466829537017104,0.7292264707098718
34,1558022400,432,394,0,826,20,-0.6466829537017104,0.5304349388172367
34,1558036800,744,599,0,1343,20,-0.6466829537017104,1.9383146920842549
34,1558051200,296,357,61,653,20,0.4920123915792393,0.05932623994838926
34,1558065600,34,95,61,129,20,0.4920123915792393,-1.3676157150069637
34,1558080000,243,229,0,472,20,-0.6466829537017104,-0.43356783227855517
34,1558094400,529,378,0,907,20,-0.6466829537017104,0.7510118440679687
34,1558108800,349,392,43,741,20,0.15600392903731974,0.2989653468874562
34,1558123200,619,632,13,1251,20,-0.4040101751992129,1.6877828984661394
34,1558137600,282,358,76,640,20,0.7720194436975056,0.02392500824148165
34,1558152000,26,141,115,167,20,1.5000377792049981,-1.264135191556003
34,1558166400,88,47,0,135,20,-0.6466829537017104,-1.351276684988391
34,1558180800,339,168,0,507,20,-0.6466829537017104,-0.3382568238368808
34,1558195200,461,260,0,721,20,-0.6466829537017104,0.2445019134922137
34,1558209600,428,402,0,830,20,-0.6466829537017104,0.5413276254962852
34,1558224000,252,340,88,592,20,0.9960250853921188,-0.1067872319071003
34,1558238400,38,116,78,154,20,0.8093537173132745,-1.2995364232629105
34,1558252800,68,37,0,105,20,-0.6466829537017104,-1.4329718350812546
34,1558267200,317,155,0,472,20,-0.6466829537017104,-0.43356783227855517
34,1558281600,465,242,0,707,20,-0.6466829537017104,0.20637751011554395
34,1558296000,348,338,0,686,20,-0.6466829537017104,0.14919090505053936
34,1558310400,167,256,89,423,20,1.0146922222000032,-0.5670032440968993
34,1558324800,23,58,35,81,20,0.006666834574244379,-1.4983279551555457
34,1558339200,238,214,0,452,20,-0.6466829537017104,-0.4880312656737977
34,1558353600,600,384,0,984,20,-0.6466829537017104,0.9606960626396522
34,1558368000,594,374,0,968,20,-0.6466829537017104,0.9171253159234583
34,1558382400,804,565,0,1369,20,-0.6466829537017104,2.00911715549807
34,1558396800,257,354,97,611,21,1.5473531934489522,0.04010016377710247
34,1558411200,32,63,31,95,21,0.05548278382884686,-1.2605200053590921
34,1558425600,239,247,8,486,21,-0.46441144982664434,-0.2749725516144175
34,1558440000,643,420,0,1063,21,-0.6452442267502935,1.1794031026328387
34,1558454400,634,682,48,1316,21,0.43975243479160125,1.817110278585275
34,1558468800,799,644,0,1443,21,-0.6452442267502935,2.1372241574230597
34,1558483200,261,398,137,659,21,2.4515170780671975,0.16108808648744613
34,1558497600,35,88,53,123,21,0.5527729203688819,-1.1899437171113916
34,1558512000,279,241,0,520,21,-0.6452442267502935,-0.18927277302792408
34,1558526400,647,451,0,1098,21,-0.6452442267502935,1.2676234629424643
34,1558540800,596,443,0,1039,21,-0.6452442267502935,1.1189091412776668
34,1558555200,787,607,0,1394,21,-0.6452442267502935,2.0137156529895837
34,1558569600,214,411,197,625,21,3.807762904994566,0.0753883079009527
34,1558584000,36,93,57,129,21,0.6431893088307065,-1.1748202267725987
34,1558598400,237,221,0,458,21,-0.6452442267502935,-0.345548839862118
34,1558598930,35,19,0,54,21,-0.6452442267502935,-1.3638638560075107
34,1558599699,44,22,0,66,21,-0.6452442267502935,-1.3336168753299247
34,1558612800,479,370,0,849,21,-0.6452442267502935,0.6399986138825565
34,1558627200,575,367,0,942,21,-0.6452442267502935,0.8744127141338474
34,1558641600,671,570,0,1241,21,-0.6452442267502935,1.6280666493503633
34,1558656000,215,328,113,543,21,1.9090187472962503,-0.1312993933958844
34,1558670400,34,87,53,121,21,0.5527729203688819,-1.194984880557656
34,1558684800,241,238,0,479,21,-0.6452442267502935,-0.2926166236763426
34,1558699200,572,394,0,966,21,-0.6452442267502935,0.9349066754890192
34,1558713600,588,426,0,1014,21,-0.6452442267502935,1.0558945981993628
34,1558728000,650,588,0,1238,21,-0.6452442267502935,1.6205049041809667
34,1558742400,292,337,45,629,21,0.3719401434452328,0.08547063479348134
34,1558756800,43,113,70,156,21,0.9370425713316363,-1.1067645202480303
34,1558771200,80,59,0,139,21,-0.6452442267502935,-1.149614409541277
34,1558785600,262,189,0,451,21,-0.6452442267502935,-0.3631929119240431
34,1558800000,385,282,0,667,21,-0.6452442267502935,0.18125274027250343
34,1558814400,351,361,10,712,21,-0.41920325559573207,0.2946789178134506
34,1558828800,185,284,99,469,21,1.5925613876798643,-0.31782244090766426
34,1558843200,29,111,82,140,21,1.20829173671711,-1.1470938278181448
34,1558857600,59,43,0,102,21,-0.6452442267502935,-1.2428759332971668
34,1558872000,277,184,0,461,21,-0.6452442267502935,-0.33798709469272153
34,1558886400,381,320,0,701,21,-0.6452442267502935,0.26695251885899685
34,1558900800,339,364,25,703,21,-0.08014179886388997,0.27199368230526116
34,1558915200,192,227,35,419,21,0.14589917229067143,-0.4438515270642722
34,1558929600,25,71,46,96,21,0.39454424056068893,-1.25799942363596
34,1558944000,68,50,0,118,21,-0.6452442267502935,-1.2025466257270523
34,1558958400,218,164,0,382,21,-0.6452442267502935,-0.5371130508201621
34,1558972800,324,285,0,609,21,-0.6452442267502935,0.03505900033083815
34,1558987200,304,354,50,658,21,0.4849606290225135,0.15856750476431397
34,1559001600,165,258,93,423,22,2.233606302951498,-0.13967921639670824
34,1559016000,30,44,14,74,22,-0.04084232148682298,-0.9016443201645747
34,1559030400,223,223,0,446,22,-0.44390916632399385,-0.0894637511054162
34,1559044800,560,409,0,969,22,-0.44390916632399385,1.0523922639965728
34,1559059200,435,437,2,872,22,-0.3863281884901123,0.8406139973332976
34,1559073600,727,547,0,1274,22,-0.44390916632399385,1.7182929993810978
34,1559088000,181,316,135,497,22,3.4428068374630105,0.02188358497527489
34,1559102400,30,56,26,86,22,0.30464354551646633,-0.875444946969118
34,1559116800,268,238,0,506,22,-0.44390916632399385,0.041533114871867435
34,1559131200,579,436,0,1015,22,-0.44390916632399385,1.152823194579157
34,1559145600,491,340,0,831,22,-0.44390916632399385,0.7510994722488205
34,1559160000,690,610,0,1300,22,-0.44390916632399385,1.775058307971254
34,1559174400,175,310,135,485,22,3.4428068374630105,-0.004315788220181836
34,1559188800,32,66,34,98,22,0.5349674568519925,-0.8492455737736613
34,1559203200,238,222,0,460,22,-0.44390916632399385,-0.05889781571071668
34,1559203675,34,26,0,60,22,-0.44390916632399385,-0.9322102555592742
34,1559217600,612,348,0,960,22,-0.44390916632399385,1.0327427340999802
34,1559232000,474,320,0,794,22,-0.44390916632399385,0.6703180715628289
34,1559246400,690,612,0,1302,22,-0.44390916632399385,1.7794248701704969
34,1559260800,232,318,86,550,22,2.0320728805329127,0.13759748325520876
34,1559275200,35,65,30,100,22,0.41980550118422943,-0.8448790115744185
34,1559289600,257,242,0,499,22,-0.44390916632399385,0.026250147174517676
34,1559304000,589,409,0,998,22,-0.44390916632399385,1.1157074158855933
34,1559318400,489,420,0,909,22,-0.44390916632399385,0.9213953980192892
34,1559332800,669,594,0,1263,22,-0.44390916632399385,1.6942769072852626
34,1559347200,236,314,78,550,22,1.8017489691973865,0.13759748325520876
34,1559361600,0,3,3,3,22,-0.3575376995731715,-1.0566572782376937
34,1559376000,0,0,0,0,22,-0.44390916632399385,-1.063207121536558
34,1559390400,0,1,1,1,22,-0.41511867740705305,-1.0610238404369365
34,1559404800,0,1,1,1,22,-0.41511867740705305,-1.0610238404369365
34,1559419200,0,0,0,0,22,-0.44390916632399385,-1.063207121536558
34,1559433600,0,0,0,0,22,-0.44390916632399385,-1.063207121536558
34,1559448000,0,0,0,0,22,-0.44390916632399385,-1.063207121536558
34,1559462400,0,0,0,0,22,-0.44390916632399385,-1.063207121536558
34,1559476800,0,0,0,0,22,-0.44390916632399385,-1.063207121536558
34,1559491200,0,0,0,0,22,-0.44390916632399385,-1.063207121536558
34,1559505600,0,0,0,0,22,-0.44390916632399385,-1.063207121536558
34,1559520000,0,1,1,1,22,-0.41511867740705305,-1.0610238404369365
34,1559534400,0,0,0,0,22,-0.44390916632399385,-1.063207121536558
34,1559548800,232,256,24,488,22,0.24706256768258478,0.002234055078682345
34,1559563200,593,405,0,998,22,-0.44390916632399385,1.1157074158855933
34,1559577600,468,365,0,833,22,-0.44390916632399385,0.7554660344480633
34,1559592000,712,582,0,1294,22,-0.44390916632399385,1.7619586213735259
34,1559606400,210,295,85,505,23,1.261725652472158,-0.3561636186206385
34,1559620800,36,70,34,106,23,0.08182031288392794,-1.5582433869340333
34,1559635200,215,222,7,437,23,-0.5428354551333704,-0.5610293435462296
34,1559649600,547,382,0,929,23,-0.7047832468415589,0.9212344309154
34,1559664000,448,345,0,793,23,-0.7047832468415589,0.5115029810642179
34,1559678400,714,588,0,1302,23,-0.7047832468415589,2.044983186757245
34,1559692800,217,331,114,548,23,1.9326522181203674,-0.22661617491769123
34,1559707200,31,70,39,101,23,0.1974973069612054,-1.573307043178562
34,1559721600,249,238,0,487,23,-0.7047832468415589,-0.4103927811009421
34,1559736000,508,401,0,909,23,-0.7047832468415589,0.860979805937285
34,1559750400,336,314,0,650,23,-0.7047832468415589,0.0806824124706954
34,1559764800,665,590,0,1255,23,-0.7047832468415589,1.9033848180586748
34,1559779200,174,349,175,523,23,3.3439115458631528,-0.301934456140335
34,1559793600,31,89,58,120,23,0.6370698844548598,-1.5160651494493527
34,1559808000,249,237,0,486,23,-0.7047832468415589,-0.4134055123498478
34,1559822400,450,374,0,824,23,-0.7047832468415589,0.6048976497802961
34,1559836800,399,308,0,707,23,-0.7047832468415589,0.25240809365832323
34,1559851200,578,613,35,1191,23,0.10495571169938343,1.710570018128707
34,1559865600,221,332,111,553,23,1.863246021674001,-0.21155251867316247
34,1559880000,30,75,45,105,23,0.3363096998539384,-1.561256118182939
34,1559894400,231,249,18,480,23,-0.28834606816335995,-0.4314818998432823
34,1559908800,475,352,0,827,23,-0.7047832468415589,0.6139358435270134
34,1559923200,342,386,44,728,23,0.31317430103848287,0.315675449885344
34,1559937600,684,595,0,1279,23,-0.7047832468415589,1.975690368032413
34,1559952000,303,352,49,655,23,0.42885129511576037,0.09574606871522416
34,1559980800,130,206,76,336,23,1.0535070631330585,-0.8653151996857105
34,1559995200,341,252,0,593,23,-0.7047832468415589,-0.09104326871693241
34,1560009600,384,330,0,714,23,-0.7047832468415589,0.2734972124006635
34,1560024000,409,381,0,790,23,-0.7047832468415589,0.5024647873175005
34,1560038400,240,306,66,546,23,0.8221530749785037,-0.23264163741550273
34,1560052800,41,164,123,205,23,2.140870807459467,-1.2599829932923639
34,1560067200,60,48,0,108,23,-0.7047832468415589,-1.5522179244362218
34,1560081600,275,189,0,464,23,-0.7047832468415589,-0.4796855998257743
34,1560096000,379,310,0,689,23,-0.7047832468415589,0.19817893117801968
34,1560110400,358,367,9,725,23,-0.49656465750245943,0.30663725613862675
34,1560124800,179,279,100,458,23,1.6087566347039906,-0.49776198731920884
34,1560139200,18,61,43,79,23,0.29003890222302736,-1.6395871306544885
34,1560153600,213,230,17,443,23,-0.31148146697881546,-0.5429529560527951
34,1560168000,538,375,0,913,23,-0.7047832468415589,0.873030730932908
34,1560182400,441,343,0,784,23,-0.7047832468415589,0.48438839982406606
34,1560196800,602,603,1,1205,23,-0.6816478480261033,1.7527482556133873
34,1560211200,130,151,21,281,24,0.45512716017067406,-0.8452450051394319
34,1560225600,0,0,0,0,24,-0.5168393174819518,-1.4884055957588982
34,1560240000,228,194,0,422,24,-0.5168393174819518,-0.5225202959673866
34,1560254400,637,391,0,1028,24,-0.5168393174819518,0.8645093051550211
34,1560268800,516,379,0,895,24,-0.5168393174819518,0.5600952177799712
34,1560283200,645,579,0,1224,24,-0.5168393174819518,1.3131195391814103
34,1560297600,112,172,60,284,24,2.260207761525551,-0.8383785219655586
34,1560312000,1,0,0,1,24,-0.5168393174819518,-1.4861167680342737
34,1560326400,244,268,24,512,24,0.5939795141210492,-0.3165258007511874
34,1560340800,617,465,0,1082,24,-0.5168393174819518,0.9881060022847405
34,1560355200,511,406,0,917,24,-0.5168393174819518,0.6104494277217087
34,1560369600,679,586,0,1265,24,-0.5168393174819518,1.4069614758910123
34,1560384000,135,190,55,325,24,2.028787171608259,-0.7445365852559568
34,1560398400,0,0,0,0,24,-0.5168393174819518,-1.4884055957588982
34,1560412800,220,255,35,475,24,1.1031048119390914,-0.4012124265622915
34,1560427200,477,431,0,908,24,-0.5168393174819518,0.5898499782000889
34,1560441600,416,380,0,796,24,-0.5168393174819518,0.33350127304215216
34,1560456000,724,587,0,1311,24,-0.5168393174819518,1.512247551223736
34,1560470400,106,179,73,285,24,2.8619012953105094,-0.8360896942409342
34,1560484800,0,0,0,0,24,-0.5168393174819518,-1.4884055957588982
34,1560499200,253,204,0,457,24,-0.5168393174819518,-0.4424113256055313
34,1560513600,553,414,0,967,24,-0.5168393174819518,0.7248908139529305
34,1560528000,503,395,0,898,24,-0.5168393174819518,0.5669617009538445
34,1560542400,690,584,0,1274,24,-0.5168393174819518,1.427560925412632
34,1561161600,7378,8466,1088,15844,25,4.122783729090383,4.1037262086965764
34,1561176000,6,11,5,17,25,-0.23565152117468893,-0.2896798712679969
34,1561190400,0,5,5,5,25,-0.23565152117468893,-0.29301094304152153
34,1561204800,0,8,8,8,25,-0.22357829333461948,-0.29217817509814037
34,1561219200,0,11,11,11,25,-0.21150506549455003,-0.2913454071547592
34,1561233600,0,8,8,8,25,-0.22357829333461948,-0.29217817509814037
34,1561248000,0,3,3,3,25,-0.24370033973473523,-0.2935661216704423
34,1561262400,0,2,2,2,25,-0.24772474901475838,-0.2938437109849027
34,1561276800,0,3,3,3,25,-0.24370033973473523,-0.2935661216704423
34,1561291200,0,2,2,2,25,-0.24772474901475838,-0.2938437109849027
34,1561305600,1,5,4,6,25,-0.23967593045471208,-0.29273335372706116
34,1561320000,0,4,4,4,25,-0.23967593045471208,-0.2932885323559819
34,1561334400,0,1,1,1,25,-0.2517491582947815,-0.29412130029936306
34,1561348800,1,0,0,1,25,-0.2557735675748047,-0.29412130029936306
34,1561363200,217,205,0,422,25,-0.2557735675748047,-0.1772561989115394
34,1561377600,465,348,0,813,25,-0.2557735675748047,-0.06871877695752739
34,1561392000,400,359,0,759,25,-0.2557735675748047,-0.08370859993838838
34,1561406400,658,523,0,1181,25,-0.2557735675748047,0.03343409076389569
34,1561420800,91,158,67,249,26,1.9339986164062284,-0.8913289960483192
34,1561435200,0,0,0,0,26,-0.656326041645712,-1.6014317339681274
34,1561449600,208,210,2,418,26,-0.5790029175247585,-0.4093717160947144
34,1561464000,540,356,0,896,26,-0.656326041645712,0.9537973952533512
34,1561478400,465,334,0,799,26,-0.656326041645712,0.6771710274693294
34,1561492800,691,512,0,1203,26,-0.656326041645712,1.8293055901986568
34,1561507200,117,195,78,312,26,2.3592757990714723,-0.711664447899934
34,1561521600,0,1,1,1,26,-0.6176644795852352,-1.5985799157435499
34,1561536000,257,226,0,483,26,-0.656326041645712,-0.2240035314971741
34,1561550400,558,396,0,954,26,-0.656326041645712,1.1192028522788486
34,1561564800,415,369,0,784,26,-0.656326041645712,0.6343937541006663
34,1561579200,605,601,0,1206,26,-0.656326041645712,1.8378610448723895
34,1561593600,112,179,67,291,26,1.9339986164062284,-0.7715526306160624
34,1561608000,0,0,0,0,26,-0.656326041645712,-1.6014317339681274
34,1561622400,191,226,35,417,26,0.6968286304709733,-0.412223534319292
34,1561636800,428,337,0,765,26,-0.656326041645712,0.580209207833693
34,1561651200,328,351,23,679,26,0.2328898857452527,0.33495284052002433
34,1561665600,546,599,53,1145,26,1.3927367475595545,1.6639001331731593
34,1561680000,117,178,61,295,26,1.7020292440433682,-0.7601453577177522
34,1561694400,0,1,1,1,26,-0.6176644795852352,-1.5985799157435499
34,1561708800,171,183,12,354,26,-0.19238729691999124,-0.5918880824676772
34,1561723200,442,377,0,819,26,-0.656326041645712,0.7342073919608804
34,1561737600,389,343,0,732,26,-0.656326041645712,0.4860992064226341
34,1561752000,639,519,0,1158,26,-0.656326041645712,1.7009737700926675
34,1561766400,317,318,1,635,26,-0.6176644795852352,0.2094728386386124
34,1561780800,58,103,45,161,26,1.0834442510757405,-1.142288999811143
34,1561795200,96,70,0,166,26,-0.656326041645712,-1.1280299086882553
34,1561809600,307,233,0,540,26,-0.656326041645712,-0.06144989269625417
34,1561824000,431,337,0,768,26,-0.656326041645712,0.5887646625074257
34,1561838400,376,386,10,762,26,-0.26971042104094467,0.5716537531599604
34,1561852800,271,296,25,567,26,0.31021300986620615,0.015549199367339492
34,1561867200,64,113,49,177,26,1.2380904993176476,-1.0966599082179023
34,1561881600,56,55,0,111,26,-0.656326041645712,-1.2848799110400202
34,1561896000,324,166,0,490,26,-0.656326041645712,-0.20404080392513133
34,1561910400,429,309,0,738,26,-0.656326041645712,0.5032101157700993
34,1561924800,316,391,75,707,26,2.2432911128900423,0.41480375080819554
34,1561939200,229,290,61,519,26,1.7020292440433682,-0.12133807541238258
34,1561953600,45,92,47,137,26,1.160767375196694,-1.210732637201004
34,1561968000,203,194,0,397,26,-0.656326041645712,-0.46925989881084285
34,1561982400,506,390,0,896,26,-0.656326041645712,0.9537973952533512
34,1561996800,445,303,0,748,26,-0.656326041645712,0.5317282980158747
34,1562011200,570,535,0,1105,26,-0.656326041645712,1.5498274041900577
34,1562025600,186,358,172,544,27,4.037201499759186,0.4059152082996489
34,1562040000,35,60,25,95,27,0.19598065532811582,-0.7716561360715499
34,1562054400,196,211,15,407,27,-0.06532688510937194,0.04661170233338107
34,1562068800,524,380,0,904,27,-0.45728819576560353,1.3500704064591846
34,1562083200,423,358,0,781,27,-0.45728819576560353,1.02748404708801
34,1562097600,597,557,0,1154,27,-0.45728819576560353,2.005733738514418
34,1562112000,184,331,147,515,27,3.3839326486654664,0.32985826178124183
34,1562126400,44,76,32,120,27,0.37889593363435725,-0.7060898028660266
34,1562140800,197,212,15,409,27,-0.06532688510937194,0.051857008989822935
34,1562155200,519,402,0,921,27,-0.45728819576560353,1.3946555130389404
34,1562169600,508,365,0,873,27,-0.45728819576560353,1.2687681532843358
34,1562184000,617,522,0,1139,27,-0.45728819576560353,1.9663939385911038
34,1562198400,210,291,81,501,27,1.6593028817780473,0.29314111518614877
34,1562212800,37,105,68,142,27,1.3196030792093132,-0.6483914296451662
34,1562227200,75,57,0,132,27,-0.45728819576560353,-0.6746179629273754
34,1562241600,212,156,0,368,27,-0.45728819576560353,-0.05567177746723531
34,1562256000,359,247,0,606,27,-0.45728819576560353,0.5685197146493467
34,1562270400,339,282,0,621,27,-0.45728819576560353,0.6078595145726606
34,1562284800,207,268,61,475,27,1.1366878009030716,0.2249521286524045
34,1562299200,36,117,81,153,27,1.6593028817780473,-0.6195422430347358
34,1562313600,135,129,0,264,27,-0.45728819576560353,-0.32842772360221234
34,1562328000,347,278,0,625,27,-0.45728819576560353,0.6183501278855444
34,1562342400,403,304,0,707,27,-0.45728819576560353,0.8334077007996609
34,1562356800,499,375,0,874,27,-0.45728819576560353,1.2713908066125568
34,1562371200,188,243,55,431,27,0.9799032766405791,0.10955538221068345
34,1562385600,0,1,1,1,27,-0.4311574417218548,-1.0181855489243177
34,1562400000,0,1,1,1,27,-0.4311574417218548,-1.0181855489243177
34,1562414400,0,0,0,0,27,-0.45728819576560353,-1.0208082022525387
34,1562428800,0,1,1,1,27,-0.4311574417218548,-1.0181855489243177
34,1562443200,0,1,1,1,27,-0.4311574417218548,-1.0181855489243177
34,1562457600,0,0,0,0,27,-0.45728819576560353,-1.0208082022525387
34,1562472000,0,0,0,0,27,-0.45728819576560353,-1.0208082022525387
34,1562486400,0,0,0,0,27,-0.45728819576560353,-1.0208082022525387
34,1562500800,0,2,2,2,27,-0.405026687678106,-1.0155628955960967
34,1562515200,0,0,0,0,27,-0.45728819576560353,-1.0208082022525387
34,1562529600,0,0,0,0,27,-0.45728819576560353,-1.0208082022525387
34,1562544000,0,1,1,1,27,-0.4311574417218548,-1.0181855489243177
34,1562558400,0,0,0,0,27,-0.45728819576560353,-1.0208082022525387
34,1562572524,183,194,11,377,27,-0.16984990128436703,-0.032067897513246915
34,1562572618,6,3,0,9,27,-0.45728819576560353,-0.9972043222985502
34,1562572800,15,9,0,24,27,-0.45728819576560353,-0.9578645223752362
34,1562587200,584,386,0,970,27,-0.45728819576560353,1.5231655261217663
34,1562601600,426,336,0,762,27,-0.45728819576560353,0.9776536338518123
34,1562616000,661,555,0,1216,27,-0.45728819576560353,2.1683382448641155
34,1562630400,172,263,91,435,28,1.6541301884450468,-0.08034977895854238
34,1562644800,28,56,28,84,28,0.23951206348525567,-0.8705542095168022
34,1562659200,208,210,2,418,28,-0.34429859126005496,-0.11862178841578004
34,1562673600,569,407,0,976,28,-0.3892071031635404,1.137600639651197
34,1562688000,460,331,0,791,28,-0.3892071031635404,0.7211111249694931
34,1562702400,624,547,0,1171,28,-0.3892071031635404,1.5766031010724526
34,1562716800,190,293,103,483,28,1.9235812598659594,0.027712365391305102
34,1562731200,2,2,0,4,28,-0.3892071031635404,-1.0506577834332147
34,1562745600,192,169,0,361,28,-0.3892071031635404,-0.24694558483122392
34,1562760000,621,466,0,1087,28,-0.3892071031635404,1.3874943484602194
34,1562774400,388,288,0,676,28,-0.3892071031635404,0.46221223746465023
34,1562788800,698,584,0,1282,28,-0.3892071031635404,1.826496809881475
34,1562803200,226,285,59,511,28,0.93559399798928,0.09074861626204947
34,1562817600,2,10,8,12,28,-0.20957305554959865,-1.0326474260415734
34,1562832000,231,212,0,443,28,-0.3892071031635404,-0.062339421566901136
34,1562846400,603,410,0,1013,28,-0.3892071031635404,1.2208985425875378
34,1562860800,430,289,0,719,28,-0.3892071031635404,0.5590179084447219
34,1562875200,658,554,0,1212,28,-0.3892071031635404,1.6689061827046139
34,1562889600,194,441,247,635,28,5.15699411691691,0.3699091558324888
34,1562904000,2,4,2,6,28,-0.34429859126005496,-1.0461551940853042
34,1562918400,202,255,53,457,28,0.8008684622788237,-0.030821296131528952
34,1562932800,599,341,0,940,28,-0.3892071031635404,1.0565540313888113
34,1562947200,475,312,0,787,28,-0.3892071031635404,0.7121059462736725
34,1562961600,695,491,0,1186,28,-0.3892071031635404,1.6103725211817799
34,1562976000,253,346,93,599,28,1.6990387003485323,0.2888625475701032
34,1562990400,3,9,6,12,28,-0.2544815674530841,-1.0326474260415734
34,1563004800,0,5,5,5,28,-0.2769358234048268,-1.0484064887592595
34,1563019200,0,1,1,1,28,-0.3667528472117977,-1.05741166745508
34,1563033600,0,3,3,3,28,-0.32184433530831225,-1.0529090781071697
34,1563048000,0,1,1,1,28,-0.3667528472117977,-1.05741166745508
34,1563062400,0,2,2,2,28,-0.34429859126005496,-1.055160372781125
34,1563076800,0,1,1,1,28,-0.3667528472117977,-1.05741166745508
34,1563091200,0,1,1,1,28,-0.3667528472117977,-1.05741166745508
34,1563105600,0,2,2,2,28,-0.34429859126005496,-1.055160372781125
34,1563120000,0,2,2,2,28,-0.34429859126005496,-1.055160372781125
34,1563134400,0,1,1,1,28,-0.3667528472117977,-1.05741166745508
34,1563148800,0,3,3,3,28,-0.32184433530831225,-1.0529090781071697
34,1563163200,0,3,3,3,28,-0.32184433530831225,-1.0529090781071697
34,1563177600,210,221,11,431,28,-0.1422102876943705,-0.08935495765436301
34,1563192000,625,424,0,1049,28,-0.3892071031635404,1.3019451508499236
34,1563206400,455,353,0,808,28,-0.3892071031635404,0.7593831344267308
34,1563220800,590,566,0,1156,28,-0.3892071031635404,1.5428336809631251
34,1563235200,183,289,106,472,29,1.933762796572575,0.0345785670555782
34,1563249600,6,4,0,10,29,-0.4242069270169907,-1.019007035898587
34,1563264000,206,205,0,411,29,-0.4242069270169907,-0.10453122034746092
34,1563274327,557,367,0,924,29,-0.4242069270169907,1.0653592868289172
34,1563278400,96,86,0,182,29,-0.4242069270169907,-0.6267630451883782
34,1563292800,455,382,0,837,29,-0.4242069270169907,0.8669568031557303
34,1563307200,675,559,0,1234,29,-0.4242069270169907,1.7723106654345258
34,1563321600,193,330,137,523,29,2.623357715735561,0.15088347127779123
34,1563336000,0,0,0,0,29,-0.4242069270169907,-1.041811919079413
34,1563350400,210,216,6,426,29,-0.2907369426628644,-0.07032389557622179
34,1563364800,570,443,0,1013,29,-0.4242069270169907,1.2683227471382692
34,1563379200,546,364,0,910,29,-0.4242069270169907,1.0334324503757606
34,1563393600,650,571,0,1221,29,-0.4242069270169907,1.7426643172994518
34,1563408000,183,372,189,555,29,3.78009758013799,0.2238590974564347
34,1563422400,0,0,0,0,29,-0.4242069270169907,-1.041811919079413
34,1563436800,198,198,0,396,29,-0.4242069270169907,-0.13873854511870004
34,1563451200,529,473,0,1002,29,-0.4242069270169907,1.2432373756393604
34,1563465600,442,304,0,746,29,-0.4242069270169907,0.659432366210213
34,1563480000,643,576,0,1219,29,-0.4242069270169907,1.7381033406632866
34,1563494400,165,310,145,475,29,2.8013176948743963,0.041420032009826024
34,1563508800,0,4,4,4,29,-0.33522693744757315,-1.0326899658070825
34,1563523200,178,185,7,363,29,-0.26849194527050996,-0.21399465961542613
34,1563537600,592,395,0,987,29,-0.4242069270169907,1.2090300508681213
34,1563552000,494,336,0,830,29,-0.4242069270169907,0.850993384929152
34,1563566400,429,525,96,954,29,1.711312822649031,1.1337739363713955
34,1563580800,173,251,78,424,29,1.310902869586652,-0.074884872212387
34,1563595200,2,11,9,13,29,-0.22400195048580118,-1.0121655709443391
34,1563609600,0,5,5,5,29,-0.31298194005521873,-1.030409477489
34,1563624000,0,6,6,6,29,-0.2907369426628644,-1.0281289891709173
34,1563638400,0,11,11,11,29,-0.1795119557010924,-1.0167265475805043
34,1563652800,0,8,8,8,29,-0.24624694787815557,-1.0235680125347522
34,1563667200,0,7,7,7,29,-0.26849194527050996,-1.0258485008528346
34,1563681600,0,1,1,1,29,-0.40196192962463634,-1.0395314307613304
34,1563696000,0,0,0,0,29,-0.4242069270169907,-1.041811919079413
34,1563710400,0,1,1,1,29,-0.40196192962463634,-1.0395314307613304
34,1563724800,0,1,1,1,29,-0.40196192962463634,-1.0395314307613304
34,1563739200,0,1,1,1,29,-0.40196192962463634,-1.0395314307613304
34,1563753600,0,1,1,1,29,-0.40196192962463634,-1.0395314307613304
34,1563768000,0,1,1,1,29,-0.40196192962463634,-1.0395314307613304
34,1563782400,225,209,0,434,29,-0.4242069270169907,-0.05207998903156092
34,1563796800,661,399,0,1060,29,-0.4242069270169907,1.375505698088152
34,1563811200,492,332,0,824,29,-0.4242069270169907,0.8373104550206564
34,1563825600,628,524,0,1152,29,-0.4242069270169907,1.5853106233517518
34,1563840000,164,317,153,481,30,3.417903543955898,-0.024583113758246074
34,1563854400,20,57,37,77,30,0.4659400505765088,-0.9274538372429201
34,1563868800,187,217,30,404,30,0.2878043225277525,-0.1966649100659686
34,1563883200,575,559,0,1134,30,-0.47563451196691725,1.43475991207218
34,1563897600,471,318,0,789,30,-0.47563451196691725,0.663744071472644
34,1563912000,660,523,0,1183,30,-0.47563451196691725,1.5442665097225488
34,1563926400,253,341,88,594,30,1.7637860692174474,0.2279525093946454
34,1563940800,38,73,35,111,30,0.41504412827686415,-0.8514696674447049
34,1563955200,263,204,0,467,30,-0.47563451196691725,-0.055870713086922895
34,1563969600,611,423,0,1034,30,-0.47563451196691725,1.2112770597244884
34,1563984000,446,375,0,821,30,-0.47563451196691725,0.7352585842239053
34,1563998400,737,568,0,1305,30,-0.47563451196691725,1.8169155895867326
34,1564012800,233,389,156,622,30,3.494247427405365,0.29052770805199907
34,1564027200,39,70,31,109,30,0.31325228367757485,-0.8559393244916588
34,1564041600,216,215,0,431,30,-0.47563451196691725,-0.13632453993209187
34,1564056000,547,458,0,1005,30,-0.47563451196691725,1.1464670325436577
34,1564070400,474,340,0,814,30,-0.47563451196691725,0.7196147845595668
34,1564084800,570,594,24,1164,30,0.13511655562881855,1.5018047677764874
34,1564099200,242,364,122,606,30,2.6290167483114066,0.2547704516763684
34,1564113600,31,85,54,116,30,0.8985553901234883,-0.8402955248273203
34,1564128000,180,196,16,376,30,-0.06846713356976004,-0.2592401087233222
34,1564142400,579,402,0,981,30,-0.47563451196691725,1.0928311479802117
34,1564156800,547,371,0,918,30,-0.47563451196691725,0.9520369510011661
34,1564171200,678,530,0,1208,30,-0.47563451196691725,1.6001372228094717
34,1564185600,266,296,30,562,30,0.2878043225277525,0.1564379966433841
34,1564200000,7,14,7,21,30,-0.297498783918161,-1.0526042345576274
34,1564214400,0,1,1,1,30,-0.4501865508170949,-1.0973008050271655
34,1564228800,0,0,0,0,30,-0.47563451196691725,-1.0995356335506425
34,1564243200,0,0,0,0,30,-0.47563451196691725,-1.0995356335506425
34,1564257600,0,0,0,0,30,-0.47563451196691725,-1.0995356335506425
34,1564272000,0,0,0,0,30,-0.47563451196691725,-1.0995356335506425
34,1564286400,1,1,0,2,30,-0.47563451196691725,-1.0950659765036888
34,1564300800,0,0,0,0,30,-0.47563451196691725,-1.0995356335506425
34,1564315200,0,0,0,0,30,-0.47563451196691725,-1.0995356335506425
34,1564329600,0,0,0,0,30,-0.47563451196691725,-1.0995356335506425
34,1564344000,0,0,0,0,30,-0.47563451196691725,-1.0995356335506425
34,1564358400,0,0,0,0,30,-0.47563451196691725,-1.0995356335506425
34,1564372800,0,0,0,0,30,-0.47563451196691725,-1.0995356335506425
34,1564387200,191,192,1,383,30,-0.4501865508170949,-0.24359630905898383
34,1564401600,588,430,0,1018,30,-0.47563451196691725,1.1755198033488576
34,1564416000,434,325,0,759,30,-0.47563451196691725,0.5966992157683365
34,1564430400,643,525,0,1168,30,-0.47563451196691725,1.510744081870395
34,1564444800,191,279,88,470,31,1.1354403493087257,-0.5587724383383477
34,1564459200,23,96,73,119,31,0.8236489490408834,-1.486279634508247
34,1564473600,189,204,15,393,31,-0.38194446532810683,-0.7622426779539666
34,1564488000,557,441,0,998,31,-0.6937358655959491,0.8364520618830396
34,1564502400,486,309,0,795,31,-0.6937358655959491,0.3000305210782259
34,1564516800,685,543,0,1228,31,-0.6937358655959491,1.4442203100855378
34,1564531200,176,320,144,496,31,2.299461576975337,-0.49006820158502173
34,1564545600,27,83,56,110,31,0.4702853620706621,-1.5100618703074753
34,1564560000,186,209,23,395,31,-0.21565571851859092,-0.7569577366652492
34,1564574400,562,457,0,1019,31,-0.6937358655959491,0.891943945414572
34,1564588800,456,334,0,790,31,-0.6937358655959491,0.2868181678564325
34,1564603200,639,591,0,1230,31,-0.6937358655959491,1.449505251374255
34,1564617600,203,304,101,507,31,1.405659562874189,-0.4610010244970762
34,1564632000,32,78,46,110,31,0.26242442855876724,-1.5100618703074753
34,1564646400,200,211,11,411,31,-0.4650888387328648,-0.7146782063555102
34,1564660800,601,455,0,1056,31,-0.6937358655959491,0.9897153592558434
34,1564675200,476,318,0,794,31,-0.6937358655959491,0.29738805043386723
34,1564689600,684,562,0,1246,31,-0.6937358655959491,1.4917847816839942
34,1564704000,202,366,164,568,31,2.7151834439991265,-0.2998103151911962
34,1564718400,30,102,72,132,31,0.802862855689694,-1.451927516131584
34,1564732800,187,195,8,382,31,-0.5274471187864332,-0.7913098550419122
34,1564747200,599,420,0,1019,31,-0.6937358655959491,0.891943945414572
34,1564761600,502,421,0,923,31,-0.6937358655959491,0.638266763556138
34,1564776000,633,531,0,1164,31,-0.6937358655959491,1.2751021888465817
34,1565395200,9526,9350,0,18876,32,-0.6304869989389048,4.113094053669035
34,1565409600,38,113,75,151,32,2.160193160298871,-0.32620731972992756
34,1565424000,92,75,0,167,32,-0.6304869989389048,-0.3224140582092663
34,1565438400,313,199,0,512,32,-0.6304869989389048,-0.24062185667000632
34,1565452800,393,305,0,698,32,-0.6304869989389048,-0.19652519149231837
34,1565467200,393,352,0,745,32,-0.6304869989389048,-0.18538248577537572
34,1565481600,216,288,72,504,32,2.04856595392936,-0.242518487430337
34,1565496000,52,101,49,153,32,1.1927573717631088,-0.3257331620398449
34,1565510400,62,52,0,114,32,-0.6304869989389048,-0.33497923699645693
34,1565524800,263,224,0,487,32,-0.6304869989389048,-0.24654882779603965
34,1565539200,384,278,0,662,32,-0.6304869989389048,-0.20506002991380637
34,1565553600,305,310,5,615,32,-0.4444416549897198,-0.21620273563074902
34,1565568000,162,220,58,382,32,1.527638990871642,-0.27144210652537965
34,1565582400,42,81,39,123,32,0.8206666838647386,-0.3328455273910849
34,1565596800,182,189,7,371,32,-0.3700235174100458,-0.2740499738208343
34,1565611200,584,406,0,990,32,-0.6304869989389048,-0.1272981687402491
34,1565625600,462,328,0,790,32,-0.6304869989389048,-0.17471393774851574
34,1565640000,625,520,0,1145,32,-0.6304869989389048,-0.09055094775884248
34,1565654400,169,288,119,457,33,2.73670668201876,-0.020919434402692297
34,1565668800,30,77,47,107,33,0.788542603293541,-0.8498026843206907
34,1565683200,221,200,0,421,33,-0.48317561476319915,-0.10617599725140071
34,1565697600,577,403,0,980,33,-0.48317561476319915,1.2176689647604884
34,1565712000,483,329,0,812,33,-0.48317561476319915,0.819805004799849
34,1565726400,681,540,0,1221,33,-0.48317561476319915,1.788414288275453
34,1565740800,182,309,127,491,33,2.953169357432673,0.05960065273219898
34,1565755200,25,67,42,92,33,0.6532534311598452,-0.8853262521743193
34,1565769600,188,213,25,401,33,0.19327024590527964,-0.15354075438957204
34,1565784000,534,397,0,931,33,-0.48317561476319915,1.1016253097719684
34,1565798400,512,372,0,884,33,-0.48317561476319915,0.9903181304972658
34,1565812800,661,533,0,1194,33,-0.48317561476319915,1.7244718661389218
34,1565827200,197,313,116,510,33,2.6555331787385423,0.10459717201346176
34,1565841600,25,82,57,107,33,1.0591209475609324,-0.8498026843206907
34,1565856000,194,190,0,384,33,-0.48317561476319915,-0.19380079795701768
34,1565870400,537,374,0,911,33,-0.48317561476319915,1.0542605526337971
34,1565884800,473,344,0,817,33,-0.48317561476319915,0.8316461940843919
34,1565899200,677,533,0,1210,33,-0.48317561476319915,1.7623636718494589
34,1565913600,215,343,128,558,33,2.980227191859412,0.21827258914507297
34,1565928000,30,75,45,105,33,0.7344269344400627,-0.8545391600345079
34,1565942400,198,182,0,380,33,-0.48317561476319915,-0.20327374938465195
34,1565956800,551,351,0,902,33,-0.48317561476319915,1.03294641192162
34,1565971200,537,397,0,934,33,-0.48317561476319915,1.1087300233426942
34,1565985600,625,479,0,1104,33,-0.48317561476319915,1.5113304590171508
34,1566000000,277,280,3,557,33,-0.4020021114829817,0.2159043512881644
34,1566014400,11,35,24,46,33,0.1662124114785405,-0.9942651935921133
34,1566028800,0,0,0,0,33,-0.48317561476319915,-1.1032041350099073
34,1566043200,0,1,1,1,33,-0.45611778033646,-1.1008358971529988
34,1566057600,0,1,1,1,33,-0.45611778033646,-1.1008358971529988
34,1566072000,0,1,1,1,33,-0.45611778033646,-1.1008358971529988
34,1566086400,0,0,0,0,33,-0.48317561476319915,-1.1032041350099073
34,1566100800,0,0,0,0,33,-0.48317561476319915,-1.1032041350099073
34,1566115200,0,0,0,0,33,-0.48317561476319915,-1.1032041350099073
34,1566129600,0,0,0,0,33,-0.48317561476319915,-1.1032041350099073
34,1566144000,0,1,1,1,33,-0.45611778033646,-1.1008358971529988
34,1566158400,0,0,0,0,33,-0.48317561476319915,-1.1032041350099073
34,1566172800,0,0,0,0,33,-0.48317561476319915,-1.1032041350099073
34,1566187200,0,0,0,0,33,-0.48317561476319915,-1.1032041350099073
34,1566201600,172,185,13,357,33,-0.13142376721559018,-0.257743220093549
34,1566216000,533,382,0,915,33,-0.48317561476319915,1.0637335040614313
34,1566230400,495,323,0,818,33,-0.48317561476319915,0.8340144319413004
34,1566244800,493,462,0,955,33,-0.48317561476319915,1.158463018337774
34,1566259200,239,266,27,505,34,0.5690373923638137,0.15573189482334313
34,1566273600,32,46,14,78,34,0.09396947763806097,-0.9188721073935997
34,1566288000,241,188,0,429,34,-0.4176421228358266,-0.03553251774922749
34,1566302400,582,427,0,1009,34,-0.4176421228358266,1.4241169466203902
34,1566316800,459,344,0,803,34,-0.4176421228358266,0.9056897230684227
34,1566331200,620,479,0,1099,34,-0.4176421228358266,1.6506142772984345
34,1566345600,257,253,0,510,34,-0.4176421228358266,0.16831507986101224
34,1566360000,43,67,24,110,34,0.4594063351194092,-0.8383397231525173
34,1566374400,258,193,0,451,34,-0.4176421228358266,0.019833496416516633
34,1566388800,568,397,0,965,34,-0.4176421228358266,1.3133849182889021
34,1566403200,427,335,0,762,34,-0.4176421228358266,0.8025076057595358
34,1566417600,589,493,0,1082,34,-0.4176421228358266,1.6078314481703595
34,1566432000,182,294,112,476,34,3.6752506809552736,0.08274942160486223
34,1566446400,42,71,29,113,34,0.6421247638600833,-0.8307898121299159
34,1566460800,218,195,0,413,34,-0.4176421228358266,-0.07579870986976868
34,1566475200,421,381,0,802,34,-0.4176421228358266,0.9031730860608888
34,1566489600,443,345,0,788,34,-0.4176421228358266,0.8679401679554153
34,1566504000,580,506,0,1086,34,-0.4176421228358266,1.6178979962004947
34,1566518400,192,301,109,493,34,3.5656196237108695,0.12553225073293722
34,1566532800,28,92,64,120,34,1.921153765044802,-0.8131733530771791
34,1566547200,196,183,0,379,34,-0.4176421228358266,-0.16136436812591867
34,1566561600,422,343,0,765,34,-0.4176421228358266,0.8100575167821373
34,1566576000,444,362,0,806,34,-0.4176421228358266,0.9132396340910242
34,1566590400,520,490,0,1010,34,-0.4176421228358266,1.4266335836279243
34,1566604800,189,264,75,453,34,2.3231343082742852,0.02486677043158428
34,1566619200,0,21,21,21,34,0.34977527787500473,-1.0623204168230276
34,1566633600,0,1,1,1,34,-0.38109843708769175,-1.1126531569737041
34,1566648000,0,1,1,1,34,-0.38109843708769175,-1.1126531569737041
34,1566662400,0,0,0,0,34,-0.4176421228358266,-1.115169793981238
34,1566676800,0,1,1,1,34,-0.38109843708769175,-1.1126531569737041
34,1566691200,0,0,0,0,34,-0.4176421228358266,-1.115169793981238
34,1566705600,0,0,0,0,34,-0.4176421228358266,-1.115169793981238
34,1566720000,0,0,0,0,34,-0.4176421228358266,-1.115169793981238
34,1566734400,0,0,0,0,34,-0.4176421228358266,-1.115169793981238
34,1566748800,0,2,2,2,34,-0.34455475133955693,-1.1101365199661704
34,1566763200,0,0,0,0,34,-0.4176421228358266,-1.115169793981238
34,1566777600,0,0,0,0,34,-0.4176421228358266,-1.115169793981238
34,1566792000,0,0,0,0,34,-0.4176421228358266,-1.115169793981238
34,1566806400,184,168,0,352,34,-0.4176421228358266,-0.22931356732933192
34,1566820800,511,399,0,910,34,-0.4176421228358266,1.1749698828745418
34,1566835200,378,320,0,698,34,-0.4176421228358266,0.6414428372773712
34,1566849600,581,537,0,1118,34,-0.4176421228358266,1.6984303804415772
34,1566864000,102,140,38,242,35,0.7680128142327749,-0.7794090022372584
34,1566878400,0,4,4,4,35,-0.35109157222069703,-1.4506973346828584
34,1566892800,219,195,0,414,35,-0.4827509118034584,-0.2942762577807743
34,1566907200,527,372,0,899,35,-0.4827509118034584,1.0736852600180324
34,1566921600,504,350,0,854,35,-0.4827509118034584,0.9467609954799988
34,1566936000,656,519,0,1175,35,-0.4827509118034584,1.8521540825179719
34,1566950400,143,155,12,298,35,-0.08777289305517424,-0.6214588063677055
34,1566964800,0,0,0,0,35,-0.4827509118034584,-1.4619794915306836
34,1566979200,281,191,0,472,35,-0.4827509118034584,-0.13068498348730878
34,1566993600,576,428,0,1004,35,-0.4827509118034584,1.3698418772734442
34,1567008000,531,357,0,888,35,-0.4827509118034584,1.0426593286865131
34,1567022400,680,499,0,1179,35,-0.4827509118034584,1.863436239365797
34,1567036800,96,164,68,260,35,1.7554578611034855,-0.728639296422045
34,1567051200,0,1,1,1,35,-0.44983607690776806,-1.4591589523187274
34,1567065600,191,209,18,400,35,0.10971611631896785,-0.3337638067481626
34,1567080000,529,348,0,877,35,-0.4827509118034584,1.0116333973549938
34,1567094400,518,360,0,878,35,-0.4827509118034584,1.01445393656695
34,1567108800,693,484,0,1177,35,-0.4827509118034584,1.8577951609418846
34,1567123200,160,154,0,314,35,-0.4827509118034584,-0.5763301789764046
34,1567137600,0,1,1,1,35,-0.44983607690776806,-1.4591589523187274
34,1567152000,163,167,4,330,35,-0.35109157222069703,-0.5312015515851037
34,1567166400,532,372,0,904,35,-0.4827509118034584,1.0877879560778139
34,1567180800,605,392,0,997,35,-0.4827509118034584,1.35009810278975
34,1567195200,579,454,0,1033,35,-0.4827509118034584,1.451637514420177
34,1567209600,121,283,162,404,35,4.849452341298378,-0.3224816499003374
34,1567224000,39,90,51,129,35,1.1959056678767495,-1.0981299331883205
34,1567238400,69,58,0,127,35,-0.4827509118034584,-1.1037710116122332
34,1567252800,256,168,0,424,35,-0.4827509118034584,-0.2660708656612113
34,1567267200,377,298,0,675,35,-0.4827509118034584,0.44188447653982066
34,1567281600,326,332,6,658,35,-0.2852619024293163,0.3939353099365635
34,1567296000,222,266,44,488,35,0.9655018236069169,-0.08555635609600795
34,1567310400,52,115,63,167,35,1.5908836866250335,-0.9909494431339811
34,1567324800,35,41,6,76,35,-0.2852619024293163,-1.2476185114220046
34,1567339200,272,162,0,434,35,-0.4827509118034584,-0.2378654735416483
34,1567353600,362,268,0,630,35,-0.4827509118034584,0.31496021200178703
34,1567368000,320,303,0,623,35,-0.4827509118034584,0.2952164375180929
34,1567382400,219,270,51,489,35,1.1959056678767495,-0.08273581688405166
34,1567396800,38,85,47,123,35,1.064246328293988,-1.1150531684600584
34,1567411200,60,45,0,105,35,-0.4827509118034584,-1.1658228742752719
34,1567425600,247,162,0,409,35,-0.4827509118034584,-0.30837895384055586
34,1567440000,302,244,0,546,35,-0.4827509118034584,0.0780349181974576
34,1567454400,311,351,40,662,35,0.8338424840241556,0.4052174667843887
34,1567468800,165,216,51,381,36,0.6751785924645263,-0.6654301436914608
34,1567483200,23,45,22,68,36,-0.08136926919305702,-1.4803867925612153
34,1567497600,185,202,17,387,36,-0.2118085556857438,-0.649807971508654
34,1567512000,560,443,0,1003,36,-0.6553021297608789,0.9540683725928436
34,1567526400,520,409,0,929,36,-0.6553021297608789,0.7613949156715597
34,1567540800,677,566,0,1243,36,-0.6553021297608789,1.5789552599051153
34,1567555200,170,287,117,457,36,2.3969771741679917,-0.4675492960425747
34,1567569600,25,73,48,98,36,0.5969150205689142,-1.4022759316471813
34,1567584000,206,175,0,381,36,-0.6553021297608789,-0.6654301436914608
34,1567598400,524,408,0,932,36,-0.6553021297608789,0.7692060017629632
34,1567612800,448,423,0,871,36,-0.6553021297608789,0.6103805845710941
34,1567627200,726,594,0,1320,36,-0.6553021297608789,1.7794398029178025
34,1567641600,231,296,65,527,36,1.0404085946440493,-0.28529062057649546
34,1567656000,21,72,51,93,36,0.6751785924645263,-1.415294408466187
34,1567670400,208,244,36,452,36,0.28386073298646597,-0.48056777286158037
34,1567684800,583,447,0,1030,36,-0.6553021297608789,1.0243681474154742
34,1567699200,527,370,0,897,36,-0.6553021297608789,0.6780766640299235
34,1567713600,745,596,0,1341,36,-0.6553021297608789,1.8341174055576264
34,1567728000,253,333,80,586,36,1.4317264541221095,-0.13167259411222865
34,1567742400,33,86,53,119,36,0.727354307061601,-1.3475983290073574
34,1567756800,260,223,0,483,36,-0.6553021297608789,-0.3998532165837453
34,1567771200,575,444,0,1019,36,-0.6553021297608789,0.9957274984136617
34,1567785600,500,441,0,941,36,-0.6553021297608789,0.7926392600371733
34,1567800000,811,648,0,1459,36,-0.6553021297608789,2.1413534584861598
34,1567814400,250,423,173,673,36,3.8578971828860835,0.09484890253846986
34,1567828800,48,123,75,171,36,1.3012871676294229,-1.2122061700896987
34,1567843200,74,66,0,140,36,-0.6553021297608789,-1.2929207263675337
34,1567857600,289,215,0,504,36,-0.6553021297608789,-0.3451756139439215
34,1567872000,421,309,0,730,36,-0.6553021297608789,0.2432595382751344
34,1567886400,477,436,0,913,36,-0.6553021297608789,0.7197357898507416
34,1567900800,238,307,69,545,36,1.1447600238381987,-0.23842410402807507
34,1567915200,43,125,82,168,36,1.4839021687191842,-1.220017256181102
34,1567929600,56,44,0,100,36,-0.6553021297608789,-1.397068540919579
34,1567944000,263,178,0,441,36,-0.6553021297608789,-0.5092084218633929
34,1567958400,413,326,0,739,36,-0.6553021297608789,0.2666927965493446
34,1567972800,325,382,57,707,36,0.8317057362557504,0.18337454490770835
34,1567987200,215,228,13,443,36,-0.3161599848798932,-0.5040010311357905
34,1568001600,23,46,23,69,36,-0.05528141189451967,-1.4777830971974142
34,1568016000,243,237,0,480,36,-0.6553021297608789,-0.4076643026751487
34,1568030400,552,462,0,1014,36,-0.6553021297608789,0.982709021594656
34,1568044800,423,374,0,797,36,-0.6553021297608789,0.4177071276498103
34,1568059200,531,554,23,1085,36,-0.05528141189451967,1.1675713924245363
34,1568073600,224,298,74,522,37,1.750154364817309,-0.31939272990845285
34,1568088000,29,65,36,94,37,0.5346424560930161,-1.3767414799700268
34,1568102400,263,250,0,513,37,-0.6168951416457877,-0.3416266989518037
34,1568116800,627,450,0,1077,37,-0.6168951416457877,1.0517020277648497
34,1568131200,531,369,0,900,37,-0.6168951416457877,0.6144339699122829
34,1568145600,747,563,0,1310,37,-0.6168951416457877,1.6273147818871552
34,1568160000,225,322,97,547,37,2.485858941150434,-0.2576317047880338
34,1568174400,32,48,16,80,37,-0.10510065376187493,-1.4113276540374613
34,1568188800,273,242,0,515,37,-0.6168951416457877,-0.3366858169421702
34,1568203200,608,515,0,1123,37,-0.6168951416457877,1.1653423139864207
34,1568217600,558,392,0,950,37,-0.6168951416457877,0.737956020153121
34,1568232000,826,569,0,1395,37,-0.6168951416457877,1.83730226729658
34,1568246400,253,313,60,566,37,1.3023341879188854,-0.21069332569651536
34,1568260800,23,67,44,90,37,0.7905397000349725,-1.3866232439892938
34,1568275200,274,253,0,527,37,-0.6168951416457877,-0.30704052488436906
34,1568289600,675,484,0,1159,37,-0.6168951416457877,1.2542781901598241
34,1568304000,590,341,0,931,37,-0.6168951416457877,0.6910176410616026
34,1568318400,785,601,0,1386,37,-0.6168951416457877,1.8150682982532291
34,1568332800,244,337,93,581,37,2.3579103191794557,-0.17363671062426392
34,1568347200,41,62,21,103,37,0.054835123701847836,-1.354507510926676
34,1568361600,238,217,0,455,37,-0.6168951416457877,-0.48491227723117586
34,1568376000,595,455,0,1050,37,-0.6168951416457877,0.9850001206347971
34,1568390400,480,408,0,888,37,-0.6168951416457877,0.5847886778544819
34,1568404800,792,616,0,1408,37,-0.6168951416457877,1.8694180003591978
34,1568419200,336,327,0,663,37,-0.6168951416457877,0.028939451770710514
34,1568433600,42,128,86,170,37,2.134000230730244,-1.1889879636039529
34,1568448000,78,46,0,124,37,-0.6168951416457877,-1.302628249825524
34,1568462400,317,146,0,463,37,-0.6168951416457877,-0.46514874919264176
34,1568476800,466,265,0,731,37,-0.6168951416457877,0.19692944009825028
34,1568491200,393,345,0,738,37,-0.6168951416457877,0.21422252713196763
34,1568505600,190,243,53,433,37,1.0784240994696734,-0.5392619793371446
34,1568520000,32,131,99,163,37,2.5498332521359233,-1.2062810506376702
34,1568534400,47,32,0,79,37,-0.6168951416457877,-1.4137980950422782
34,1568548800,264,121,0,385,37,-0.6168951416457877,-0.6578431475683492
34,1568563200,291,248,0,539,37,-0.6168951416457877,-0.2773952328265679
34,1568577600,304,342,38,646,37,0.5986167670785052,-0.01305804531117443
34,1568592000,146,205,59,351,37,1.2703470324261408,-0.741838141732119
34,1568606400,26,50,24,76,37,0.15079659018008149,-1.4212094180567285
34,1568620800,226,236,10,462,37,-0.2970235867183422,-0.4676191901974585
34,1568635200,555,447,0,1002,37,-0.6168951416457877,0.8664189524035927
34,1568649600,496,372,0,868,37,-0.6168951416457877,0.5353798577581466
34,1568664000,679,612,0,1291,37,-0.6168951416457877,1.5803764027956366
34,1568678400,192,286,94,478,38,1.9409209110846044,-0.48930816080335615
34,1568692800,17,61,44,78,38,0.5726987179736043,-1.5226679472893878
34,1568707200,251,226,0,477,38,-0.6313368119640758,-0.49189156026957126
34,1568721600,610,478,0,1088,38,-0.6313368119640758,1.0865655135878423
34,1568736000,531,379,0,910,38,-0.6313368119640758,0.6267204086015581
34,1568750400,722,645,0,1367,38,-0.6313368119640758,1.8073339646618494
34,1568764800,252,322,70,574,38,1.2841742583913245,-0.24130181204670853
34,1568779200,24,56,32,80,38,0.24432539162696426,-1.5175011483569578
34,1568793600,253,239,0,492,38,-0.6313368119640758,-0.453140568276345
34,1568808000,524,475,0,999,38,-0.6313368119640758,0.8566429610947002
34,1568822400,519,411,0,930,38,-0.6313368119640758,0.6783883979258597
34,1568836800,659,604,0,1263,38,-0.6313368119640758,1.5386604201754812
34,1568851200,226,354,128,580,38,2.8713120024000847,-0.22580141524941807
34,1568865600,23,68,45,91,38,0.6000631618358243,-1.489083754228592
34,1568880000,266,242,0,508,38,-0.6313368119640758,-0.4118061768169038
34,1568894400,585,427,0,1012,38,-0.6313368119640758,0.8902271541554962
34,1568908800,531,404,0,935,38,-0.6313368119640758,0.6913053952569351
34,1568923200,643,614,0,1257,38,-0.6313368119640758,1.5231600233781906
34,1568937600,302,345,43,647,38,0.5453342741113842,-0.05271365101300775
34,1568952000,38,96,58,134,38,0.9558009320446844,-1.3779975771813435
34,1568966400,248,206,0,454,38,-0.6313368119640758,-0.5513097479925181
34,1568980800,570,405,0,975,38,-0.6313368119640758,0.7946413739055382
34,1568995200,609,426,0,1035,38,-0.6313368119640758,0.9496453418784431
34,1569009600,762,647,0,1409,38,-0.6313368119640758,1.9158367422428828
34,1569024000,325,373,48,698,38,0.6821564934224843,0.0790397217639613
34,1569038400,60,140,80,200,38,1.5578186970135244,-1.2074932124111482
34,1569052800,71,73,2,144,38,-0.5766079242396358,-1.3521635825191927
34,1569067200,354,232,0,586,38,-0.6313368119640758,-0.2103010184521276
34,1569081600,499,388,0,887,38,-0.6313368119640758,0.5673022208786113
34,1569096000,424,367,0,791,38,-0.6313368119640758,0.3192958721219637
34,1569110400,215,302,87,517,38,1.7493698040490644,-0.38855558162096804
34,1569124800,53,141,88,194,38,1.7767342479112844,-1.2229936092084388
34,1569139200,54,43,0,97,38,-0.6313368119640758,-1.4735833574313013
34,1569153600,269,214,0,483,38,-0.6313368119640758,-0.4763911634722808
34,1569168000,372,331,0,703,38,-0.6313368119640758,0.09195671909503669
34,1569182400,336,347,11,683,38,-0.3303279294796558,0.04028872977073511
34,1569196800,151,267,116,418,38,2.5429386760534443,-0.6443121287762609
34,1569211200,33,56,23,89,38,-0.001954603133015756,-1.494250553161022
34,1569225600,254,242,0,496,38,-0.6313368119640758,-0.44280697041148476
34,1569240000,565,492,0,1057,38,-0.6313368119640758,1.006480130135175
34,1569254400,527,380,0,907,38,-0.6313368119640758,0.6189702102029129
34,1569268800,729,579,0,1308,38,-0.6313368119640758,1.6549133961551596
34,1569283200,238,295,57,533,39,1.0251913552836245,-0.3375993186727149
34,1569297600,23,58,35,81,39,0.4032105199047217,-1.4888451361116983
34,1569312000,249,243,0,492,39,-0.5863044454708055,-0.4420264835289059
34,1569326400,534,479,0,1013,39,-0.5863044454708055,0.8849626113509843
34,1569340800,580,359,0,939,39,-0.5863044454708055,0.696484313805664
34,1569355200,751,608,0,1359,39,-0.5863044454708055,1.7662260025764007
34,1569369600,227,334,107,561,39,2.438784162962949,-0.26628320608799916
34,1569384000,28,68,40,96,39,0.5445698006726541,-1.4506400757984577
34,1569398400,271,231,0,502,39,-0.5863044454708055,-0.41655644332007885
34,1569412800,596,477,0,1073,39,-0.5863044454708055,1.0377828526039468
34,1569427200,538,375,0,913,39,-0.5863044454708055,0.6302622092627136
34,1569441600,779,697,0,1476,39,-0.5863044454708055,2.0642254730196776
34,1569456000,277,347,70,624,39,1.3927254852802489,-0.10582195277238862
34,1569470400,26,59,33,85,39,0.3466668075975487,-1.4786571200281675
34,1569484800,263,238,0,501,39,-0.5863044454708055,-0.41910344734096155
34,1569499200,582,462,0,1044,39,-0.5863044454708055,0.9639197359983482
34,1569513600,597,351,0,948,39,-0.5863044454708055,0.7194073499936083
34,1569528000,726,539,0,1265,39,-0.5863044454708055,1.5268076246134263
34,1569542400,302,359,57,661,39,1.0251913552836245,-0.011582803999728473
34,1569556800,30,89,59,119,39,1.0817350675907973,-1.3920589833181556
34,1569571200,252,224,0,476,39,-0.5863044454708055,-0.4827785478630292
34,1569585600,601,402,0,1003,39,-0.5863044454708055,0.8594925711421573
34,1569600000,560,431,0,991,39,-0.5863044454708055,0.8289285228915647
34,1569614400,837,620,0,1457,39,-0.5863044454708055,2.015832396622906
34,1569628800,330,356,26,686,39,0.14876381452244322,0.052092296522339196
34,1569643200,52,114,62,166,39,1.166550636051557,-1.2723497943366684
34,1569657600,77,66,0,143,39,-0.5863044454708055,-1.3309308868169705
34,1569672000,351,217,0,568,39,-0.5863044454708055,-0.2484541779418202
34,1569686400,481,348,0,829,39,-0.5863044454708055,0.41631387150856625
34,1569700800,471,375,0,846,39,-0.5863044454708055,0.45961293986357227
34,1569715200,245,286,41,531,39,0.5728416568262407,-0.34269332671448033
34,1569729600,35,165,130,200,39,3.0890368544954385,-1.1857516576266562
34,1569744000,56,54,0,110,39,-0.5863044454708055,-1.4149820195060998
34,1569758400,275,209,0,484,39,-0.5863044454708055,-0.4624025156959676
34,1569772800,422,293,0,715,39,-0.5863044454708055,0.1259554131279377
34,1569787200,352,330,0,682,39,-0.5863044454708055,0.04190428043880837
34,1569801600,144,273,129,417,39,3.0607649983418517,-0.633051785095109
34,1569816000,29,54,25,83,39,0.12049195836885675,-1.483751128069933
34,1569830400,175,169,0,344,39,-0.5863044454708055,-0.8189830786195466
34,1569844800,501,379,0,880,39,-0.5863044454708055,0.5462110765735843
34,1569859200,490,383,0,873,39,-0.5863044454708055,0.5283820484274053
34,1569873600,664,520,0,1184,39,-0.5863044454708055,1.3205002989219272
34,1569888000,237,266,29,503,40,-0.07276571011455088,-0.29868244958655693
34,1569902400,32,44,12,76,40,-0.3954658158399503,-1.337180132968742
34,1569916800,186,194,8,380,40,-0.4713952524812207,-0.5978281522938375
34,1569931200,549,414,0,963,40,-0.6232541257637616,0.820073836960996
34,1569945600,530,349,0,879,40,-0.6232541257637616,0.6157792107218777
34,1569960000,735,535,0,1270,40,-0.6232541257637616,1.5667220542872977
34,1569974400,292,294,2,586,40,-0.5852894074431264,-0.09681990223123761
34,1569988800,34,63,29,97,40,-0.07276571011455088,-1.2861064764089625
34,1570003200,254,242,0,496,40,-0.6232541257637616,-0.31570700177315014
34,1570017600,623,445,0,1068,40,-0.6232541257637616,1.075442119759894
34,1570032000,595,385,0,980,40,-0.6232541257637616,0.8614191779855795
34,1570046400,709,603,0,1312,40,-0.6232541257637616,1.6688693674068569
34,1570060800,279,291,12,570,40,-0.3954658158399503,-0.13573316437202207
34,1570075200,25,60,35,85,40,0.04112844484735478,-1.3152914230145507
34,1570089600,253,219,0,472,40,-0.6232541257637616,-0.37407689498432684
34,1570104000,631,459,0,1090,40,-0.6232541257637616,1.1289478552034726
34,1570118400,575,387,0,962,40,-0.6232541257637616,0.817641758077197
34,1570132800,831,661,0,1492,40,-0.6232541257637616,2.106643566490682
34,1570147200,296,342,46,638,40,0.2499343956108485,0.029648199726311858
34,1570161600,43,72,29,115,40,-0.07276571011455088,-1.2423290565005798
34,1570176000,241,257,16,498,40,-0.31953637919867983,-0.31084284400555207
34,1570190400,597,456,0,1053,40,-0.6232541257637616,1.0389609365029087
34,1570204800,604,409,0,1013,40,-0.6232541257637616,0.9416777811509475
34,1570219200,767,656,0,1423,40,-0.6232541257637616,1.938830123508549
34,1570233600,341,353,12,694,40,-0.3954658158399503,0.16584461721905744
34,1570248000,38,129,91,167,40,1.1041405578251409,-1.1158609545430305
34,1570262400,56,56,0,112,40,-0.6232541257637616,-1.249625293151977
34,1570276800,155,213,58,368,40,0.4777227055346598,-0.6270130988994258
34,1570291200,218,306,88,524,40,1.047193480344188,-0.24760879302677735
34,1570305600,202,437,235,639,40,3.8376002769108766,0.03208027861011088
34,1570320000,109,266,157,375,40,2.356976262406103,-0.6099885467128325
34,1570334400,32,116,84,148,40,0.9712640437029176,-1.162070453335212
34,1570348800,24,40,16,64,40,-0.31953637919867983,-1.3663650795743303
34,1570363200,105,151,46,256,40,0.2499343956108485,-0.899405933884917
34,1570377600,155,216,61,371,40,0.5346697830156126,-0.6197168622480287
34,1570392000,174,346,172,520,40,2.6417116498108673,-0.25733710856197345
34,1570406400,100,211,111,311,40,1.483787741031493,-0.7656415952759703
34,1570420800,22,52,30,74,40,-0.053783350954233276,-1.3420442907363401
34,1570435200,232,220,0,452,40,-0.6232541257637616,-0.4227184726603074
34,1570449600,542,471,0,1013,40,-0.6232541257637616,0.9416777811509475
34,1570464000,579,435,0,1014,40,-0.6232541257637616,0.9441098600347465
34,1570478400,610,551,0,1161,40,-0.6232541257637616,1.3016254559532037
34,1570492800,239,384,145,623,41,3.7220856888906435,-0.059304580089501596
34,1570507200,32,80,48,112,41,0.8182601246354766,-1.4427772951774167
34,1570521600,257,221,0,478,41,-0.6186844844804824,-0.45187511568196287
34,1570536000,566,438,0,1004,41,-0.6186844844804824,0.9722083444672415
34,1570550400,527,386,0,913,41,-0.6186844844804824,0.7258364910954209
34,1570564800,686,589,0,1275,41,-0.6186844844804824,1.705909138574531
34,1570579200,264,303,39,567,41,0.5488330104262343,-0.21091802831831422
34,1570593600,33,64,31,97,41,0.30934224224024115,-1.4833880402387059
34,1570608000,165,187,22,352,41,0.03991512803099882,-0.7930053741967913
34,1570622400,431,420,0,851,41,-0.6186844844804824,0.5579787448420926
34,1570636800,519,340,0,859,41,-0.6186844844804824,0.5796378088747802
34,1570651200,555,622,67,1177,41,1.3870506990772102,1.440585604174109
34,1570665600,215,306,91,521,41,2.1055230036351897,-0.33545764650626747
34,1570680000,23,63,40,86,41,0.5787693564494835,-1.5131692532836511
34,1570694400,243,237,0,480,41,-0.6186844844804824,-0.446460349673791
34,1570708800,630,428,0,1058,41,-0.6186844844804824,1.1184070266878823
34,1570723200,538,411,0,949,41,-0.6186844844804824,0.8233022792425148
34,1570737600,777,586,0,1363,41,-0.6186844844804824,1.944158842934094
34,1570752000,274,369,95,643,41,2.2252683877281862,-0.005156920007782801
34,1570766400,44,80,36,124,41,0.45902397235648684,-1.4102886991283856
34,1570780800,293,217,0,510,41,-0.6186844844804824,-0.36523885955121277
34,1570795200,587,396,0,983,41,-0.6186844844804824,0.9153533013814367
34,1570809600,581,389,0,970,41,-0.6186844844804824,0.8801573223283194
34,1570824000,832,616,0,1448,41,-0.6186844844804824,2.174286398281399
34,1570838400,340,366,26,706,41,0.1596605121239954,0.1654082092496314
34,1570852800,68,134,66,202,41,1.357114353053961,-1.1991128248096823
34,1570867200,113,64,0,177,41,-0.6186844844804824,-1.2667973999118307
34,1570881600,343,185,0,528,41,-0.6186844844804824,-0.31650596547766585
34,1570896000,486,316,0,802,41,-0.6186844844804824,0.42531697764188164
34,1570910400,458,420,0,878,41,-0.6186844844804824,0.631078085952413
34,1570924800,261,294,33,555,41,0.3692149342867394,-0.2434066243673455
34,1570939200,66,120,54,186,41,0.9978782007749714,-1.2424309528750572
34,1570953600,83,45,0,128,41,-0.6186844844804824,-1.3994591671120418
34,1570968000,270,182,0,452,41,-0.6186844844804824,-0.5222670737881973
34,1570982400,443,337,0,780,41,-0.6186844844804824,0.36575455155199094
34,1570996800,359,363,4,722,41,-0.4989391003874858,0.20872633731500645
34,1571011200,179,248,69,427,41,1.4469233911237085,-0.5899516488903458
34,1571025600,43,45,2,88,41,-0.558811792433984,-1.5077544872754793
34,1571040000,168,132,0,300,41,-0.6186844844804824,-0.9337892904092602
34,1571054400,472,370,0,842,41,-0.6186844844804824,0.5336122978053192
34,1571068800,509,313,0,822,41,-0.6186844844804824,0.47946463772360043
34,1571083200,584,464,0,1048,41,-0.6186844844804824,1.0913331966470228
34,1571097600,216,258,42,474,42,0.8903465748549537,-0.5478185792967095
34,1571112000,28,54,26,82,42,0.32483343846314944,-1.5491825283964125
34,1571126400,299,230,0,529,42,-0.5941254081735324,-0.40732108643833276
34,1571140800,595,433,0,1028,42,-0.5941254081735324,0.8673743487676666
34,1571155200,510,378,0,888,42,-0.5941254081735324,0.5097443669463442
34,1571169600,687,596,0,1283,42,-0.5941254081735324,1.518771815656504
34,1571184000,336,301,0,637,42,-0.5941254081735324,-0.13143510046188403
34,1571198400,34,56,22,90,42,0.18345515436519838,-1.528746529435194
34,1571212800,301,223,0,524,42,-0.5941254081735324,-0.4200935857890943
34,1571227200,661,498,0,1159,42,-0.5941254081735324,1.2020138317576183
34,1571241600,612,388,0,1000,42,-0.5941254081735324,0.7958483524034021
34,1571256000,700,607,0,1307,42,-0.5941254081735324,1.5800798125401592
34,1571270400,312,362,50,674,42,1.1731031430508558,-0.036918605266248794
34,1571284800,30,67,37,97,42,0.7136237197325149,-1.5108650303441278
34,1571299200,314,260,0,574,42,-0.5941254081735324,-0.29236859228147916
34,1571313600,567,441,0,1008,42,-0.5941254081735324,0.8162843513646205
34,1571328000,510,390,0,900,42,-0.5941254081735324,0.5403983653881718
34,1571342400,753,684,0,1437,42,-0.5941254081735324,1.9121647956599588
34,1571356800,266,365,99,631,42,2.9049871232507565,-0.14676209968279783
34,1571371200,41,88,47,129,42,1.0670694299773926,-1.4291210344992542
34,1571385600,216,229,13,445,42,-0.13464598485519153,-0.6218990755311262
34,1571400000,623,458,0,1081,42,-0.5941254081735324,1.0027628418857386
34,1571414400,560,394,0,954,42,-0.5941254081735324,0.6783413583763962
34,1571428800,767,679,0,1446,42,-0.5941254081735324,1.9351552944913295
34,1571443200,310,318,8,628,42,-0.3113688399776303,-0.15442559929325475
34,1571457600,77,129,52,206,42,1.2437922850998313,-1.2324245444975268
34,1571472000,108,67,0,175,42,-0.5941254081735324,-1.3116140404722483
34,1571486400,406,274,0,680,42,-0.5941254081735324,-0.02159160604533497
34,1571500800,504,379,0,883,42,-0.5941254081735324,0.4969718675955826
34,1571515200,485,480,0,965,42,-0.5941254081735324,0.7064408569480715
34,1571529600,242,319,77,561,42,2.1274065607120254,-0.3255770905934591
34,1571544000,55,110,55,165,42,1.3498259981732947,-1.337159039173771
34,1571558400,69,58,0,127,42,-0.5941254081735324,-1.4342300342395586
34,1571572800,296,194,0,490,42,-0.5941254081735324,-0.5069465813742726
34,1571587200,430,333,0,763,42,-0.5941254081735324,0.1904318831773062
34,1571601600,346,406,60,752,42,1.5265488532957334,0.16233238460563088
34,1571616000,182,287,105,469,42,3.117054549397683,-0.5605910786474709
34,1571630400,37,50,13,87,42,-0.13464598485519153,-1.5364100290456508
34,1571644800,267,231,0,498,42,-0.5941254081735324,-0.48651058241305417
34,1571659200,545,406,0,951,42,-0.5941254081735324,0.6706778587659392
34,1571673600,506,361,0,867,42,-0.5941254081735324,0.45609986967314575
34,1571688000,730,541,0,1271,42,-0.5941254081735324,1.4881178172146763
34,1571702400,246,312,66,558,43,2.349450252922666,-0.34362557978484715
34,1571716800,22,48,26,70,43,0.5446599351768595,-1.4487487373668697
34,1571731200,251,213,0,464,43,-0.6284537713579148,-0.5564976634174499
34,1571745600,578,463,0,1041,43,-0.6284537713579148,0.7501745946252285
34,1571760000,508,356,0,864,43,-0.6284537713579148,0.34934099033830635
34,1571774400,764,670,0,1434,43,-0.6284537713579148,1.6401610719402588
34,1571788800,436,454,18,890,43,0.18370187162769816,0.4082205028324305
34,1571803200,28,69,41,97,43,1.221456304331537,-1.387604628238356
34,1571817600,241,223,0,464,43,-0.6284537713579148,-0.5564976634174499
34,1571832000,632,415,0,1047,43,-0.6284537713579148,0.7637621744315648
34,1571846400,501,391,0,892,43,-0.6284537713579148,0.41274969610120926
34,1571860800,733,771,38,1504,43,1.0860970305006015,1.7986828363475162
34,1571875200,547,383,0,930,43,-0.6284537713579148,0.4988043682080061
34,1571889600,26,65,39,91,43,1.1312167884442466,-1.4011922080446926
34,1571904000,240,231,0,471,43,-0.6284537713579148,-0.5406454869767241
34,1571918400,620,489,0,1109,43,-0.6284537713579148,0.904167165763707
34,1571932800,549,444,0,993,43,-0.6284537713579148,0.6414739561745377
34,1571947200,896,828,0,1724,43,-0.6284537713579148,2.2968940959131823
34,1571961600,714,455,0,1169,43,-0.6284537713579148,1.0400429638270705
34,1571976000,36,84,48,120,43,1.537294609937053,-1.3355189056474002
34,1571990400,225,223,0,448,43,-0.6284537713579148,-0.5927312095676801
34,1572004800,631,467,0,1098,43,-0.6284537713579148,0.8792566027854237
34,1572019200,512,454,0,966,43,-0.6284537713579148,0.5803298470460242
34,1572033600,772,650,0,1422,43,-0.6284537713579148,1.6129859123275863
34,1572048000,289,331,42,620,43,1.266576062275182,-0.20322058845270494
34,1572062400,45,110,65,155,43,2.304330494979021,-1.2562580234437715
34,1572076800,78,78,0,156,43,-0.6284537713579148,-1.2539934268093822
34,1572091200,355,236,0,591,43,-0.6284537713579148,-0.26889389084999726
34,1572105600,451,341,0,792,43,-0.6284537713579148,0.18629003266227023
34,1572120000,453,472,19,925,43,0.22882162957134333,0.48748138503605914
34,1572134400,287,290,3,577,43,-0.4930944975269793,-0.3005982437314487
34,1572148800,57,134,77,191,43,2.845767590302763,-1.1747325446057535
34,1572163200,46,40,0,86,43,-0.6284537713579148,-1.4125151912166394
34,1572177600,206,164,0,370,43,-0.6284537713579148,-0.7693697470500526
34,1572192000,306,272,0,578,43,-0.6284537713579148,-0.29833364709705934
34,1572206400,329,345,16,674,43,0.09346235574040783,-0.08093237019567785
34,1572220800,146,198,52,344,43,1.7177736417116338,-0.8282492595441767
34,1572235200,25,60,35,85,43,0.9507377566696659,-1.4147797878510289
34,1572249600,249,247,0,496,43,-0.6284537713579148,-0.4840305711169894
34,1572264000,568,450,0,1018,43,-0.6284537713579148,0.6980888720342725
34,1572278400,501,371,0,872,43,-0.6284537713579148,0.36745776341342146
34,1572292800,716,697,0,1413,43,-0.6284537713579148,1.5926045426180817
34,1572307200,205,322,117,527,44,1.8616973243889157,-0.37811495400016226
34,1572321600,29,68,39,97,44,0.14486124355294563,-1.4386952785546219
34,1572336000,257,240,0,497,44,-0.7135567968650393,-0.45210893013186876
34,1572350400,578,512,0,1090,44,-0.7135567968650393,1.0105053314048629
34,1572364800,513,385,0,898,44,-0.7135567968650393,0.5369438841619413
34,1572379200,759,630,0,1389,44,-0.7135567968650393,1.7479786268508708
34,1572393600,271,353,82,624,44,1.0913221599112368,-0.13886776450764463
34,1572408000,37,60,23,97,44,-0.20731026020827895,-1.4386952785546219
34,1572422400,222,241,19,463,44,-0.2953531361485851,-0.5359687697478027
34,1572436800,588,443,0,1031,44,-0.7135567968650393,0.8649838450125067
34,1572451200,608,443,0,1051,44,-0.7135567968650393,0.9143131624336444
34,1572465600,742,587,0,1329,44,-0.7135567968650393,1.599990674587458
34,1572480000,231,350,119,581,44,1.9057187623590688,-0.24492579696309058
34,1572494400,39,70,31,109,44,-0.031224508327666652,-1.4090976881019392
34,1572508800,229,235,6,464,44,-0.5814924829545801,-0.5335023038767459
34,1572523200,589,528,0,1117,44,-0.7135567968650393,1.0770999099233987
34,1572537600,543,459,0,1002,44,-0.7135567968650393,0.7934563347518572
34,1572552000,755,747,0,1502,44,-0.7135567968650393,2.0266892702802988
34,1572566400,301,376,75,677,44,0.937247127015701,-0.008145073341629817
34,1572580800,46,143,97,189,44,1.421482944687385,-1.2117804184173886
34,1572595200,211,241,30,452,44,-0.05323522731274319,-0.5630998943294285
34,1572609600,596,455,0,1051,44,-0.7135567968650393,0.9143131624336444
34,1572624000,562,418,0,980,44,-0.7135567968650393,0.7391940855886057
34,1572638400,740,665,0,1405,44,-0.7135567968650393,1.7874420807877809
34,1572652800,281,387,106,668,44,1.6195794155530738,-0.030343266181141762
34,1572667200,56,134,78,190,44,1.0032792839709306,-1.209313952546332
34,1572681600,85,70,0,155,44,-0.7135567968650393,-1.2956402580333226
34,1572696000,318,225,0,543,44,-0.7135567968650393,-0.3386515000632521
34,1572710400,462,348,0,810,44,-0.7135567968650393,0.31989488750893563
34,1572724800,477,395,0,872,44,-0.7135567968650393,0.47281577151446236
34,1572739200,197,326,129,523,44,2.125825952209834,-0.3879808174843898
34,1572750000,52,147,95,199,44,1.3774615067172318,-1.1871157597068198
34,1572764400,34,41,7,75,44,-0.5594817639695036,-1.4929575277178733
34,1572778800,255,182,0,437,44,-0.7135567968650393,-0.6000968823952817
34,1572793200,362,351,0,713,44,-0.7135567968650393,0.08064769801641797
34,1572807600,347,393,46,740,44,0.2989362764484814,0.1472422765349538
34,1572822000,199,278,79,477,44,1.025290002956007,-0.5014382475530064
34,1572836400,37,77,40,114,44,0.16687196253802217,-1.3967653587466549
34,1572850800,105,117,12,222,44,-0.44942816904412086,-1.1303870446725115
34,1572865200,624,506,0,1130,44,-0.7135567968650393,1.1091639662471382
34,1572879600,420,330,0,750,44,-0.7135567968650393,0.17190693524552264
34,1572894000,705,630,0,1335,44,-0.7135567968650393,1.6147894698137992
34,1572908400,257,421,164,678,44,2.896201116687513,-0.005678607470572934
34,1572922800,67,134,67,201,45,0.5170676247868394,-1.191818749234841
34,1572937200,124,106,0,230,45,-0.616131982806748,-1.120572848053588
34,1572951600,639,359,0,998,45,-0.616131982806748,0.7662151556430521
34,1572966000,518,371,0,889,45,-0.616131982806748,0.49842883741006544
34,1572980400,677,523,0,1200,45,-0.616131982806748,1.2624797086986788
34,1572994800,228,430,202,658,45,2.800380266953023,-0.06908161682681453
34,1573009200,54,116,62,170,45,0.4325004898917956,-1.267978160842388
34,1573023600,116,135,19,251,45,-0.2947768702055814,-1.068980988577508
34,1573038000,573,500,0,1073,45,-0.616131982806748,0.9504717966290521
34,1573052400,437,378,0,815,45,-0.616131982806748,0.3166289516372121
34,1573066800,815,595,0,1410,45,-0.616131982806748,1.7783983034594788
34,1573081200,326,470,144,796,45,1.8194015021705146,0.2699506025874255
34,1573095600,94,264,170,358,45,2.259150603624742,-0.8061081807708145
34,1573110000,131,132,1,263,45,-0.5992185558277392,-1.039499926019748
34,1573124400,643,521,0,1164,45,-0.616131982806748,1.1740365210253987
34,1573138800,496,355,0,851,45,-0.616131982806748,0.40507213931049213
34,1573153200,865,712,0,1577,45,-0.616131982806748,2.188676424054972
34,1573167600,429,510,81,939,45,0.7538556024929622,0.6212665980673988
34,1573182000,93,301,208,394,45,2.9018608288270755,-0.7176649930975345
34,1573196400,102,126,24,228,45,-0.21020973531053758,-1.125486358479881
34,1573210800,648,526,0,1174,45,-0.616131982806748,1.1986040731568655
34,1573225200,491,391,0,882,45,-0.616131982806748,0.48123155091803876
34,1573239600,748,662,0,1410,45,-0.616131982806748,1.7783983034594788
34,1573254000,343,425,82,768,45,0.770769029471971,0.20116145661931878
34,1573268400,108,220,112,328,45,1.278171838842234,-0.8798108371652145
34,1573282800,50,53,3,103,45,-0.5653917018697217,-1.4325807601232146
34,1573297200,245,194,0,439,45,-0.616131982806748,-0.6071110085059346
34,1573311600,474,299,0,773,45,-0.616131982806748,0.21344523268505214
34,1573326000,488,462,0,950,45,-0.616131982806748,0.6482909054120121
34,1573340400,312,306,0,618,45,-0.616131982806748,-0.1673518253526812
34,1573354800,95,204,109,299,45,1.2274315579052077,-0.9510567383464679
34,1573369200,21,35,14,56,45,-0.37934400510062527,-1.5480482551411079
34,1573383600,181,150,0,331,45,-0.616131982806748,-0.8724405715257745
34,1573398000,452,393,0,845,45,-0.616131982806748,0.3903316080316121
34,1573412400,493,416,0,909,45,-0.616131982806748,0.5475639416729988
34,1573426800,216,281,65,497,45,0.4832407708288219,-0.4646192061434279
34,1573441200,63,99,36,162,45,-0.007248611562432363,-1.2876322025475613
34,1573455600,65,69,4,134,45,-0.548478274890713,-1.3564213485156678
34,1573470000,521,423,0,944,45,-0.616131982806748,0.6335503741331321
34,1573484400,361,309,0,670,45,-0.616131982806748,-0.03960055426905454
34,1573498800,704,621,0,1325,45,-0.616131982806748,1.569574110342012
34,1573513200,304,431,127,735,45,1.5318732435273654,0.1200885345854788
34,1573527600,94,194,100,288,46,0.8340143823159146,-0.9408091367343963
34,1573542000,124,119,0,243,46,-0.7876802499650304,-1.0541524098366406
34,1573556400,665,545,0,1210,46,-0.7876802499650304,1.3814685921604763
34,1573570800,426,333,0,759,46,-0.7876802499650304,0.245517121735761
34,1573585200,822,515,0,1337,46,-0.7876802499650304,1.7013484962490326
34,1573599600,298,514,216,812,46,2.715180155761811,0.3790103100561821
34,1573614000,88,215,127,303,46,1.2718719330317698,-0.9030280457003148
34,1573628400,107,129,22,236,46,-0.4309074308632225,-1.0717835856525453
34,1573642800,630,563,0,1193,46,-0.7876802499650304,1.3386500223218507
34,1573657200,256,347,91,603,46,0.6880618654106295,-0.147406225018686
34,1573671600,737,548,0,1285,46,-0.7876802499650304,1.5703740473308836
34,1573686000,299,430,131,729,46,1.3367397183230074,0.16995493966759811
34,1573700400,85,235,150,320,46,1.644861698456387,-0.8602094758616892
34,1573714800,102,133,31,235,46,-0.28495491395793743,-1.0743023250548174
34,1573729200,526,522,0,1048,46,-0.7876802499650304,0.9734328089923968
34,1573743600,226,343,117,569,46,1.1097024698036753,-0.23304336469593726
34,1573758000,687,633,0,1320,46,-0.7876802499650304,1.658529926410407
34,1573772400,283,425,142,708,46,1.5151261278739114,0.1170614122198841
34,1573786800,93,257,164,350,46,1.8718989469757195,-0.7846472937935264
34,1573801200,106,143,37,249,46,-0.18765323602108075,-1.039039973423008
34,1573815600,617,494,0,1111,46,-0.7876802499650304,1.1321133913355388
34,1573830000,379,346,0,725,46,-0.7876802499650304,0.15987998205850973
34,1573844400,765,598,0,1363,46,-0.7876802499650304,1.7668357207081071
34,1573858800,335,467,132,802,46,1.3529566646458169,0.35382291603346117
34,1573873200,106,205,99,311,46,0.8177974359931052,-0.882878130482138
34,1573887600,53,56,3,109,46,-0.739029410996602,-1.3916634897411015
34,1573902000,279,195,0,474,46,-0.7876802499650304,-0.4723236079117864
34,1573916400,388,303,0,691,46,-0.7876802499650304,0.07424284238125847
34,1573930800,407,371,0,778,46,-0.7876802499650304,0.29337317037893085
34,1573945200,241,357,116,598,46,1.0934855234808658,-0.15999992203004648
34,1573959600,76,197,121,273,46,1.174570255094913,-0.9785902277684777
34,1573974000,41,46,5,87,46,-0.7065955183509831,-1.4470757565910877
34,1573988400,195,152,0,347,46,-0.7876802499650304,-0.7922035120003427
34,1574002800,378,299,0,677,46,-0.7876802499650304,0.03898049074944912
34,1574017200,368,359,0,727,46,-0.7876802499650304,0.16491746086305392
34,1574031600,189,242,53,431,46,0.07181790514387046,-0.5806294022094866
34,1574046000,44,76,32,120,46,-0.268737967635128,-1.3639573563161085
34,1574060400,89,105,16,194,46,-0.5282091088000792,-1.1775706405479733
34,1574074800,606,538,0,1144,46,-0.7876802499650304,1.215231791610518
34,1574089200,314,327,13,641,46,-0.5768599477685076,-0.05169412773234634
34,1574103600,922,604,0,1526,46,-0.7876802499650304,2.1773902432784586
34,1574118000,368,490,122,858,46,1.1907872014177225,0.4948723225606985
34,1574132400,88,253,165,341,47,1.5122272653911941,-0.8853091882122134
34,1574146800,126,139,13,265,47,-0.599334165548741,-1.0711996584643766
34,1574161200,803,507,0,1310,47,-0.7799282353001827,1.4847943075028676
34,1574175600,465,349,0,814,47,-0.7799282353001827,0.27161439638348656
34,1574190000,931,603,0,1534,47,-0.7799282353001827,2.032682009298717
34,1574204400,374,487,113,861,47,0.7898509863854267,0.38657297667100854
34,1574218800,101,253,152,354,47,1.3316331956397522,-0.8535121340901328
34,1574233200,108,146,38,254,47,-0.252037877565199,-1.098104858106137
34,1574247600,638,547,0,1185,47,-0.7799282353001827,1.1790534024828623
34,1574262000,252,334,82,586,47,0.35920358928583473,-0.28605701437300307
34,1574276400,699,666,0,1365,47,-0.7799282353001827,1.6193203057116698
34,1574290800,313,526,213,839,47,2.1790361383195944,0.3327625773874876
34,1574305200,100,364,264,464,47,2.88752056580602,-0.5844601376725281
34,1574319600,97,154,57,251,47,0.011907301302292823,-1.105442639826617
34,1574334000,616,519,0,1135,47,-0.7799282353001827,1.05675704047486
34,1574348400,256,326,70,582,47,0.19250137105373463,-0.2958407233336432
34,1574362800,785,586,0,1371,47,-0.7799282353001827,1.63399586915263
34,1574377200,406,543,137,949,47,1.123255422849627,0.6018145738050923
34,1574391600,107,282,175,389,47,1.6511457805846108,-0.7679046806845313
34,1574406000,102,129,27,231,47,-0.40484824427795746,-1.154361184629818
34,1574420400,665,503,0,1168,47,-0.7799282353001827,1.1374726394001415
34,1574434800,383,371,0,754,47,-0.7799282353001827,0.12485876197388403
34,1574449200,784,677,0,1461,47,-0.7799282353001827,1.8541293207670337
34,1574463600,425,472,47,897,47,-0.12701121389112394,0.47462635731677005
34,1574478000,109,261,152,370,47,1.3316331956397522,-0.8143772982475721
34,1574492400,51,63,12,114,47,-0.6132260170680827,-1.440534671728543
34,1574506800,237,186,0,423,47,-0.7799282353001827,-0.68474315451909
34,1574521200,402,349,0,751,47,-0.7799282353001827,0.1175209802534039
34,1574535600,487,499,12,986,47,-0.6132260170680827,0.6923138816910138
34,1574550000,294,416,122,710,47,0.914877650059502,0.017237963406842177
34,1574564400,82,186,104,268,47,0.6648243227113516,-1.0638618767438965
34,1574578800,31,40,9,71,47,-0.6549015716261076,-1.5457095430554249
34,1574593200,178,178,0,356,47,-0.7799282353001827,-0.8486202796098128
34,1574607600,377,329,0,706,47,-0.7799282353001827,0.007454254446202006
34,1574622000,348,401,53,749,47,-0.043660104775073885,0.11262912577308382
34,1574636400,172,304,132,476,47,1.0537961652529186,-0.5551090107906077
34,1574650800,59,81,22,140,47,-0.47430750187466586,-1.3769405634843819
34,1574665200,103,108,5,211,47,-0.7104689777034744,-1.2032797294330189
34,1574679600,581,522,0,1103,47,-0.7799282353001827,0.9784873687897387
34,1574694000,418,364,0,782,47,-0.7799282353001827,0.1933447246983652
34,1574708400,728,562,0,1290,47,-0.7799282353001827,1.4358757626996665
34,1574722800,238,420,182,658,47,1.7483887412200025,-0.10995025308148001
34,1574737200,67,129,62,196,48,0.4581389777537323,-0.9389831260035462
34,1574751600,111,128,17,239,48,-0.5039528755291054,-0.8121561477997914
34,1574766000,628,576,0,1204,48,-0.8674097978803996,2.034077200261215
34,1574780400,452,312,0,764,48,-0.8674097978803996,0.7363127721297718
34,1574794800,740,549,0,1289,48,-0.8674097978803996,2.284781692059335
34,1574809200,286,418,132,704,48,1.954726305082591,0.5593448955663931
34,1574823600,61,163,102,224,48,1.3133317362273658,-0.8563981169406361
34,1574838000,100,116,16,216,48,-0.5253326944909462,-0.8799938338157532
34,1574852400,513,415,0,928,48,-0.8674097978803996,1.2200249680696735
34,1574866800,534,287,0,821,48,-0.8674097978803996,0.9044322548649815
34,1574881200,606,537,0,1143,48,-0.8674097978803996,1.854159859088447
34,1574895600,223,331,108,554,48,1.441610649998411,0.11692520415794651
34,1574910000,46,154,108,200,48,1.441610649998411,-0.9271852675659875
34,1574924400,41,41,0,82,48,-0.8674097978803996,-1.2752220914739656
34,1574938800,211,126,0,337,48,-0.8674097978803996,-0.5231086160796062
34,1574953200,240,255,15,495,48,-0.546712513452787,-0.057093207796042496
34,1574967600,256,255,0,511,48,-0.8674097978803996,-0.009901774045808187
34,1574982000,137,257,120,394,48,1.6981684775405008,-0.3549891333443966
34,1574996400,56,183,127,239,48,1.8478272102733868,-0.8121561477997914
34,1575010800,50,61,11,111,48,-0.6322317893001504,-1.1896876178016658
34,1575025200,229,175,0,404,48,-0.8674097978803996,-0.3254944872505001
34,1575039600,361,268,0,629,48,-0.8674097978803996,0.33813504986216986
34,1575054000,373,429,56,802,48,0.32986006398268725,0.8483924272865783
34,1575068400,184,287,103,471,48,1.3347115551892066,-0.12788035842139395
34,1575082800,54,138,84,192,48,0.9284949949142307,-0.9507809844411047
34,1575097200,52,55,3,107,48,-0.8032703409948772,-1.2014854762392244
34,1575111600,174,126,0,300,48,-0.8674097978803996,-0.6322388066270231
34,1575126000,327,259,0,586,48,-0.8674097978803996,0.21130807165841514
34,1575140400,299,392,93,691,48,1.1209133655707983,0.5210018556443278
34,1575154800,239,332,93,571,48,1.1209133655707983,0.16706610251757045
34,1575169200,60,174,114,234,48,1.5698895637694559,-0.8269034708467397
34,1575183600,24,47,23,71,48,-0.3756739617580604,-1.3076662021772516
34,1575198000,159,159,0,318,48,-0.8674097978803996,-0.5791484436580095
34,1575212400,308,278,0,586,48,-0.8674097978803996,0.21130807165841514
34,1575226800,249,315,66,564,48,0.5436582536010957,0.14641985025184295
34,1575241200,151,241,90,392,48,1.0567739086852757,-0.36088806256317585
34,1575255600,31,87,56,118,48,0.32986006398268725,-1.1690413655359384
34,1575270000,82,104,22,186,48,-0.3970537807199012,-0.9684777720974426
34,1575284400,578,490,0,1068,48,-0.8674097978803996,1.6329500133842236
34,1575298800,424,336,0,760,48,-0.8674097978803996,0.7245149136922132
34,1575313200,692,617,0,1309,48,-0.8674097978803996,2.343770984247128
34,1575327600,255,338,83,593,48,0.9071151759523899,0.23195432392414264
34,1575342000,48,127,79,175,49,1.025897062812987,-1.1560919108153793
34,1575356400,108,103,0,211,49,-0.6701300694309049,-1.0674638639080702
34,1575370800,628,546,0,1174,49,-0.6701300694309049,1.303336390862443
34,1575385200,416,343,0,759,49,-0.6701300694309049,0.28165196123652075
34,1575399600,762,585,0,1347,49,-0.6701300694309049,1.7292433940558996
34,1575414000,284,449,165,733,49,2.8722050801924137,0.21764281624790874
34,1575428400,57,145,88,202,49,1.2191153437015319,-1.0896208756348975
34,1575442800,85,122,37,207,49,0.12421175199977869,-1.077311424675549
34,1575457200,591,493,0,1084,49,-0.6701300694309049,1.0817662735941704
34,1575471600,410,309,0,719,49,-0.6701300694309049,0.18317635356173306
34,1575486000,845,528,0,1373,49,-0.6701300694309049,1.7932525390445115
34,1575500400,242,405,163,647,49,2.829267684439404,0.005920259747115264
34,1575514800,52,118,66,170,49,0.7468039904184226,-1.1684013617747278
34,1575529200,95,118,23,213,49,-0.1763500182712908,-1.062540083524331
34,1575543600,535,509,0,1044,49,-0.6701300694309049,0.9832906659193829
34,1575558000,335,266,0,601,49,-0.6701300694309049,-0.10732668907889055
34,1575572400,760,576,0,1336,49,-0.6701300694309049,1.7021626019453329
34,1575586800,375,483,108,858,49,1.6484893012316308,0.5253790902316202
34,1575601200,65,165,100,230,49,1.4767397182195912,-1.020687950262546
34,1575615600,88,115,27,203,49,-0.09047522676527094,-1.087158985443028
34,1575630000,595,499,0,1094,49,-0.6701300694309049,1.1063851755128675
34,1575644400,394,306,0,700,49,-0.6701300694309049,0.13640043991620893
34,1575658800,761,564,0,1325,49,-0.6701300694309049,1.6750818098347662
34,1575673200,361,384,23,745,49,-0.1763500182712908,0.24718549855034505
34,1575687600,85,175,90,260,49,1.2620527394545418,-0.9468312445064554
34,1575702000,40,49,9,89,49,-0.47691178854236027,-1.3678144673161727
34,1575716400,287,180,0,467,49,-0.6701300694309049,-0.43721997478942926
34,1575730800,449,342,0,791,49,-0.6701300694309049,0.3604324473763509
34,1575745200,483,426,0,909,49,-0.6701300694309049,0.6509354900169745
34,1575759600,276,314,38,590,49,0.14568044987628365,-0.13440748118945717
34,1575774000,74,175,101,249,49,1.4982084160960962,-0.9739120366170221
34,1575788400,30,33,3,63,49,-0.60572397580139,-1.4318236123047847
34,1575802800,199,149,0,348,49,-0.6701300694309049,-0.7301849076219226
34,1575817200,379,346,0,725,49,-0.6701300694309049,0.1979476947129512
34,1575831600,370,333,0,703,49,-0.6701300694309049,0.143786110491818
34,1575846000,215,237,22,452,49,-0.19781871614779575,-0.4741483276674746
34,1575860400,43,82,39,125,49,0.1671491477527886,-1.2791864204088639
34,1575874800,98,114,16,212,49,-0.32663090340682555,-1.0650019737162006
34,1575889200,624,512,0,1136,49,-0.6701300694309049,1.2097845635713944
34,1575903600,434,328,0,762,49,-0.6701300694309049,0.2890376318121298
34,1575918000,752,630,0,1382,49,-0.6701300694309049,1.8154095507713386
34,1575932400,273,387,114,660,49,1.7773014884906606,0.03792483224142126
34,1575946800,80,120,40,200,50,0.13154509546832158,-1.2118721944629733
34,1575961200,99,123,24,222,50,-0.2097610981792156,-1.1554577701754127
34,1575975600,670,538,0,1208,50,-0.7217203886505213,1.3729341547125236
34,1575990000,464,312,0,776,50,-0.7217203886505213,0.2651600050658821
34,1576004400,811,571,0,1382,50,-0.7217203886505213,1.8191209649868654
34,1576018800,304,368,64,672,50,0.6435043859396273,-0.0015263642934945454
34,1576033200,47,123,76,170,50,0.8994840311752802,-1.2888009548551012
34,1576047600,101,115,14,216,50,-0.42307746920892636,-1.1708435222538385
34,1576062000,614,503,0,1117,50,-0.7217203886505213,1.139583581523069
34,1576076400,393,307,0,700,50,-0.7217203886505213,0.07027381207249148
34,1576090800,694,646,0,1340,50,-0.7217203886505213,1.7114207004378863
34,1576105200,320,429,109,749,50,1.6034280555733256,0.19592412071296703
34,1576119600,59,98,39,157,50,0.1102134583653505,-1.3221367510250233
34,1576134000,94,121,27,215,50,-0.14576618687030238,-1.1734078142669093
34,1576148400,580,504,0,1084,50,-0.7217203886505213,1.0549619450917285
34,1576162800,446,316,0,762,50,-0.7217203886505213,0.2292599168828891
34,1576177200,794,554,0,1348,50,-0.7217203886505213,1.7319350365424537
34,1576191600,353,441,88,794,50,1.1554636764109332,0.31131726130115883
34,1576206000,75,144,69,219,50,0.7501625714544827,-1.1631506462146255
34,1576220400,105,126,21,231,50,-0.27375600948812884,-1.1323791420577745
34,1576234800,549,455,0,1004,50,-0.7217203886505213,0.849818584046054
34,1576249200,519,352,0,871,50,-0.7217203886505213,0.5087677463076204
34,1576263600,811,565,0,1376,50,-0.7217203886505213,1.8037352129084399
34,1576278000,355,478,123,833,50,1.9020709750149205,0.4113246498109251
34,1576292400,70,232,162,302,50,2.7340048220307924,-0.9503144091297384
34,1576306800,56,64,8,120,50,-0.5510672918267527,-1.4170155555086477
34,1576321200,240,198,0,438,50,-0.7217203886505213,-0.6015706953520921
34,1576335600,338,390,52,728,50,0.38752474070397447,0.14207398843847752
34,1576350000,448,554,106,1002,50,1.5394331442644122,0.8446900000199121
34,1576364400,329,372,43,701,50,0.1955400067772348,0.0728381040855624
34,1576378800,76,232,156,308,50,2.6060149994129658,-0.9349286570513129
34,1576393200,34,45,11,79,50,-0.4870723805178396,-1.5221515280445557
34,1576407600,183,120,0,303,50,-0.7217203886505213,-0.9477501171166676
34,1576422000,410,291,0,701,50,-0.7217203886505213,0.0728381040855624
34,1576436400,401,376,0,777,50,-0.7217203886505213,0.26772429707895307
34,1576450800,331,309,0,640,50,-0.7217203886505213,-0.08358370871176429
34,1576465200,232,354,122,586,50,1.8807393379119495,-0.2220554774175945
34,1576479600,117,105,0,222,50,-0.7217203886505213,-1.1554577701754127
34,1576494000,572,489,0,1061,50,-0.7217203886505213,0.995983228791097
34,1576508400,421,303,0,724,50,-0.7217203886505213,0.13181682038619377
34,1576522800,638,526,0,1164,50,-0.7217203886505213,1.2601053061374028
34,1576537200,340,407,67,747,50,0.7074992972485405,0.19079553668682517
34,1576551600,69,144,75,213,51,0.23866636068579622,-1.0985433548675747
34,1576566000,110,133,23,243,51,-0.4072411135865444,-1.0165867779753288
34,1576580400,590,548,0,1138,51,-0.6929309579762335,1.4284510993100132
34,1576594800,366,407,41,773,51,-0.18365775710765728,0.431312747121019
34,1576609200,679,572,0,1251,51,-0.6929309579762335,1.7371542056041402
34,1576623600,265,447,182,712,51,1.5677452019769587,0.26466770744011864
34,1576638000,66,163,97,229,51,0.5119349074933249,-1.0548331805250435
34,1576652400,104,127,23,231,51,-0.4072411135865444,-1.0493694087322272
34,1576666800,572,480,0,1052,51,-0.6929309579762335,1.1935089122189078
34,1576681200,450,332,0,782,51,-0.6929309579762335,0.45589972018869285
34,1576695600,759,553,0,1312,51,-0.6929309579762335,1.9037992452850405
34,1576710000,311,422,111,733,51,0.6858330736435705,0.3220373112646909
34,1576724400,43,115,72,158,51,0.20140246793931502,-1.248797079170026
34,1576738800,103,124,21,227,51,-0.4320837087508652,-1.06029695231786
34,1576753200,547,453,0,1000,51,-0.6929309579762335,1.0514508456056813
34,1576767600,406,318,0,724,51,-0.6929309579762335,0.29745033819701705
34,1576782000,760,580,0,1340,51,-0.6929309579762335,1.9802920503844703
34,1576796400,288,588,300,876,51,3.0334583166718856,0.7126969944510639
34,1576810800,66,194,128,260,51,0.8969951325402973,-0.9701447177363892
34,1576825200,105,124,19,229,51,-0.456926303915186,-1.0548331805250435
34,1576839600,498,488,0,986,51,-0.6929309579762335,1.0132044430559664
34,1576854000,513,361,0,874,51,-0.6929309579762335,0.7072332226582475
34,1576868400,614,604,0,1218,51,-0.6929309579762335,1.6470019710226695
34,1576882800,242,543,301,785,51,3.045879614254046,0.46409537787791744
34,1576897200,73,217,144,290,51,1.0957358938548636,-0.8881881408441431
34,1576911600,46,61,15,107,51,-0.5066114942438276,-1.3881232598868443
34,1576926000,214,147,0,361,51,-0.6929309579762335,-0.6942242421991607
34,1576940400,352,305,0,657,51,-0.6929309579762335,0.11441398313766744
34,1576954800,352,380,28,732,51,-0.34513462567574243,0.3193054253682827
34,1576969200,219,343,124,562,51,0.8473099422116558,-0.14511517702111187
34,1576983600,66,215,149,281,51,1.1578423817656656,-0.912775113911817
34,1576998000,36,49,13,85,51,-0.5314540894081484,-1.4482247496078249
34,1577012400,173,123,0,296,51,-0.6929309579762335,-0.8717968254656939
34,1577026800,316,243,0,559,51,-0.6929309579762335,-0.15331083471033646
34,1577041200,346,318,0,664,51,-0.6929309579762335,0.13353718441252488
34,1577055600,151,319,168,470,51,1.3938470358267132,-0.3964486794906666
34,1577070000,45,108,63,153,51,0.08961078969987145,-1.262456508652067
34,1577084400,74,111,37,185,51,-0.23334294743629888,-1.1750361599670045
34,1577098800,348,286,0,634,51,-0.6929309579762335,0.05158060752027877
34,1577113200,441,322,0,763,51,-0.6929309579762335,0.403993888156937
34,1577127600,588,503,0,1091,51,-0.6929309579762335,1.3000524621788276
34,1577142000,195,404,209,599,51,1.9031202366952895,-0.04403539885400835
34,1577156400,47,144,97,191,52,0.5242217544749103,-0.89189401982151
34,1577170800,72,86,14,158,52,-0.4886295887976612,-1.0055878977707513
34,1577185200,292,211,0,503,52,-0.6594719840484564,0.18302991715313457
34,1577199600,372,279,0,651,52,-0.6594719840484564,0.6929297334103378
34,1577214000,329,406,77,735,52,0.28016118983091715,0.9823323318265882
34,1577228400,164,251,87,415,52,0.40219147215291373,-0.12015375737817541
34,1577242800,50,99,49,149,52,-0.061523600670673244,-1.036595319029635
34,1577257200,28,28,0,56,52,-0.6594719840484564,-1.3570053387047696
34,1577271600,113,84,0,197,52,-0.6594719840484564,-0.8712224056489206
34,1577286000,190,112,0,302,52,-0.6594719840484564,-0.5094691576286076
34,1577300400,196,196,0,392,52,-0.6594719840484564,-0.1993949450397678
34,1577314800,129,171,42,300,52,-0.14694479829607085,-0.5163596956861374
34,1577329200,25,84,59,109,52,0.06050668165132333,-1.1744060801802307
34,1577343600,70,110,40,180,52,-0.17135085476047016,-0.9297919791379237
34,1577358000,290,245,0,535,52,-0.6594719840484564,0.29327852607361093
34,1577372400,337,306,0,643,52,-0.6594719840484564,0.6653675811802187
34,1577386800,522,548,26,1070,52,-0.3421932500112654,2.136497456462825
34,1577401200,202,520,318,722,52,3.221090993791034,0.9375438344526447
34,1577415600,54,138,84,192,52,0.3655823874563148,-0.8884487507927451
34,1577430000,79,117,38,196,52,-0.19575691122486946,-0.8746676746776856
34,1577444400,303,243,0,546,52,-0.6594719840484564,0.3311764853900247
34,1577458800,440,353,0,793,52,-0.6594719840484564,1.1821579354949516
34,1577473200,491,570,79,1061,52,0.30456724629531645,2.105490035203941
34,1577487600,207,494,287,701,52,2.8427971185928453,0.8651931848485821
