remote_unit_id,time_stamp,entries,exits,num_people_exited,sum_exit_entry,week_num,z_score_num_people_exited,z_score_sum_exit_entry
330,1546311600,157,153,0,310,1,-0.6035215506830399,-0.6916577918450729
330,1546326000,61,84,23,145,1,-0.46059391695913293,-1.150072912109644
330,1546340400,36,116,80,152,1,-0.10638195512162435,-1.1306249979166016
330,1546354800,130,274,144,404,1,0.2913297213275081,-0.43050008696707487
330,1546369200,257,385,128,642,1,0.191901802215225,0.23072899559636706
330,1546383600,241,168,0,409,1,-0.6035215506830399,-0.4166087196863303
330,1546398000,91,20,0,111,1,-0.6035215506830399,-1.244534209618707
330,1546412400,20,106,86,126,1,-0.06909648545451819,-1.2028601077764733
330,1546426800,174,688,514,862,1,2.5906003507990554,0.8419491559491284
330,1546441200,260,357,97,617,1,-0.0007397910648235434,0.16127215919264418
330,1546455600,708,466,0,1174,1,-0.6035215506830399,1.7087704742675902
330,1546470000,485,230,0,715,1,-0.6035215506830399,0.4335429578952379
330,1546484400,84,64,0,148,1,-0.6035215506830399,-1.1417380917411972
330,1546498800,14,122,108,136,1,0.0676169033248711,-1.1750773732149842
330,1546513200,172,746,574,918,1,2.963455047470117,0.9975324694934677
330,1546527600,247,350,103,597,1,0.036545678602282625,0.10570669006966585
330,1546542000,691,422,0,1113,1,-0.6035215506830399,1.5392957934425062
330,1546556400,575,199,0,774,1,-0.6035215506830399,0.5974610918080239
330,1546570800,120,54,0,174,1,-0.6035215506830399,-1.0695029818813255
330,1546585200,16,110,94,126,1,-0.019382525898376628,-1.2028601077764733
330,1546599600,171,714,543,885,1,2.770813454190068,0.9058494454405536
330,1546614000,258,368,110,626,1,0.08004539321390648,0.1862766202979844
330,1546628400,729,530,0,1259,1,-0.6035215506830399,1.9449237180402479
330,1546642800,601,338,0,939,1,-0.6035215506830399,1.055876212072595
330,1546657200,219,112,0,331,1,-0.6035215506830399,-0.6333140492659457
330,1546671600,36,41,5,77,1,-0.5724503259604514,-1.3389955071277702
330,1546686000,87,280,193,367,1,0.5958277236088751,-0.5332962048445847
330,1546700400,274,464,190,738,1,0.577184988775322,0.49744324738666296
330,1546714800,475,489,14,964,1,-0.5165221214597921,1.1253330484763178
330,1546729200,431,398,0,829,1,-0.6035215506830399,0.7502661318962143
330,1546743600,202,119,0,321,1,-0.6035215506830399,-0.6610967838274349
330,1546758000,30,41,11,71,1,-0.5351648562933453,-1.3556651478646637
330,1546772400,59,236,177,295,1,0.496399804496592,-0.7333318936873067
330,1546786800,309,485,176,794,1,0.4901855595520743,0.6530265609310022
330,1546801200,468,460,0,928,1,-0.6035215506830399,1.025315204054957
330,1546815600,370,183,0,553,1,-0.6035215506830399,-0.016537342000886433
330,1546830000,104,40,0,144,1,-0.6035215506830399,-1.1528511855657928
330,1546844400,15,108,93,123,1,-0.02559677084289432,-1.2111949281449201
330,1546858800,213,801,588,1014,1,3.0504544766933646,1.2642467212837636
330,1546873200,260,288,28,548,1,-0.42952269223654443,-0.03042870928163101
330,1546887600,707,490,0,1197,1,-0.6035215506830399,1.7726707637590151
330,1546902000,569,251,0,820,1,-0.6035215506830399,0.725261670790874
330,1546916400,119,27,0,146,2,-0.597413045710393,-1.1597151140248059
330,1546930800,25,109,84,134,2,-0.1294099475871178,-1.1891413036641494
330,1546933771,20,106,86,126,2,-0.11826701667942076,-1.2087587634237118
330,1546945200,222,860,638,1082,2,2.9571819138449587,1.1355276778439822
330,1546945632,5,7,2,12,2,-0.586270114802696,-1.4883075649974744
330,1546959600,273,297,24,570,2,-0.4636978748180286,-0.11998974676800446
330,1546974000,728,433,0,1161,2,-0.597413045710393,1.32925009296966
330,1546988400,569,301,0,870,2,-0.597413045710393,0.6156649942155815
330,1547002800,138,59,0,197,2,-0.597413045710393,-1.0346538080575964
330,1547017200,19,142,123,161,2,0.08787720511297425,-1.1229323769756268
330,1547031600,218,842,624,1060,2,2.8791813974910796,1.081579663505186
330,1547046000,282,316,34,598,2,-0.4079832202795435,-0.05132863760953644
330,1547060400,718,516,0,1234,2,-0.597413045710393,1.508259413275666
330,1547074800,613,289,0,902,2,-0.597413045710393,0.6941348332538306
330,1547089200,126,50,0,176,2,-0.597413045710393,-1.0861496399264474
330,1547103600,16,117,101,133,2,-0.03469503487169305,-1.1915934861340947
330,1547118000,220,639,419,859,2,1.7370309794521344,0.5886909870461834
330,1547132400,229,324,95,553,2,-0.06812382759478414,-0.16167684875707433
330,1547146800,711,522,0,1233,2,-0.597413045710393,1.5058072308057204
330,1547161200,593,321,0,914,2,-0.597413045710393,0.7235610228931741
330,1547175600,146,54,0,200,2,-0.597413045710393,-1.0272972606477604
330,1547190000,28,97,69,125,2,-0.2129819293948455,-1.211210945893657
330,1547204400,221,776,555,997,2,2.494750281175532,0.9270921678986329
330,1547218800,272,355,83,627,2,-0.1349814130409663,0.01978465401887687
330,1547233200,695,657,0,1352,2,-0.597413045710393,1.7976169447292096
330,1547247600,594,426,0,1020,2,-0.597413045710393,0.9834923647073744
330,1547262000,232,108,0,340,2,-0.597413045710393,-0.6839917148554204
330,1547276400,31,51,20,82,2,-0.48598373663342265,-1.3166547921013043
330,1547290800,99,347,248,446,2,0.7843103868440384,-0.42406037304122
330,1547305200,278,540,262,818,2,0.8623109031979176,0.4881515057784266
330,1547319600,497,572,75,1069,2,-0.1795531366717544,1.1036493057346934
330,1547334000,522,470,0,992,2,-0.597413045710393,0.9148312555489064
330,1547348400,268,153,0,421,2,-0.597413045710393,-0.48536493478985215
330,1547362800,34,31,0,65,2,-0.597413045710393,-1.3583418940903742
330,1547377200,67,271,204,338,2,0.5391659068747039,-0.688896079795311
330,1547391600,311,524,213,835,2,0.5893090959593404,0.5298386077674965
330,1547406000,511,473,0,984,2,-0.597413045710393,0.8952137957893442
330,1547420400,367,198,0,565,2,-0.597413045710393,-0.1322506591177309
330,1547434800,84,28,0,112,2,-0.597413045710393,-1.2430893180029456
330,1547449200,16,121,105,137,2,-0.012409173056299,-1.1817847562543136
330,1547463600,195,780,585,975,2,2.6618942447909877,0.8731441535598367
330,1547478000,261,330,69,591,2,-0.2129819293948455,-0.06849391489915345
330,1547492400,741,498,0,1239,2,-0.597413045710393,1.5205203256253923
330,1547506800,544,238,0,782,2,-0.597413045710393,0.39987293686039627
330,1547521200,56,29,0,85,3,-0.6677657341424585,-1.261569862150092
330,1547535600,25,144,119,169,3,0.07326874027396423,-1.039970030517748
330,1547541545,71,342,271,413,3,1.0198001697806554,-0.39627528149046304
330,1547541629,50,258,208,308,3,0.6274878009719611,-0.673275071030893
330,1547550000,134,501,367,635,3,1.6176094936796181,0.18938141639501746
330,1547564400,265,360,95,625,3,-0.0761835907007765,0.16300048405783363
330,1547578800,708,477,0,1185,3,-0.6677657341424585,1.6403326949401267
330,1547593200,613,267,0,880,3,-0.6677657341424585,0.8357142586560207
330,1547607600,95,41,0,136,3,-0.6677657341424585,-1.1270271072304545
330,1547621967,24,127,103,151,3,-0.02636614704252959,-1.0874557087246788
330,1547622000,23,75,52,98,3,-0.34395235036385363,-1.2272746501117529
330,1547633471,191,694,503,885,3,2.4645060358698156,0.8489047248246125
330,1547636400,131,532,401,663,3,1.8293336292271676,0.26324802693913213
330,1547650800,274,352,78,626,3,-0.18204565847455118,0.165638577291552
330,1547665200,690,529,0,1219,3,-0.6677657341424585,1.7300278648865517
330,1547679600,640,316,0,956,3,-0.6677657341424585,1.0362093444186176
330,1547694000,140,42,0,182,3,-0.6677657341424585,-1.0056748184794089
330,1547708400,31,109,78,140,3,-0.18204565847455118,-1.116474734295581
330,1547722800,219,852,633,1071,3,3.274039495316328,1.3395900662962315
330,1547737200,256,348,92,604,3,-0.09486513207261908,0.10760052614974765
330,1547751600,700,574,0,1274,3,-0.6677657341424585,1.8751229927410626
330,1547766000,607,318,0,925,3,-0.6677657341424585,0.9544284541733478
330,1547780400,144,64,0,208,3,-0.6677657341424585,-0.9370843944027311
330,1547794800,21,80,59,101,3,-0.3003620871628876,-1.2193603704105977
330,1547797513,18,75,57,93,3,-0.3128164480774493,-1.2404651162803448
330,1547809200,194,824,630,1018,3,3.2553579539444857,1.1997711249091572
330,1547823600,302,354,52,656,3,-0.34395235036385363,0.24478137430310343
330,1547838000,733,594,0,1327,3,-0.6677657341424585,2.014941934128137
330,1547852400,593,368,0,961,3,-0.6677657341424585,1.0493998105872095
330,1547866800,261,146,0,407,3,-0.6677657341424585,-0.4121038408927733
330,1547881200,40,60,20,100,3,-0.5432221249968412,-1.2219984636443162
330,1547895600,87,327,240,414,3,0.8267575756049486,-0.39363718825674465
330,1547910000,328,504,176,832,3,0.42821802633897343,0.7090857834375385
330,1547924400,545,558,13,1103,3,-0.5868123881978072,1.4240090497752196
330,1547938800,424,353,0,777,3,-0.6677657341424585,0.5639906555830275
330,1547953200,183,97,0,280,3,-0.6677657341424585,-0.7471416815750077
330,1547967600,25,37,12,62,3,-0.5930395686550881,-1.3222460065256145
330,1547982000,56,214,158,270,3,0.3161287781079179,-0.7735226139121915
330,1547996400,276,529,253,805,3,0.9077109215495998,0.6378572661271421
330,1548010800,422,500,78,922,3,-0.18204565847455118,0.9465141744721927
330,1548025200,387,248,0,635,3,-0.6677657341424585,0.18938141639501746
330,1548039600,129,44,0,173,3,-0.6677657341424585,-1.0294176575828744
330,1548054000,11,54,43,65,3,-0.3999969744793814,-1.3143317268244594
330,1548068400,94,273,179,367,3,0.446899567710816,-0.5176275702415085
330,1548082800,201,271,70,472,3,-0.2318631021327981,-0.2406277807010786
330,1548097200,391,359,0,750,3,-0.6677657341424585,0.4927621382726312
330,1548111600,282,161,0,443,3,-0.6677657341424585,-0.3171324844789116
330,1548126000,67,20,0,87,4,-0.6619552176608678,-1.365438081097338
330,1548140400,20,116,96,136,4,-0.10651246052946024,-1.242525279842866
330,1548154800,238,749,511,987,4,2.294620291653187,0.8921439827603124
330,1548169200,250,374,124,624,4,0.055491676967200296,-0.018414116328940005
330,1548183600,727,525,0,1252,4,-0.6619552176608678,1.5568764793406205
330,1548198000,620,290,0,910,4,-0.6619552176608678,0.6989952950747134
330,1548212400,128,33,0,161,4,-0.6619552176608678,-1.1798146669579312
330,1548226800,9,24,15,33,4,-0.5751672868590854,-1.5008930049287972
330,1548241200,160,812,652,972,4,3.110426841189942,0.8545176150293515
330,1548255600,233,526,293,759,4,1.0333023640006156,0.32022319324970755
330,1548270000,701,448,0,1149,4,-0.6619552176608678,1.2985087542546894
330,1548284400,656,276,0,932,4,-0.6619552176608678,0.754180634413456
330,1548298800,152,38,0,190,4,-0.6619552176608678,-1.107070356011407
330,1548313200,21,123,102,144,4,-0.07179728820874727,-1.2224578837196869
330,1548327600,216,734,518,950,4,2.3351213260273522,0.7993322756906089
330,1548342000,228,356,128,584,4,0.07863512518100894,-0.11875109694483559
330,1548356400,629,518,0,1147,4,-0.6619552176608678,1.2934919052238947
330,1548370800,616,347,0,963,4,-0.6619552176608678,0.831941794390775
330,1548385200,145,50,0,195,4,-0.6619552176608678,-1.09452823343442
330,1548399600,29,102,73,131,4,-0.23958728775885996,-1.255067402419853
330,1548407619,112,466,354,578,4,1.3862399492611976,-0.13380164403721992
330,1548408270,14,35,21,49,4,-0.5404521145383724,-1.460758212682439
330,1548414000,134,476,342,610,4,1.3168096046197717,-0.053532059544503456
330,1548428400,283,390,107,673,4,-0.04286797794148646,0.10449868492553208
330,1548442800,678,602,0,1280,4,-0.6619552176608678,1.6271123657717474
330,1548457200,598,457,0,1055,4,-0.6619552176608678,1.062716849807335
330,1548471600,212,113,0,325,4,-0.6619552176608678,-0.7684330464327594
330,1548486000,34,52,18,86,4,-0.5578097006987289,-1.3679465056127356
330,1548500400,96,351,255,447,4,0.8134396059694335,-0.4624052555542779
330,1548514800,348,476,128,824,4,0.07863512518100894,0.48327078675053786
330,1548529200,564,649,85,1213,4,-0.170156943117434,1.4590479232401223
330,1548543600,507,455,0,962,4,-0.6619552176608678,0.8294333698753776
330,1548558000,251,166,0,417,4,-0.6619552176608678,-0.5376579910161996
330,1548572400,56,45,0,101,4,-0.6619552176608678,-1.3303201378817746
330,1548586800,86,291,205,377,4,0.5241465032968254,-0.6379949716320952
330,1548601200,285,548,263,833,4,0.8597265023970508,0.5058466073891144
330,1548615600,574,520,0,1094,4,-0.6619552176608678,1.160545405907833
330,1548630000,406,210,0,616,4,-0.6619552176608678,-0.03848151245211912
330,1548644400,116,31,0,147,4,-0.6619552176608678,-1.2149326101734947
330,1548658800,20,144,124,164,4,0.055491676967200296,-1.172289393411739
330,1548673200,214,780,566,994,4,2.612842704593056,0.9097029543680941
330,1548687600,267,321,54,588,4,-0.34951866677445104,-0.10871739888324602
330,1548702000,699,478,0,1177,4,-0.6619552176608678,1.3687446406858164
330,1548716400,604,259,0,863,4,-0.6619552176608678,0.581099342851036
330,1548730800,19,14,0,33,5,-0.5128724680332742,-0.9183440438178895
330,1548745200,15,120,105,135,5,0.08301512670945176,-0.6961174520283577
330,1548759600,233,851,618,1084,5,2.994351661023913,1.371461328444835
330,1548774000,304,357,53,661,5,-0.21209111068694592,0.4498745801411885
330,1548788400,676,506,0,1182,5,-0.5128724680332742,1.5849731519288948
330,1548802800,565,327,0,892,5,-0.5128724680332742,0.9531524497821868
330,1548817200,17,16,0,33,5,-0.5128724680332742,-0.9183440438178895
330,1548831600,20,112,92,132,5,0.009238567360352338,-0.7026535282574615
330,1548846000,229,801,572,1030,5,2.7332961433270997,1.253811956320965
330,1548860400,276,306,30,582,5,-0.3426188695353526,0.27775790610811973
330,1548874800,672,611,0,1283,5,-0.5128724680332742,1.8050210516420586
330,1548889200,523,323,0,846,5,-0.5128724680332742,0.8529326142692608
330,1548903600,21,11,0,32,5,-0.5128724680332742,-0.9205227358942574
330,1548918000,16,103,87,119,5,-0.019137032389301284,-0.730976525250245
330,1548932400,248,621,373,869,5,1.6039472732908857,0.9030425320257238
330,1548946800,203,306,103,509,5,0.07166488680959031,0.11871338453325876
330,1548961200,536,514,0,1050,5,-0.5128724680332742,1.2973857978483243
330,1548975600,504,285,0,789,5,-0.5128724680332742,0.7287471659162871
330,1548990000,3,9,6,12,5,-0.47882174833368996,-0.9640965774216166
330,1549004400,18,98,80,116,5,-0.05886287203881635,-0.7375126014793489
330,1549013421,135,524,389,659,5,1.6947491924897773,0.4455171959884525
330,1549018800,114,548,434,662,5,1.9501295902366598,0.4520532722175564
330,1549033200,273,379,106,652,5,0.08869024665938248,0.4302663514538768
330,1549047600,649,602,0,1251,5,-0.5128724680332742,1.735302905198284
330,1549062000,598,411,0,1009,5,-0.5128724680332742,1.208059422717238
330,1549076400,24,19,0,43,5,-0.5128724680332742,-0.8965571230542099
330,1549090800,0,0,0,0,5,-0.5128724680332742,-0.9902408823380321
330,1549105200,1,0,0,1,5,-0.5128724680332742,-0.9880621902616641
330,1549119600,0,0,0,0,5,-0.5128724680332742,-0.9902408823380321
330,1549134000,0,0,0,0,5,-0.5128724680332742,-0.9902408823380321
330,1549148400,0,1,1,1,5,-0.5071973480833436,-0.9880621902616641
330,1549162800,0,1,1,1,5,-0.5071973480833436,-0.9880621902616641
330,1549177200,0,1,1,1,5,-0.5071973480833436,-0.9880621902616641
330,1549191600,0,2,2,2,5,-0.5015222281334129,-0.9858834981852962
330,1549206000,0,6,6,6,5,-0.47882174833368996,-0.9771687298798243
330,1549220400,0,1,1,1,5,-0.5071973480833436,-0.9880621902616641
330,1549234800,0,0,0,0,5,-0.5128724680332742,-0.9902408823380321
330,1549249200,2,1,0,3,5,-0.5128724680332742,-0.9837048061089282
330,1549263600,19,116,97,135,5,0.03761416711000596,-0.6961174520283577
330,1549278000,203,854,651,1057,5,3.181630619371627,1.3126366423829
330,1549292400,267,345,78,612,5,-0.0702131119386778,0.3431186683991585
330,1549306800,767,432,0,1199,5,-0.5128724680332742,1.6220109172271502
330,1549321200,611,249,0,860,5,-0.5128724680332742,0.8834343033384122
330,1549335600,15,15,0,30,6,-0.45637560723168985,-0.7237332957084296
330,1549350000,13,89,76,102,6,0.008606947375648813,-0.5677743325790525
330,1549362820,206,755,549,961,6,2.902511530655533,1.2929027414228202
330,1549364400,120,451,331,571,6,1.5687457819134298,0.4481250244720282
330,1549378800,258,425,167,683,6,0.5653623746028569,0.6907278560066147
330,1549393200,641,437,0,1078,6,-0.45637560723168985,1.546336056508058
330,1549407600,693,290,0,983,6,-0.45637560723168985,1.3405568690456855
330,1549422000,25,16,0,41,6,-0.45637560723168985,-0.699906231896997
330,1549436400,19,86,67,105,6,-0.04645677619627287,-0.5612760424486618
330,1549450800,255,624,369,879,6,1.8012370592170992,1.115282811192141
330,1549465200,304,757,453,1061,6,2.3151651458883684,1.5095124124358439
330,1549475026,255,239,0,494,6,-0.45637560723168985,0.281335577792
330,1549475106,4,0,0,4,6,-0.45637560723168985,-0.7800518101718157
330,1549475187,3,3,0,6,6,-0.45637560723168985,-0.7757196167515552
330,1549475267,4,1,0,5,6,-0.45637560723168985,-0.7778857134616854
330,1549475348,4,1,0,5,6,-0.45637560723168985,-0.7778857134616854
330,1549475428,2,4,2,6,6,-0.44413922421570723,-0.7757196167515552
330,1549475509,5,1,0,6,6,-0.45637560723168985,-0.7757196167515552
330,1549475592,2,0,0,2,6,-0.45637560723168985,-0.7843840035920762
330,1549475682,4,6,2,10,6,-0.44413922421570723,-0.7670552299110343
330,1549475762,4,5,1,9,6,-0.45025741572369854,-0.7692213266211645
330,1549475844,4,3,0,7,6,-0.45637560723168985,-0.773553520041425
330,1549475923,3,1,0,4,6,-0.45637560723168985,-0.7800518101718157
330,1549476004,2,1,0,3,6,-0.45637560723168985,-0.7822179068819459
330,1549476084,3,0,0,3,6,-0.45637560723168985,-0.7822179068819459
330,1549476166,3,1,0,4,6,-0.45637560723168985,-0.7800518101718157
330,1549476246,4,3,0,7,6,-0.45637560723168985,-0.773553520041425
330,1549479600,696,508,0,1204,6,-0.45637560723168985,1.8192642419844676
330,1549494000,616,300,0,916,6,-0.45637560723168985,1.1954283894669597
330,1549508400,25,33,8,58,6,-0.4074300751677594,-0.6630825878247829
330,1549522800,16,97,81,113,6,0.0391979049156053,-0.5439472687676199
330,1549537200,183,796,613,979,6,3.2940757871669755,1.3318924822051645
330,1549551600,252,440,188,692,6,0.6938443962706742,0.7102227263977868
330,1549566000,687,441,0,1128,6,-0.45637560723168985,1.6546408920145697
330,1549580400,708,293,0,1001,6,-0.45637560723168985,1.3795466098280298
330,1549594800,32,20,0,52,6,-0.45637560723168985,-0.6760791680855643
330,1549609200,18,106,88,124,6,0.08202524547154438,-0.5201202049561874
330,1549623600,234,784,550,1018,6,2.908629722163524,1.4163702539002438
330,1549638000,303,394,91,697,6,0.10037981999551827,0.7210532099484379
330,1549652400,732,640,0,1372,6,-0.45637560723168985,2.183168489286347
330,1549666800,653,461,0,1114,6,-0.45637560723168985,1.6243155380727463
330,1549681200,23,28,5,51,6,-0.42578464969173335,-0.6782452647956946
330,1549695600,0,2,2,2,6,-0.44413922421570723,-0.7843840035920762
330,1549710000,0,6,6,6,6,-0.41966645818374204,-0.7757196167515552
330,1549724400,1,6,5,7,6,-0.42578464969173335,-0.773553520041425
330,1549738800,0,1,1,1,6,-0.45025741572369854,-0.7865501003022064
330,1549753200,1,4,3,5,6,-0.4380210327077159,-0.7778857134616854
330,1549767600,1,2,1,3,6,-0.45025741572369854,-0.7822179068819459
330,1549782000,0,2,2,2,6,-0.44413922421570723,-0.7843840035920762
330,1549796400,0,2,2,2,6,-0.44413922421570723,-0.7843840035920762
330,1549810800,0,1,1,1,6,-0.45025741572369854,-0.7865501003022064
330,1549825200,1,1,0,2,6,-0.45637560723168985,-0.7843840035920762
330,1549839600,1,3,2,4,6,-0.44413922421570723,-0.7800518101718157
330,1549854000,1,3,2,4,6,-0.44413922421570723,-0.7800518101718157
330,1549868400,17,87,70,104,6,-0.028102201672298974,-0.563442139158792
330,1549882800,208,816,608,1024,6,3.263484829627019,1.429366834161025
330,1549897200,281,336,55,617,6,-0.11987507429216844,0.547765473138019
330,1549911600,728,459,0,1187,6,-0.45637560723168985,1.7824405979122537
330,1549926000,658,266,0,924,6,-0.45637560723168985,1.2127571631480016
330,1549940400,13,9,0,22,7,-0.4370122999160673,-0.7610491610953664
330,1549954800,20,120,100,140,7,0.15602539302334553,-0.5143999561261906
330,1549969200,256,763,507,1019,7,2.5696888032867555,1.322927596144195
330,1549983600,237,343,106,580,7,0.1916076545997103,0.4053089437588716
330,1549998000,577,548,0,1125,7,-0.4370122999160673,1.5444938311165055
330,1550012400,486,313,0,799,7,-0.4370122999160673,0.863073146201664
330,1550026800,11,16,5,27,7,-0.40736041526909667,-0.7505979235966724
330,1550041200,16,122,106,138,7,0.1916076545997103,-0.5185804511256682
330,1550055600,226,805,579,1031,7,2.996675942203133,1.3480105661410604
330,1550070000,286,383,97,669,7,0.13823426223516314,0.5913409712356228
330,1550084400,699,536,0,1235,7,-0.4370122999160673,1.7744210560877711
330,1550098800,687,343,0,1030,7,-0.4370122999160673,1.3459203186413216
330,1550113200,14,19,5,33,7,-0.40736041526909667,-0.7380564385982398
330,1550127600,18,76,58,94,7,-0.09305043801120787,-0.6105513411141744
330,1550142000,232,886,654,1118,7,3.441454211907693,1.529862098618334
330,1550156400,251,371,120,622,7,0.2746329316112281,0.4930993387479003
330,1550170800,761,593,0,1354,7,-0.4370122999160673,2.0231605085566855
330,1550185200,684,336,0,1020,7,-0.4370122999160673,1.325017843643934
330,1550199600,23,11,0,34,7,-0.4370122999160673,-0.735966191098501
330,1550214000,19,103,84,122,7,0.06113936215303947,-0.5520244111214886
330,1550228400,222,799,577,1021,7,2.984815188344345,1.3271080911436726
330,1550242800,322,370,48,692,7,-0.15235420730514915,0.6394166637296147
330,1550257200,711,474,0,1185,7,-0.4370122999160673,1.6699086811008321
330,1550271600,628,369,0,997,7,-0.4370122999160673,1.276942151149942
330,1550286000,25,21,0,46,7,-0.4370122999160673,-0.7108832211016357
330,1550300400,0,0,0,0,7,-0.4370122999160673,-0.8070346060896195
330,1550314800,0,8,8,8,7,-0.38956928448091427,-0.7903126260917093
330,1550329200,0,11,11,11,7,-0.37177815369273187,-0.7840418835924929
330,1550343600,0,8,8,8,7,-0.38956928448091427,-0.7903126260917093
330,1550358000,0,1,1,1,7,-0.4310819229866732,-0.8049443585898807
330,1550372400,3,2,0,5,7,-0.4370122999160673,-0.7965833685909256
330,1550386800,1,3,2,4,7,-0.42515154605727906,-0.7986736160906643
330,1550401200,0,3,3,3,7,-0.41922116912788493,-0.8007638635904032
330,1550415600,0,4,4,4,7,-0.4132907921984908,-0.7986736160906643
330,1550430000,0,2,2,2,7,-0.42515154605727906,-0.8028541110901419
330,1550444400,0,1,1,1,7,-0.4310819229866732,-0.8049443585898807
330,1550458800,1,2,1,3,7,-0.4310819229866732,-0.8007638635904032
330,1550473200,0,1,1,1,7,-0.4310819229866732,-0.8049443585898807
330,1550487600,0,2,2,2,7,-0.42515154605727906,-0.8028541110901419
330,1550502000,0,2,2,2,7,-0.42515154605727906,-0.8028541110901419
330,1550516400,3,2,0,5,7,-0.4370122999160673,-0.7965833685909256
330,1550530800,0,3,3,3,7,-0.41922116912788493,-0.8007638635904032
330,1550545200,2,2,0,4,8,-0.6369521084541309,-1.4578577990988797
330,1550559600,13,109,96,122,8,-0.11911948393814017,-1.1878170320736963
330,1550574000,197,719,522,916,8,2.1787627873515683,0.6292369426550793
330,1550588400,247,375,128,622,8,0.053491390900523364,-0.04357649383139425
330,1550602800,723,431,0,1154,8,-0.6369521084541309,1.1738954388584153
330,1550617200,671,333,0,1004,8,-0.6369521084541309,0.8306232773857246
330,1550631600,15,42,27,57,8,-0.49131168280900844,-1.3365683020451957
330,1550646000,16,103,87,119,8,-0.1676662924865143,-1.1946824753031502
330,1550660400,213,780,567,993,8,2.4214968300934387,0.805449985544394
330,1550674800,253,321,68,574,8,-0.27015399942197077,-0.15342358550265525
330,1550689200,564,543,0,1107,8,-0.6369521084541309,1.0663368282636387
330,1550703600,529,376,0,905,8,-0.6369521084541309,0.6040636508137488
330,1550718000,14,9,0,23,8,-0.6369521084541309,-1.414376658645672
330,1550732400,11,106,95,117,8,-0.12451357377684842,-1.1992594374561194
330,1550746800,203,714,511,917,8,2.1194277991257775,0.631525423731564
330,1550761200,264,361,97,625,8,-0.11372539409943194,-0.03671105060194044
330,1550775600,696,466,0,1162,8,-0.6369521084541309,1.192203287470292
330,1550790000,665,299,0,964,8,-0.6369521084541309,0.7390840343263404
330,1550804400,25,17,0,42,8,-0.6369521084541309,-1.3708955181924647
330,1550818800,12,88,76,100,8,-0.22700128071230488,-1.2381636157563576
330,1550833200,218,704,486,922,8,1.9845755531580718,0.642967829113987
330,1550847600,262,336,74,598,8,-0.23778946038972137,-0.09850003966702475
330,1550862000,700,537,0,1237,8,-0.6369521084541309,1.3638393682066374
330,1550876400,705,396,0,1101,8,-0.6369521084541309,1.052605941804731
330,1551495600,8576,9511,935,18087,9,3.724299510234617,4.111071719224477
330,1551510000,2,3,1,5,9,-0.39280486680801724,-0.2866643580985556
330,1551524400,0,14,14,14,9,-0.3355004161639549,-0.2844754616990474
330,1551538800,0,7,7,7,9,-0.36635665881845,-0.28617793667644265
330,1551553200,0,3,3,3,9,-0.3839887974781615,-0.28715077952066853
330,1551567600,2,4,2,6,9,-0.38839683214308934,-0.28642114738749913
330,1551582000,2,2,0,4,9,-0.3972129014729451,-0.28690756880961205
330,1551596400,1,2,1,3,9,-0.39280486680801724,-0.28715077952066853
330,1551610800,0,4,4,4,9,-0.3795807628132336,-0.28690756880961205
330,1551625200,0,10,10,10,9,-0.35313255482366634,-0.28544830454327325
330,1551639600,1,6,5,7,9,-0.3751727281483057,-0.28617793667644265
330,1551654000,3,4,1,7,9,-0.39280486680801724,-0.28617793667644265
330,1551668400,2,6,4,8,9,-0.3795807628132336,-0.2859347259653862
330,1551682800,11,94,83,105,9,-0.03134602428393156,-0.26234328699290893
330,1551697200,159,574,415,733,9,1.4321214844721226,-0.10960696044944775
330,1551711600,222,359,137,581,9,0.20668784762217363,-0.1465749885300307
330,1551726000,572,373,0,945,9,-0.3972129014729451,-0.05804628970547677
330,1551740400,532,245,0,777,9,-0.3972129014729451,-0.0989056891629632
330,1551754800,13,12,0,25,10,-0.5375501252928323,-0.9399994459467609
330,1551769200,21,92,71,113,10,-0.15709585475370397,-0.7553265354661776
330,1551783600,232,808,576,1040,10,2.5489521258415047,1.1900346919826947
330,1551798000,250,367,117,617,10,0.08939564446882992,0.3023455881953453
330,1551812400,661,535,0,1196,10,-0.5375501252928323,1.5174093969255469
330,1551826800,651,312,0,963,10,-0.5375501252928323,1.0284458953121844
330,1551841200,15,13,0,28,10,-0.5375501252928323,-0.9337037785440138
330,1551855600,19,122,103,141,10,0.014376492531536993,-0.6965669730405374
330,1551870000,249,844,595,1093,10,2.6507638320421165,1.3012581494312279
330,1551884400,252,329,77,581,10,-0.12494478963772128,0.22679757936237935
330,1551898800,698,538,0,1236,10,-0.5375501252928323,1.6013516289621756
330,1551913200,595,308,0,903,10,-0.5375501252928323,0.9025325472572412
330,1551927600,15,11,0,26,10,-0.5375501252928323,-0.9379008901458451
330,1551942000,18,111,93,129,10,-0.0392086159951008,-0.721749642651526
330,1551956400,251,880,629,1131,10,2.8329532010326854,1.381003269866025
330,1551970800,287,334,47,621,10,-0.28570011521763466,0.31073981139900814
330,1551985200,653,572,0,1225,10,-0.5375501252928323,1.5782675151521028
330,1551999600,605,290,0,895,10,-0.5375501252928323,0.8857441008499154
330,1552014000,4,25,21,29,10,-0.42502139738689293,-0.931605222743098
330,1552028400,20,108,88,128,10,-0.0660011702584197,-0.7238481984524417
330,1552042800,206,768,562,974,10,2.473932973904212,1.0515300091222572
330,1552057200,282,382,100,664,10,-0.001699040026454347,0.4009777108383841
330,1552071600,660,645,0,1305,10,-0.5375501252928323,1.7461519792253604
330,1552086000,567,409,0,976,10,-0.5375501252928323,1.0557271207240886
330,1552100400,16,18,2,34,10,-0.5268331035875048,-0.9211124437385194
330,1552114800,1,29,28,30,10,-0.38751182141824647,-0.9295066669421823
330,1552129200,2,23,21,25,10,-0.42502139738689293,-0.9399994459467609
330,1552143600,5,28,23,33,10,-0.4143043756815654,-0.9232109995394351
330,1552158000,4,26,22,30,10,-0.4196628865342292,-0.9295066669421823
330,1552172400,1,13,12,14,10,-0.47324799506086695,-0.9630835597568338
330,1552190400,0,15,15,15,10,-0.45717246250287563,-0.960985003955918
330,1552204800,0,21,21,21,10,-0.42502139738689293,-0.9483936691504238
330,1552219200,2,7,5,9,10,-0.5107575710295135,-0.9735763387614124
330,1552233600,5,26,21,31,10,-0.42502139738689293,-0.9274081111412665
330,1552248000,2,21,19,23,10,-0.4357384190922205,-0.9441965575485923
330,1552262400,0,11,11,11,10,-0.47860650591353077,-0.9693792271595809
330,1552276800,2,2,0,4,10,-0.5375501252928323,-0.984069117765991
330,1552291200,45,291,246,336,10,0.7806435444624575,-0.287348591861972
330,1552305600,201,761,560,962,10,2.4632159521988846,1.0263473395112686
330,1552320000,325,353,28,678,10,-0.38751182141824647,0.43035749205120416
330,1552334400,697,398,0,1095,10,-0.5375501252928323,1.3054552610330592
330,1552348800,483,153,0,636,11,-0.5341823777617016,0.33517126380990475
330,1552363200,2,5,3,7,11,-0.5172583195273606,-1.016462753489754
330,1552377600,52,305,253,357,11,0.8930798666677279,-0.2643611540384335
330,1552392000,247,773,526,1020,11,2.4331691659927643,1.160334161493639
330,1552406400,330,418,88,748,11,-0.03774333622103046,0.5758437756343273
330,1552420800,816,608,0,1424,11,-0.5341823777617016,2.0284742934317346
330,1552435200,439,224,0,663,11,-0.5341823777617016,0.39319053005329235
330,1552449600,0,14,14,14,11,-0.45520343933477664,-1.0014207215007276
330,1552464000,46,301,255,347,11,0.9043625721572885,-0.2858497711656141
330,1552478400,214,800,586,1014,11,2.7716503306795857,1.147440991217331
330,1552492800,360,356,0,716,11,-0.5341823777617016,0.5070802008273494
330,1552507200,764,512,0,1276,11,-0.5341823777617016,1.710442759949462
330,1552521600,477,177,0,654,11,-0.5341823777617016,0.3738507746388298
330,1552536000,0,0,0,0,11,-0.5341823777617016,-1.0315047854787802
330,1552550400,41,210,169,251,11,0.4192062361061782,-0.49214049558654765
330,1552564800,232,714,482,946,11,2.184949645222429,1.0013183947525028
330,1552579200,358,358,0,716,11,-0.5341823777617016,0.5070802008273494
330,1552593600,747,542,0,1289,11,-0.5341823777617016,1.7383779622147968
330,1552608000,527,204,0,731,11,-0.5341823777617016,0.5393131265181204
330,1552622400,0,3,3,3,11,-0.5172583195273606,-1.0250582003406261
330,1552636800,54,208,154,262,11,0.3345859449344729,-0.468503016746649
330,1552651200,201,743,542,944,11,2.52343080990925,0.9970206713270667
330,1552665600,372,363,0,735,11,-0.5341823777617016,0.5479085733689926
330,1552680000,774,511,0,1285,11,-0.5341823777617016,1.7297825153639246
330,1552694400,413,315,0,728,11,-0.5341823777617016,0.5328665413799661
330,1552708800,2,7,5,9,11,-0.5059756140377998,-1.012165030064318
330,1552723200,4,8,4,12,11,-0.5116169667825802,-1.0057184449261636
330,1552737600,1,12,11,13,11,-0.4721274975691177,-1.0035695832134455
330,1552752000,2,25,23,27,11,-0.40443126463175344,-0.9734855192353927
330,1552766400,1,24,23,25,11,-0.40443126463175344,-0.9777832426608288
330,1552780800,0,17,17,17,11,-0.43827938110043557,-0.9949741363625734
330,1552795200,0,7,7,7,11,-0.4946929085482391,-1.016462753489754
330,1552809600,0,3,3,3,11,-0.5172583195273606,-1.0250582003406261
330,1552824000,0,4,4,4,11,-0.5116169667825802,-1.022909338627908
330,1552838400,0,10,10,10,11,-0.47776885031389804,-1.0100161683515998
330,1552852800,0,8,8,8,11,-0.48905155580345877,-1.0143138917770358
330,1552867200,1,9,8,10,11,-0.48905155580345877,-1.0100161683515998
330,1552881600,1,4,3,5,11,-0.5172583195273606,-1.0207604769151901
330,1552896000,54,259,205,313,11,0.6222949349182709,-0.3589110693980281
330,1552910400,211,774,563,985,11,2.6418992175496374,1.085124001548507
330,1552924800,349,357,8,706,11,-0.48905155580345877,0.48559158370016886
330,1552939200,778,463,0,1241,11,-0.5341823777617016,1.63523260000433
330,1552953600,436,163,0,599,12,-0.599072407472367,-0.1235332801347553
330,1552968000,41,14,0,55,12,-0.599072407472367,-1.508463792656291
330,1552982400,49,291,242,340,12,0.6124222104243974,-0.7829027704712952
330,1552996800,210,803,593,1013,12,2.3695900239854066,0.9304395731445015
330,1553011200,348,353,5,701,12,-0.5740415269373099,0.13614119096303262
330,1553025600,765,489,0,1254,12,-0.599072407472367,1.5439841568167259
330,1553040000,495,195,0,690,12,-0.599072407472367,0.1081370813348398
330,1553054400,45,15,0,60,12,-0.599072407472367,-1.4957346519162031
330,1553068800,43,239,196,282,12,0.38213810950187194,-0.9305608030563118
330,1553083200,187,1048,861,1235,12,3.7112452206644684,1.4956134220043928
330,1553097600,347,347,0,694,12,-0.599072407472367,0.11832039392690992
330,1553112000,709,532,0,1241,12,-0.599072407472367,1.5108883908924982
330,1553126400,534,160,0,694,12,-0.599072407472367,0.11832039392690992
330,1553140800,46,23,0,69,12,-0.599072407472367,-1.4728221985840455
330,1553155200,48,241,193,289,12,0.36711958118083765,-0.9127400060201891
330,1553169600,240,764,524,1004,12,2.0241638726016187,0.9075271198123438
330,1553184000,309,337,28,646,12,-0.4588994764760471,-0.003879357177931458
330,1553198400,679,665,0,1344,12,-0.599072407472367,1.7731086901383035
330,1553212800,381,214,0,595,12,-0.599072407472367,-0.13371659272682543
330,1553227200,58,26,0,84,12,-0.599072407472367,-1.4346347763637826
330,1553241600,38,220,182,258,12,0.312051644003712,-0.9916606786087325
330,1553256000,261,722,461,983,12,1.708774777859899,0.8540647287039757
330,1553270400,387,390,3,777,12,-0.5840538791513328,0.3296241302123648
330,1553284800,736,608,0,1344,12,-0.599072407472367,1.7731086901383035
330,1553299200,606,331,0,937,12,-0.599072407472367,0.7369566338951694
330,1553313600,384,241,0,625,12,-0.599072407472367,-0.05734174828629956
330,1553328000,56,187,131,243,12,0.05673666254612944,-1.0298481008289955
330,1553342400,105,300,195,405,12,0.3771319333948605,-0.6174239408501558
330,1553356800,338,506,168,844,12,0.2419651785055521,0.5001946161295392
330,1553371200,473,579,106,1052,12,-0.06841774012915613,1.0297268709171852
330,1553385600,426,319,0,745,12,-0.599072407472367,0.24815762947580386
330,1553400000,155,72,0,227,12,-0.599072407472367,-1.070581351197276
330,1553414400,22,16,0,38,12,-0.599072407472367,-1.551742871172589
330,1553428800,95,258,163,353,12,0.216934297970495,-0.7498070045470673
330,1553443200,306,498,192,804,12,0.3621134050738262,0.39836149020883804
330,1553457600,479,415,0,894,12,-0.599072407472367,0.6274860235304156
330,1553472000,310,158,0,468,12,-0.599072407472367,-0.45703676752505157
330,1553486400,61,28,0,89,12,-0.599072407472367,-1.421905635623695
330,1553500800,40,252,212,292,12,0.46223692721405474,-0.9051025215761366
330,1553515200,189,760,571,949,12,2.2594541496311558,0.7675065716713797
330,1553529600,371,346,0,717,12,-0.599072407472367,0.17687444133131308
330,1553544000,792,471,0,1263,12,-0.599072407472367,1.5668966101488837
330,1553558400,497,161,0,658,13,-0.6690542235663574,-0.03054134148459099
330,1553572800,46,17,0,63,13,-0.6690542235663574,-1.4107006971806688
330,1553587200,44,275,231,319,13,0.5749404251574447,-0.8168842348979866
330,1553601600,233,798,565,1031,13,2.373616670498353,0.8346678008257232
330,1553616000,369,375,6,744,13,-0.636742674248856,0.16894387631349755
330,1553630400,646,899,253,1545,13,0.693416105988283,2.026939916502671
330,1553644800,602,171,0,773,13,-0.6690542235663574,0.23621214743145766
330,1553659200,56,30,0,86,13,-0.6690542235663574,-1.357349999397459
330,1553673600,59,277,218,336,13,0.5049320683028584,-0.7774511104495272
330,1553688000,210,803,593,1013,13,2.5244039006466927,0.7929150808214722
330,1553702400,399,369,0,768,13,-0.6690542235663574,0.224614169652499
330,1553716800,768,793,25,1561,13,-0.5344227680767684,2.0640534453953387
330,1553731200,500,201,0,701,13,-0.6690542235663574,0.06920126741445329
330,1553745600,61,27,0,88,13,-0.6690542235663574,-1.3527108082858754
330,1553760000,55,248,193,303,13,0.3703006128132694,-0.8539977637906542
330,1553774400,214,779,565,993,13,2.373616670498353,0.7465231697056376
330,1553788800,311,352,41,663,13,-0.44825863656343146,-0.018943363705632352
330,1553803200,767,523,0,1290,13,-0.6690542235663574,1.4354430497757806
330,1553817600,629,224,0,853,13,-0.6690542235663574,0.4217797918947958
330,1553832000,86,52,0,138,13,-0.6690542235663574,-1.236731030496289
330,1553846400,49,247,198,296,13,0.3972269039111872,-0.8702349326811962
330,1553860800,200,742,542,942,13,2.2497557314479315,0.6282237963602596
330,1553875200,272,356,84,628,13,-0.21669253312133843,-0.10012920815834281
330,1553889600,1134,649,0,1783,13,-0.6690542235663574,2.5790036587811023
330,1553904000,603,309,0,912,13,-0.6690542235663574,0.5586359296865078
330,1553918400,171,120,0,291,13,-0.6690542235663574,-0.8818329104601549
330,1553932800,41,81,40,122,13,-0.45364389478301503,-1.273844559388957
330,1553947200,109,320,211,429,13,0.4672352607657735,-0.5617287237608966
330,1553961600,321,532,211,853,13,0.4672352607657735,0.4217797918947958
330,1553976000,502,538,36,1040,13,-0.47518492766134923,0.8555441608278488
330,1553990400,520,363,0,883,13,-0.6690542235663574,0.49136765856854764
330,1554004800,155,97,0,252,13,-0.6690542235663574,-0.9722971371360323
330,1554019200,46,64,18,110,13,-0.5721195756138533,-1.3016797060584575
330,1554033600,105,317,212,422,13,0.47262051898535706,-0.5779658926514386
330,1554048000,281,419,138,700,13,0.07411141073617372,0.06688167185866156
330,1554062400,390,383,0,773,13,-0.6690542235663574,0.23621214743145766
330,1554076800,342,150,0,492,13,-0.6690542235663574,-0.4155942037460177
330,1554091200,61,13,0,74,13,-0.6690542235663574,-1.3851851460669597
330,1554105600,51,250,199,301,13,0.4026121621307708,-0.8586369549022376
330,1554120000,202,806,604,1008,13,2.5836417410621118,0.7813171030425136
330,1554134400,342,377,35,719,13,-0.4805701858809328,0.11095398741870438
330,1554148800,757,476,0,1233,13,-0.6690542235663574,1.3032261030956522
330,1554163200,486,160,0,646,14,-0.6865195460106454,-0.10132867117996873
330,1554177600,57,26,0,83,14,-0.6865195460106454,-1.5377901572240595
330,1554192000,70,324,254,394,14,0.6617482221855189,-0.7442918940629365
330,1554206400,231,762,531,993,14,2.1321032292340916,0.7840214809644354
330,1554220800,369,370,1,739,14,-0.6812114051909754,0.13595537536017416
330,1554235200,757,512,0,1269,14,-0.6865195460106454,1.488219296502924
330,1554249600,522,218,0,740,14,-0.6865195460106454,0.13850681672082085
330,1554264000,68,20,0,88,14,-0.6865195460106454,-1.525032950420826
330,1554278400,61,301,240,362,14,0.5874342507101398,-0.8259380176036308
330,1554292800,212,797,585,1009,14,2.4187428334962684,0.8248445427347825
330,1554307200,346,369,23,715,14,-0.5644323071582368,0.07472078270465342
330,1554321600,824,443,0,1267,14,-0.6865195460106454,1.4831164137816306
330,1554336000,601,193,0,794,14,-0.6865195460106454,0.27628465019574255
330,1554350400,78,22,0,100,14,-0.6865195460106454,-1.4944156540930655
330,1554364800,50,336,286,386,14,0.8316087284149569,-0.7647034249481102
330,1554379200,219,776,557,995,14,2.27011489054551,0.7891243636857288
330,1554393600,349,372,23,721,14,-0.5644323071582368,0.0900294308685336
330,1554408000,813,568,0,1381,14,-0.6865195460106454,1.773980728895354
330,1554422400,603,222,0,825,14,-0.6865195460106454,0.35537933237579017
330,1554436800,96,31,0,127,14,-0.6865195460106454,-1.4255267373556049
330,1554451200,61,294,233,355,14,0.5502772649724502,-0.8437981071281577
330,1554465600,216,728,512,944,14,2.0312485536603626,0.6590008542927471
330,1554480000,357,390,33,747,14,-0.5113508989615374,0.15636690624534774
330,1554494400,681,697,16,1378,14,-0.6015892928959263,1.766326404813414
330,1554508800,516,336,0,852,14,-0.6865195460106454,0.424268249113251
330,1554523200,155,88,0,243,14,-0.6865195460106454,-1.129559539520588
330,1554537600,37,90,53,127,14,-0.40518808256813865,-1.4255267373556049
330,1554552000,125,509,384,634,14,1.3518065287426109,-0.1319459675077291
330,1554566400,450,651,201,1101,14,0.3804167587430122,1.0595771479142786
330,1554580800,553,691,138,1244,14,0.04600388710380608,1.4244332624867564
330,1554595200,521,411,0,932,14,-0.6865195460106454,0.6283835579649868
330,1554609600,179,116,0,295,14,-0.6865195460106454,-0.9968845887669596
330,1554624000,40,63,23,103,14,-0.5644323071582368,-1.4867613300111255
330,1554638400,129,372,243,501,14,0.6033586731691496,-0.4712876684737399
330,1554652800,324,566,242,890,14,0.5980505323494797,0.5212230208178255
330,1554667200,481,464,0,945,14,-0.6865195460106454,0.6615522956533939
330,1554681600,351,182,0,533,14,-0.6865195460106454,-0.38964154493304554
330,1554696000,62,21,0,83,14,-0.6865195460106454,-1.5377901572240595
330,1554710400,41,280,239,321,14,0.5821261098904699,-0.9305471133901455
330,1554724800,194,786,592,980,14,2.455899819233958,0.7508527432760282
330,1554739200,344,367,23,711,14,-0.5644323071582368,0.06451501726206663
330,1554753600,817,430,0,1247,14,-0.6865195460106454,1.4320875865686966
330,1554768000,520,184,0,704,15,-0.6768428458526233,0.10998950083684085
330,1554782400,65,30,0,95,15,-0.6768428458526233,-1.3909459126151411
330,1554796800,57,304,247,361,15,0.7736712513630167,-0.7353649274292179
330,1554811200,225,779,554,1004,15,2.5765369511411604,0.8493665517984084
330,1554825600,371,374,3,745,15,-0.6592252657244981,0.2110376978015884
330,1554840000,824,614,0,1438,15,-0.6768428458526233,1.9189986855228092
330,1554854400,533,186,0,719,15,-0.6768428458526233,0.14695835338491922
330,1554868800,86,24,0,110,15,-0.6768428458526233,-1.3539770600670626
330,1554883200,60,319,259,379,15,0.8441415718755175,-0.6910023043715239
330,1554883392,2,0,0,2,15,-0.6768428458526233,-1.620152798413227
330,1554897600,273,842,569,1115,15,2.6646248517817863,1.1229360606541883
330,1554912000,377,394,17,771,15,-0.5770098917932472,0.2751170422182576
330,1554926400,779,534,0,1313,15,-0.6768428458526233,1.610924914288823
330,1554940800,536,239,0,775,15,-0.6768428458526233,0.28497540289774514
330,1554955200,65,25,0,90,15,-0.6768428458526233,-1.4032688634645005
330,1554969600,70,303,233,373,15,0.691455877431766,-0.7057898453907553
330,1554984000,316,778,462,1094,15,2.036264493878655,1.0711796670868785
330,1554998400,367,384,17,751,15,-0.5770098917932472,0.22582523882081976
330,1555012800,776,470,0,1246,15,-0.6768428458526233,1.445797372907406
330,1555027200,579,227,0,806,15,-0.6768428458526233,0.3613776981637738
330,1555041600,86,32,0,118,15,-0.6768428458526233,-1.3342603387080876
330,1555056000,74,250,176,324,15,0.35672185499738746,-0.8265547637144779
330,1555070400,310,773,463,1083,15,2.04213702058803,1.0440691752182878
330,1555084800,371,410,39,781,15,-0.4478143041869959,0.2997629439169765
330,1555099200,767,686,0,1453,15,-0.6768428458526233,1.9559675380708876
330,1555113600,520,323,0,843,15,-0.6768428458526233,0.4525675344490338
330,1555128000,122,61,0,183,15,-0.6768428458526233,-1.1740619776664147
330,1555142400,29,83,54,112,15,-0.35972640354637003,-1.3490478797273189
330,1555156800,128,424,296,552,15,1.0614250601223947,-0.26462820498368667
330,1555171200,423,586,163,1009,15,0.28037900777551167,0.8616895026477678
330,1555185600,526,600,74,1126,15,-0.2422758693588688,1.150046552522779
330,1555200000,469,366,0,835,15,-0.6768428458526233,0.43285081309005863
330,1555214400,168,129,0,297,15,-0.6768428458526233,-0.893098698301019
330,1555228800,32,63,31,95,15,-0.4947945178619964,-1.3909459126151411
330,1555243200,106,320,214,426,15,0.5798778699536398,-0.575166566387545
330,1555257600,292,445,153,737,15,0.22165374068176102,0.19132097644261328
330,1555272000,431,390,0,821,15,-0.6768428458526233,0.39834655071185215
330,1555286400,294,154,0,448,15,-0.6768428458526233,-0.5209455826503634
330,1555300800,60,17,0,77,15,-0.6768428458526233,-1.4353085356728352
330,1555315200,78,274,196,352,15,0.4741723891848887,-0.7575462389580649
330,1555329600,277,800,523,1077,15,2.394488623150534,1.0292816341990565
330,1555344000,340,355,15,695,15,-0.5887549452119974,0.08780818930799383
330,1555358400,410,608,198,1018,15,0.4859174426036388,0.8838708141766148
330,1555372800,388,154,0,542,16,-0.617086643043048,-0.18938917230380128
330,1555387200,2,10,8,12,16,-0.5678603581279331,-1.5239263598576536
330,1555401600,73,278,205,351,16,0.6443369079067723,-0.6703261587618876
330,1555416000,303,819,516,1122,16,2.558008733981866,1.2710477499249426
330,1555430400,404,372,0,776,16,-0.617086643043048,0.399821585974692
330,1555444800,811,501,0,1312,16,-0.617086643043048,1.749466741689531
330,1555459200,458,166,0,624,16,-0.617086643043048,0.017086392563021142
330,1555473600,0,4,4,4,16,-0.5924735005854906,-1.544070317405636
330,1555488000,86,301,215,387,16,0.705869764050666,-0.5796783497959656
330,1555502400,275,804,529,1079,16,2.6380014469689277,1.1627739781045359
330,1555516800,386,360,0,746,16,-0.617086643043048,0.32428174516975694
330,1555531200,833,541,0,1374,16,-0.617086643043048,1.905582412686397
330,1555545600,477,181,0,658,16,-0.617086643043048,0.1026982121419475
330,1555560000,1,1,0,2,16,-0.617086643043048,-1.5491063067926318
330,1555574400,77,261,184,338,16,0.5151179100045956,-0.7030600897773595
330,1555588800,305,805,500,1110,16,2.459556164151636,1.2408318136029686
330,1555603200,384,382,0,766,16,-0.617086643043048,0.3746416390397136
330,1555617600,801,503,0,1304,16,-0.617086643043048,1.7293227841415484
330,1555632000,506,185,0,691,16,-0.617086643043048,0.18579203702737604
330,1555646400,2,4,2,6,16,-0.6047800718142694,-1.5390343280186405
330,1555660800,41,199,158,240,16,0.3551324840304721,-0.9498235697401473
330,1555675200,193,635,442,828,16,2.102665598517053,0.5307573100365793
330,1555689600,437,434,0,871,16,-0.617086643043048,0.6390310818569862
330,1555704000,723,472,0,1195,16,-0.617086643043048,1.4548613625502846
330,1555718400,548,246,0,794,16,-0.617086643043048,0.445145490457653
330,1555732800,125,67,0,192,16,-0.617086643043048,-1.0706873150280434
330,1555747200,34,70,36,104,16,-0.39556836092503084,-1.2922708480558527
330,1555761600,105,271,166,376,16,0.40435876894558703,-0.6073762914244418
330,1555776000,319,473,154,792,16,0.3305193415729146,0.4401095010706573
330,1555790400,438,487,49,925,16,-0.31557564793796905,0.7750027953058692
330,1555804800,465,312,0,777,16,-0.617086643043048,0.4023395806681898
330,1555819200,128,72,0,200,16,-0.617086643043048,-1.0505433574800607
330,1555833600,31,57,26,88,16,-0.45710121706892454,-1.332558763151818
330,1555848000,107,292,185,399,16,0.521271195618985,-0.5494624134739916
330,1555862400,282,408,126,690,16,0.1582273443700123,0.1832740423338782
330,1555876800,368,302,0,670,16,-0.617086643043048,0.13291414846392152
330,1555891200,264,173,0,437,16,-0.617086643043048,-0.45377861512107387
330,1555905600,49,19,0,68,16,-0.617086643043048,-1.3829186570217749
330,1555920000,39,254,215,293,16,0.705869764050666,-0.816369850984762
330,1555934400,210,701,491,911,16,2.404176593622132,0.7397508695968996
330,1555948800,351,352,1,703,16,-0.6109333574286587,0.21600797334935004
330,1555963200,693,473,0,1166,16,-0.617086643043048,1.3818395164388473
330,1555977600,382,126,0,508,17,-0.7097715591307027,-0.08961738193339941
330,1555992000,2,5,3,7,17,-0.6904180627698372,-1.307473847086196
330,1556006400,59,242,183,301,17,0.47079171888209,-0.5928035860983273
330,1556020800,179,741,562,920,17,2.915783425804759,0.9118933239407566
330,1556035200,357,370,13,727,17,-0.6259064082336191,0.4427390369657272
330,1556049600,871,468,0,1339,17,-0.7097715591307027,1.9304199884098618
330,1556064000,460,151,0,611,17,-0.7097715591307027,0.16076029453513957
330,1556078400,1,7,6,8,17,-0.6710645664089717,-1.305042995858346
330,1556092800,49,246,197,295,17,0.5611080352327954,-0.6073886934654267
330,1556107200,225,728,503,953,17,2.5351646640410714,0.992111414459803
330,1556121600,352,378,26,730,17,-0.5420412573365354,0.4500315906492769
330,1556136000,810,515,0,1325,17,-0.7097715591307027,1.8963880712199632
330,1556150400,434,177,0,611,17,-0.7097715591307027,0.16076029453513957
330,1556164800,0,1,1,1,17,-0.7033203936770809,-1.3220589544532952
330,1556179200,44,299,255,343,17,0.9352756315428608,-0.49070783452863176
330,1556193600,206,710,504,916,17,2.5416158294946936,0.902169919029357
330,1556208000,304,355,51,659,17,-0.38076212099599,0.27744115347193443
330,1556222400,710,696,0,1406,17,-0.7097715591307027,2.0932870206758047
330,1556236800,424,204,0,628,17,-0.7097715591307027,0.20208476540858777
330,1556251200,0,8,8,8,17,-0.6581622355017281,-1.305042995858346
330,1556265600,38,225,187,263,17,0.49659638069657724,-0.6851759327566233
330,1556280000,205,697,492,902,17,2.4642018440512317,0.8681380018394584
330,1556294400,320,419,99,739,17,-0.07110617922214273,0.4719092516999259
330,1556308800,801,705,0,1506,17,-0.7097715591307027,2.336372143460794
330,1556323200,461,252,0,713,17,-0.7097715591307027,0.4087071197758287
330,1556337600,123,50,0,173,17,-0.7097715591307027,-0.9039525432631136
330,1556352000,25,45,20,70,17,-0.5807482500582664,-1.1543302197316525
330,1556366400,98,263,165,361,17,0.35467074071689725,-0.4469525124273337
330,1556380800,194,486,292,680,17,1.173968753326868,0.3284890292567822
330,1556395200,291,538,247,829,17,0.8836663079138862,0.6906858622064163
330,1556409600,266,329,63,595,17,-0.30334813555252815,0.1218666748895413
330,1556424000,114,92,0,206,17,-0.7097715591307027,-0.8237344527440671
330,1556438400,19,48,29,67,17,-0.5226877609756699,-1.1616227734152023
330,1556452800,52,225,173,277,17,0.40628006434587177,-0.6511440155667247
330,1556467200,173,317,144,490,17,0.21919626619083907,-0.13337270403469748
330,1556481600,297,305,8,602,17,-0.6581622355017281,0.13888263348449054
330,1556496000,227,147,0,374,17,-0.7097715591307027,-0.4153514464652851
330,1556510400,36,25,0,61,17,-0.7097715591307027,-1.1762078807823015
330,1556524800,46,242,196,288,17,0.5546568697791736,-0.6244046520603759
330,1556526822,22,156,134,178,17,0.15468461165462088,-0.8917982871238641
330,1556528244,26,104,78,130,17,-0.2065806537482009,-1.008479146060659
330,1556528408,3,27,24,30,17,-0.5549435882437791,-1.2515642688456483
330,1556539200,159,447,288,606,17,1.1481640915123807,0.14860603839589012
330,1556553600,344,342,0,686,17,-0.7097715591307027,0.3430741366238816
330,1556568000,825,572,0,1397,17,-0.7097715591307027,2.0714093596251555
330,1556582400,454,175,0,629,18,-0.6649431331894345,5.702114954507009e-05
330,1556596800,51,17,0,68,18,-0.6649431331894345,-1.3434753044317018
330,1556611200,46,309,263,355,18,0.7214218817615836,-0.6561423678152707
330,1556625600,223,814,591,1037,18,2.450424638050306,0.9771714397540883
330,1556640000,391,371,0,762,18,-0.6649431331894345,0.31857716250837903
330,1556654400,790,550,0,1340,18,-0.6649431331894345,1.7028225888648152
330,1556668800,519,201,0,720,18,-0.6649431331894345,0.2179918547108525
330,1556683200,57,23,0,80,18,-0.6649431331894345,-1.31473664506098
330,1556697600,50,265,215,315,18,0.46839708815835596,-0.7519378990510103
330,1556712000,211,742,531,953,18,2.1341436460462715,0.7760008241590353
330,1556726400,388,367,0,755,18,-0.6649431331894345,0.3018129445421246
330,1556740800,750,516,0,1266,18,-0.6649431331894345,1.525600856078697
330,1556755200,449,230,0,679,18,-0.6649431331894345,0.11980143519421949
330,1556769600,41,17,0,58,18,-0.6649431331894345,-1.3674241872406367
330,1556784000,57,286,229,343,18,0.5421959862926307,-0.6848810271859926
330,1556798400,194,754,560,948,18,2.287012792181555,0.7640263827545678
330,1556812800,351,340,0,691,18,-0.6649431331894345,0.14854009456494136
330,1556827200,768,610,0,1378,18,-0.6649431331894345,1.7938283435387679
330,1556841600,425,266,0,691,18,-0.6649431331894345,0.14854009456494136
330,1556856000,56,38,0,94,18,-0.6649431331894345,-1.281208209128471
330,1556870400,47,258,211,305,18,0.4473116886914203,-0.7758867818599452
330,1556884800,180,439,259,619,18,0.700336482294648,-0.023891861659389814
330,1556899200,467,1107,640,1574,18,2.7087207815202676,2.2632264465938916
330,1556913600,766,604,0,1370,18,-0.6649431331894345,1.77466923729162
330,1556928000,469,346,0,815,18,-0.6649431331894345,0.4455062413957339
330,1556942400,131,77,0,208,18,-0.6649431331894345,-1.0081909451066136
330,1556956800,26,72,46,98,18,-0.4224610393196747,-1.2716286560048973
330,1556971200,81,223,142,304,18,0.08358854788678058,-0.7782816701408386
330,1556985600,268,403,135,671,18,0.04668909881964321,0.10064232894707158
330,1557000000,364,500,136,864,18,0.05196044868637713,0.5628557671595148
330,1557014400,355,407,52,762,18,-0.3908329401192712,0.31857716250837903
330,1557028800,123,97,0,220,18,-0.6649431331894345,-0.9794522857358916
330,1557043200,22,46,24,68,18,-0.5384307363878207,-1.3434753044317018
330,1557057600,83,246,163,329,18,0.19428689508819266,-0.7184094631185014
330,1557072000,217,417,200,634,18,0.3893268401573473,0.012031462554012511
330,1557086400,301,368,67,669,18,-0.3117626921182626,0.0958525523852846
330,1557100800,181,153,0,334,18,-0.6649431331894345,-0.7064350217140339
330,1557115200,34,25,0,59,18,-0.6649431331894345,-1.3650292989597432
330,1557129600,43,280,237,323,18,0.584366785226502,-0.7327787928038624
330,1557144000,185,782,597,967,18,2.4820527372507093,0.8095292600915441
330,1557158400,368,344,0,712,18,-0.6649431331894345,0.1988327484637046
330,1557172800,814,536,0,1350,18,-0.6649431331894345,1.7267714716737501
330,1557187200,450,150,0,600,19,-0.609440216727049,0.05335475068600413
330,1557201600,54,34,0,88,19,-0.609440216727049,-1.3044447271268176
330,1557216000,66,284,218,350,19,0.6070486920047715,-0.6096332755897877
330,1557230400,213,756,543,969,19,2.4206216063985404,1.031925077469073
330,1557244800,362,358,0,720,19,-0.609440216727049,0.3715890032983842
330,1557259200,830,456,0,1286,19,-0.609440216727049,1.8725938947867768
330,1557273600,473,210,0,683,19,-0.609440216727049,0.27346677540956704
330,1557288000,62,18,0,80,19,-0.609440216727049,-1.3256603439676429
330,1557302400,45,290,245,335,19,0.7577147495082538,-0.6494125571663352
330,1557316800,218,761,543,979,19,2.4206216063985404,1.0584445985201045
330,1557331200,345,319,0,664,19,-0.609440216727049,0.22307968541260684
330,1557345600,784,474,0,1258,19,-0.609440216727049,1.7983392358438883
330,1557360000,504,170,0,674,19,-0.609440216727049,0.2495992064636385
330,1557374400,46,26,0,72,19,-0.609440216727049,-1.3468759608084682
330,1557388800,46,276,230,322,19,0.6740113842285415,-0.6838879345326764
330,1557403200,208,723,515,931,19,2.264375324543077,0.9311508974751526
330,1557417600,366,374,8,740,19,-0.5647984219112023,0.4246280454004476
330,1557432000,750,514,0,1264,19,-0.609440216727049,1.8142509484745073
330,1557446400,544,198,0,742,19,-0.609440216727049,0.4299319496106539
330,1557460800,79,32,0,111,19,-0.609440216727049,-1.2434498287094446
330,1557475200,42,226,184,268,19,0.41732106403742336,-0.8270933482082474
330,1557489600,191,848,657,1039,19,3.056767182524355,1.2175617248262947
330,1557504000,342,377,35,719,19,-0.41413236440771994,0.368937051193281
330,1557518400,745,575,0,1320,19,-0.609440216727049,1.9627602663602846
330,1557532800,447,331,0,778,19,-0.609440216727049,0.5254022253943679
330,1557547200,130,84,0,214,19,-0.609440216727049,-0.9702987618838185
330,1557561600,38,77,39,115,19,-0.39181146699979663,-1.232842020289032
330,1557576000,91,294,203,385,19,0.5233453267250591,-0.5168149519111769
330,1557590400,240,354,114,594,19,0.026705359398765425,0.037443038055385125
330,1557604800,301,431,130,732,19,0.11598894903045867,0.4034124285596222
330,1557619200,291,232,0,523,19,-0.609440216727049,-0.15084556140693975
330,1557633600,86,106,20,192,19,-0.4978357296874324,-1.0286417081960881
330,1557648000,19,49,30,68,19,-0.4420334861676241,-1.3574837692288808
330,1557662400,76,141,65,217,19,-0.24672563384829513,-0.962342905568509
330,1557676800,182,238,56,420,19,-0.2969476530161226,-0.423996628232566
330,1557691200,210,293,83,503,19,-0.14628159551264022,-0.20388460350900312
330,1557705600,191,136,0,327,19,-0.609440216727049,-0.6706281740071606
330,1557720000,39,16,0,55,19,-0.609440216727049,-1.3919591465952221
330,1557734400,52,201,149,253,19,0.2220132117180944,-0.866872629784795
330,1557748800,201,708,507,909,19,2.2197335297272307,0.8728079511628828
330,1557763200,315,328,13,643,19,-0.5368973001512982,0.1673886912054403
330,1557777600,695,518,0,1213,19,-0.609440216727049,1.6790013911142456
330,1557792000,351,158,0,509,20,-0.6272062303410992,-0.1757886699532512
330,1557806400,46,27,0,73,20,-0.6272062303410992,-1.435607471284884
330,1557820800,61,258,197,319,20,0.5550509964545064,-0.7247922760381371
330,1557835200,195,738,543,933,20,2.6315027754965348,1.0493562194151258
330,1557849600,399,314,0,713,20,-0.6272062303410992,0.41366783342209995
330,1557864000,703,487,0,1190,20,-0.6272062303410992,1.791955833961524
330,1557878400,419,199,0,618,20,-0.6272062303410992,0.13916603037965702
330,1557892800,57,25,0,82,20,-0.6272062303410992,-1.4096020373124423
330,1557907200,54,276,222,330,20,0.7050836394488726,-0.6930078567384859
330,1557921600,187,764,577,951,20,2.835547169968873,1.1013670873600097
330,1557936000,369,347,0,716,20,-0.6272062303410992,0.42233631141291395
330,1557950400,625,432,0,1057,20,-0.6272062303410992,1.407653309702104
330,1557964800,446,183,0,629,20,-0.6272062303410992,0.1709504496793083
330,1557979200,59,39,0,98,20,-0.6272062303410992,-1.3633701546947676
330,1557993600,39,255,216,294,20,0.6690758051302248,-0.7970295926282537
330,1558008000,209,788,579,997,20,2.8475497814084223,1.2342837498858241
330,1558022400,415,374,0,789,20,-0.6272062303410992,0.6332692758560543
330,1558036800,609,479,0,1088,20,-0.6272062303410992,1.4972275822738486
330,1558051200,527,190,0,717,20,-0.6272062303410992,0.4252258040765186
330,1558065600,86,32,0,118,20,-0.6272062303410992,-1.3055803014226743
330,1558080000,35,182,147,217,20,0.254985710465774,-1.0195205277258128
330,1558086884,93,386,293,479,20,1.1311763455528727,-0.2624734498613911
330,1558094400,156,424,268,580,20,0.9811437025585065,0.029365309162679838
330,1558108800,356,350,0,706,20,-0.6272062303410992,0.39344138477686735
330,1558123200,769,510,0,1279,20,-0.6272062303410992,2.0491206810223392
330,1558137600,553,276,0,829,20,-0.6272062303410992,0.7488489824002409
330,1558152000,113,93,0,206,20,-0.6272062303410992,-1.051304947025464
330,1558166400,22,79,57,101,20,-0.2851318043139443,-1.3547016767039537
330,1558180800,97,267,170,364,20,0.3930157420205909,-0.5947651061759273
330,1558195200,315,339,24,654,20,-0.48317489306650774,0.24318776626942487
330,1558209600,335,428,93,763,20,-0.06908479840205699,0.5581424666023331
330,1558224000,359,323,0,682,20,-0.6272062303410992,0.32409356085035546
330,1558238400,127,72,0,199,20,-0.6272062303410992,-1.0715313956706967
330,1558252800,35,48,13,83,20,-0.5491892559840289,-1.4067125446488375
330,1558267200,68,213,145,281,20,0.24298309902622472,-0.8345929972551143
330,1558281600,218,347,129,565,20,0.14696220750983036,-0.013977080791390104
330,1558296000,290,292,2,582,20,-0.61520361890155,0.035144294489889163
330,1558310400,233,175,0,408,20,-0.6272062303410992,-0.4676274289773221
330,1558324800,47,40,0,87,20,-0.6272062303410992,-1.395154573994419
330,1558339200,41,264,223,305,20,0.7110849451686473,-0.7652451733286024
330,1558353600,197,695,498,892,20,2.361444018106676,0.9308870202073346
330,1558368000,334,432,98,766,20,-0.03907826980318374,0.5668109445931471
330,1558382400,791,463,0,1254,20,-0.6272062303410992,1.9768833644322226
330,1558396800,465,156,0,621,21,-0.5876262227526159,0.3540520161488116
330,1558411200,42,24,0,66,21,-0.5876262227526159,-1.3053060681778552
330,1558425600,55,279,224,334,21,0.795564338721772,-0.5040304526831765
330,1558436980,142,672,530,814,21,2.6851014450216057,0.9310900526804272
330,1558440000,101,475,374,576,21,1.721808018280514,0.21950946877097374
330,1558454400,307,338,31,645,21,-0.39620252897714253,0.42580804141699174
330,1558468800,771,438,0,1209,21,-0.5876262227526159,2.112074635219226
330,1558483200,493,151,0,644,21,-0.5876262227526159,0.42281820703081757
330,1558497600,66,33,0,99,21,-0.5876262227526159,-1.2066415334341074
330,1558512000,51,293,242,344,21,0.9067135802688211,-0.4741321088214347
330,1558526400,168,769,601,937,21,3.1235234533460767,1.2988396821798507
330,1558540800,325,345,20,670,21,-0.46412706547811694,0.5005539010713461
330,1558555200,774,472,0,1246,21,-0.5876262227526159,2.2226985075076704
330,1558569600,492,207,0,699,21,-0.5876262227526159,0.5872590982703972
330,1558584000,55,26,0,81,21,-0.5876262227526159,-1.2604585523852425
330,1558598400,56,234,178,290,21,0.5115162769904246,-0.6355831656748401
330,1558612800,172,710,538,882,21,2.734501107931405,1.134398790940271
330,1558627200,343,337,0,680,21,-0.5876262227526159,0.5304522449330878
330,1558641600,728,518,0,1246,21,-0.5876262227526159,2.2226985075076704
330,1558656000,439,159,0,598,21,-0.5876262227526159,0.28528582526680557
330,1558670400,71,33,0,104,21,-0.5876262227526159,-1.1916923615032367
330,1558684800,41,217,176,258,21,0.4991663612629747,-0.7312578660324137
330,1558699200,182,638,456,820,21,2.2281545631059596,0.9490290589974723
330,1558713600,446,390,0,836,21,-0.5876262227526159,0.996866409176259
330,1558728000,653,425,0,1078,21,-0.5876262227526159,1.7204063306304092
330,1558742400,396,185,0,581,21,-0.5876262227526159,0.2344586407018446
330,1558756800,114,70,0,184,21,-0.5876262227526159,-0.9525056106093026
330,1558771200,18,58,40,76,21,-0.340627908203618,-1.2754077243161135
330,1558785600,100,164,64,264,21,-0.19242891947421928,-0.7133188597153687
330,1558800000,234,306,72,540,21,-0.14302925656441973,0.11187543086870347
330,1558814400,277,408,131,685,21,0.2212932573953521,0.5454014168639587
330,1558828800,215,229,14,444,21,-0.5011768126604667,-0.17514867020401728
330,1558843200,58,64,6,122,21,-0.5505764755702661,-1.1378753425521013
330,1558857600,22,51,29,73,21,-0.4085524447045924,-1.284377227474636
330,1558872000,62,167,105,229,21,0.060744352938503506,-0.8179630632314647
330,1558886400,159,226,67,385,21,-0.17390404588304445,-0.35154889898829356
330,1558900800,231,250,19,481,21,-0.47030202334184185,-0.06452479791557282
330,1558915200,197,167,0,364,21,-0.5876262227526159,-0.41433542109795124
330,1558929600,67,46,0,113,21,-0.5876262227526159,-1.164783852027669
330,1558944000,18,57,39,75,21,-0.34680286606734295,-1.2783975587022876
330,1558958400,68,204,136,272,21,0.25216804671397686,-0.6894001846259753
330,1558972800,211,208,0,419,21,-0.5876262227526159,-0.24989452985837163
330,1558987200,268,259,0,527,21,-0.5876262227526159,0.0730075838484392
330,1559001600,196,162,0,358,22,-0.6016886900982648,-0.5734031602110945
330,1559016000,34,14,0,48,22,-0.6016886900982648,-1.414325569081161
330,1559030400,43,261,218,304,22,0.6523658618115262,-0.7198864185303964
330,1559044800,204,719,515,923,22,2.360871375193214,0.9592457462778974
330,1559059200,329,356,27,685,22,-0.4463700070635659,0.3136343485002336
330,1559073600,744,402,0,1146,22,-0.6016886900982648,1.5641673500779774
330,1559088000,387,159,0,546,22,-0.6016886900982648,-0.06342440902537681
330,1559102400,38,25,0,63,22,-0.6016886900982648,-1.373635775103577
330,1559116800,64,271,207,335,22,0.5890878798344267,-0.6357941776433897
330,1559131200,226,795,569,1021,22,2.671508741262612,1.225085733598112
330,1559145600,401,397,0,798,22,-0.6016886900982648,0.6201641297980319
330,1559160000,621,638,17,1259,22,-0.5038954452245654,1.8706971313757759
330,1559174400,396,188,0,584,22,-0.6016886900982648,0.039656402384502284
330,1559188800,53,23,0,76,22,-0.6016886900982648,-1.338371286989671
330,1559203200,50,251,201,301,22,0.5545726169378269,-0.7280243773259131
330,1559217600,199,767,568,966,22,2.665756197446512,1.075889822346971
330,1559232000,361,357,0,718,22,-0.6016886900982648,0.40315189525091805
330,1559246400,652,698,46,1350,22,-0.3370716745576667,2.1175485481731178
330,1559260800,411,232,0,643,22,-0.6016886900982648,0.1997029253629988
330,1559275200,64,38,0,102,22,-0.6016886900982648,-1.267842310761859
330,1559289600,39,267,228,306,22,0.7098912999725258,-0.7144611126667185
330,1559304000,176,723,547,899,22,2.5449527773084126,0.8941420759137633
330,1559318400,376,355,0,731,22,-0.6016886900982648,0.4384163833648241
330,1559332800,734,488,0,1222,22,-0.6016886900982648,1.7703289728977356
330,1559347200,431,261,0,692,22,-0.6016886900982648,0.33262291902310603
330,1559361600,134,83,0,217,22,-0.6016886900982648,-0.9558872236003827
330,1559376000,41,71,30,112,22,-0.429112375615266,-1.2407157814434697
330,1559390400,133,266,133,399,22,0.16339963744302974,-0.4621843900056986
330,1559404800,270,398,128,668,22,0.13463691836252994,0.26751924865897186
330,1559419200,353,395,42,748,22,-0.3600818498220665,0.4845314832060858
330,1559433600,252,278,26,530,22,-0.45212255087966585,-0.1068268559347996
330,1559448000,120,109,0,229,22,-0.6016886900982648,-0.9233353884183156
330,1559462400,29,41,12,70,22,-0.5326581643050653,-1.3546472045807045
330,1559476800,78,212,134,290,22,0.1691521812591297,-0.7578635595761413
330,1559491200,205,259,54,464,22,-0.29105132402886696,-0.28586194943616855
330,1559505600,289,281,0,570,22,-0.6016886900982648,0.0016792613387573555
330,1559520000,169,159,0,328,22,-0.6016886900982648,-0.6547827481662621
330,1559534400,38,19,0,57,22,-0.6016886900982648,-1.3899116926946105
330,1559548800,52,262,210,314,22,0.6063455112827265,-0.6927598892120072
330,1559563200,216,695,479,911,22,2.1537797978136157,0.9266939110958303
330,1559577600,342,344,2,686,22,-0.5901836024660648,0.3163470014320725
330,1559592000,771,474,0,1245,22,-0.6016886900982648,1.8327199903300309
330,1559606400,424,170,0,594,23,-0.5723778372559455,0.09484718724278565
330,1559620800,59,31,0,90,23,-0.5723778372559455,-1.326048254763788
330,1559635200,44,264,220,308,23,0.7091271824302519,-0.7114545913561827
330,1559649600,149,672,523,821,23,2.474109095907151,0.7348139835433655
330,1559664000,321,368,47,689,23,-0.2986017648684397,0.3626747011130723
330,1559678400,776,439,0,1215,23,-0.5723778372559455,1.845593356858028
330,1559692800,487,148,0,635,23,-0.5723778372559455,0.21043590375522517
330,1559707200,69,27,0,96,23,-0.5723778372559455,-1.3091328328351384
330,1559721600,42,264,222,306,23,0.7207772280637628,-0.7170930653323992
330,1559736000,161,708,547,869,23,2.6139096435092815,0.870137358972563
330,1559750400,344,321,0,665,23,-0.5723778372559455,0.2950130133984736
330,1559764800,776,503,0,1279,23,-0.5723778372559455,2.026024524096958
330,1559779200,432,201,0,633,23,-0.5723778372559455,0.2047974297790086
330,1559793600,53,47,0,100,23,-0.5723778372559455,-1.297855884882705
330,1559808000,36,238,202,274,23,0.6042767717286539,-0.8073086489518643
330,1559822400,175,675,500,850,23,2.340133571121776,0.8165718561985056
330,1559836800,322,329,7,651,23,-0.5316026775386574,0.25554369556495765
330,1559851200,674,499,0,1173,23,-0.5723778372559455,1.7271854033574803
330,1559865600,466,204,0,670,23,-0.5723778372559455,0.309109198339015
330,1559880000,80,65,0,145,23,-0.5723778372559455,-1.1709902204178324
330,1559894400,50,257,207,307,23,0.6334018858124311,-0.714273828344291
330,1559908800,188,611,423,799,23,1.8916068142316067,0.6727907698049832
330,1559923200,390,358,0,748,23,-0.5723778372559455,0.5290096834114609
330,1559937600,760,582,0,1342,23,-0.5723778372559455,2.2036364543477798
330,1559952000,456,262,0,718,23,-0.5723778372559455,0.4444325737682125
330,1559966400,118,75,0,193,23,-0.5723778372559455,-1.035666844988635
330,1559980800,35,66,31,101,23,-0.3918021299365268,-1.295036647894597
330,1559995200,110,179,69,289,23,-0.17045126289981996,-0.7650200941302401
330,1560009600,292,275,0,567,23,-0.5723778372559455,0.01872778856386206
330,1560024000,344,409,65,753,23,-0.19375135416684172,0.5431058683520024
330,1560038400,266,283,17,549,23,-0.473352449371103,-0.032018477222087
330,1560052800,108,79,0,187,23,-0.5723778372559455,-1.0525822669172846
330,1560067200,21,43,22,64,23,-0.4442273352873258,-1.3993484164546033
330,1560081600,88,187,99,275,23,0.004299421602843319,-0.804489411963756
330,1560096000,246,244,0,490,23,-0.5723778372559455,-0.19835345952047556
330,1560110400,294,267,0,561,23,-0.5723778372559455,0.0018123666352123748
330,1560124800,187,174,0,361,23,-0.5723778372559455,-0.5620350309864438
330,1560139200,36,32,0,68,23,-0.5723778372559455,-1.3880714685021702
330,1560153600,38,281,243,319,23,0.8431027072156271,-0.6804429844869916
330,1560168000,166,777,611,943,23,2.9867111037816296,1.0787608960925756
330,1560182400,282,354,72,636,23,-0.15297619444955363,0.21325514074333343
330,1560196800,717,485,0,1202,23,-0.5723778372559455,1.8089432760126205
330,1560211200,373,179,0,552,24,-0.678996938729876,-0.2125505974008258
330,1560225600,49,26,0,75,24,-0.678996938729876,-1.511713013600133
330,1560240000,39,277,238,316,24,0.5262631404594921,-0.8553227781619087
330,1560254400,171,778,607,949,24,2.394922675000991,0.8687229439642162
330,1560268800,323,320,0,643,24,-0.678996938729876,0.03529799772315109
330,1560283200,748,473,0,1221,24,-0.678996938729876,1.6095451184007186
330,1560297600,465,162,0,627,24,-0.678996938729876,-0.008279777243701986
330,1560312000,70,23,0,93,24,-0.678996938729876,-1.4626880167624234
330,1560326400,40,272,232,312,24,0.49587843258076847,-0.8662172219036219
330,1560333100,83,555,472,638,24,1.7112667477297108,0.021679943046009505
330,1560340800,156,415,259,571,24,0.6326096180350245,-0.16080198962768777
330,1560355200,337,328,0,665,24,-0.678996938729876,0.09521743830257408
330,1560369600,745,498,0,1243,24,-0.678996938729876,1.6694645589801416
330,1560384000,449,211,0,660,24,-0.678996938729876,0.08159938362543248
330,1560398400,57,16,0,73,24,-0.678996938729876,-1.5171602354709899
330,1560412800,38,270,232,308,24,0.49587843258076847,-0.8771116656453353
330,1560427200,190,675,485,865,24,1.7771002814669452,0.6399396253882376
330,1560441600,301,340,39,641,24,-0.4814963375181728,0.029850775852294457
330,1560456000,702,556,0,1258,24,-0.678996938729876,1.7103187230115662
330,1560470400,417,236,0,653,24,-0.678996938729876,0.06253410707743426
330,1560484800,84,32,0,116,24,-0.678996938729876,-1.4000449652475722
330,1560499200,41,270,229,311,24,0.4806860786414067,-0.8689408328390502
330,1560513600,186,745,559,931,24,2.1518450119712025,0.8196979471265065
330,1560528000,407,365,0,772,24,-0.678996938729876,0.386643808393404
330,1560542400,717,541,0,1258,24,-0.678996938729876,1.7103187230115662
330,1561161600,6643,9060,2417,15703,25,4.007922264277535,4.108554379779041
330,1561176000,112,109,0,221,25,-0.3683618946838754,-0.3052213775860986
330,1561190400,32,70,38,102,25,-0.2995580891230423,-0.3391471827228026
330,1561204800,115,238,123,353,25,-0.1456548398422315,-0.2675893920563092
330,1561219200,297,302,5,599,25,-0.3593087623732395,-0.19745705538715638
330,1561233600,347,417,70,764,25,-0.2416180423349724,-0.15041707347491973
330,1561248000,256,251,0,507,25,-0.3683618946838754,-0.22368540893822167
330,1561262400,84,86,2,170,25,-0.36474064175962106,-0.3197610083589717
330,1561276800,34,53,19,87,25,-0.3339599919034589,-0.3434235447148241
330,1561291200,87,166,79,253,25,-0.2253224041758277,-0.29609847200311934
330,1561305600,206,273,67,479,25,-0.24704992172135393,-0.23166795132332849
330,1561320000,249,283,34,532,25,-0.3068005949715511,-0.21655813895151915
330,1561334400,206,168,0,374,25,-0.3683618946838754,-0.2616024852674791
330,1561348800,43,23,0,66,25,-0.3683618946838754,-0.3494104515036542
330,1561363200,46,264,218,310,25,0.02635467405985125,-0.27984829643343756
330,1561377600,167,725,558,892,25,0.6419676711830947,-0.11392545114300279
330,1561392000,289,321,32,610,25,-0.31042184789580546,-0.19432105659300727
330,1561406400,753,474,0,1227,25,-0.3683618946838754,-0.018420033321188963
330,1561420800,392,147,0,539,26,-0.6461563127685462,-0.08159066227136551
330,1561435200,56,23,0,79,26,-0.6461563127685462,-1.4263748677863817
330,1561449600,37,205,168,242,26,0.31838073569371017,-0.9498535080060607
330,1561464000,175,722,547,897,26,2.4943303866889193,0.965002262890321
330,1561478400,304,346,42,650,26,-0.40502205065298214,0.24291161340725795
330,1561492800,702,497,0,1199,26,-0.6461563127685462,1.8478823282501793
330,1561507200,425,186,0,611,26,-0.6461563127685462,0.12889730033098484
330,1561521600,57,24,0,81,26,-0.6461563127685462,-1.4205279799363164
330,1561535743,36,229,193,265,26,0.46191303457202215,-0.8826142977303099
330,1561535816,1,5,4,6,26,-0.6231911449480163,-1.6397862743137646
330,1561536000,37,173,136,210,26,0.13465939312947087,-1.0434037136071053
330,1561550400,189,736,547,925,26,2.4943303866889193,1.046858692791235
330,1561564800,290,370,80,660,26,-0.18685295635794794,0.2721460526575844
330,1561579200,731,548,0,1279,26,-0.6461563127685462,2.0817578422527907
330,1561593600,437,208,0,645,26,-0.6461563127685462,0.22829439378209473
330,1561608000,73,50,0,123,26,-0.6461563127685462,-1.2977433350849452
330,1561622400,34,279,245,313,26,0.7604602162389109,-0.742288989328743
330,1561636800,144,709,565,853,26,2.597673641881304,0.8363707301888846
330,1561651200,315,311,0,626,26,-0.6461563127685462,0.17274895920647448
330,1561665600,670,487,0,1157,26,-0.6461563127685462,1.7250976833988083
330,1561680000,460,250,0,710,26,-0.6461563127685462,0.4183182489092166
330,1561694400,91,53,0,144,26,-0.6461563127685462,-1.2363510126592598
330,1561708800,32,258,226,290,26,0.6513756690913939,-0.8095281996044938
330,1561723200,157,620,463,777,26,2.012061862457791,0.6141889918864037
330,1561737600,344,354,10,698,26,-0.5887433932172215,0.38323692180882485
330,1561752000,657,464,0,1121,26,-0.6461563127685462,1.6198537020976331
330,1561766400,439,279,0,718,26,-0.6461563127685462,0.4417058003094777
330,1561780800,129,114,0,243,26,-0.6461563127685462,-0.9469300640810281
330,1561795200,35,82,47,117,26,-0.37631559087731975,-1.3152839986351412
330,1561809600,102,406,304,508,26,1.0991964415917272,-0.17221742394737746
330,1561824000,316,407,91,723,26,-0.12369874485149068,0.4563230199346409
330,1561838400,353,388,35,741,26,-0.4452110943389095,0.5089450105852286
330,1561852800,327,294,0,621,26,-0.6461563127685462,0.15813173958131127
330,1561867200,176,115,0,291,26,-0.6461563127685462,-0.8066047556794611
330,1561881600,41,67,26,108,26,-0.4968827219351018,-1.341594993960435
330,1561896000,106,354,248,460,26,0.7776840921043083,-0.31254273234894436
330,1561910400,295,443,148,738,26,0.2035548965910606,0.5001746788101306
330,1561924800,537,403,0,940,26,-0.6461563127685462,1.0907103516667247
330,1561939200,358,222,0,580,26,-0.6461563127685462,0.03827053865497288
330,1561953600,88,34,0,122,26,-0.6461563127685462,-1.300666779009978
330,1561968000,31,278,247,309,26,0.7719428001491759,-0.7539827650288736
330,1561982400,162,716,554,878,26,2.534519430374847,0.9094568283147008
330,1561996800,301,327,26,628,26,-0.4968827219351018,0.17859584705653977
330,1562011200,712,407,0,1119,26,-0.6461563127685462,1.6140068142475679
330,1562025600,394,149,0,543,27,-0.5853635026758219,0.23506764566084543
330,1562040000,81,26,0,107,27,-0.5853635026758219,-1.2390963020588128
330,1562054400,35,284,249,319,27,1.0479693444383043,-0.5223009880299881
330,1562068800,156,725,569,881,27,3.147031637918306,1.377882816140764
330,1562083200,326,348,22,674,27,-0.4410529699990718,0.6779930519711097
330,1562097600,714,448,0,1162,27,-0.5853635026758219,2.32797471822614
330,1562112000,392,176,0,568,27,-0.5853635026758219,0.31959539495669737
330,1562126400,81,26,0,107,27,-0.5853635026758219,-1.2390963020588128
330,1562140800,32,258,226,290,27,0.8970992420944293,-0.6203531772131764
330,1562155200,148,705,557,853,27,3.0683168019128058,1.2832117369294098
330,1562169600,414,350,0,764,27,-0.5853635026758219,0.9822929494361767
330,1562184000,635,446,0,1081,27,-0.5853635026758219,2.0541048105075794
330,1562198400,389,188,0,577,27,-0.5853635026758219,0.3500253847032041
330,1562212800,108,50,0,158,27,-0.5853635026758219,-1.0666596934952748
330,1562227200,23,74,51,97,27,-0.25082544965244663,-1.2729074017771536
330,1562241600,89,199,110,288,27,0.13618916070792866,-0.6271153971568445
330,1562256000,258,238,0,496,27,-0.5853635026758219,0.07615547698464374
330,1562270400,259,272,13,531,27,-0.5000890970031968,0.19449432599883648
330,1562284800,198,231,33,429,27,-0.36889770366069674,-0.15037889112823952
330,1562299200,65,87,22,152,27,-0.4410529699990718,-1.0869463533262793
330,1562313600,31,182,151,213,27,0.40513151706005385,-0.8806986450444004
330,1562328000,116,410,294,526,27,1.3431499794589297,0.1775887761396661
330,1562342400,302,351,49,653,27,-0.26394458898669665,0.6069897425625941
330,1562356800,437,363,0,800,27,-0.5853635026758219,1.1040129084222037
330,1562371200,310,253,0,563,27,-0.5853635026758219,0.302689845097527
330,1562385600,108,54,0,162,27,-0.5853635026758219,-1.0531352536079384
330,1562400000,32,69,37,101,27,-0.3426594249921967,-1.2593829618898171
330,1562414400,99,191,92,290,27,0.018116906699678567,-0.6203531772131764
330,1562428800,213,364,151,577,27,0.40513151706005385,0.3500253847032041
330,1562443200,292,359,67,651,27,-0.14587233497844657,0.6002275226189259
330,1562457600,211,222,11,433,27,-0.5132082363374468,-0.1368544512409032
330,1562472000,106,80,0,186,27,-0.5853635026758219,-0.9719886142839206
330,1562486400,27,41,14,68,27,-0.4935295273360718,-1.3709595909603418
330,1562500800,72,171,99,243,27,0.0640338943695536,-0.7792653458893781
330,1562515200,171,262,91,433,27,0.011557337032553563,-0.1368544512409032
330,1562529600,259,299,40,558,27,-0.3229807159908217,0.2857842952383566
330,1562544000,210,127,0,337,27,-0.5853635026758219,-0.46144100853697473
330,1562558400,43,22,0,65,27,-0.5853635026758219,-1.381102920875844
330,1562572800,41,271,230,312,27,0.9233375207629293,-0.5459687578328267
330,1562587200,155,725,570,880,27,3.153591207585431,1.3745017061689297
330,1562601600,320,319,0,639,27,-0.5853635026758219,0.5596542029569169
330,1562616000,739,380,0,1119,27,-0.5853635026758219,2.1825869894372745
330,1562630400,384,153,0,537,28,-0.5356771277771101,-0.1578602914984509
330,1562644800,50,30,0,80,28,-0.5356771277771101,-1.4135463399946242
330,1562659200,42,301,259,343,28,0.8175731731888454,-0.6909086359366513
330,1562673600,128,698,570,826,28,2.4425185152753786,0.6362168814017549
330,1562688000,392,311,0,703,28,-0.5356771277771101,0.29825324034042167
330,1562702400,917,355,0,1272,28,-0.5356771277771101,1.8616785392339066
330,1562716800,500,171,0,671,28,-0.5356771277771101,0.21032774022690406
330,1562731200,76,26,0,102,28,-0.5356771277771101,-1.3530975586665808
330,1562745600,48,265,217,313,28,0.5981271784376093,-0.7733387922930741
330,1562760000,151,746,595,897,28,2.5731411311987333,0.8313015847786221
330,1562774400,386,316,0,702,28,-0.5356771277771101,0.2955055684618742
330,1562788800,938,389,0,1327,28,-0.5356771277771101,2.012800492554015
330,1562803200,579,158,0,737,28,-0.5356771277771101,0.3916740842110341
330,1562817600,102,23,0,125,28,-0.5356771277771101,-1.28990110545999
330,1562832000,55,264,209,319,28,0.5563279413421358,-0.7568527610217896
330,1562846400,198,935,737,1133,28,3.315077589643389,1.4797521481158145
330,1562860800,433,307,0,740,28,-0.5356771277771101,0.3999170998466764
330,1562875200,814,413,0,1227,28,-0.5356771277771101,1.7380333046992724
330,1562889600,469,145,0,614,28,-0.5356771277771101,0.053710443149700825
330,1562904000,68,21,0,89,28,-0.5356771277771101,-1.3888172930876974
330,1562918400,52,237,185,289,28,0.43093023005571524,-0.8392829173782123
330,1562932800,198,655,457,853,28,1.852104291301815,0.7104040221225354
330,1562947200,449,300,0,749,28,-0.5356771277771101,0.4246461467536032
330,1562961600,859,430,0,1289,28,-0.5356771277771101,1.9083889611692126
330,1562976000,528,235,0,763,28,-0.5356771277771101,0.4631135530532672
330,1562990400,175,111,0,286,28,-0.5356771277771101,-0.8475259330138546
330,1563004800,38,87,49,125,28,-0.2796568005673348,-1.28990110545999
330,1563019200,130,248,118,378,28,0.08086161938112442,-0.5947401201874915
330,1563033600,327,307,0,634,28,-0.5356771277771101,0.10866388072064932
330,1563048000,393,397,4,790,28,-0.5147775092293734,0.5373006937740477
330,1563062400,407,232,0,639,28,-0.5356771277771101,0.12240224011338645
330,1563076800,134,81,0,215,28,-0.5356771277771101,-1.0426106363907217
330,1563091200,40,61,21,101,28,-0.4259541304014921,-1.3558452305451283
330,1563105600,110,198,88,308,28,-0.07588551972690132,-0.7870771516858113
330,1563120000,265,319,54,584,28,-0.2535322773826638,-0.028719713206721925
330,1563134400,354,243,0,597,28,-0.5356771277771101,0.0070000212143946005
330,1563148800,252,175,0,427,28,-0.5356771277771101,-0.46010419813866765
330,1563163200,58,22,0,80,28,-0.5356771277771101,-1.4135463399946242
330,1563177600,48,256,208,304,28,0.5511030367052016,-0.7980678392000009
330,1563192000,172,707,535,879,28,2.259646852982682,0.7818434909647685
330,1563206400,363,312,0,675,28,-0.5356771277771101,0.22131842774109375
330,1563220800,935,310,0,1245,28,-0.5356771277771101,1.787491398513126
330,1563235200,492,146,0,638,29,-0.5323978622866349,0.32268502550593753
330,1563249600,78,22,0,100,29,-0.5323978622866349,-1.0948986015457827
330,1563264000,40,264,224,304,29,1.0756473586430817,-0.5573761853402976
330,1563278400,186,665,479,851,29,2.9062345521121786,0.8839216659557821
330,1563279580,11,21,10,32,29,-0.46061012920941535,-1.2740727402809444
330,1563292800,356,311,0,667,29,-0.5323978622866349,0.39909752584887415
330,1563307200,927,374,0,1301,29,-0.5323978622866349,2.069632878173764
330,1563321600,512,156,0,668,29,-0.5323978622866349,0.401732439653803
330,1563336000,61,32,0,93,29,-0.5323978622866349,-1.1133429981802847
330,1563350400,51,263,212,314,29,0.9895020789504183,-0.5310270472910092
330,1563364800,207,659,452,866,29,2.7124076728036863,0.9234453730297149
330,1563379200,372,290,0,662,29,-0.5323978622866349,0.3859229568242299
330,1563393600,917,417,0,1334,29,-0.5323978622866349,2.1565850337364156
330,1563408000,447,187,0,634,29,-0.5323978622866349,0.31214537028622213
330,1563422400,46,29,0,75,29,-0.5323978622866349,-1.1607714466690038
330,1563436800,62,215,153,277,29,0.5659544537948235,-0.6285188580733766
330,1563451200,241,625,384,866,29,2.2242510878785935,0.9234453730297149
330,1563465600,378,282,0,660,29,-0.5323978622866349,0.3806531292143722
330,1563480000,909,435,0,1344,29,-0.5323978622866349,2.1829341717857043
330,1563494400,543,186,0,729,29,-0.5323978622866349,0.5624621817544627
330,1563508800,68,40,0,108,29,-0.5323978622866349,-1.073819291106352
330,1563523200,62,203,141,265,29,0.47980917410216,-0.6601378237325227
330,1563537600,174,562,388,736,29,2.2529661811094814,0.5809065783889646
330,1563552000,411,304,0,715,29,-0.5323978622866349,0.5255733884854589
330,1563566400,800,421,0,1221,29,-0.5323978622866349,1.858839773779456
330,1563580800,502,214,0,716,29,-0.5323978622866349,0.5282083022903877
330,1563595200,113,81,0,194,29,-0.5323978622866349,-0.847216703882471
330,1563609600,32,32,0,64,29,-0.5323978622866349,-1.1897554985232213
330,1563624000,74,159,85,233,29,0.07779786886973085,-0.7444550654902459
330,1563638400,191,207,16,398,29,-0.41753748936308366,-0.309694287676986
330,1563652800,225,256,31,481,29,-0.3098558897472544,-0.09099644186789159
330,1563667200,209,170,0,379,29,-0.5323978622866349,-0.3597576499706341
330,1563681600,65,62,0,127,29,-0.5323978622866349,-1.0237559288127038
330,1563696000,15,22,7,37,29,-0.4821464491325812,-1.2608981712563
330,1563710400,68,111,43,179,29,-0.22371061005459103,-0.8867404109564037
330,1563724800,171,165,0,336,29,-0.5323978622866349,-0.47305894358257455
330,1563739200,183,171,0,354,29,-0.5323978622866349,-0.4256304950938553
330,1563753600,118,113,0,231,29,-0.5323978622866349,-0.7497248931001036
330,1563768000,21,14,0,35,29,-0.5323978622866349,-1.2661679988661578
330,1563782400,47,204,157,251,29,0.5946695470257112,-0.6970266170015266
330,1563796800,202,609,407,811,29,2.3893628739561983,0.7785251137586282
330,1563811200,416,281,0,697,29,-0.5323978622866349,0.47814493999673957
330,1563825600,782,403,0,1185,29,-0.5323978622866349,1.7639828768020174
330,1563840000,387,112,0,499,30,-0.5387502159801486,-0.09865108175160411
330,1563854400,27,15,0,42,30,-0.5387502159801486,-1.292540654980032
330,1563868800,55,211,156,266,30,0.5380928026598556,-0.7073518926098616
330,1563883200,211,707,496,918,30,2.885058356106019,0.9959653978604556
330,1563897600,369,335,0,704,30,-0.5387502159801486,0.43690113381038215
330,1563912000,935,383,0,1318,30,-0.5387502159801486,2.0409453306643313
330,1563926400,524,138,0,662,30,-0.5387502159801486,0.3271782408659752
330,1563940800,54,15,0,69,30,-0.5387502159801486,-1.2220045095157703
330,1563955200,53,258,205,311,30,0.8763319559506262,-0.5897916501694257
330,1563969600,185,682,497,867,30,2.891961195969096,0.8627304564279614
330,1563984000,388,287,0,675,30,-0.5387502159801486,0.3611400886821012
330,1563998400,950,373,0,1323,30,-0.5387502159801486,2.0540075798243795
330,1564012800,531,150,0,681,30,-0.5387502159801486,0.37681478767415927
330,1564027200,54,17,0,71,30,-0.5387502159801486,-1.216779609851751
330,1564041600,55,256,201,311,30,0.8487205964983183,-0.5897916501694257
330,1564056000,231,658,427,889,30,2.408762405553709,0.9202043527321746
330,1564070400,360,331,0,691,30,-0.5387502159801486,0.4029392859942562
330,1564084800,874,365,0,1239,30,-0.5387502159801486,1.8345617939355658
330,1564099200,541,189,0,730,30,-0.5387502159801486,0.5048248294426341
330,1564113600,69,23,0,92,30,-0.5387502159801486,-1.1619181633795475
330,1564128000,48,215,167,263,30,0.614024041153702,-0.7151892421058907
330,1564142400,189,587,398,776,30,2.208580049524478,0.6249975217150797
330,1564156800,414,335,0,749,30,-0.5387502159801486,0.5544613762508181
330,1564171200,821,444,0,1265,30,-0.5387502159801486,1.9024854895678176
330,1564185600,457,204,0,661,30,-0.5387502159801486,0.3245657910339655
330,1564200000,113,52,0,165,30,-0.5387502159801486,-0.9712093256428402
330,1564214400,24,30,6,54,30,-0.497333176801687,-1.2611912569959158
330,1564228800,95,154,59,249,30,-0.1314826640586086,-0.7517635397540264
330,1564243200,246,233,0,479,30,-0.5387502159801486,-0.1509000783917979
330,1564257600,311,235,0,546,30,-0.5387502159801486,0.02413406035285127
330,1564272000,190,224,34,414,30,-0.30405366063553235,-0.3207093174724277
330,1564286400,94,64,0,158,30,-0.5387502159801486,-0.9894964744669081
330,1564300800,15,22,7,37,30,-0.49043033693861,-1.3056029041400805
330,1564315200,67,102,35,169,30,-0.2971508207724554,-0.9607595263148015
330,1564329600,149,207,58,356,30,-0.13838550392168555,-0.47223140772898964
330,1564344000,241,191,0,432,30,-0.5387502159801486,-0.27368522049625327
330,1564358400,145,120,0,265,30,-0.5387502159801486,-0.7099643424418713
330,1564372800,34,15,0,49,30,-0.5387502159801486,-1.274253506155964
330,1564387200,51,222,171,273,30,0.6416354006060099,-0.6890647437857939
330,1564401600,248,609,361,857,30,1.9531749745906304,0.8366059581078645
330,1564416000,360,307,0,667,30,-0.5387502159801486,0.34024049002602363
330,1564430400,957,345,0,1302,30,-0.5387502159801486,1.9991461333521763
330,1564444800,479,160,0,639,31,-0.6414982764788196,-0.05360835619142413
330,1564459200,43,11,0,54,31,-0.6414982764788196,-1.526526792448951
330,1564473600,57,282,225,339,31,0.7958837538056724,-0.8089511440157968
330,1564488000,292,687,395,979,31,1.881905732242844,0.8024468033428649
330,1564502400,366,285,0,651,31,-0.6414982764788196,-0.023394644678449227
330,1564516800,816,434,0,1250,31,-0.6414982764788196,1.4847731216775482
330,1564531200,481,124,0,605,31,-0.6414982764788196,-0.13921387214485303
330,1564545600,49,21,0,70,31,-0.6414982764788196,-1.4862418437649842
330,1564560000,65,259,194,324,31,0.5978444518553646,-0.8467182834070155
330,1564574400,238,664,426,902,31,2.079945034193152,0.6085754878012759
330,1564588800,390,293,0,683,31,-0.6414982764788196,0.05717525268948386
330,1564603200,849,482,0,1331,31,-0.6414982764788196,1.6887156743901288
330,1564617600,463,139,0,602,31,-0.6414982764788196,-0.14676730002309676
330,1564632000,44,31,0,75,31,-0.6414982764788196,-1.4736527973012448
330,1564646400,65,251,186,316,31,0.5467375352230271,-0.8668607577489987
330,1564660800,241,717,476,958,31,2.3993632631452613,0.7495728081951588
330,1564675200,383,307,0,690,31,-0.6414982764788196,0.07479991773871922
330,1564689600,886,463,0,1349,31,-0.6414982764788196,1.7340362416595911
330,1564704000,592,172,0,764,31,-0.6414982764788196,0.2611178054020645
330,1564718400,76,34,0,110,31,-0.6414982764788196,-1.385529472055068
330,1564732800,53,223,170,276,31,0.44452370195835217,-0.967573129458915
330,1564747200,244,582,338,826,31,1.5177689512374395,0.41722198155243484
330,1564761600,468,329,0,797,31,-0.6414982764788196,0.34420551206274547
330,1564776000,817,440,0,1257,31,-0.6414982764788196,1.5023977867267837
330,1565395200,5130,8301,3171,13431,32,4.080389874876614,4.103960187403694
330,1565409600,126,74,0,200,32,-0.32743201993786375,-0.3200445847705745
330,1565424000,29,73,44,102,32,-0.26627018979852696,-0.35281251370059324
330,1565438400,105,222,117,327,32,-0.16479715343099086,-0.27758002381024405
330,1565452800,263,334,71,597,32,-0.22873906675847935,-0.187301035941825
330,1565467200,305,367,62,672,32,-0.2412494411051619,-0.1622235393117086
330,1565481600,297,250,0,547,32,-0.32743201993786375,-0.20401936702856927
330,1565496000,95,80,0,175,32,-0.32743201993786375,-0.32840375031394664
330,1565510400,36,51,15,87,32,-0.3065813960267262,-0.35782801302661654
330,1565524800,91,194,103,285,32,-0.18425773574805257,-0.29162342192310925
330,1565539200,234,276,42,510,32,-0.2690502729866786,-0.21639093203276002
330,1565553600,283,244,0,527,32,-0.32743201993786375,-0.21070669946326698
330,1565568000,200,112,0,312,32,-0.32743201993786375,-0.28259552313626735
330,1565582400,43,32,0,75,32,-0.32743201993786375,-0.3618404124874352
330,1565596800,40,219,179,259,32,-0.07861457459828898,-0.30031695408821624
330,1565611200,205,641,436,846,32,0.2786261150792011,-0.10404374712983853
330,1565625600,361,311,0,672,32,-0.32743201993786375,-0.1622235393117086
330,1565640000,880,325,0,1205,32,-0.32743201993786375,0.015993870072985326
330,1565654400,455,97,0,552,33,-0.5806812056567188,-0.02200526993603735
330,1565668800,59,25,0,84,33,-0.5806812056567188,-1.3287593057751572
330,1565683200,56,230,174,286,33,0.7613865523886008,-0.7647329911608362
330,1565697600,250,651,401,901,33,2.512245064321288,0.9524758379867251
330,1565712000,377,355,0,732,33,-0.5806812056567188,0.4805924361559318
330,1565726400,959,322,0,1281,33,-0.5806812056567188,2.013515439736438
330,1565740800,487,146,0,633,33,-0.5806812056567188,0.20416369780534876
330,1565755200,72,22,0,94,33,-0.5806812056567188,-1.30083721099227
330,1565769600,50,217,167,267,33,0.7073953207430994,-0.8177849712483218
330,1565784000,239,667,428,906,33,2.7204969578110787,0.9664368853781686
330,1565798400,373,285,0,658,33,-0.5806812056567188,0.27396893476256673
330,1565812800,896,342,0,1238,33,-0.5806812056567188,1.893450432170023
330,1565827200,501,163,0,664,33,-0.5806812056567188,0.290722191632299
330,1565841600,71,21,0,92,33,-0.5806812056567188,-1.3064216299488474
330,1565856000,48,211,163,259,33,0.6765431883742415,-0.8401226470746316
330,1565870400,251,643,392,894,33,2.4428277664913574,0.9329303716387041
330,1565884800,362,296,0,658,33,-0.5806812056567188,0.27396893476256673
330,1565899200,839,371,0,1210,33,-0.5806812056567188,1.8152685667779387
330,1565913600,505,163,0,668,33,-0.5806812056567188,0.3018910295454539
330,1565928000,79,40,0,119,33,-0.5806812056567188,-1.231031974035052
330,1565942400,54,213,159,267,33,0.6456910560053836,-0.8177849712483218
330,1565956800,204,564,360,768,33,2.196010707540494,0.5811119773743256
330,1565971200,437,331,0,768,33,-0.5806812056567188,0.5811119773743256
330,1565985600,804,439,0,1243,33,-0.5806812056567188,1.9074114795614665
330,1566000000,522,228,0,750,33,-0.5806812056567188,0.5308522067651287
330,1566014400,131,66,0,197,33,-0.5806812056567188,-1.013239634728532
330,1566028800,33,66,33,99,33,-0.3261511136136409,-1.2868761636008264
330,1566043200,99,240,141,339,33,0.5068564603455229,-0.6167458888115341
330,1566057600,266,321,55,587,33,-0.15646438558492237,0.07572206180406776
330,1566072000,351,328,0,679,33,-0.5806812056567188,0.33260533380662977
330,1566086400,316,232,0,548,33,-0.5806812056567188,-0.03317410784919222
330,1566100800,124,72,0,196,33,-0.5806812056567188,-1.0160318442068208
330,1566115200,31,47,16,78,33,-0.4572726761812871,-1.3455125626448894
330,1566129600,96,168,72,264,33,-0.025342823017276195,-0.826161599683188
330,1566144000,232,269,37,501,33,-0.295298981244783,-0.16440795332876193
330,1566158400,313,265,0,578,33,-0.5806812056567188,0.05059217649946931
330,1566172800,237,139,0,376,33,-0.5806812056567188,-0.5134341381148516
330,1566187200,49,17,0,66,33,-0.5806812056567188,-1.379019076384354
330,1566201600,47,237,190,284,33,0.8847950818640324,-0.7703174101174136
330,1566216000,202,576,374,778,33,2.303993170831497,0.6090340721572128
330,1566230400,354,336,0,690,33,-0.5806812056567188,0.36331963806780565
330,1566244800,937,326,0,1263,33,-0.5806812056567188,1.9632556691272407
330,1566259200,429,108,0,537,34,-0.540818188658865,-0.11636679980628509
330,1566273600,64,24,0,88,34,-0.540818188658865,-1.317486181714837
330,1566288000,58,314,256,372,34,0.9934501924651762,-0.557758109416332
330,1566302400,240,1016,776,1256,34,4.109932841623385,1.8070292705550708
330,1566316800,388,319,0,707,34,-0.540818188658865,0.33840000403436926
330,1566331200,894,430,0,1324,34,-0.540818188658865,1.9889359920913325
330,1566345600,529,201,0,730,34,-0.540818188658865,0.3999272774951637
330,1566360000,82,37,0,119,34,-0.540818188658865,-1.2345581174850706
330,1566374400,50,247,197,297,34,0.6398492765029948,-0.7583905228754442
330,1566388800,240,660,420,900,34,1.976340874122765,0.854694081335818
330,1566403200,353,292,0,645,34,-0.540818188658865,0.17254387557483652
330,1566417600,874,418,0,1292,34,-0.540818188658865,1.9033328290154445
330,1566432000,496,107,0,603,34,-0.540818188658865,0.06018972403773367
330,1566446400,65,28,0,93,34,-0.540818188658865,-1.3041106874842294
330,1566460800,53,232,179,285,34,0.5319710309552107,-0.7904917090289022
330,1566475200,228,625,397,853,34,1.838496449256152,0.7289644355681077
330,1566489600,344,307,0,651,34,-0.540818188658865,0.18859446865156548
330,1566504000,853,428,0,1281,34,-0.540818188658865,1.8739067417081081
330,1566518400,509,187,0,696,34,-0.540818188658865,0.30897391672703284
330,1566532800,82,39,0,121,34,-0.540818188658865,-1.2292079197928276
330,1566547200,51,217,166,268,34,0.45405896472625545,-0.8359683894129676
330,1566561600,221,620,399,841,34,1.8504829209836835,0.6968632494146498
330,1566576000,462,345,0,807,34,-0.540818188658865,0.605909888646519
330,1566590400,823,390,0,1213,34,-0.540818188658865,1.6920000201718464
330,1566604800,488,177,0,665,34,-0.540818188658865,0.22604585249726644
330,1566619200,133,92,0,225,34,-0.540818188658865,-0.9509976397961919
330,1566633600,36,68,32,104,34,-0.3490346410183598,-1.274684600176893
330,1566648000,119,232,113,351,34,0.13641746394666882,-0.6139351851848834
330,1566662400,291,285,0,576,34,-0.540818188658865,-0.012037944807546733
330,1566676800,334,374,40,708,34,-0.30108875410823355,0.34107510288049075
330,1566691200,324,226,0,550,34,-0.540818188658865,-0.08159051480670564
330,1566705600,123,88,0,211,34,-0.540818188658865,-0.9884490236418929
330,1566720000,28,48,20,76,34,-0.4209534713835492,-1.3495873678682948
330,1566734400,87,180,93,267,34,0.016552746671353105,-0.8386434882590891
330,1566748800,218,315,97,533,34,0.04052569012641625,-0.1270671951907711
330,1566763200,346,267,0,613,34,-0.540818188658865,0.08694071249894864
330,1566777600,236,126,0,362,34,-0.540818188658865,-0.5845090978775469
330,1566792000,45,30,0,75,34,-0.540818188658865,-1.3522624667144163
330,1566806400,44,214,170,258,34,0.4780319081813186,-0.8627193778741825
330,1566820800,211,646,435,857,34,2.0662394120792515,0.7396648309525937
330,1566835200,382,324,0,706,34,-0.540818188658865,0.33572490518824777
330,1566849600,942,323,0,1265,34,-0.540818188658865,1.8311051601701642
330,1566864000,455,111,0,566,35,-0.5345302623762,0.1944180230235636
330,1566878400,55,27,0,82,35,-0.5345302623762,-1.2140387025726593
330,1566892800,47,246,199,293,35,0.9536789091562049,-0.6000214110420745
330,1566907200,240,695,455,935,35,2.8681590494189972,1.2682207745628327
330,1566921600,378,353,0,731,35,-0.5345302623762,0.6745737249313668
330,1566936000,982,373,0,1355,35,-0.5345302623762,2.490435288509968
330,1566950400,478,149,0,627,35,-0.5345302623762,0.37193013100159994
330,1566964800,58,28,0,86,35,-0.5345302623762,-1.2023985643445914
330,1566979200,50,249,199,299,35,0.9536789091562049,-0.5825612036999726
330,1566993600,238,690,452,928,35,2.8457237352752927,1.2478505326637137
330,1567008000,366,329,0,695,35,-0.5345302623762,0.5698124808787552
330,1567022400,866,384,0,1250,35,-0.5345302623762,2.1848816600231844
330,1567036800,502,122,0,624,35,-0.5345302623762,0.36320002733054896
330,1567051200,63,21,0,84,35,-0.5345302623762,-1.2082186334586253
330,1567065600,45,219,174,264,35,0.7667179579586666,-0.6844124131955672
330,1567080000,217,696,479,913,35,3.047641562568634,1.2042000143084588
330,1567094400,379,359,0,738,35,-0.5345302623762,0.6949439668304858
330,1567108800,812,375,0,1187,35,-0.5345302623762,2.001549482931114
330,1567123200,543,133,0,676,35,-0.5345302623762,0.5145218242954324
330,1567137600,86,37,0,123,35,-0.5345302623762,-1.0947272857349626
330,1567152000,55,196,141,251,35,0.519929502377916,-0.722242862436788
330,1567166400,206,606,400,812,35,2.456844956784413,0.910286524049743
330,1567180800,489,385,0,874,35,-0.5345302623762,1.0907086665847963
330,1567195200,582,288,0,870,35,-0.5345302623762,1.0790685283567283
330,1567209600,240,95,0,335,35,-0.5345302623762,-0.47779995964736094
330,1567224000,90,41,0,131,35,-0.5345302623762,-1.0714470092788269
330,1567238400,35,73,38,108,35,-0.25034961655594185,-1.1383778040902175
330,1567252800,104,193,89,297,35,0.13105072388703634,-0.5883812728140065
330,1567267200,264,279,15,543,35,-0.42235369165767706,0.12748722821217282
330,1567281600,288,306,18,594,35,-0.39991837751397247,0.27589899062003925
330,1567296000,240,165,0,405,35,-0.5345302623762,-0.2740975406561717
330,1567310400,52,38,0,90,35,-0.5345302623762,-1.1907584261165234
330,1567324800,25,51,26,76,35,-0.3400908731307602,-1.231498909914761
330,1567339200,68,163,95,231,35,0.17592135217444554,-0.7804435535771278
330,1567353600,200,232,32,432,35,-0.295220244843351,-0.19552660761671298
330,1567368000,297,271,0,568,35,-0.5345302623762,0.20023809213759755
330,1567382400,220,148,0,368,35,-0.5345302623762,-0.3817688192658003
330,1567396800,81,37,0,118,35,-0.5345302623762,-1.1092774585200476
330,1567411200,29,63,34,92,35,-0.280263368747548,-1.1849383570024894
330,1567425600,79,184,105,263,35,0.25070573265346086,-0.6873224477525842
330,1567440000,212,263,51,475,35,-0.1531299219332219,-0.07039512166498245
330,1567454400,302,275,0,577,35,-0.5345302623762,0.22642840315075047
330,1567468800,209,116,0,325,36,-0.5701449843281791,-0.7652003458629717
330,1567483200,51,11,0,62,36,-0.5701449843281791,-1.4321092160225413
330,1567497600,59,220,161,279,36,0.35107852439993253,-0.8818460037616037
330,1567512000,214,730,516,944,36,2.382347751719682,0.8044444854251406
330,1567526400,392,353,0,745,36,-0.5701449843281791,0.299825226254972
330,1567540800,1007,360,0,1367,36,-0.5701449843281791,1.8770773830582126
330,1567555200,535,126,0,661,36,-0.5701449843281791,0.08682011183138326
330,1567569600,67,20,0,87,36,-0.5701449843281791,-1.3687148367298065
330,1567584000,68,255,187,323,36,0.4998475382318015,-0.7702718962063905
330,1567598400,223,759,536,982,36,2.496785454667273,0.9008039419500974
330,1567612800,411,361,0,772,36,-0.5701449843281791,0.36829115589112554
330,1567627200,992,342,0,1334,36,-0.5701449843281791,1.7933968023918025
330,1567641600,518,139,0,657,36,-0.5701449843281791,0.0766770111445457
330,1567656000,70,32,0,102,36,-0.5701449843281791,-1.3306782091541656
330,1567670400,58,285,227,343,36,0.7287229441269845,-0.7195563927722027
330,1567684800,264,770,506,1034,36,2.325128900245886,1.0326642508789856
330,1567699200,446,358,0,804,36,-0.5701449843281791,0.44943596138582603
330,1567713600,968,421,0,1389,36,-0.5701449843281791,1.932864436835819
330,1567728000,620,174,0,794,36,-0.5701449843281791,0.4240782096687321
330,1567742400,105,48,0,153,36,-0.5701449843281791,-1.201353675396987
330,1567756800,71,287,216,358,36,0.6657822075058092,-0.6815197651965619
330,1567771200,240,800,560,1040,36,2.6341106982043834,1.047878901909242
330,1567785600,414,376,0,790,36,-0.5701449843281791,0.41393510898189456
330,1567800000,853,506,0,1359,36,-0.5701449843281791,1.8567911816845373
330,1567814400,519,209,0,728,36,-0.5701449843281791,0.25671704833591236
330,1567828800,171,89,0,260,36,-0.5701449843281791,-0.9300257320240821
330,1567843200,48,80,32,128,36,-0.38704465961203266,-1.2647480546897216
330,1567857600,133,291,158,424,36,0.3339128689577938,-0.5141586038637421
330,1567872000,305,341,36,646,36,-0.36415711902251435,0.04878348425574241
330,1567886400,424,443,19,867,36,-0.4614291665279671,0.6091897972035176
330,1567900800,389,309,0,698,36,-0.5701449843281791,0.1806437931846307
330,1567915200,177,104,0,281,36,-0.5701449843281791,-0.8767744534181849
330,1567929600,47,56,9,103,36,-0.5186480180017629,-1.3281424339824563
330,1567944000,95,218,123,313,36,0.13364688879950867,-0.7956296479234845
330,1567958400,246,337,91,583,36,-0.049453435916637735,-0.11097035156194915
330,1567972800,423,279,0,702,36,-0.5701449843281791,0.19078689387146824
330,1567987200,257,133,0,390,36,-0.5701449843281791,-0.6003749597018614
330,1568001600,53,21,0,74,36,-0.5701449843281791,-1.4016799139620286
330,1568016000,67,322,255,389,36,0.8889357282536126,-0.6029107348735708
330,1568030400,214,763,549,977,36,2.571169961583208,0.8881250660915505
330,1568044800,335,339,4,674,36,-0.5472574437386608,0.11978518906360533
330,1568059200,1012,371,0,1383,36,-0.5701449843281791,1.9176497858055628
330,1568073600,535,109,0,644,37,-0.5128823657146833,0.2341701322162824
330,1568088000,92,16,0,108,37,-0.5128823657146833,-0.8536627230154445
330,1568102400,73,322,249,395,37,0.9309194594923577,-0.2711850561283071
330,1568116800,277,719,442,996,37,2.0500108340504255,0.9485678281893568
330,1568131200,442,361,0,803,37,-0.5128823657146833,0.5568668187495746
330,1568145600,1033,410,0,1443,37,-0.5128823657146833,1.8557717205188007
330,1568160000,611,128,0,739,37,-0.5128823657146833,0.42697632857265194
330,1568174400,88,22,0,110,37,-0.5128823657146833,-0.8496036451974157
330,1568188800,70,298,228,368,37,0.8091530404989928,-0.3259826066716964
330,1568203200,265,843,578,1108,37,2.8385933570550743,1.1758761859989715
330,1568217600,415,367,0,782,37,-0.5128823657146833,0.5142465016602719
330,1568232000,1012,410,0,1422,37,-0.5128823657146833,1.813151403429498
330,1568246400,633,137,0,770,37,-0.5128823657146833,0.4898920347520988
330,1568260800,95,33,0,128,37,-0.5128823657146833,-0.8130719448351562
330,1568275200,62,274,212,336,37,0.7163786260278577,-0.39092785176015765
330,1568289600,257,712,455,969,37,2.125390045808223,0.8937702776459676
330,1568304000,443,357,0,800,37,-0.5128823657146833,0.5507782020225312
330,1568318400,945,464,0,1409,37,-0.5128823657146833,1.7867673976123106
330,1568332800,568,178,0,746,37,-0.5128823657146833,0.44118310093575286
330,1568347200,80,34,0,114,37,-0.5128823657146833,-0.841485489561358
330,1568361600,77,275,198,352,37,0.6352010133656144,-0.35845522921592704
330,1568376000,255,765,510,1020,37,2.44430209555275,0.9972767620057028
330,1568390400,464,402,0,866,37,-0.5128823657146833,0.6847277700174828
330,1568404800,960,564,0,1524,37,-0.5128823657146833,2.0201643721489684
330,1568419200,540,257,0,797,37,-0.5128823657146833,0.544689585295488
330,1568433600,1,3,2,4,37,-0.5012855639057913,-1.0647347695529437
330,1568448000,3,5,2,8,37,-0.5012855639057913,-1.056616613916886
330,1568462400,2,4,2,6,37,-0.5012855639057913,-1.060675691734915
330,1568476800,1,4,3,5,37,-0.4954871630013454,-1.0627052306439293
330,1568491200,1,8,7,9,37,-0.4722935593835616,-1.0545870750078716
330,1568505600,2,2,0,4,37,-0.5128823657146833,-1.0647347695529437
330,1568520000,0,1,1,1,37,-0.5070839648102372,-1.070823386279987
330,1568534400,1,2,1,3,37,-0.5070839648102372,-1.0667643084619582
330,1568548800,1,2,1,3,37,-0.5070839648102372,-1.0667643084619582
330,1568563200,1,2,1,3,37,-0.5070839648102372,-1.0667643084619582
330,1568577600,1,2,1,3,37,-0.5070839648102372,-1.0667643084619582
330,1568592000,0,0,0,0,37,-0.5128823657146833,-1.0728529251890013
330,1568606400,0,2,2,2,37,-0.5012855639057913,-1.0687938473709726
330,1568620800,50,307,257,357,37,0.9773066667279252,-0.34830753467085496
330,1568635200,203,766,563,969,37,2.7516173434883853,0.8937702776459676
330,1568649600,439,347,0,786,37,-0.5128823657146833,0.5223646572963295
330,1568664000,956,334,0,1290,37,-0.5128823657146833,1.545252267439595
330,1568678400,566,88,0,654,38,-0.5484552970401559,0.029695786688385233
330,1568692800,89,22,0,111,38,-0.5484552970401559,-1.352430970893892
330,1568707200,66,338,272,404,38,0.8457488225385582,-0.6066424994913003
330,1568721600,186,810,624,996,38,2.6500129772874823,0.9002065621821951
330,1568736000,465,408,0,873,38,-0.5484552970401559,0.5871281253817898
330,1568750400,948,403,0,1351,38,-0.5484552970401559,1.8038069285573486
330,1568764800,634,131,0,765,38,-0.5484552970401559,0.31222998575216565
330,1568779200,83,20,0,103,38,-0.5484552970401559,-1.3727937960516419
330,1568793600,73,299,226,372,38,0.6099643023156874,-0.6880938001223001
330,1568808000,178,769,591,947,38,2.4808632127797705,0.7754842580909768
330,1568822400,428,371,0,799,38,-0.5484552970401559,0.3987719926726029
330,1568836800,979,377,0,1356,38,-0.5484552970401559,1.8165336942809425
330,1568851200,605,143,0,748,38,-0.5484552970401559,0.26895898229194704
330,1568865600,76,26,0,102,38,-0.5484552970401559,-1.3753391491963605
330,1568880000,68,316,248,384,38,0.7227308119874951,-0.6575495623856752
330,1568894400,177,773,596,950,38,2.5064919649779087,0.783120317525133
330,1568908800,438,370,0,808,38,-0.5484552970401559,0.42168017097507154
330,1568923200,944,494,0,1438,38,-0.5484552970401559,2.0252526521478793
330,1568937600,599,170,0,769,38,-0.5484552970401559,0.3224113983310406
330,1568952000,94,58,0,152,38,-0.5484552970401559,-1.2480714919604234
330,1568966400,76,301,225,377,38,0.6048385518760598,-0.6753670343987064
330,1568980800,196,694,498,890,38,2.0041684218944016,0.6303991288420084
330,1568995200,440,416,0,856,38,-0.5484552970401559,0.5438571219215712
330,1569009600,903,505,0,1408,38,-0.5484552970401559,1.948892057806317
330,1569024000,606,220,0,826,38,-0.5484552970401559,0.4674965275800089
330,1569038400,162,92,0,254,38,-0.5484552970401559,-0.9884454711991117
330,1569052800,41,71,30,112,38,-0.39468278385132716,-1.3498856177491732
330,1569067200,111,222,111,333,38,0.0205030017585105,-0.787362572766331
330,1569081600,314,335,21,649,38,-0.44081453780797575,0.01696902096479152
330,1569096000,377,360,0,737,38,-0.5484552970401559,0.24096009770004084
330,1569110400,370,296,0,666,38,-0.5484552970401559,0.06024002442501014
330,1569124800,156,82,0,238,38,-0.5484552970401559,-1.0291711215146115
330,1569139200,37,55,18,92,38,-0.45619178912685865,-1.400792680643548
330,1569153600,91,202,111,293,38,0.0205030017585105,-0.8891766985550807
330,1569168000,261,292,31,553,38,-0.3895570334116995,-0.22738488092820774
330,1569182400,348,286,0,634,38,-0.5484552970401559,-0.021211276205989615
330,1569196800,278,112,0,390,38,-0.5484552970401559,-0.6422774435173627
330,1569211200,51,24,0,75,38,-0.5484552970401559,-1.4440636841037666
330,1569225600,57,309,252,366,38,0.7432338137460056,-0.7033659189906126
330,1569240000,170,810,640,980,38,2.7320249843215243,0.8594809118666953
330,1569254400,415,369,0,784,38,-0.5484552970401559,0.36059169550182174
330,1569268800,1021,362,0,1383,38,-0.5484552970401559,1.8852582291883484
330,1569283200,511,103,0,614,39,-0.5236225095973862,0.03882018852297525
330,1569297600,57,27,0,84,39,-0.5236225095973862,-1.2547986685450307
330,1569312000,66,280,214,346,39,0.5550662633252146,-0.6153116109000919
330,1569326400,188,719,531,907,39,2.1529370157386,0.7539717453549106
330,1569340800,445,369,0,814,39,-0.5236225095973862,0.5269782477939209
330,1569355200,982,450,0,1432,39,-0.5236225095973862,2.035386650941143
330,1569369600,611,132,0,743,39,-0.5236225095973862,0.3536821367527352
330,1569384000,58,22,0,80,39,-0.5236225095973862,-1.2645618297304495
330,1569398400,69,283,214,352,39,0.5550662633252146,-0.6006668691219635
330,1569412800,165,898,733,1063,39,3.171138567749653,1.134735031586248
330,1569427200,417,404,0,821,39,-0.5236225095973862,0.544063779868404
330,1569441600,995,382,0,1377,39,-0.5236225095973862,1.901143184641633
330,1569456000,600,131,0,731,39,-0.5236225095973862,0.3243926531964785
330,1569470400,62,36,0,98,39,-0.5236225095973862,-1.2206276043960644
330,1569484800,67,337,270,404,39,0.8373399609124372,-0.47374577371151766
330,1569499200,173,775,602,948,39,2.510819739465257,0.8540441475054544
330,1569513600,427,369,0,796,39,-0.5236225095973862,0.48304402245953576
330,1569528000,895,418,0,1313,39,-0.5236225095973862,1.7449326056749304
330,1569542400,636,163,0,799,39,-0.5236225095973862,0.4903663933486
330,1569556800,61,44,0,105,39,-0.5236225095973862,-1.2035420723215815
330,1569571200,69,317,248,386,39,0.7264467225745997,-0.5176799990459028
330,1569585600,193,771,578,964,39,2.389845297642162,0.8930967922471301
330,1569600000,474,380,0,854,39,-0.5236225095973862,0.62460985964811
330,1569614400,973,476,0,1449,39,-0.5236225095973862,2.076880085979173
330,1569628800,610,243,0,853,39,-0.5236225095973862,0.6221690693517553
330,1569643200,137,89,0,226,39,-0.5236225095973862,-0.9082064464626592
330,1569657600,30,37,7,67,39,-0.4883382973989834,-1.296292103583061
330,1569672000,95,154,59,249,39,-0.22622700678227664,-0.8520682696465005
330,1569686400,226,265,39,491,39,-0.32703904163485614,-0.26139701792865633
330,1569700800,273,323,50,596,39,-0.27159242246593746,-0.005114036811409854
330,1569715200,257,195,0,452,39,-0.5236225095973862,-0.3565878394864907
330,1569729600,97,65,0,162,39,-0.5236225095973862,-1.064417025429362
330,1569744000,25,32,7,57,39,-0.4883382973989834,-1.3207000065466084
330,1569758400,76,97,21,173,39,-0.4177698730021777,-1.03756833216946
330,1569772800,161,207,46,368,39,-0.2917548294364533,-0.5616142243802879
330,1569787200,241,225,0,466,39,-0.5236225095973862,-0.3224167753375245
330,1569801600,144,134,0,278,39,-0.5236225095973862,-0.7812853510522134
330,1569816000,34,19,0,53,39,-0.5236225095973862,-1.3304631677320273
330,1569830400,43,218,175,261,39,0.35848279536268457,-0.8227787860902438
330,1569844800,163,732,569,895,39,2.344479881958501,0.7246822617986539
330,1569859200,397,336,0,733,39,-0.5236225095973862,0.3292742337891879
330,1569873600,897,363,0,1260,39,-0.5236225095973862,1.6155707199681297
330,1569888000,319,181,0,500,40,-0.5663993195689612,-0.16455930998426613
330,1569902400,44,23,0,67,40,-0.5663993195689612,-1.2105836411180884
330,1569916800,55,233,178,288,40,0.3541227050174636,-0.6767005529412414
330,1569931200,168,741,573,909,40,2.3968541640716086,0.8234867672298984
330,1569945600,422,388,0,810,40,-0.5663993195689612,0.5843264698113109
330,1569960000,958,418,0,1376,40,-0.5663993195689612,1.9516469580832354
330,1569974400,335,199,0,534,40,-0.5663993195689612,-0.08242345026475123
330,1569988800,57,32,0,89,40,-0.5663993195689612,-1.1574369083584022
330,1570003200,58,285,227,343,40,0.6075248353811423,-0.5438337210420261
330,1570017600,179,811,632,990,40,2.7019710149176706,1.0191633742087427
330,1570032000,418,347,0,765,40,-0.5663993195689612,0.47561724371195296
330,1570046400,964,392,0,1356,40,-0.5663993195689612,1.9033317464835209
330,1570060800,403,176,0,579,40,-0.5663993195689612,0.026285775834606725
330,1570075200,49,31,0,80,40,-0.5663993195689612,-1.1791787535782738
330,1570089600,57,301,244,358,40,0.6954398602011942,-0.5075973123422401
330,1570104000,169,793,624,962,40,2.660599238531764,0.9515220779691422
330,1570118400,393,330,0,723,40,-0.5663993195689612,0.3741552993525522
330,1570132800,900,461,0,1361,40,-0.5663993195689612,1.9154105493834495
330,1570147200,350,190,0,540,40,-0.5663993195689612,-0.06792888678483684
330,1570161600,56,40,0,96,40,-0.5663993195689612,-1.140526584298502
330,1570176000,70,274,204,344,40,0.48858097827166047,-0.5414179604620404
330,1570190400,192,761,569,953,40,2.3761682758786553,0.9297802327492707
330,1570204800,453,415,0,868,40,-0.5663993195689612,0.7244405834504835
330,1570219200,950,507,0,1457,40,-0.5663993195689612,2.14732356506208
330,1570233600,298,283,0,581,40,-0.5663993195689612,0.03111729699457819
330,1570248000,79,68,0,147,40,-0.5663993195689612,-1.0173227947192296
330,1570262400,21,33,12,54,40,-0.5043416549901011,-1.2419885286579029
330,1570276800,80,203,123,283,40,0.06969174236435483,-0.6887793558411701
330,1570291200,251,258,7,509,40,-0.5301990152312928,-0.14281746476439455
330,1570305600,235,347,112,582,40,0.012805549833733065,0.03353305757456392
330,1570320000,199,216,17,415,40,-0.47848429474890936,-0.3698989592830534
330,1570334400,64,56,0,120,40,-0.5663993195689612,-1.0825483303788446
330,1570348800,15,20,5,35,40,-0.5405419593277695,-1.2878879796776317
330,1570363200,63,152,89,215,40,-0.10613830727574879,-0.8530510752801999
330,1570377600,119,247,128,366,40,0.09554910260554653,-0.48827122770235426
330,1570392000,207,260,53,467,40,-0.2923113010123291,-0.2442794091237953
330,1570406400,117,110,0,227,40,-0.5663993195689612,-0.824061948320371
330,1570420800,23,28,5,51,40,-0.5405419593277695,-1.24923581039786
330,1570435200,56,261,205,317,40,0.49375245031989884,-0.6066434961216551
330,1570449600,173,766,593,939,40,2.5002836050363753,0.8959595846294705
330,1570464000,440,382,0,822,40,-0.5663993195689612,0.6133155967711397
330,1570478400,991,392,0,1383,40,-0.5663993195689612,1.9685572821431356
330,1570492800,329,160,0,489,41,-0.6328462325644646,-0.25840518397608103
330,1570507200,60,25,0,85,41,-0.6328462325644646,-1.3186354286696285
330,1570521600,60,344,284,404,41,0.9424326488210312,-0.4814734285279413
330,1570523184,16,84,68,100,41,-0.2556667820918811,-1.2792704443369471
330,1570536000,182,761,579,943,41,2.578725853077092,0.933041675159737
330,1570550400,439,415,0,854,41,-0.6328462325644646,0.6994761014524952
330,1570564800,996,357,0,1353,41,-0.6328462325644646,2.009017913586357
330,1570579200,376,175,0,551,41,-0.6328462325644646,-0.09569658206766536
330,1570593600,52,38,0,90,41,-0.6328462325644646,-1.3055137672254014
330,1570608000,45,254,209,299,41,0.5264259019762699,-0.7570283188567097
330,1570622400,143,703,560,846,41,2.4733374772097525,0.6784814431417319
330,1570636800,345,311,0,656,41,-0.6328462325644646,0.17985830826110313
330,1570651200,860,383,0,1243,41,-0.6328462325644646,1.7203413618133614
330,1570665600,300,152,0,452,41,-0.6328462325644646,-0.3555054786633614
330,1570680000,54,46,0,100,41,-0.6328462325644646,-1.2792704443369471
330,1570694400,61,306,245,367,41,0.7261091404617553,-0.5785737232152216
330,1570708800,182,827,645,1009,41,2.9448117903004816,1.1062476062235345
330,1570723200,419,368,0,787,41,-0.6328462325644646,0.5236458380998524
330,1570737600,907,461,0,1368,41,-0.6328462325644646,2.0483828979190384
330,1570752000,391,251,0,642,41,-0.6328462325644646,0.14311765621726735
330,1570766400,97,43,0,140,41,-0.6328462325644646,-1.1742971527831307
330,1570780800,59,285,226,344,41,0.6207207645944158,-0.6389333658586661
330,1570795200,184,737,553,921,41,2.4345101808375746,0.8753063648051379
330,1570809600,479,380,0,859,41,-0.6328462325644646,0.7125977628967223
330,1570824000,949,460,0,1409,41,-0.6328462325644646,2.1559805217617
330,1570838400,336,356,20,692,41,-0.5219111000725283,0.2743342706595381
330,1570852800,179,109,0,288,41,-0.6328462325644646,-0.7858959740340093
330,1570867200,35,68,33,103,41,-0.44980326395276965,-1.271397447470411
330,1570881600,81,273,192,354,41,0.4321310393581241,-0.612690042970212
330,1570896000,242,362,120,604,41,0.03276456238715332,0.0433930292411416
330,1570910400,363,447,84,810,41,-0.16691867609833205,0.584005480743297
330,1570924800,326,355,29,681,41,-0.4719902904511569,0.2454666154822385
330,1570939200,150,91,0,241,41,-0.6328462325644646,-0.9092395916097438
330,1570953600,31,58,27,89,41,-0.48308380370035053,-1.3081380995142469
330,1570968000,69,263,194,332,41,0.4432245526073177,-0.6704253533248111
330,1570982400,210,312,102,522,41,-0.06707705685558936,-0.1718022184441824
330,1570996800,315,451,136,766,41,0.12151266838070238,0.4685348600340987
330,1571011200,187,169,0,356,41,-0.6328462325644646,-0.6074413783925212
330,1571025600,56,33,0,89,41,-0.6328462325644646,-1.3081380995142469
330,1571040000,40,180,140,220,41,0.14369969487908962,-0.9643505696754975
330,1571054400,175,621,446,796,41,1.8410072220057154,0.5472648286994611
330,1571068800,386,400,14,786,41,-0.5551916398201091,0.521021505811007
330,1571083200,827,394,0,1221,41,-0.6328462325644646,1.6626060514587622
330,1571097600,282,177,0,459,42,-0.6083722436291953,-0.4073383190816606
330,1571112000,61,20,0,81,42,-0.6083722436291953,-1.3570964559212033
330,1571126400,64,308,244,372,42,0.627670332245506,-0.6259334458145712
330,1571140800,175,841,666,1016,42,2.765416098717325,0.9921730095416865
330,1571155200,417,377,0,794,42,-0.6083722436291953,0.43437854822322497
330,1571169600,980,447,0,1427,42,-0.6083722436291953,2.0248465392799195
330,1571184000,612,213,0,825,42,-0.6083722436291953,0.5122687657947219
330,1571198400,131,86,0,217,42,-0.6083722436291953,-1.0153845336720557
330,1571212800,55,318,263,373,42,0.7239195492193555,-0.6234208581509746
330,1571227200,189,785,596,974,42,2.410813720392616,0.8866443276706262
330,1571241600,418,332,0,750,42,-0.6083722436291953,0.32382469102497136
330,1571256000,744,518,0,1262,42,-0.6083722436291953,1.6102695747864681
330,1571270400,260,144,0,404,42,-0.6083722436291953,-0.5455306405794776
330,1571284800,50,20,0,70,42,-0.6083722436291953,-1.3847349202207666
330,1571299200,48,308,260,356,42,0.7087223044340109,-0.666134848432118
330,1571313600,198,816,618,1014,42,2.5222601821518102,0.9871478342144931
330,1571328000,314,381,67,695,42,-0.2689671100898306,0.1856323695271543
330,1571342400,837,607,0,1444,42,-0.6083722436291953,2.067560529561063
330,1571356800,346,197,0,543,42,-0.6083722436291953,-0.19628095533954007
330,1571371200,97,63,0,160,42,-0.6083722436291953,-1.1586020304970661
330,1571385600,46,275,229,321,42,0.5516841083187825,-0.7540754166580016
330,1571400000,205,783,578,988,42,2.3196302516805476,0.9218205549609797
330,1571414400,406,389,0,795,42,-0.6083722436291953,0.43689113588682166
330,1571428800,787,669,0,1456,42,-0.6083722436291953,2.097711581524223
330,1571443200,349,278,0,627,42,-0.6083722436291953,0.014776408402580505
330,1571457600,134,88,0,222,42,-0.6083722436291953,-1.0028215953540722
330,1571472000,24,92,68,116,42,-0.263901361828049,-1.2691558876953197
330,1571486400,110,282,172,392,42,0.2629364573972334,-0.5756816925426378
330,1571500800,311,398,87,709,42,-0.16765214485419935,0.22080859681750772
330,1571515200,400,468,68,868,42,-0.263901361828049,0.6203100353293788
330,1571529600,308,364,56,672,42,-0.3246903409694278,0.12784285326443082
330,1571544000,148,106,0,254,42,-0.6083722436291953,-0.9224187901189788
330,1571558400,27,45,18,72,42,-0.5171887749171271,-1.3797097448935733
330,1571572800,105,205,100,310,42,-0.10179741745103904,-0.781713880957565
330,1571587200,258,370,112,628,42,-0.0410084383096603,0.01728899606617718
330,1571601600,323,353,30,676,42,-0.4563997957757484,0.13789320391881751
330,1571616000,208,134,0,342,42,-0.6083722436291953,-0.7013110757224714
330,1571630400,41,18,0,59,42,-0.6083722436291953,-1.4123733845203301
330,1571644800,47,264,217,311,42,0.49089512917740374,-0.7792012932939684
330,1571659200,182,777,595,959,42,2.4057479721308344,0.8489555127166761
330,1571673600,389,360,0,749,42,-0.6083722436291953,0.32131210336137467
330,1571688000,862,463,0,1325,42,-0.6083722436291953,1.7685625975930586
330,1571702400,268,156,0,424,43,-0.6111656914001821,-0.5072926661362972
330,1571716800,138,97,0,235,43,-0.6111656914001821,-0.9888051836288153
330,1571731200,52,328,276,380,43,0.8302651722236045,-0.6193908183567777
330,1571745600,176,755,579,931,43,2.4127055768540657,0.7843837696769653
330,1571760000,370,416,46,786,43,-0.370927214129551,0.41496940440492774
330,1571774400,855,557,0,1412,43,-0.6111656914001821,2.009820388269035
330,1571788800,324,170,0,494,43,-0.6111656914001821,-0.3289546966946239
330,1571803200,79,22,0,101,43,-0.6111656914001821,-1.3301950108457328
330,1571817600,56,321,265,377,43,0.7728168407023666,-0.6270338741899922
330,1571832000,188,778,590,966,43,2.4701539083753037,0.873552754397802
330,1571846400,379,369,0,748,43,-0.6111656914001821,0.3181573638508765
330,1571860800,877,532,0,1409,43,-0.6111656914001821,2.0021773324358203
330,1571875200,327,223,0,550,43,-0.6111656914001821,-0.18628432114128524
330,1571889600,60,19,0,79,43,-0.6111656914001821,-1.386244086955973
330,1571904000,55,284,229,339,43,0.5848041193601335,-0.7238459147440435
330,1571918400,173,824,651,997,43,2.788731019538532,0.9525309980076859
330,1571932800,377,346,0,723,43,-0.6111656914001821,0.2544652319074217
330,1571947200,825,518,0,1343,43,-0.6111656914001821,1.8340301041051
330,1571961600,375,251,0,626,43,-0.6111656914001821,0.007339759966817237
330,1571976000,89,49,0,138,43,-0.6111656914001821,-1.2359306555694198
330,1571990400,57,251,194,308,43,0.40201397361074037,-0.8028241583539274
330,1572004800,218,736,518,954,43,2.0941284656908374,0.8429805310649437
330,1572019200,431,396,0,827,43,-0.6111656914001821,0.5194245007921935
330,1572033600,852,513,0,1365,43,-0.6111656914001821,1.89007918021534
330,1572048000,404,291,0,695,43,-0.6111656914001821,0.18313004413075237
330,1572062400,172,148,0,320,43,-0.6111656914001821,-0.772251935021069
330,1572076800,26,72,46,98,43,-0.370927214129551,-1.3378380666789473
330,1572091200,110,277,167,387,43,0.2610044326040656,-0.6015570214126102
330,1572105600,310,458,148,768,43,0.16177549634010926,0.3691110694056403
330,1572120000,432,537,105,969,43,-0.0627952541520024,0.8811958102310166
330,1572134400,369,299,0,668,43,-0.6111656914001821,0.11434254163182124
330,1572148800,145,141,0,286,43,-0.6111656914001821,-0.8588732344641675
330,1572163200,31,49,18,80,43,-0.5171593307290655,-1.3836964016782347
330,1572177600,75,190,115,265,43,-0.010569498223604342,-0.9123746252966696
330,1572192000,200,347,147,547,43,0.15655292074726945,-0.19392737697449983
330,1572206400,338,375,37,713,43,-0.4179303944651092,0.2289883791300398
330,1572220800,270,116,0,386,43,-0.6111656914001821,-0.6041047066903485
330,1572235200,36,28,0,64,43,-0.6111656914001821,-1.424459366122046
330,1572249600,63,238,175,301,43,0.302785037346784,-0.8206579552980947
330,1572264000,183,792,609,975,43,2.56938284463926,0.8964819218974457
330,1572278400,402,370,0,772,43,-0.6111656914001821,0.37930181051659306
330,1572292800,899,466,0,1365,43,-0.6111656914001821,1.89007918021534
330,1572307200,279,196,0,475,44,-0.5687974565220385,-0.39077153834835415
330,1572321600,45,24,0,69,44,-0.5687974565220385,-1.428983304667874
330,1572336000,65,281,216,346,44,0.6207974041347266,-0.7206467054794331
330,1572350400,213,773,560,986,44,2.5153373674029083,0.9159432709848346
330,1572364800,354,368,14,722,44,-0.49169408592391484,0.24084990569332418
330,1572379200,810,540,0,1350,44,-0.5687974565220385,1.846753820098887
330,1572393600,341,157,0,498,44,-0.5687974565220385,-0.3319565860691695
330,1572408000,52,22,0,74,44,-0.5687974565220385,-1.416197445476747
330,1572422400,55,253,198,308,44,0.5216644990799962,-0.817819235331999
330,1572436800,188,742,554,930,44,2.482293065717998,0.7727416480442112
330,1572451200,394,374,0,768,44,-0.5687974565220385,0.3584798102516934
330,1572465600,866,488,0,1354,44,-0.5687974565220385,1.8569825074517885
330,1572480000,345,177,0,522,44,-0.5687974565220385,-0.2705844619517595
330,1572494400,82,34,0,116,44,-0.5687974565220385,-1.3087962282712793
330,1572508800,55,260,205,315,44,0.5602161843790581,-0.7999190324644211
330,1572523200,238,742,504,980,44,2.2069238850104136,0.9006002399554821
330,1572537600,388,388,0,776,44,-0.5687974565220385,0.3789371849574968
330,1572552000,815,598,0,1413,44,-0.5687974565220385,2.0078556459070884
330,1572566400,488,313,0,801,44,-0.5687974565220385,0.44286648091313224
330,1572580800,182,107,0,289,44,-0.5687974565220385,-0.866405500258282
330,1572595200,73,283,210,356,44,0.5877531024498165,-0.695074987097179
330,1572609600,225,747,522,972,44,2.306056790065144,0.8801428652496788
330,1572624000,412,443,31,855,44,-0.3980685644833361,0.5809537601773048
330,1572638400,825,567,0,1392,44,-0.5687974565220385,1.9541550373043544
330,1572652800,380,351,0,731,44,-0.5687974565220385,0.26386445223735294
330,1572667200,130,110,0,240,44,-0.5687974565220385,-0.9917069203313275
330,1572681600,37,83,46,120,44,-0.31545781027106073,-1.2985675409183777
330,1572696000,118,267,149,385,44,0.25180270198656335,-0.6209170037886418
330,1572710400,373,411,38,784,44,-0.3595168791842743,0.3993945596633001
330,1572724800,430,540,110,970,44,0.03701474103464744,0.875028521573228
330,1572739200,367,309,0,676,44,-0.5687974565220385,0.12322000113495493
330,1572750000,135,126,0,261,44,-0.5687974565220385,-0.9380063117285937
330,1572764400,28,45,17,73,44,-0.4751719350814598,-1.4187546173149723
330,1572778800,122,170,48,292,44,-0.3044430430427574,-0.8587339847436057
330,1572793200,235,378,143,613,44,0.21875840030165322,-0.03788182467324642
330,1572807600,374,472,98,846,44,-0.02907386233517284,0.557939213633276
330,1572822000,296,188,0,484,44,-0.5687974565220385,-0.36775699180432536
330,1572836400,101,37,0,138,44,-0.5687974565220385,-1.25253844783032
330,1572850800,20,78,58,98,44,-0.24936920690124045,-1.3548253213593369
330,1572865200,189,883,694,1072,44,3.253326771699235,1.1358600490722206
330,1572879600,323,349,26,672,44,-0.4256054825540945,0.11299131378205327
330,1572894000,781,452,0,1233,44,-0.5687974565220385,1.547564715026513
330,1572908400,478,163,0,641,44,-0.5687974565220385,0.03371898679706529
330,1572922800,98,45,0,143,45,-0.540817793478038,-1.163839321268252
330,1572937200,21,115,94,136,45,-0.055997482703448107,-1.1821763395133147
330,1572951600,177,807,630,984,45,2.708509821287831,1.0392224421742557
330,1572966000,306,369,63,675,45,-0.21588503200145118,0.22977406535649722
330,1572980400,761,479,0,1240,45,-0.540817793478038,1.7098333951365412
330,1572994800,484,245,0,729,45,-0.540817793478038,0.3712310632469793
330,1573009200,122,39,0,161,45,-0.540817793478038,-1.1166869886380915
330,1573023600,18,120,102,138,45,-0.014736179658802149,-1.176937191443297
330,1573038000,219,908,689,1127,45,3.0128119312420947,1.4138215291805325
330,1573052400,261,338,77,599,45,-0.14367775167332075,0.030686438695818736
330,1573066800,825,456,0,1281,45,-0.540817793478038,1.8172359305719072
330,1573081200,501,233,0,734,45,-0.540817793478038,0.38432893342202396
330,1573095600,122,72,0,194,45,-0.540817793478038,-1.0302410454827968
330,1573110000,20,116,96,136,45,-0.04568215694228662,-1.1821763395133147
330,1573124400,185,829,644,1014,45,2.780717101615961,1.1178096632245236
330,1573138800,262,385,123,647,45,0.09357474083339348,0.15642599237624724
330,1573153200,718,517,0,1235,45,-0.540817793478038,1.6967355249614966
330,1573167600,464,255,0,719,45,-0.540817793478038,0.34503532289689004
330,1573182000,128,67,0,195,45,-0.540817793478038,-1.027621471447788
330,1573196400,27,108,81,135,45,-0.12304710015099779,-1.1847959135483235
330,1573210800,189,787,598,976,45,2.543464609109247,1.0182658498941843
330,1573225200,304,345,41,649,45,-0.3293536153742276,0.1616651404462651
330,1573239600,745,660,0,1405,45,-0.540817793478038,2.142063110913014
330,1573254000,401,298,0,699,45,-0.540817793478038,0.29264384219671147
330,1573268400,188,139,0,327,45,-0.540817793478038,-0.6818376988266095
330,1573282800,30,50,20,80,45,-0.4376645358664232,-1.3288724854738145
330,1573297200,92,185,93,277,45,-0.06115514558402885,-0.8128164005770558
330,1573311600,287,370,83,657,45,-0.1127317743898363,0.18262173272633653
330,1573326000,380,361,0,741,45,-0.540817793478038,0.4026659516670864
330,1573340400,363,324,0,687,45,-0.540817793478038,0.26120895377660436
330,1573354800,174,103,0,277,45,-0.540817793478038,-0.8128164005770558
330,1573369200,42,37,0,79,45,-0.540817793478038,-1.3314920595088235
330,1573383600,47,234,187,281,45,0.42366516519056113,-0.8023381044370201
330,1573398000,239,402,163,641,45,0.29988125605662325,0.1407085481661937
330,1573412400,311,310,0,621,45,-0.540817793478038,0.08831706746601514
330,1573426800,276,189,0,465,45,-0.540817793478038,-0.3203364819953775
330,1573441200,81,44,0,125,45,-0.540817793478038,-1.210991653898413
330,1573455600,22,94,72,116,45,-0.1694660660762245,-1.234567820213493
330,1573470000,159,659,500,818,45,2.038013646812334,0.6043731523627738
330,1573484400,328,376,48,704,45,-0.29324997521016233,0.3057417123717561
330,1573498800,772,380,0,1152,45,-0.540817793478038,1.4793108800557555
330,1573513200,454,213,0,667,45,-0.540817793478038,0.20881747307642579
330,1573527600,116,45,0,161,46,-0.5286121016003614,-1.1148356899653087
330,1573542000,27,130,103,157,46,0.0038153609195835307,-1.1246554559126778
330,1573556400,214,837,623,1051,46,2.6917986668455187,1.0700622333243281
330,1573570800,301,353,52,654,46,-0.2598137710077678,0.09545046304793953
330,1573585200,756,551,0,1307,46,-0.5286121016003614,1.698527253955954
330,1573599600,486,287,0,773,46,-0.5286121016003614,0.3875884999821719
330,1573614000,100,48,0,148,46,-0.5286121016003614,-1.1467499292942585
330,1573628400,28,121,93,149,46,-0.04787662573283831,-1.1442949878074162
330,1573642800,216,811,595,1027,46,2.547061104218738,1.011143637640113
330,1573657200,287,364,77,651,46,-0.13058380437671324,0.08808563858741265
330,1573671600,851,529,0,1380,46,-0.5286121016003614,1.877737982495441
330,1573686000,465,238,0,703,46,-0.5286121016003614,0.21574259590321165
330,1573700400,127,51,0,178,46,-0.5286121016003614,-1.0731016846889898
330,1573714800,45,132,87,177,46,-0.07889181772429141,-1.075556626175832
330,1573729200,226,853,627,1079,46,2.7124754615064877,1.1388005949559121
330,1573743600,314,340,26,654,46,-0.3942129363040646,0.09545046304793953
330,1573758000,798,512,0,1310,46,-0.5286121016003614,1.7058920784164808
330,1573772400,497,246,0,743,46,-0.5286121016003614,0.3139402553769032
330,1573786800,157,87,0,244,46,-0.5286121016003614,-0.9110755465573988
330,1573801200,27,102,75,129,46,-0.1409222017071976,-1.193393817544262
330,1573815600,187,779,592,966,46,2.5315535082230114,0.8613922069427336
330,1573830000,348,364,16,712,46,-0.4459049229564865,0.23783706928479226
330,1573844400,850,600,0,1450,46,-0.5286121016003614,2.049583886574401
330,1573858800,456,387,0,843,46,-0.5286121016003614,0.5594344040611321
330,1573873200,244,212,0,456,46,-0.5286121016003614,-0.3906279513468336
330,1573887600,32,46,14,78,46,-0.45624332028697084,-1.3185958333732186
330,1573902000,59,190,131,249,46,0.14855292354636468,-0.8988008391231873
330,1573916400,257,356,99,613,46,-0.016861433741385205,-0.0052021379125943065
330,1573930800,425,471,46,896,46,-0.29082896299922095,0.6895463028637734
330,1573945200,381,365,0,746,46,-0.5286121016003614,0.32130507983743006
330,1573959600,186,124,0,310,46,-0.5286121016003614,-0.7490494084258077
330,1573974000,34,42,8,76,46,-0.4872585122784239,-1.3235057163469033
330,1573988400,47,156,109,203,46,0.034830552911036636,-1.0117281475179325
330,1574002800,221,296,75,517,46,-0.1409222017071976,-0.240876520649454
330,1574017200,336,309,0,645,46,-0.5286121016003614,0.07335598966635892
330,1574031600,272,131,0,403,46,-0.5286121016003614,-0.5207398501494749
330,1574046000,51,44,0,95,46,-0.5286121016003614,-1.2768618280968997
330,1574060400,23,124,101,147,46,-0.006523036410900837,-1.1492048707811007
330,1574074800,192,837,645,1029,46,2.805521037480847,1.0160535206137977
330,1574089200,326,427,101,753,46,-0.006523036410900837,0.33848967024532606
330,1574103600,800,499,0,1299,46,-0.5286121016003614,1.6788877220612155
330,1574118000,475,199,0,674,46,-0.5286121016003614,0.1445492927847853
330,1574132400,65,32,0,97,47,-0.5256547345043423,-1.2614073280963978
330,1574146800,29,136,107,165,47,-0.013671124434443252,-1.0969435376812728
330,1574161200,209,930,721,1139,47,2.9242535165274073,1.258758401500076
330,1574175600,344,377,33,721,47,-0.367753247286523,0.24778980747769005
330,1574190000,872,534,0,1406,47,-0.5256547345043423,1.9045206373947576
330,1574204400,642,237,0,879,47,-0.5256547345043423,0.6299262616775392
330,1574218800,109,58,0,167,47,-0.5256547345043423,-1.0921063673749456
330,1574233200,28,122,94,150,47,-0.07587474061115995,-1.1332223149787268
330,1574247600,182,863,681,1045,47,2.732857774445202,1.0314113971026972
330,1574262000,321,403,82,724,47,-0.13329346323582153,0.25504556293718084
330,1574276400,825,580,0,1405,47,-0.5256547345043423,1.9021020522415941
330,1574290800,556,271,0,827,47,-0.5256547345043423,0.5041598337130319
330,1574305200,138,77,0,215,47,-0.5256547345043423,-0.9760142800230928
330,1574319600,23,124,101,147,47,-0.04238048574677404,-1.1404780704382178
330,1574334000,211,879,668,1090,47,2.6706541582684853,1.1402477289950594
330,1574348400,284,389,105,673,47,-0.023240911538553514,0.13169772012583714
330,1574362800,807,512,0,1319,47,-0.5256547345043423,1.6941037290695242
330,1574377200,549,231,0,780,47,-0.5256547345043423,0.3904863315143426
330,1574391600,135,72,0,207,47,-0.5256547345043423,-0.9953629612484016
330,1574406000,28,115,87,143,47,-0.10936899547554588,-1.150152411050872
330,1574420400,183,809,626,992,47,2.4696886290821696,0.9032263839850263
330,1574434800,346,403,57,749,47,-0.2529158020371998,0.31551019176627093
330,1574449200,831,585,0,1416,47,-0.5256547345043423,1.9287064889263936
330,1574463600,478,424,0,902,47,-0.5256547345043423,0.6855537202003021
330,1574478000,257,144,0,401,47,-0.5256547345043423,-0.5261574415346627
330,1574492400,44,60,16,104,47,-0.4490964376714602,-1.2444772320242525
330,1574506800,73,182,109,255,47,-0.004101337330332989,-0.8792708738965487
330,1574521200,227,309,82,536,47,-0.13329346323582153,-0.19964844585757638
330,1574535600,419,369,0,788,47,-0.5256547345043423,0.4098350127396514
330,1574550000,340,278,0,618,47,-0.5256547345043423,-0.0013244632981609943
330,1574564400,158,207,49,365,47,-0.29119495045364086,-0.6132265070485524
330,1574578800,38,44,6,82,47,-0.4969453731920115,-1.297686105393852
330,1574593200,70,144,74,214,47,-0.1715726116522626,-0.9784328651762564
330,1574607600,195,308,113,503,47,0.015038236877887535,-0.27946175591197525
330,1574622000,322,303,0,625,47,-0.5256547345043423,0.015605632773984223
330,1574636400,238,161,0,399,47,-0.5256547345043423,-0.53099461184099
330,1574650800,69,32,0,101,47,-0.5256547345043423,-1.2517329874837435
330,1574665200,17,114,97,131,47,-0.061520059954994565,-1.1791754328888353
330,1574679600,167,804,637,971,47,2.5223224581547763,0.8524360957685907
330,1574694000,291,360,69,651,47,-0.19549707941253824,0.07848884675623788
330,1574708400,798,429,0,1227,47,-0.5256547345043423,1.4715938949784728
330,1574722800,457,193,0,650,47,-0.5256547345043423,0.07607026160307429
330,1574737200,97,49,0,146,48,-0.540376443842307,-0.8624114660187803
330,1574751600,25,102,77,127,48,-0.005294564054792946,-0.9204437073446077
330,1574766000,186,807,621,993,48,3.7750241710673835,1.724604765716787
330,1574780400,290,384,94,674,48,0.11284039641777509,0.7502739771410538
330,1574794800,758,424,0,1182,48,-0.540376443842307,2.3018728504842274
330,1574809200,442,206,0,648,48,-0.540376443842307,0.6708614363793953
330,1574823600,96,39,0,135,48,-0.540376443842307,-0.8960090794179435
330,1574838000,26,108,82,134,48,0.029451012554785886,-0.8990634079087765
330,1574852400,154,641,487,795,48,2.8438427179306713,1.1198477245318492
330,1574866800,384,368,0,752,48,-0.540376443842307,0.9885115994260294
330,1574881200,670,395,0,1065,48,-0.540376443842307,1.9445164170567641
330,1574895600,332,220,0,552,48,-0.540376443842307,0.3776459012594255
330,1574910000,99,63,0,162,48,-0.540376443842307,-0.8135422101654519
330,1574924400,18,49,31,67,48,-0.3249538688629182,-1.1037034167945887
330,1574938800,39,96,57,135,48,-0.14427687049310828,-0.8960090794179435
330,1574953200,112,167,55,279,48,-0.1581751011369398,-0.4561857767379887
330,1574967600,156,158,2,314,48,-0.5264782131984754,-0.34928427955883307
330,1574982000,96,91,0,187,48,-0.540376443842307,-0.7371839978946265
330,1574996400,41,42,1,83,48,-0.5334273285203912,-1.0548341609412604
330,1575010800,12,58,46,70,48,-0.22071713903418172,-1.0945404313220897
330,1575025200,52,267,215,319,48,0.9536833503695828,-0.33401263710466794
330,1575039600,178,296,118,474,48,0.2796191641437535,0.13940827897445002
330,1575054000,337,345,8,682,48,-0.4847835212669808,0.774708605067718
330,1575068400,253,197,0,450,48,-0.540376443842307,0.06610439519445756
330,1575082800,109,75,0,184,48,-0.540376443842307,-0.7463469833671256
330,1575097200,23,39,16,62,48,-0.4291905986916547,-1.118975059248754
330,1575111600,57,163,106,220,48,0.1962297802807643,-0.6363911576971368
330,1575126000,183,359,176,542,48,0.682667852814868,0.34710261635109535
330,1575140400,319,401,82,720,48,0.029451012554785886,0.8907730877193727
330,1575154800,304,259,0,563,48,-0.540376443842307,0.4112435146585887
330,1575169200,107,90,0,197,48,-0.540376443842307,-0.7066407129862963
330,1575183600,31,26,0,57,48,-0.540376443842307,-1.134246701702919
330,1575198000,56,164,108,220,48,0.21012801092459582,-0.6363911576971368
330,1575212400,177,245,68,422,48,-0.06783660195203485,-0.019416802548866977
330,1575226800,220,309,89,529,48,0.07809481980819626,0.30739634597026605
330,1575241200,178,153,0,331,48,-0.540376443842307,-0.29736069521467173
330,1575255600,52,29,0,81,48,-0.540376443842307,-1.0609428179229266
330,1575270000,14,103,89,117,48,0.07809481980819626,-0.9509869922529378
330,1575284400,190,759,569,949,48,3.4136701743277644,1.590214312120134
330,1575298800,247,316,69,563,48,-0.06088748663011908,0.4112435146585887
330,1575313200,655,587,0,1242,48,-0.540376443842307,2.4851325599342085
330,1575327600,367,200,0,567,48,-0.540376443842307,0.4234608286219208
330,1575342000,92,25,0,117,49,-0.5498436658236897,-1.2726784741478687
330,1575356400,15,117,102,132,49,-0.038660882753228154,-1.233939167064081
330,1575370800,186,823,637,1009,49,2.6425429304104675,1.0310189871013822
330,1575385200,280,356,76,636,49,-0.1689623764770713,0.06770155095119103
330,1575399600,777,474,0,1251,49,-0.5498436658236897,1.656013141386493
330,1575414000,494,211,0,705,49,-0.5498436658236897,0.24590236353661515
330,1575428400,104,61,0,165,49,-0.5498436658236897,-1.1487126914797476
330,1575442800,21,109,88,130,49,-0.10882322552760523,-1.2391044080085858
330,1575457200,189,898,709,1087,49,3.0033778361072643,1.232463383937079
330,1575471600,286,321,35,607,49,-0.374437808887747,-0.007194442744132156
330,1575486000,731,505,0,1236,49,-0.5498436658236897,1.617273834302705
330,1575500400,512,286,0,798,49,-0.5498436658236897,0.48608606745609984
330,1575514800,108,61,0,169,49,-0.5498436658236897,-1.1383822095907374
330,1575529200,21,115,94,136,49,-0.0787536500528722,-1.2236086851750707
330,1575543600,179,874,695,1053,49,2.933215493332887,1.1446542878804933
330,1575558000,247,366,119,613,49,0.04653624775851544,0.008301280089382985
330,1575572400,714,532,0,1246,49,-0.5498436658236897,1.6431000390252304
330,1575586800,498,329,0,827,49,-0.5498436658236897,0.560982061151423
330,1575601200,134,59,0,193,49,-0.5498436658236897,-1.076399318256677
330,1575615600,25,106,81,131,49,-0.1439043969147938,-1.2365217875363332
330,1575630000,184,799,615,983,49,2.532287820336446,0.9638708548228166
330,1575644400,316,429,113,745,49,0.016466672283782405,0.3492071824267161
330,1575658800,735,599,0,1334,49,-0.5498436658236897,1.8703706405834524
330,1575673200,494,410,0,904,49,-0.5498436658236897,0.7598438375148673
330,1575687600,304,132,0,436,49,-0.5498436658236897,-0.44882254349931366
330,1575702000,43,58,15,101,49,-0.4746697271368572,-1.314000401703909
330,1575716400,97,228,131,325,49,0.10667539870798151,-0.7354934159193438
330,1575730800,261,370,109,631,49,-0.0035797113660396163,0.05478844858992841
330,1575745200,428,440,12,868,49,-0.4897045148742237,0.6668695005137765
330,1575759600,404,422,18,826,49,-0.4596349393994906,0.5583994406791705
330,1575774000,206,143,0,349,49,-0.5498436658236897,-0.6735105245852833
330,1575788400,46,52,6,98,49,-0.5197740903489567,-1.3217482631206665
330,1575802800,67,129,62,196,49,-0.23912471925144838,-1.0686514568399192
330,1575817200,224,418,194,642,49,0.4224059411926784,0.08319727378470616
330,1575831600,359,360,1,719,49,-0.5448320699112342,0.28205905014815047
330,1575846000,319,227,0,546,49,-0.5498436658236897,-0.1647342915515361
330,1575860400,79,56,0,135,49,-0.5498436658236897,-1.2261913056473233
330,1575874800,17,106,89,123,49,-0.10381162961514973,-1.2571827513143534
330,1575889200,217,717,500,934,49,1.955954290404063,0.837322451682443
330,1575903600,272,379,107,651,49,-0.013602903190950628,0.10644085803497888
330,1575918000,669,534,0,1203,49,-0.5498436658236897,1.5320473587183718
330,1575932400,381,240,0,621,49,-0.5498436658236897,0.028962243867403172
330,1575946800,121,43,0,164,50,-0.6316322348266536,-1.2097516537113338
330,1575961200,24,118,94,142,50,-0.1551927883047529,-1.2662381122503845
330,1575975600,216,889,673,1105,50,2.7794714620801466,1.2063282319816946
330,1575990000,282,444,162,726,50,0.18946553471109023,0.23322060533168634
330,1576004400,770,514,0,1284,50,-0.6316322348266536,1.6659225991857882
330,1576018800,460,282,0,742,50,-0.6316322348266536,0.2743016660873595
330,1576033200,145,84,0,229,50,-0.6316322348266536,-1.0428598443914117
330,1576047600,19,103,84,122,50,-0.20587783580708277,-1.317589438194976
330,1576062000,213,829,616,1042,50,2.4905666913168667,1.0445715552562316
330,1576076400,273,413,140,686,50,0.0779584302059645,0.13051795344250341
330,1576090800,705,513,0,1218,50,-0.6316322348266536,1.4964632235686364
330,1576105200,473,314,0,787,50,-0.6316322348266536,0.3898421494626903
330,1576119600,135,56,0,191,50,-0.6316322348266536,-1.1404273636861353
330,1576134000,28,123,95,151,50,-0.1501242835545199,-1.2431300155753182
330,1576148400,196,841,645,1037,50,2.637553329073623,1.0317337237700837
330,1576162800,282,435,153,717,50,0.14384899195899334,0.21011250865662018
330,1576177200,688,571,0,1259,50,-0.6316322348266536,1.6017334417550488
330,1576191600,449,299,0,748,50,-0.6316322348266536,0.28970706387073697
330,1576206000,183,96,0,279,50,-0.6316322348266536,-0.9144815295299329
330,1576220400,22,110,88,132,50,-0.18560381680615082,-1.2919137752226801
330,1576234800,185,802,617,987,50,2.4956351960670995,0.903355408908605
330,1576249200,276,491,215,767,50,0.45809628647343853,0.33849082351809884
330,1576263600,653,659,6,1312,50,-0.6012212063252558,1.7378144555082162
330,1576278000,408,351,0,759,50,-0.6316322348266536,0.31795029314026224
330,1576292400,250,153,0,403,50,-0.6316322348266536,-0.5961033086734658
330,1576306800,43,51,8,94,50,-0.5910841968247897,-1.389481294517404
330,1576321200,95,207,112,302,50,-0.06395970280055913,-0.8554275046936527
330,1576335600,267,432,165,699,50,0.2046710489617892,0.16389631530648785
330,1576350000,517,621,104,1138,50,-0.10450774080242303,1.2910579197902705
330,1576364400,454,535,81,989,50,-0.22108335005778174,0.9084905415030641
330,1576378800,272,181,0,453,50,-0.6316322348266536,-0.4677249938119872
330,1576393200,60,39,0,99,50,-0.6316322348266536,-1.376643463031256
330,1576407600,69,169,100,238,50,-0.12478175980335497,-1.0197517477163454
330,1576422000,207,423,216,630,50,0.46316479122367155,-0.013265759202352697
330,1576436400,383,432,49,815,50,-0.3832755020652373,0.46173400578511836
330,1576450800,322,222,0,544,50,-0.6316322348266536,-0.234076460764096
330,1576465200,77,34,0,111,50,-0.6316322348266536,-1.3458326674645011
330,1576479600,18,130,112,148,50,-0.06395970280055913,-1.250832714467007
330,1576494000,183,794,611,977,50,2.4652241675657014,0.8776797459363093
330,1576508400,263,351,88,614,50,-0.18560381680615082,-0.05434681995802587
330,1576522800,699,484,0,1183,50,-0.6316322348266536,1.4065984031656014
330,1576537200,438,216,0,654,50,-0.6316322348266536,0.04835583193115706
330,1576551600,119,51,0,170,51,-0.6098895180984165,-1.0447886052693889
330,1576566000,23,109,86,132,51,-0.07167282145256249,-1.1561099627705536
330,1576580400,215,782,567,997,51,2.9385856795550627,1.3779156750849042
330,1576594800,211,396,185,607,51,0.5479022130583625,0.23540700599400421
330,1576609200,636,542,0,1178,51,-0.6098895180984165,1.908156877919399
330,1576623600,500,259,0,759,51,-0.6098895180984165,0.6806924359986627
330,1576638000,110,55,0,165,51,-0.6098895180984165,-1.0594361523090159
330,1576652400,26,114,88,140,51,-0.059156154088705414,-1.1326738875071505
330,1576666800,197,787,590,984,51,3.082527354239419,1.3398320527818741
330,1576681200,259,349,90,608,51,-0.04663948672484835,0.2383365154019296
330,1576695600,654,481,0,1135,51,-0.6098895180984165,1.7821879733786072
330,1576710000,370,259,0,629,51,-0.6098895180984165,0.2998562129683627
330,1576724400,144,58,0,202,51,-0.6098895180984165,-0.9510443042157766
330,1576738800,18,106,88,124,51,-0.059156154088705414,-1.1795460380339566
330,1576753200,216,721,505,937,51,2.5505689912754934,1.2021451106093812
330,1576767600,232,392,160,624,51,0.3914438710101491,0.2852086659287357
330,1576782000,626,622,0,1248,51,-0.6098895180984165,2.1132225364741757
330,1576796400,354,281,0,635,51,-0.6098895180984165,0.317433269415915
330,1576810800,162,70,0,232,51,-0.6098895180984165,-0.863159021978015
330,1576825200,26,83,57,109,51,-0.25316449822849,-1.2234886791528372
330,1576839600,168,674,506,842,51,2.556827324957422,0.9238417168564697
330,1576854000,295,385,90,680,51,-0.04663948672484835,0.44926119277255727
330,1576868400,620,506,0,1126,51,-0.6098895180984165,1.7558223887072788
330,1576882800,357,294,0,651,51,-0.6098895180984165,0.36430541994272114
330,1576897200,191,118,0,309,51,-0.6098895180984165,-0.6375867975677604
330,1576911600,34,42,8,76,51,-0.5598228486429883,-1.320162489614375
330,1576926000,71,214,143,285,51,0.285052198417364,-0.7078950233579696
330,1576940400,235,322,87,557,51,-0.06541448777063395,0.08893153559773498
330,1576954800,352,419,67,771,51,-0.19058116140920464,0.7158465488937673
330,1576969200,285,294,9,579,51,-0.5535645149610596,0.15338074257209344
330,1576983600,146,108,0,254,51,-0.6098895180984165,-0.7987098150036566
330,1576998000,33,35,2,68,51,-0.5973728507345595,-1.3435985648777782
330,1577012400,44,143,99,187,51,0.009685516412508468,-0.9949869453346574
330,1577026800,158,270,112,428,51,0.09104385427757943,-0.2889751780246396
330,1577041200,301,358,57,659,51,-0.25316449822849,0.3877414952061242
330,1577055600,237,187,0,424,51,-0.6098895180984165,-0.30069321565634116
330,1577070000,88,46,0,134,51,-0.6098895180984165,-1.1502509439547026
330,1577084400,11,95,84,106,51,-0.08418948881641955,-1.2322772073766135
330,1577098800,90,434,344,524,51,1.5429772684849994,-0.007742274863802707
330,1577113200,250,319,69,569,51,-0.17806449404534758,0.1240856484928396
330,1577127600,574,313,0,887,51,-0.6098895180984165,1.0556696402131118
330,1577142000,236,152,0,388,51,-0.6098895180984165,-0.406155554341655
330,1577156400,99,33,0,132,52,-0.7161167645859178,-0.8032505567798659
330,1577170800,12,64,52,76,52,-0.07083609873521354,-1.0388613704664962
330,1577185200,78,314,236,392,52,2.212464718890355,0.2906567924794887
330,1577199600,289,262,0,551,52,-0.7161167645859178,0.959623209911171
330,1577214000,386,326,0,712,52,-0.7161167645859178,1.637004299260233
330,1577228400,158,103,0,261,52,-0.7161167645859178,-0.26050421810887847
330,1577242800,53,34,0,87,52,-0.7161167645859178,-0.9925806749209081
330,1577257200,8,27,19,35,52,-0.48034113667892964,-1.211362144772779
330,1577271600,22,61,39,83,52,-0.2321562651978896,-1.0094100187556674
330,1577286000,56,145,89,201,52,0.38830591350471055,-0.512944375630268
330,1577300400,123,163,40,286,52,-0.21974702162383758,-0.15532081914163282
330,1577314800,104,86,0,190,52,-0.7161167645859178,-0.5592250711758561
330,1577329200,44,23,0,67,52,-0.7161167645859178,-1.0767273940947046
330,1577343600,12,74,62,86,52,0.053256337005306485,-0.9967880108795979
330,1577358000,74,282,208,356,52,1.865005898816899,0.13919269796665498
330,1577372400,153,285,132,438,52,0.9219033871889466,0.48419424657922067
330,1577386800,397,345,0,742,52,-0.7161167645859178,1.7632243780209276
330,1577401200,225,172,0,397,52,-0.7161167645859178,0.3116934722729378
330,1577415600,115,38,0,153,52,-0.7161167645859178,-0.7148965016473796
330,1577430000,14,74,60,88,52,0.028437849857202477,-0.9883733389622182
330,1577444400,89,368,279,457,52,2.746062192574591,0.5641336297943274
330,1577458800,227,365,138,592,52,0.9963588486332586,1.1321239842174537
330,1577473200,503,360,0,863,52,-0.7161167645859178,2.2723120290223964
330,1577487600,237,268,31,505,52,-0.33143021379030563,0.766085755811439
