remote_unit_id,time_stamp,entries,exits,num_people_exited,sum_exit_entry,week_num,z_score_num_people_exited,z_score_sum_exit_entry
35,1546311600,92,177,85,269,1,0.052912034386830495,-0.7455595952029735
35,1546326000,54,85,31,139,1,-0.2177747941605339,-0.9136078202140469
35,1546340400,214,104,0,318,1,-0.37316908462290976,-0.6822183411603383
35,1546354800,347,155,0,502,1,-0.37316908462290976,-0.44436546883697303
35,1546369200,361,274,0,635,1,-0.37316908462290976,-0.2724392078641058
35,1546383600,226,189,0,415,1,-0.37316908462290976,-0.5568285117289989
35,1546398000,58,72,14,130,1,-0.30299101796248196,-0.9252419280994288
35,1546412400,191,188,0,379,1,-0.37316908462290976,-0.6033649432705269
35,1546426800,855,1343,488,2198,1,2.0730378103977167,1.7480175282305672
35,1546441200,616,469,0,1085,1,-0.37316908462290976,0.3092661864049939
35,1546455600,1320,727,0,2047,1,-0.37316908462290976,1.5528230514869361
35,1546470000,407,302,0,709,1,-0.37316908462290976,-0.17678098747318718
35,1546484400,97,89,0,186,1,-0.37316908462290976,-0.8528519234792742
35,1546498800,213,193,0,406,1,-0.37316908462290976,-0.5684626196143809
35,1546513200,949,1336,387,2285,1,1.5667531866332016,1.8604805711225934
35,1546527600,622,578,0,1200,1,-0.37316908462290976,0.45792423160709717
35,1546542000,1473,919,0,2392,1,-0.37316908462290976,1.998797187093246
35,1546556400,472,335,0,807,1,-0.37316908462290976,-0.05009847938791658
35,1546570800,111,99,0,210,1,-0.37316908462290976,-0.8218276357849222
35,1546585200,232,196,0,428,1,-0.37316908462290976,-0.5400236892278917
35,1546599600,958,1357,399,2315,1,1.6269058151992826,1.8992609307405333
35,1546614000,604,497,0,1101,1,-0.37316908462290976,0.3299490448678952
35,1546628400,1344,790,0,2134,1,-0.37316908462290976,1.665286094378962
35,1546642800,475,316,0,791,1,-0.37316908462290976,-0.0707813378508179
35,1546657200,77,160,83,237,1,0.04288659629248367,-0.7869253121287763
35,1546671600,99,120,21,219,1,-0.26790198463226805,-0.8101935278995402
35,1546686000,461,362,0,823,1,-0.37316908462290976,-0.02941562092501526
35,1546700400,583,333,0,916,1,-0.37316908462290976,0.09080349389059868
35,1546714800,561,437,0,998,1,-0.37316908462290976,0.19680314351296796
35,1546729200,358,342,0,700,1,-0.37316908462290976,-0.18841509535856918
35,1546743600,56,116,60,172,1,-0.07240594179250487,-0.8709494246343128
35,1546758000,70,79,9,149,1,-0.328054613198349,-0.9006810336747335
35,1546763399,74,66,0,140,1,-0.37316908462290976,-0.9123151415601155
35,1546770443,75,91,16,166,1,-0.2929655798681351,-0.8787054965579009
35,1546770527,2,0,0,2,1,-0.37316908462290976,-1.0907047958026395
35,1546772400,366,119,0,485,1,-0.37316908462290976,-0.4663410059538057
35,1546786800,505,287,0,792,1,-0.37316908462290976,-0.06948865919688657
35,1546801200,405,365,0,770,1,-0.37316908462290976,-0.09792758958337588
35,1546815600,139,227,88,366,1,0.06795019152835075,-0.6201697657716343
35,1546830000,37,75,38,112,1,-0.18268576083032,-0.9485101438701928
35,1546844400,220,273,53,493,1,-0.10749497512271877,-0.455999576722355
35,1546858800,923,2056,1133,2979,1,5.30624159582457,2.757599556950938
35,1546873200,480,901,421,1381,1,1.7371856342370977,0.6918990679686684
35,1546887600,1504,888,0,2392,1,-0.37316908462290976,1.998797187093246
35,1546902000,331,355,24,686,1,-0.2528638274907478,-0.20651259651360784
35,1546916400,70,62,0,132,2,-0.5271976356837337,-1.0209441323431248
35,1546930800,236,254,18,490,2,-0.47395673098470853,-0.6548534146594649
35,1546945200,963,2176,1213,3139,2,3.0606477754227983,2.0540133762456048
35,1546959600,530,867,337,1397,2,0.4695904134035715,0.2726445767904778
35,1546974000,1637,1011,0,2648,2,-0.5271976356837337,1.5519168891431552
35,1546988400,395,385,0,780,2,-0.5271976356837337,-0.3582994813402991
35,1547002800,55,72,17,127,2,-0.47691455902354324,-1.0260571311934552
35,1547017200,230,273,43,503,2,-0.4000110300138402,-0.6415596176486057
35,1547031600,1003,1987,984,2990,2,2.383305154529644,1.9016460105057575
35,1547046000,513,959,446,1472,2,0.7919936696365575,0.3493395595454345
35,1547060400,1500,988,0,2488,2,-0.5271976356837337,1.388300925932581
35,1547074800,384,442,58,826,2,-0.3556436094313192,-0.311259891917259
35,1547089200,67,91,24,158,2,-0.4562097627517001,-0.9943565383214065
35,1547103600,238,275,37,513,2,-0.41775799824684856,-0.6313336199479448
35,1547118000,969,1870,901,2839,2,2.1378054273063616,1.747233445225778
35,1547132400,515,850,335,1365,2,0.463674757325902,0.23992138414836295
35,1547146800,1635,1197,0,2832,2,-0.5271976356837337,1.7400752468353156
35,1547161200,415,413,0,828,2,-0.5271976356837337,-0.3092146923771268
35,1547175600,60,76,16,136,2,-0.479872387062378,-1.0168537332628604
35,1547190000,235,248,13,483,2,-0.4887458711788822,-0.6620116130499275
35,1547204400,932,1927,995,2859,2,2.4158412629568264,1.7676854406270999
35,1547218800,495,748,253,1243,2,0.2211328581414539,0.11516421220030011
35,1547233200,1411,884,0,2295,2,-0.5271976356837337,1.1909391703098258
35,1547247600,320,336,16,656,2,-0.479872387062378,-0.4851018528284941
35,1547262000,83,103,20,186,2,-0.46804107490703906,-0.9657237447595559
35,1547276400,88,101,13,189,2,-0.4887458711788822,-0.9626559454493576
35,1547290800,433,383,0,816,2,-0.5271976356837337,-0.3214858896179199
35,1547305200,539,354,0,893,2,-0.5271976356837337,-0.24274570732283102
35,1547319600,487,479,0,966,2,-0.5271976356837337,-0.16809592410800653
35,1547334000,251,269,18,520,2,-0.47395673098470853,-0.6241754215574822
35,1547348400,45,97,52,142,2,-0.3733905776643276,-1.0107181346424639
35,1547362800,50,83,33,133,2,-0.4295893104021875,-1.0199215325730586
35,1547377200,372,203,0,575,2,-0.5271976356837337,-0.5679324342038473
35,1547391600,473,281,0,754,2,-0.5271976356837337,-0.3848870753620174
35,1547406000,323,349,26,672,2,-0.45029410667403064,-0.46874025650743667
35,1547420400,140,238,98,378,2,-0.23733048787792982,-0.7693845889068669
35,1547434800,41,59,18,100,2,-0.47395673098470853,-1.0536673249852395
35,1547449200,220,307,87,527,2,-0.2698665963051119,-0.6170172231670196
35,1547463600,844,1983,1139,2827,2,2.841768500549028,1.734962247984985
35,1547478000,488,764,276,1252,2,0.28916290303465275,0.12436761013089491
35,1547492400,1581,986,0,2567,2,-0.5271976356837337,1.4690863077678018
35,1547506800,393,387,0,780,2,-0.5271976356837337,-0.3582994813402991
35,1547521200,61,71,10,132,3,-0.49645035777778623,-0.9779534370943841
35,1547535600,222,238,16,460,3,-0.47570317864677425,-0.620076254217183
35,1547550000,999,2123,1124,3122,3,3.3556092342134343,2.284402589743516
35,1547564400,516,790,274,1306,3,0.41642552398674,0.302985016252671
35,1547578800,1546,976,0,2522,3,-0.5310289896628062,1.6297492064315628
35,1547593200,357,427,70,784,3,-0.2889785664676666,-0.2665634272287283
35,1547607600,65,91,26,156,3,-0.44112454676175433,-0.9517673017619059
35,1547622000,209,278,69,487,3,-0.2924364296561686,-0.5906168519681452
35,1547636400,986,1981,995,2967,3,2.9095448828966775,2.1152837990545947
35,1547650800,522,861,339,1383,3,0.6411866312393696,0.3869988671110383
35,1547665200,1564,939,0,2503,3,-0.5310289896628062,1.6090185159600177
35,1547679600,387,422,35,809,3,-0.4100037780652364,-0.23928620292406358
35,1547694000,66,80,14,146,3,-0.48261890502377824,-0.9626781914837719
35,1547708400,236,285,49,521,3,-0.3615936934262085,-0.5535198269138011
35,1547722800,999,1922,923,2921,3,2.6605787333245337,2.065093706334012
35,1547737200,573,865,292,1438,3,0.4786670613797759,0.4470087605813007
35,1547751600,1680,1109,0,2789,3,-0.5310289896628062,1.921069962005382
35,1547766000,443,319,0,762,3,-0.5310289896628062,-0.29056738461683324
35,1547780400,73,77,4,150,3,-0.5171975369087982,-0.9583138355950255
35,1547794800,237,273,36,510,3,-0.4065459148767344,-0.5655218056078536
35,1547809200,947,1868,921,2815,3,2.65366300694753,1.9494382752822332
35,1547823600,481,813,332,1294,3,0.6169815889198557,0.2898919485864319
35,1547838000,1365,990,0,2355,3,-0.5310289896628062,1.4475373480764024
35,1547852400,401,359,0,760,3,-0.5310289896628062,-0.29274956256120643
35,1547866800,68,107,39,175,3,-0.3961723253112284,-0.9310366112903607
35,1547881200,94,96,2,190,3,-0.5241132632858022,-0.914670276707562
35,1547895600,422,374,0,796,3,-0.5310289896628062,-0.2534703595624892
35,1547910000,631,366,0,997,3,-0.5310289896628062,-0.034161476152984906
35,1547924400,509,376,0,885,3,-0.5310289896628062,-0.15636344103788283
35,1547938800,221,288,67,509,3,-0.2993521560331726,-0.5666128945800402
35,1547953200,37,84,47,121,3,-0.3685094198032125,-0.9899554157884366
35,1547967600,62,94,32,156,3,-0.42037736763074235,-0.9517673017619059
35,1547982000,371,178,0,549,3,-0.5310289896628062,-0.5229693356925766
35,1547996400,480,270,0,750,3,-0.5310289896628062,-0.3036604522830723
35,1548010800,395,282,0,677,3,-0.5310289896628062,-0.3833099472526933
35,1548025200,136,226,90,362,3,-0.21982130269762676,-0.7270029734914687
35,1548039600,36,68,32,104,3,-0.42037736763074235,-1.0085039283156085
35,1548054000,123,158,35,281,3,-0.4100037780652364,-0.8153811802385824
35,1548068400,494,720,226,1214,3,0.25044809093864434,0.20260483081150482
35,1548082800,422,687,265,1109,3,0.38530475529022207,0.08804048873191303
35,1548097200,439,409,0,848,3,-0.5310289896628062,-0.1967337330087866
35,1548111600,144,230,86,374,3,-0.23365275545163475,-0.7139099058252296
35,1548126000,43,59,16,102,4,-0.4661035157909742,-1.0808645927013272
35,1548140400,229,266,37,495,4,-0.40468981681761906,-0.6791273104583561
35,1548154800,1001,2145,1144,3146,4,2.8326894576349586,2.030810438208607
35,1548169200,533,943,410,1476,4,0.686134455423403,0.32368254674356434
35,1548183600,1668,1027,0,2695,4,-0.5128949054849591,1.5697836842860118
35,1548198000,405,414,9,819,4,-0.48657474878209256,-0.34792405486873096
35,1548212400,65,75,10,140,4,-0.48365028692621853,-1.0420197664284698
35,1548226800,249,277,28,526,4,-0.43100997352048553,-0.6474381100778672
35,1548241200,1015,1967,952,2982,4,2.27119278130714,1.863164345873118
35,1548255600,572,865,293,1437,4,0.3439724182861387,0.2838154882003687
35,1548270000,1569,862,0,2431,4,-0.5128949054849591,1.2999143649166875
35,1548284400,437,435,0,872,4,-0.5128949054849591,-0.29374574454079844
35,1548298800,185,82,0,267,4,-0.5128949054849591,-0.9121962680954996
35,1548313200,262,265,3,527,4,-0.5041215199173369,-0.6464158778075288
35,1548327600,994,2091,1097,3085,4,2.695239750408878,1.9684542697179679
35,1548342000,531,1024,493,1555,4,0.9288647894609494,0.4044388961002939
35,1548356400,1515,976,0,2491,4,-0.5128949054849591,1.3612483011369885
35,1548370800,468,397,0,865,4,-0.5128949054849591,-0.3009013704331669
35,1548385200,65,93,28,158,4,-0.43100997352048553,-1.0236195855623795
35,1548399600,245,228,0,473,4,-0.5128949054849591,-0.7016164204057997
35,1548414000,984,1996,1012,2980,4,2.4466604926595834,1.8611198813324412
35,1548428400,571,861,290,1432,4,0.33519903271851653,0.27870432684867696
35,1548442800,1540,820,0,2360,4,-0.5128949054849591,1.2273358737226647
35,1548457200,401,346,0,747,4,-0.5128949054849591,-0.4215247783330921
35,1548471600,73,90,17,163,4,-0.4631790539351001,-1.0185084242106879
35,1548486000,101,106,5,207,4,-0.4982725962055888,-0.9735302043158005
35,1548500400,419,379,0,798,4,-0.5128949054849591,-0.36939093254583627
35,1548514800,594,389,0,983,4,-0.5128949054849591,-0.18027796253324171
35,1548529200,534,476,0,1010,4,-0.5128949054849591,-0.1526776912341063
35,1548543600,261,206,0,467,4,-0.5128949054849591,-0.7077498140278298
35,1548558000,57,100,43,157,4,-0.38714304568237473,-1.024641817832718
35,1548572400,76,100,24,176,4,-0.44270782094398176,-1.0052194046962895
35,1548586800,359,237,0,596,4,-0.5128949054849591,-0.5758818511541828
35,1548601200,511,265,0,776,4,-0.5128949054849591,-0.39188004249327996
35,1548615600,387,326,0,713,4,-0.5128949054849591,-0.45628067552459595
35,1548630000,145,208,63,353,4,-0.3286538085648937,-0.8242842928464016
35,1548644400,51,64,13,115,4,-0.47487690135859634,-1.0675755731869288
35,1548658800,259,278,19,537,4,-0.457330130223352,-0.6361935551041453
35,1548673200,944,1973,1029,2917,4,2.4963763442094424,1.7967192483011252
35,1548687600,507,838,331,1345,4,0.4551019688093528,0.18977011932924062
35,1548702000,1555,888,0,2443,4,-0.5128949054849591,1.3121811521607478
35,1548716400,451,425,0,876,4,-0.5128949054849591,-0.28965681545944505
35,1548730800,76,74,0,150,5,-0.5612309395928862,-1.0308859081547688
35,1548745200,266,295,29,561,5,-0.4723967245929986,-0.6194182669559244
35,1548759600,1203,2137,934,3340,5,2.2998434331621156,2.1627437157486695
35,1548774000,514,921,407,1435,5,0.6855113191986403,0.2555761817248295
35,1548788400,1729,1179,0,2908,5,-0.5612309395928862,1.730252180473972
35,1548802800,439,373,0,812,5,-0.5612309395928862,-0.36813267585882004
35,1548817200,69,87,18,156,5,-0.5060924613170938,-1.0248790812759534
35,1548831600,245,292,47,537,5,-0.41725824631720626,-0.6434455744711854
35,1548846000,1063,2063,1000,3126,5,2.5020178535066875,1.9485002237375926
35,1548860400,541,920,379,1461,5,0.5997403529918522,0.28160576486636224
35,1548874800,1624,875,0,2499,5,-0.5612309395928862,1.3207868149013995
35,1548889200,373,446,73,819,5,-0.3376137776966173,-0.3611247111668689
35,1548903600,53,73,20,126,5,-0.49996596373089475,-1.0549132156700296
35,1548918000,240,281,41,521,5,-0.43563773907580366,-0.6594637794813594
35,1548932400,881,2025,1144,2906,5,2.943125679713026,1.7282499048477002
35,1548946800,481,796,315,1277,5,0.4036924302334795,0.0973964072493614
35,1548961200,1594,1036,0,2630,5,-0.5612309395928862,1.451935868422199
35,1548975600,418,400,0,818,5,-0.5612309395928862,-0.36212584898000477
35,1548990000,60,70,10,130,5,-0.5305984516618905,-1.050908664417486
35,1549004400,248,284,36,532,5,-0.4509539830413016,-0.6484512635368648
35,1549018800,978,2016,1038,2994,5,2.6184213076444713,1.8163500324036572
35,1549033200,610,829,219,1439,5,0.10962054609592044,0.259580732977373
35,1549047600,1496,780,0,2276,5,-0.5612309395928862,1.0975330825720997
35,1549062000,353,354,1,707,5,-0.5581676907997867,-0.4732521462380868
35,1549076400,68,178,110,246,5,-0.2242735723519331,-0.9347766780937248
35,1549090800,90,111,21,201,5,-0.49690271493779514,-0.9798278796848391
35,1549105200,468,322,0,790,5,-0.5612309395928862,-0.3901577077478093
35,1549119600,571,397,0,968,5,-0.5612309395928862,-0.21195517700962369
35,1549134000,508,487,0,995,5,-0.5612309395928862,-0.18492445605495508
35,1549148400,215,347,132,562,5,-0.15688209890374247,-0.6184171291427886
35,1549162800,60,159,99,219,5,-0.25796930907602844,-0.9618073990483934
35,1549177200,70,107,37,177,5,-0.44789073424820197,-1.0038551872001
35,1549191600,368,288,0,656,5,-0.5612309395928862,-0.5243101747080164
35,1549206000,499,445,0,944,5,-0.5612309395928862,-0.23598248452488466
35,1549220400,409,381,0,790,5,-0.5612309395928862,-0.3901577077478093
35,1549234800,149,290,141,439,5,-0.1293128597658463,-0.7415570801585011
35,1549249200,46,133,87,179,5,-0.2947282945932233,-1.0018529115738284
35,1549263600,234,263,29,497,5,-0.4723967245929986,-0.6834910869966204
35,1549278000,1025,2011,986,3036,5,2.4591323704032932,1.858397820555364
35,1549292400,522,864,342,1386,5,0.486400147647168,0.20652042888117167
35,1549306800,1491,1036,0,2527,5,-0.5612309395928862,1.348818673669204
35,1549321200,396,380,0,776,5,-0.5612309395928862,-0.4041736371317115
35,1549335600,62,65,3,127,6,-0.5520798206672586,-1.1015217635162802
35,1549350000,224,287,63,511,6,-0.3670743488479113,-0.7154193771390185
35,1549364400,1020,2171,1151,3191,6,2.98769154014292,1.9792535277856202
35,1549378800,597,945,348,1542,6,0.5117016422939884,0.32122531128534815
35,1549393200,1636,1003,0,2639,6,-0.561330094258226,1.4242313473683066
35,1549407600,459,405,0,864,6,-0.561330094258226,-0.36048671466200444
35,1549422000,64,130,66,194,6,-0.35782407525694393,-1.034154940893164
35,1549436400,248,290,42,538,6,-0.4318262639846829,-0.6882715530968673
35,1549450800,1089,2098,1009,3187,6,2.5498452568371315,1.9752316279275237
35,1549465200,592,945,353,1537,6,0.5271187649456007,0.3161979364627276
35,1549479600,1673,1029,0,2702,6,-0.561330094258226,1.4875762701333262
35,1549494000,455,411,0,866,6,-0.561330094258226,-0.3584757647329562
35,1549508400,60,86,26,146,6,-0.48116105646984214,-1.0824177391903218
35,1549522800,251,244,0,495,6,-0.561330094258226,-0.7315069765714043
35,1549537200,1048,2164,1116,3212,6,2.879771681581634,2.0003685020406268
35,1549551600,569,872,303,1441,6,0.372947538429478,0.21967233986841217
35,1549566000,1690,893,0,2583,6,-0.561330094258226,1.367924749354956
35,1549580400,418,347,0,765,6,-0.561330094258226,-0.46002873614989226
35,1549594800,63,90,27,153,6,-0.4780776319395197,-1.075379414438653
35,1549609200,231,291,60,522,6,-0.37632462243887865,-0.7043591525292532
35,1549623600,1065,1977,912,3042,6,2.2507530773958533,1.8294377580715266
35,1549638000,624,789,165,1413,6,-0.05256504675502087,0.19151904086173682
35,1549652400,1343,912,0,2255,6,-0.561330094258226,1.038128960991045
35,1549666800,391,373,0,764,6,-0.561330094258226,-0.46103421111441634
35,1549681200,77,207,130,284,6,-0.1604849053163068,-0.9436621940859934
35,1549695600,103,136,33,239,6,-0.45957708475758496,-0.9889085674895788
35,1549710000,476,358,0,834,6,-0.561330094258226,-0.39065096359772805
35,1549724400,564,596,32,1160,6,-0.4626605092879074,-0.06286612516286526
35,1549738800,554,305,0,859,6,-0.561330094258226,-0.36551408948462505
35,1549753200,756,838,82,1594,6,-0.30848928277178467,0.37351000944060236
35,1549767600,50,169,119,219,6,-0.19440257514985382,-1.0090180667800612
35,1549782000,75,88,13,163,6,-0.521245575364034,-1.0653246647934118
35,1549796400,373,382,9,755,6,-0.5335792734853239,-0.4700834857951334
35,1549810800,503,514,11,1017,6,-0.527412424424679,-0.20664904508981427
35,1549825200,347,424,77,771,6,-0.32390640542339694,-0.4539958863627475
35,1549839600,179,272,93,451,6,-0.2745716129382377,-0.7757478750104656
35,1549854000,41,101,60,142,6,-0.37632462243887865,-1.0864396390484183
35,1549868400,223,292,69,515,6,-0.34857380166597657,-0.711397477280922
35,1549882800,1014,1936,922,2950,6,2.2815873226990777,1.7369340613353077
35,1549897200,522,829,307,1351,6,0.3852812365507678,0.12917959306124147
35,1549911600,1552,952,0,2504,6,-0.561330094258226,1.2884922271575505
35,1549926000,402,447,45,849,6,-0.4225759903937155,-0.3755688391298662
35,1549940400,59,62,3,121,7,-0.48647457053124327,-1.0556000925646698
35,1549954800,244,292,48,536,7,-0.3305222355448358,-0.5874908593990792
35,1549969200,994,2128,1134,3122,7,3.433127448793799,2.3294500489532517
35,1549983600,608,888,280,1496,7,0.4734986914961985,0.49536423418879305
35,1549998000,1543,1061,0,2604,7,-0.49687139286367044,1.745159488038129
35,1550012400,413,403,0,816,7,-0.49687139286367044,-0.2716581237692831
35,1550026800,66,80,14,146,7,-0.448352888645677,-1.0274007411691521
35,1550041200,242,303,61,545,7,-0.2854693387709847,-0.5773390928966928
35,1550055600,1148,2087,939,3235,7,2.757333997186033,2.456911117260991
35,1550070000,599,912,313,1511,7,0.5878637371528973,0.5122838450261036
35,1550084400,1568,1089,0,2657,7,-0.49687139286367044,1.8049421129966259
35,1550098800,448,410,0,858,7,-0.49687139286367044,-0.2242832134248137
35,1550113200,83,78,0,161,7,-0.49687139286367044,-1.0104811303318417
35,1550127600,266,288,22,554,7,-0.4206280290925379,-0.5671873263943066
35,1550142000,1078,2098,1020,3176,7,3.0380482001615663,2.3903606479675696
35,1550156400,604,849,245,1453,7,0.3522024309512149,0.44686134978850295
35,1550170800,1671,897,0,2568,7,-0.49687139286367044,1.7045524220285837
35,1550185200,423,391,0,814,7,-0.49687139286367044,-0.2739140718809245
35,1550199600,71,108,37,179,7,-0.36864391743040203,-0.9901775973270691
35,1550214000,229,275,46,504,7,-0.3374534504331205,-0.6235860291853416
35,1550222523,368,1321,953,1689,7,2.805852501404026,0.7130632269621882
35,1550228400,1080,603,0,1683,7,-0.49687139286367044,0.706295382627264
35,1550242800,593,696,103,1289,7,-0.13991382611700437,0.2618736046339081
35,1550257200,1378,896,0,2274,7,-0.49687139286367044,1.3729280496172978
35,1550271600,358,430,72,788,7,-0.24734765688541843,-0.3032413973322627
35,1550286000,79,174,95,253,7,-0.16763868567014348,-0.9067075171963374
35,1550300400,89,122,33,211,7,-0.3825063472069716,-0.9540824275408067
35,1550314800,395,424,29,819,7,-0.39636877698354117,-0.26827420160182097
35,1550329200,558,368,0,926,7,-0.49687139286367044,-0.14758097762900607
35,1550343600,478,489,11,967,7,-0.4587497109781042,-0.10133404134035737
35,1550358000,251,332,81,583,7,-0.21615718988813692,-0.5344760787755063
35,1550372400,55,150,95,205,7,-0.16763868567014348,-0.9608502718757309
35,1550386800,67,101,34,168,7,-0.3790407397628292,-1.0025853119410968
35,1550401200,404,222,0,626,7,-0.49687139286367044,-0.48597319437521613
35,1550415600,527,307,0,834,7,-0.49687139286367044,-0.2513545907645105
35,1550430000,401,449,48,850,7,-0.3305222355448358,-0.23330700587137929
35,1550444400,168,320,152,488,7,0.029900938645972704,-0.6416336140784727
35,1550458800,38,103,65,141,7,-0.27160690899441514,-1.0330406114482558
35,1550473200,136,123,0,259,7,-0.49687139286367044,-0.8999396728614131
35,1550487600,505,382,0,887,7,-0.49687139286367044,-0.19157196580601338
35,1550502000,436,468,32,904,7,-0.385971954651114,-0.17239640685706148
35,1550516400,478,519,41,997,7,-0.3547814876538325,-0.06749481966573635
35,1550530800,194,353,159,547,7,0.054160190754969424,-0.5750831447850514
35,1550545200,52,108,56,160,8,-0.4680801331875839,-1.1747619345684917
35,1550559600,218,246,28,464,8,-0.5386956705219177,-0.8704920677273187
35,1550574000,945,2179,1234,3124,8,2.5028164018068875,1.791869267132944
35,1550588400,554,936,382,1490,8,0.3540864800621594,0.15641873286163976
35,1550602800,1548,942,0,2490,8,-0.6093112078562515,1.157306452733919
35,1550617200,433,406,0,839,8,-0.6093112078562515,-0.495159172775214
35,1550631600,66,73,7,139,8,-0.591657323522668,-1.1957805766858094
35,1550646000,230,286,56,516,8,-0.4680801331875839,-0.8184459062939602
35,1550660400,985,1922,937,2907,8,1.7537873093677039,1.5746766319206593
35,1550674800,606,884,278,1490,8,0.09180019853463393,0.15641873286163976
35,1550689200,1567,843,0,2410,8,-0.6093112078562515,1.0772354351441367
35,1550703600,418,377,0,795,8,-0.6093112078562515,-0.5391982324495943
35,1550718000,59,91,32,150,8,-0.5286077366170129,-1.1847708117672144
35,1550732400,220,287,67,507,8,-0.44033831494909564,-0.8274538957728107
35,1550746800,994,1994,1000,2988,8,1.9126722683699549,1.655748537230314
35,1550761200,555,911,356,1466,8,0.28851490968027804,0.13239742758470507
35,1550775600,1568,989,0,2557,8,-0.6093112078562515,1.2243659299653618
35,1550790000,464,426,0,890,8,-0.6093112078562515,-0.44411389906172777
35,1550804400,64,92,28,156,8,-0.5386956705219177,-1.1787654854479808
35,1550818800,213,257,44,470,8,-0.4983439349022984,-0.864486741408085
35,1550823549,368,29,0,397,8,-0.6093112078562515,-0.9375515449587614
35,1550833200,604,1849,1245,2453,8,2.5305582200453753,1.1202736070986445
35,1550847600,603,874,271,1477,8,0.07414631420105049,0.14340719250330014
35,1550862000,1429,814,0,2243,8,-0.6093112078562515,0.910087185925466
35,1550876400,373,392,19,765,8,-0.5613935218079535,-0.5692248640457627
35,1551495600,7154,2826,0,9980,9,-0.4968739023769356,3.934286479400618
35,1551510000,96,140,44,236,9,-0.3245778731814308,-0.5168818753488301
35,1551524400,436,430,0,866,9,-0.4968739023769356,-0.22909081792968475
35,1551538800,563,359,0,922,9,-0.4968739023769356,-0.2035093906035385
35,1551553200,446,379,0,825,9,-0.4968739023769356,-0.24782007722204183
35,1551567600,209,311,102,520,9,-0.0974603801509926,-0.38714749390908837
35,1551582000,48,102,54,150,9,-0.28541968472790696,-0.5561676387425547
35,1551596400,63,102,39,165,9,-0.3441569674081927,-0.5493154707087655
35,1551610800,626,940,314,1566,9,0.7326932150637124,0.09067702364714342
35,1551625200,527,488,0,1015,9,-0.4968739023769356,-0.1610259487940456
35,1551639600,356,450,94,806,9,-0.12878693091381166,-0.25649949006484146
35,1551654000,142,250,108,392,9,-0.07396546707887831,-0.4456193277974227
35,1551668400,42,59,17,101,9,-0.4303049820059451,-0.5785513876529327
35,1551682800,204,285,81,489,9,-0.17969257590339263,-0.40130864117891935
35,1551697200,769,1874,1105,2643,9,3.8301059217374465,0.5826626884732062
35,1551711600,447,763,316,1210,9,0.7405248527544172,-0.07194776435478634
35,1551726000,1338,717,0,2055,9,-0.4968739023769356,0.3140577015486705
35,1551740400,332,342,10,674,9,-0.45771571392341176,-0.3167985687621862
35,1551754800,50,81,31,131,10,-0.3669172431129765,-0.8856309198877906
35,1551769200,244,309,65,553,10,-0.2552579767812985,-0.4660445800937248
35,1551783600,1078,2226,1148,3304,10,3.301418065489504,2.2692208719761213
35,1551798000,593,936,343,1529,10,0.6577207302835982,0.504373115733309
35,1551812400,1611,1147,0,2758,10,-0.4687242212389182,1.7263437593515718
35,1551826800,443,427,0,870,10,-0.4687242212389182,-0.15085768503514924
35,1551841200,71,61,0,132,10,-0.4687242212389182,-0.8846366394617383
35,1551855600,245,288,43,533,10,-0.32750809029003136,-0.48593018861477055
35,1551870000,1018,2199,1181,3217,10,3.4097932357526033,2.182718474909572
35,1551879026,176,166,0,342,10,-0.4687242212389182,-0.6758377499907577
35,1551879146,402,569,167,971,10,0.07971982221373554,-0.05043536200386808
35,1551879825,27,46,19,73,10,-0.4063263959359217,-0.9432991845988233
35,1551882043,399,64,0,463,10,-0.4687242212389182,-0.5555298184384307
35,1551882375,14,2,0,16,10,-0.4687242212389182,-0.9999731688838038
35,1551882437,2,1,0,3,10,-0.4687242212389182,-1.0128988144224835
35,1551882500,2,0,0,2,10,-0.4687242212389182,-1.0138930948485358
35,1551882598,3,0,0,3,10,-0.4687242212389182,-1.0128988144224835
35,1551882738,90,75,0,165,10,-0.4687242212389182,-0.8518253854020128
35,1551883099,12,2,0,14,10,-0.4687242212389182,-1.0019617297359085
35,1551884400,214,287,73,501,10,-0.22898520823266838,-0.5177471622484437
35,1551898800,1665,1004,0,2669,10,-0.4687242212389182,1.6378528014329181
35,1551913200,436,375,0,811,10,-0.4687242212389182,-0.20952023017223428
35,1551927600,52,74,22,126,10,-0.39647410773018543,-0.890602322018052
35,1551942000,224,276,52,500,10,-0.29795122567282245,-0.5187414426744961
35,1551956400,970,1987,1017,2957,10,2.8712014805056856,1.9242055641359774
35,1551970800,559,894,335,1453,10,0.6314479617349681,0.42880780335333507
35,1551985200,1759,1114,0,2873,10,-0.4687242212389182,1.8406860083475851
35,1551999600,439,438,0,877,10,-0.4687242212389182,-0.14389772205278323
35,1552014000,61,100,39,161,10,-0.3406444745643464,-0.855802507106222
35,1552028400,241,276,35,517,10,-0.35378085883866145,-0.5018386754316072
35,1552042800,1085,2138,1053,3223,10,2.9894289389745214,2.188684157465886
35,1552057200,700,887,187,1587,10,0.14540174358531083,0.5620413804443418
35,1552071600,1583,1037,0,2620,10,-0.4687242212389182,1.589133060556356
35,1552086000,486,438,0,924,10,-0.4687242212389182,-0.09716654202832566
35,1552100400,65,103,38,168,10,-0.34392857063292515,-0.848842544123856
35,1552114800,94,124,30,218,10,-0.3702013391815553,-0.7991285228212415
35,1552129200,507,465,0,972,10,-0.4687242212389182,-0.04944108157781579
35,1552143600,615,583,0,1198,10,-0.4687242212389182,0.17526629471000146
35,1552158000,584,630,46,1214,10,-0.31765580208429506,0.1911747815268381
35,1552172400,332,389,57,721,10,-0.2815307453299286,-0.29900546851694026
35,1552190400,52,119,67,171,10,-0.248689784644141,-0.8458597028456991
35,1552204800,121,146,25,267,10,-0.38662181952444913,-0.7504087819446793
35,1552219200,419,422,3,841,10,-0.45887193303318197,-0.17969181739066561
35,1552233600,473,416,0,889,10,-0.4687242212389182,-0.13196635694015577
35,1552248000,319,346,27,665,10,-0.3800536273872916,-0.35468517237586844
35,1552262400,105,235,130,340,10,-0.041791732323678776,-0.6778263108428623
35,1552276800,24,61,37,85,10,-0.3472126667015039,-0.9313678194861958
35,1552291200,533,602,69,1135,10,-0.24212159250698345,0.11262662786870727
35,1552305600,917,1634,717,2551,10,1.8859726599320563,1.520527711158748
35,1552320000,669,892,223,1561,10,0.26362920205414636,0.5361900893669823
35,1552334400,1452,782,0,2234,10,-0.4687242212389182,1.2053408161001726
35,1552348800,256,297,41,553,11,-0.404906462009854,-0.7029986505074586
35,1552363200,33,47,14,80,11,-0.48597353967919976,-1.2348659363243972
35,1552377600,519,722,203,1241,11,0.08149600400622059,0.07062649249899754
35,1552392000,856,2370,1514,3226,11,4.017752997506676,2.3026699646905895
35,1552406400,818,814,0,1632,11,-0.5280083206929346,0.5102884560390039
35,1552420800,1542,918,0,2460,11,-0.5280083206929346,1.441337320006076
35,1552435200,254,329,75,583,11,-0.3028219938336408,-0.669264996015898
35,1552449600,32,59,27,91,11,-0.44694124302358884,-1.2224969296774917
35,1552464000,536,656,120,1192,11,-0.16771019771806453,0.015528190162781907
35,1552478400,820,1853,1033,2673,11,2.5735580212490716,1.6808462668961561
35,1552492800,749,895,146,1644,11,-0.08964560440684267,0.5237819178356281
35,1552507200,1549,883,0,2432,11,-0.5280083206929346,1.4098525758139528
35,1552521600,255,322,67,577,11,-0.32684186869863213,-0.6760117269142101
35,1552536000,30,54,24,84,11,-0.45594869609796057,-1.2303681157255224
35,1552550400,533,692,159,1225,11,-0.05061330775123176,0.05263521010349855
35,1552564800,879,1812,933,2691,11,2.27330958543668,1.7010864595910926
35,1552579200,697,973,276,1670,11,0.30067736214926655,0.5530177517283139
35,1552593600,1559,978,0,2537,11,-0.5280083206929346,1.527920366534415
35,1552608000,290,363,73,653,11,-0.3088269625498886,-0.59055313553559
35,1552622400,33,50,17,83,11,-0.476966086604828,-1.231492570875241
35,1552636800,484,711,227,1195,11,0.1535556286011946,0.018901555611937966
35,1552651200,833,1581,748,2414,11,1.7178499791837554,1.3896123831190166
35,1552665600,777,803,26,1580,11,-0.44994372738171273,0.45181678825363214
35,1552680000,1313,755,0,2068,11,-0.5280083206929346,1.000550901316351
35,1552694400,295,309,14,604,11,-0.48597353967919976,-0.6456514378718056
35,1552708800,31,72,41,103,11,-0.404906462009854,-1.2090034678808674
35,1552723200,180,209,29,389,11,-0.440936274307341,-0.8874092950613232
35,1552737600,595,283,0,878,11,-0.5280083206929346,-0.3375507268488856
35,1552752000,589,411,0,1000,11,-0.5280083206929346,-0.20036719858320584
35,1552766400,496,438,0,934,11,-0.5280083206929346,-0.27458123846463917
35,1552780800,161,321,160,482,11,-0.04761082339310784,-0.7828349661374853
35,1552795200,23,67,44,90,11,-0.39589900893548224,-1.2236213848272104
35,1552809600,135,166,31,301,11,-0.43493130559109316,-0.9863613482365675
35,1552824000,474,197,0,671,11,-0.5280083206929346,-0.5703129428406536
35,1552838400,525,339,0,864,11,-0.5280083206929346,-0.35329309894494715
35,1552852800,342,424,82,766,11,-0.2818046033267734,-0.4634897036173784
35,1552867200,120,237,117,357,11,-0.1767176507924363,-0.9233918598523211
35,1552881600,25,36,11,61,11,-0.4949809927535715,-1.2562305841690522
35,1552896000,501,707,206,1208,11,0.09050345708059235,0.03351947255828089
35,1552910400,824,1732,908,2556,11,2.198247476483582,1.54928501437907
35,1552924800,731,751,20,1482,11,-0.46795863353045625,0.3416201835812009
35,1552939200,1489,665,0,2154,11,-0.5280083206929346,1.097254044192158
35,1552953600,217,256,39,473,12,-0.5249388618129005,-0.7409998995911976
35,1552968000,27,32,5,59,12,-0.6755394536438386,-1.2085436797188824
35,1552982400,537,749,212,1286,12,0.24135238485628452,0.17714766863056033
35,1552996800,877,1672,795,2549,12,2.823709591839723,1.6034949978606714
35,1553011200,665,930,265,1595,12,0.47611213094568805,0.5261115045229627
35,1553025600,734,394,0,1128,12,-0.6976865995013295,-0.001286914123483649
35,1553040000,1753,1203,0,2956,12,-0.6976865995013295,2.0631334483726707
35,1553054400,21,34,13,55,12,-0.6401040202718532,-1.2130610109278455
35,1553068800,518,746,228,1264,12,0.3122232516002554,0.15230234698126305
35,1553083200,865,1571,706,2436,12,2.429490395576385,1.4758803912074627
35,1553097600,634,818,184,1452,12,0.11732836805433551,0.3646169138025306
35,1553112000,1375,808,0,2183,12,-0.6976865995013295,1.1901591922405441
35,1553126400,231,305,74,536,12,-0.3699088408104642,-0.6698519330500281
35,1553140800,30,45,15,75,12,-0.6312451619288568,-1.1904743548830299
35,1553155200,483,671,188,1154,12,0.13504608474032823,0.028075738734776753
35,1553169600,855,1725,870,2580,12,3.1559167797020864,1.6385043147301357
35,1553184000,651,911,260,1562,12,0.4539649850881971,0.4888435220490169
35,1553198400,1527,891,0,2418,12,-0.6976865995013295,1.4555524007671286
35,1553212800,207,268,61,475,12,-0.42749142003994056,-0.738741233986716
35,1553227200,25,46,21,71,12,-0.6046685868998677,-1.194991686091993
35,1553241600,448,735,287,1183,12,0.573559572718648,0.060826389999759506
35,1553242478,45,126,81,171,12,-0.33890283660997694,-1.0820584058679146
35,1553256000,870,1553,683,2423,12,2.327613524631927,1.4611990647783324
35,1553270400,666,860,194,1526,12,0.1616226597693173,0.44818754116834864
35,1553284800,1215,677,0,1892,12,-0.6976865995013295,0.8615233467884758
35,1553299200,205,294,89,499,12,-0.30346740323799154,-0.7116372467329372
35,1553313600,31,62,31,93,12,-0.5603742951848859,-1.1701463644426957
35,1553328000,192,176,0,368,12,-0.6976865995013295,-0.85957984382648
35,1553342400,543,291,0,834,12,-0.6976865995013295,-0.33331075798227433
35,1553356800,588,419,0,1007,12,-0.6976865995013295,-0.1379361831946186
35,1553371200,476,417,0,893,12,-0.6976865995013295,-0.266680122650068
35,1553385600,183,254,71,437,12,-0.3831971283249588,-0.7816558804718658
35,1553400000,26,72,46,98,12,-0.49393285761241323,-1.1644997004314919
35,1553414400,130,138,8,268,12,-0.6622511661293441,-0.9725131240505585
35,1553428800,483,170,0,653,12,-0.6976865995013295,-0.5377199951878563
35,1553443200,460,308,0,768,12,-0.6976865995013295,-0.4078467229301661
35,1553457600,314,446,132,760,12,-0.11300194886356982,-0.4168813853480924
35,1553472000,125,261,136,386,12,-0.0952842321775771,-0.8392518533861458
35,1553486400,32,40,8,72,12,-0.6622511661293441,-1.193862353289752
35,1553500800,248,711,463,959,12,1.3531391069023275,-0.19214415770217624
35,1553515200,1369,1748,379,3117,12,0.9810670564964805,2.2449560295334368
35,1553529600,663,892,229,1555,12,0.31665268077175357,0.48093819243333136
35,1553544000,1513,771,0,2284,12,-0.6976865995013295,1.3042218052668633
35,1553558400,163,214,51,377,13,-0.39788146036416333,-0.8731009373871443
35,1553572800,46,47,1,93,13,-0.5602189514783547,-1.1894061152505873
35,1553587200,502,708,206,1210,13,0.10536476208982996,0.054653334303869656
35,1553601600,926,1847,921,2773,13,2.4267908850227666,1.7954455631790855
35,1553616000,760,948,188,1708,13,0.04692326528872107,0.6093011461911746
35,1553630400,1453,847,0,2300,13,-0.5634657013006386,1.268641516948774
35,1553644800,247,223,0,470,13,-0.5634657013006386,-0.7695221291431296
35,1553659200,55,62,7,117,13,-0.5407384525446517,-1.1626761002198738
35,1553673600,516,652,136,1168,13,-0.12190772547003796,0.007875808000121047
35,1553688000,899,1965,1066,2864,13,2.897569609253922,1.8967968701705409
35,1553702400,746,921,175,1667,13,0.004715517599031309,0.5636373705137057
35,1553716800,1512,814,0,2326,13,-0.5634657013006386,1.2975990332320468
35,1553731200,192,243,51,435,13,-0.39788146036416333,-0.8085034010629201
35,1553745600,43,58,15,101,13,-0.514764453966381,-1.1804961102403495
35,1553760000,519,692,173,1211,13,-0.0017779820455363466,0.05576708493014938
35,1553774400,880,1809,929,2689,13,2.4527648836010374,1.7018905105715885
35,1553788800,736,980,244,1716,13,0.2287412553366154,0.6182111512014123
35,1553803200,1512,966,0,2478,13,-0.5634657013006386,1.4668891284265657
35,1553817600,223,273,50,496,13,-0.4011282101864471,-0.7405646128598566
35,1553832000,42,85,43,127,13,-0.4238554589424339,-1.1515385939570766
35,1553846400,488,631,143,1119,13,-0.09918047671405117,-0.04669797268758566
35,1553860800,881,1841,960,2722,13,2.553414128091836,1.7386442812388194
35,1553875200,757,880,123,1637,13,-0.16411547315972771,0.5302248517253139
35,1553889600,1284,662,0,1946,13,-0.5634657013006386,0.87437379524575
35,1553904000,213,310,97,523,13,-0.24853096853910725,-0.710493345950304
35,1553918400,50,72,22,122,13,-0.4920372052103943,-1.1571073470884752
35,1553932800,184,174,0,358,13,-0.5634657013006386,-0.8942621992864592
35,1553947200,606,404,0,1010,13,-0.5634657013006386,-0.16809679095207608
35,1553961600,682,294,0,976,13,-0.5634657013006386,-0.20596431224558687
35,1553976000,494,379,0,873,13,-0.5634657013006386,-0.32068062675239895
35,1553990400,202,247,45,449,13,-0.4173619592978663,-0.7929108922950039
35,1554004800,35,71,36,106,13,-0.44658270769842073,-1.174927357108951
35,1554019200,121,134,13,255,13,-0.5212579536109487,-1.0089785137932712
35,1554033600,508,191,0,699,13,-0.5634657013006386,-0.5144732357250718
35,1554048000,428,345,0,773,13,-0.5634657013006386,-0.4320556893803718
35,1554062400,354,382,28,736,13,-0.47255670627669133,-0.47326446255272175
35,1554076800,106,197,91,303,13,-0.2680114674728102,-0.9555184837318443
35,1554091200,23,45,22,68,13,-0.4920372052103943,-1.2172498809075805
35,1554105600,512,684,172,1196,13,-0.005024731867820174,0.03906082553595345
35,1554120000,851,1907,1056,2758,13,2.8651021110310833,1.7787393037848898
35,1554134400,695,920,225,1615,13,0.16705300871322268,0.5057223379471598
35,1554148800,1400,789,0,2189,13,-0.5634657013006386,1.145015197431724
35,1554163200,261,278,17,539,14,-0.5290281006025866,-0.7550638810476187
35,1554177600,25,38,13,63,14,-0.5425187989786089,-1.3002150948397455
35,1554192000,531,741,210,1272,14,0.12189809604048671,0.08442317716588768
35,1554206400,899,1975,1076,2874,14,3.042634294449303,1.9191547832477938
35,1554220800,768,923,155,1691,14,-0.06359900662981917,0.5642936783820666
35,1554235200,1525,872,0,2397,14,-0.5863635687006812,1.3728582937964398
35,1554249600,240,354,114,594,14,-0.2018786649840472,-0.692073719790125
35,1554264000,29,48,19,77,14,-0.5222827514145756,-1.2841812356105653
35,1554278400,526,685,159,1211,14,-0.050108308253796925,0.014561361953031076
35,1554292800,883,1929,1046,2812,14,2.941454056629136,1.84814769237571
35,1554307200,751,872,121,1623,14,-0.17826994282600825,0.4864149335546199
35,1554321600,1460,781,0,2241,14,-0.5863635687006812,1.1941952909570033
35,1554336000,244,373,129,617,14,-0.15128854607396378,-0.6657323796279004
35,1554350400,31,52,21,83,14,-0.5155374022265644,-1.2773095816552025
35,1554364800,514,755,241,1269,14,0.22645100845465913,0.0809873501882062
35,1554379200,889,1745,856,2634,14,2.3006458837680794,1.644288625033276
35,1554393600,766,904,138,1670,14,-0.12093447472791372,0.5402428895382964
35,1554408000,1465,835,0,2300,14,-0.5863635687006812,1.2617665548514054
35,1554422400,281,354,73,635,14,-0.3401583233382752,-0.6451174177618115
35,1554436800,27,49,22,76,14,-0.5121647276325588,-1.2853265112697925
35,1554451200,505,721,216,1226,14,0.14213414360452006,0.03174049684143843
35,1554465600,891,1780,889,2671,14,2.411944145370263,1.6866638244246808
35,1554480000,809,803,0,1612,14,-0.5863635687006812,0.4738169013031212
35,1554494400,1393,755,0,2148,14,-0.5863635687006812,1.0876846546488774
35,1554508800,267,302,35,569,14,-0.46831995791048653,-0.7207056112708039
35,1554523200,31,67,36,98,14,-0.464947283316481,-1.260130446766795
35,1554537600,194,301,107,495,14,-0.22548738714208613,-0.8054560100536136
35,1554552000,628,360,0,988,14,-0.5863635687006812,-0.24083511005462502
35,1554566400,647,460,0,1107,14,-0.5863635687006812,-0.1045473066065933
35,1554580800,576,436,0,1012,14,-0.5863635687006812,-0.21334849423317323
35,1554595200,217,276,59,493,14,-0.38737576765435305,-0.8077465613720679
35,1554609600,23,122,99,145,14,-0.25246878389413063,-1.2063024907831186
35,1554624000,134,212,78,346,14,-0.3232949503682474,-0.97610208327846
35,1554638400,548,315,0,863,14,-0.5863635687006812,-0.3839945674580197
35,1554652800,564,330,0,894,14,-0.5863635687006812,-0.3484910220219778
35,1554667200,364,438,74,802,14,-0.33678564874426964,-0.4538563826708763
35,1554681600,126,231,105,357,14,-0.23223273633009725,-0.9635040510269614
35,1554696000,21,49,28,70,14,-0.49192868006852547,-1.2921981652251555
35,1554710400,564,673,109,1237,14,-0.21874203795407499,0.044338529092937166
35,1554724800,904,1818,914,2722,14,2.496261010220402,1.7450728830452658
35,1554739200,704,847,143,1551,14,-0.1040711017578859,0.4039550860902646
35,1554753600,1428,816,0,2244,14,-0.5863635687006812,1.1976311179346846
35,1554768000,249,297,48,546,15,-0.3804626841557028,-0.5163548262188983
35,1554782400,28,40,12,68,15,-0.5284290113813613,-1.1026724797274623
35,1554796800,526,736,210,1262,15,0.2853857883597608,0.3618950480742644
35,1554811200,896,1886,990,2782,15,3.4913228782490298,2.2263361219927105
35,1554825600,698,959,261,1657,15,0.49500475192944376,0.8464044060991238
35,1554840000,1500,852,0,2352,15,-0.5777511204565808,1.6988955550289395
35,1554854400,255,322,67,577,15,-0.3023693447866052,-0.47833004115871947
35,1554868800,25,53,28,78,15,-0.46266619928106867,-1.0904064200306305
35,1554883200,530,719,189,1249,15,0.19907209747812663,0.34594917046838297
35,1554887389,224,128,0,352,15,-0.5777511204565808,-0.7543163843374369
35,1554894641,165,230,65,395,15,-0.3105896962991418,-0.7015723276410597
35,1554897600,950,1737,787,2687,15,2.656957199726566,2.109808554872808
35,1554912000,706,881,175,1587,15,0.1415296368903705,0.7605419882213006
35,1554926400,1492,807,0,2299,15,-0.5777511204565808,1.6338854386357307
35,1554940800,286,347,61,633,15,-0.32703039932421496,-0.40964010685646096
35,1554955200,26,69,43,95,15,-0.40101356293704427,-1.0695541185460162
35,1554969600,509,720,211,1229,15,0.28949596411602907,0.32141705107471924
35,1554972307,155,63,0,218,15,-0.5777511204565808,-0.918681584274984
35,1554978361,196,264,68,460,15,-0.2982591690303369,-0.6218429396116525
35,1554984000,927,1761,834,2688,15,2.850135460271176,2.1110351608424907
35,1554998400,712,905,193,1617,15,0.2155128005031998,0.7973401673117962
35,1555012800,1416,705,0,2121,15,-0.5777511204565808,1.415549576032123
35,1555027200,262,314,52,576,15,-0.3640219811306296,-0.4795566471284027
35,1555041600,28,35,7,63,15,-0.5489798901627028,-1.1088055095758782
35,1555055898,230,660,430,890,15,1.1896244547387855,-0.09440237264788158
35,1555055979,4,15,11,19,15,-0.5325391871376296,-1.1627761722419385
35,1555056000,471,154,0,625,15,-0.5777511204565808,-0.41945295461392645
35,1555056059,0,0,0,0,15,-0.5777511204565808,-1.186081685665919
35,1555058013,115,311,196,426,15,0.22784332777200467,-0.6635475425808809
35,1555069293,391,1266,875,1657,15,3.018652666278176,0.8464044060991238
35,1555069368,4,3,0,7,15,-0.5777511204565808,-1.1774954438781369
35,1555070400,911,478,0,1389,15,-0.5777511204565808,0.5176740062240294
35,1555084800,811,717,0,1528,15,-0.5777511204565808,0.6881722360099924
35,1555099200,1365,811,0,2176,15,-0.5777511204565808,1.4830129043646985
35,1555113600,254,360,106,614,15,-0.14207249029214175,-0.43294562028044153
35,1555128000,32,78,46,110,15,-0.38868303566823936,-1.0511550290007683
35,1555142400,182,198,16,380,15,-0.5119883083562882,-0.7199714171863075
35,1555143588,31,25,0,56,15,-0.5777511204565808,-1.1173917513636606
35,1555156800,599,270,0,869,15,-0.5777511204565808,-0.12016109801122854
35,1555171200,640,386,0,1026,15,-0.5777511204565808,0.07241603922903202
35,1555185600,420,460,40,880,15,-0.4133440902058491,-0.10666843234471346
35,1555200000,222,305,83,527,15,-0.2366065326863125,-0.5396603396428789
35,1555214400,41,68,27,109,15,-0.46677637503733693,-1.0523816349704516
35,1555228800,157,148,0,305,15,-0.5777511204565808,-0.8119668649125467
35,1555243200,515,224,0,739,15,-0.5777511204565808,-0.279619874070043
35,1555257600,534,345,0,879,15,-0.5777511204565808,-0.10789503831439665
35,1555272000,325,373,48,698,15,-0.3804626841557028,-0.3299107188270537
35,1555286400,116,231,115,347,15,-0.1050809084857271,-0.7604494141858528
35,1555300800,23,40,17,63,15,-0.5078781326000199,-1.1088055095758782
35,1555315200,497,705,208,1202,15,0.2771654368472242,0.2882986898932731
35,1555329600,832,1521,689,2353,15,2.2541599756122737,1.7001221609986228
35,1555344000,697,939,242,1636,15,0.4169114125603462,0.8206456807357768
35,1555358400,1421,727,0,2148,15,-0.5777511204565808,1.4486679372135691
35,1555372800,223,299,76,522,16,-0.31690537219498094,-0.7434318922161911
35,1555387200,30,43,13,73,16,-0.5689437295222787,-1.2966494213541018
35,1555401600,552,704,152,1256,16,-0.012859099863637672,0.1609370752386563
35,1555416000,921,1772,851,2693,16,2.7835664838154273,1.9314795905419475
35,1555430400,751,731,0,1482,16,-0.6209516445263242,0.43939400527243766
35,1555444800,1463,803,0,2266,16,-0.6209516445263242,1.4053684882214845
35,1555459200,242,353,111,595,16,-0.17688406256870445,-0.65348783959466
35,1555473600,27,38,11,65,16,-0.5769449472152087,-1.3065063038331737
35,1555488000,544,668,124,1212,16,-0.12487614756465888,0.10672422160376081
35,1555502400,877,1616,739,2493,16,2.3354982930113426,1.68505752856515
35,1555516800,734,910,176,1644,16,0.08315551245152336,0.6389958754736438
35,1555531200,1477,776,0,2253,16,-0.6209516445263242,1.3893510541929925
35,1555545600,261,335,74,596,16,-0.32490658988791105,-0.652255729284776
35,1555560000,33,46,13,79,16,-0.5689437295222787,-1.289256759494798
35,1555574400,504,726,222,1230,16,0.2671835193889154,0.12890220718167258
35,1555588800,918,1780,862,2698,16,2.8275731811265428,1.9376401420913674
35,1555603200,737,859,122,1596,16,-0.13287736525758898,0.5798545805992124
35,1555617600,1464,811,0,2275,16,-0.6209516445263242,1.4164574810104404
35,1555632000,303,299,0,602,16,-0.6209516445263242,-0.6448630674254721
35,1555646400,28,50,22,78,16,-0.5329382499040933,-1.290488869804682
35,1555660800,343,652,309,995,16,0.6152364890313742,-0.16064371564106467
35,1555675200,799,1439,640,2238,16,1.9394380172113035,1.3708693995447327
35,1555689600,782,804,22,1586,16,-0.5329382499040933,0.5675334775003724
35,1555704000,961,652,0,1613,16,-0.6209516445263242,0.6008004558672401
35,1555718400,231,293,62,524,16,-0.3729138960454916,-0.7409676715964232
35,1555732800,68,76,8,144,16,-0.5889467737546039,-1.2091695893523386
35,1555747200,189,219,30,408,16,-0.5009333791323729,-0.8838924675429658
35,1555761600,585,312,0,897,16,-0.6209516445263242,-0.2813905260096955
35,1555776000,587,426,0,1013,16,-0.6209516445263242,-0.13846573006315285
35,1555790400,456,452,0,908,16,-0.6209516445263242,-0.26783731260097166
35,1555804800,197,360,163,557,16,0.031147597447477804,-0.7003080313702515
35,1555819200,49,77,28,126,16,-0.5089345968253031,-1.2313475749302505
35,1555833600,138,169,31,307,16,-0.49693277028590793,-1.0083356088412485
35,1555848000,543,220,0,763,16,-0.6209516445263242,-0.44649330753414995
35,1555862400,404,386,0,790,16,-0.6209516445263242,-0.41322632916728225
35,1555876800,321,467,146,788,16,-0.03686275294242793,-0.4156905497870502
35,1555891200,178,298,120,476,16,-0.14087858295051905,-0.8001089664708546
35,1555905600,40,63,23,103,16,-0.5289376410576283,-1.2596861120575822
35,1555920000,379,687,308,1066,16,0.611235880184909,-0.07316388363930149
35,1555934400,807,1678,871,2485,16,2.863578660744728,1.675200646086078
35,1555948800,684,874,190,1558,16,0.13916403630203397,0.5330343888236208
35,1555963200,1428,785,0,2213,16,-0.6209516445263242,1.340066641797633
35,1555977600,237,249,12,486,17,-0.528552566285947,-0.6346442912716584
35,1555992000,101,250,149,351,17,-0.053117301985054266,-0.8037958278670903
35,1556006400,448,699,251,1147,17,0.30085639844334766,0.19357175087338147
35,1556020800,884,1786,902,2670,17,2.5600414864716776,2.101851678538882
35,1556035200,721,827,106,1548,17,-0.20234150902840017,0.6960144632790713
35,1556049600,1456,796,0,2252,17,-0.5701965310422297,1.578108402265619
35,1556064000,232,291,59,523,17,-0.3654470376571736,-0.5882842405010587
35,1556078400,32,53,21,85,17,-0.4973195927187351,-1.1370870036773484
35,1556092800,459,721,262,1180,17,0.3390300328032734,0.2349199042633759
35,1556107200,826,1735,909,2561,17,2.584333799246176,1.965277474917385
35,1556121600,693,851,158,1544,17,-0.02188432841784233,0.691002565898466
35,1556136000,1498,700,0,2198,17,-0.5701965310422297,1.5104477876274462
35,1556150400,230,279,49,509,17,-0.4001503416207424,-0.6058258813331775
35,1556164800,29,76,47,105,17,-0.4070910024134562,-1.1120275167743214
35,1556179200,463,682,219,1145,17,0.18980582575992744,0.19106580218307878
35,1556193600,886,1695,809,2581,17,2.2373007596104877,1.9903369618204119
35,1556208000,681,888,207,1569,17,0.14816186100364487,0.7223269245272496
35,1556222400,1400,784,0,2184,17,-0.5701965310422297,1.4929061467953275
35,1556236800,258,256,0,514,17,-0.5701965310422297,-0.5995610096074208
35,1556251200,35,66,31,101,17,-0.4626162887551663,-1.1170394141549267
35,1556265600,389,682,293,1071,17,0.4466102750903367,0.09834570064187914
35,1556266217,65,3,0,68,17,-0.5701965310422297,-1.1583875675449211
35,1556266300,29,21,0,50,17,-0.5701965310422297,-1.1809411057576455
35,1556272197,527,39,0,566,17,-0.5701965310422297,-0.5344063436595508
35,1556272342,190,237,47,427,17,-0.4070910024134562,-0.7085697776355879
35,1556280000,531,1643,1112,2174,17,3.288810869706623,1.480376403343814
35,1556294400,745,860,115,1605,17,-0.17110853546118823,0.7674340009526981
35,1556308800,1166,651,0,1817,17,-0.5701965310422297,1.0330645621247836
35,1556323200,218,274,56,492,17,-0.37585802884624425,-0.6271264452007503
35,1556337600,102,100,0,202,17,-0.5701965310422297,-0.9904890052946408
35,1556352000,194,245,51,439,17,-0.39320968082802865,-0.6935340854937717
35,1556366400,626,297,0,923,17,-0.5701965310422297,-0.08709450244052011
35,1556380800,621,479,0,1100,17,-0.5701965310422297,0.1346819566512682
35,1556395200,510,437,0,947,17,-0.5701965310422297,-0.0570231181568878
35,1556409600,180,337,157,517,17,-0.025354658814199214,-0.5958020865719668
35,1556424000,28,91,63,119,17,-0.3515657160717461,-1.0944858759422025
35,1556438400,137,131,0,268,17,-0.5701965310422297,-0.9077926985146519
35,1556452800,504,221,0,725,17,-0.5701965310422297,-0.3351834227804867
35,1556467200,500,337,0,837,17,-0.5701965310422297,-0.19485029612353588
35,1556481600,303,402,99,705,17,-0.22663382180289834,-0.36024290968351363
35,1556496000,108,215,107,323,17,-0.1988711786320433,-0.8388791095313279
35,1556510400,24,51,27,75,17,-0.47649761034059385,-1.1496167471288619
35,1556523084,351,15,0,366,17,-0.5701965310422297,-0.78500121268982
35,1556524592,158,12,0,170,17,-0.5701965310422297,-1.0305841843394838
35,1556524800,277,697,420,974,17,0.8873422354276607,-0.023192810837801447
35,1556526764,244,11,0,255,17,-0.5701965310422297,-0.9240813650016194
35,1556539200,632,1721,1089,2353,17,3.2089932705904145,1.704658811125905
35,1556553600,703,927,224,1630,17,0.20715747774171187,0.7987583595814818
35,1556568000,1345,837,0,2182,17,-0.5701965310422297,1.4904001981050248
35,1556582400,237,288,51,525,18,-0.4474645070110446,-0.7502452612428436
35,1556596800,32,112,80,144,18,-0.3405702081139617,-1.1943100076188509
35,1556611200,554,678,124,1232,18,-0.1783857546149394,0.07378039673048224
35,1556625600,897,1825,928,2722,18,2.7851665320490135,1.8104115570985948
35,1556640000,724,868,144,1592,18,-0.1046655484790202,0.4933691334637175
35,1556654400,1434,868,0,2302,18,-0.6354510326576387,1.3208913642431537
35,1556668800,247,327,80,574,18,-0.3405702081139617,-0.6931345720763755
35,1556683200,31,150,119,181,18,-0.19681580614891922,-1.151185609676824
35,1556697600,517,715,198,1232,18,0.09437900808796174,0.07378039673048224
35,1556700223,173,109,0,282,18,-0.6354510326576387,-1.0334676585377776
35,1556712000,823,1858,1035,2681,18,3.1795696348761813,1.762625062081754
35,1556726400,731,941,210,1672,18,0.13861113176951326,0.586611074959992
35,1556740800,1525,842,0,2367,18,-0.6354510326576387,1.3966504417088768
35,1556755200,299,328,29,627,18,-0.5285567337605558,-0.6313617858350937
35,1556769600,182,153,0,335,18,-0.6354510326576387,-0.9716948722964956
35,1556784000,504,671,167,1175,18,-0.019887311422713078,0.007345513414386661
35,1556798400,912,1740,828,2652,18,2.4165655013694174,1.7288248582893546
35,1556812800,725,919,194,1644,18,0.07963496686077788,0.553976395436296
35,1556827200,1568,857,0,2425,18,-0.6354510326576387,1.4642508492936757
35,1556841600,273,391,118,664,18,-0.2005018164557152,-0.5882373878930667
35,1556856000,31,161,130,192,18,-0.15626969277416367,-1.1383648427210862
35,1556870400,475,733,258,1208,18,0.3155396264957194,0.04580781428159989
35,1556884800,916,1755,839,2671,18,2.457111614744173,1.7509698193947199
35,1556899200,713,838,125,1551,18,-0.17469974430814347,0.44558263844687684
35,1556913600,1303,789,0,2092,18,-0.6354510326576387,1.0761312678154331
35,1556928000,229,329,100,558,18,-0.2668500019780425,-0.7117829603756304
35,1556942400,31,73,42,104,18,-0.48063859977220824,-1.2409309783669882
35,1556956800,194,193,0,387,18,-0.6354510326576387,-0.9110876103239172
35,1556971200,573,305,0,878,18,-0.6354510326576387,-0.3388151943905324
35,1556985600,608,351,0,959,18,-0.6354510326576387,-0.2444077286255545
35,1557000000,536,428,0,964,18,-0.6354510326576387,-0.23858010728203732
35,1557014400,186,309,123,495,18,-0.18207176492173538,-0.7852109893039466
35,1557028800,29,83,54,112,18,-0.43640647609065675,-1.2316067842173608
35,1557043200,115,140,25,255,18,-0.5433007749877397,-1.0649368137927702
35,1557057600,509,229,0,738,18,-0.6354510326576387,-0.5019885920090128
35,1557072000,495,520,25,1015,18,-0.5433007749877397,-0.17913836957816234
35,1557086400,372,426,54,798,18,-0.43640647609065675,-0.43205713588680694
35,1557100800,120,202,82,322,18,-0.3331981875003698,-0.9868466877896402
35,1557115200,26,29,3,55,18,-0.6243930017372508,-1.2980416675334563
35,1557129600,547,744,197,1291,18,0.09069299778116577,0.1425463285839847
35,1557144000,961,1770,809,2731,18,2.346531305540294,1.8209012755169256
35,1557158400,701,943,242,1644,18,0.256563461586984,0.553976395436296
35,1557172800,1424,782,0,2206,18,-0.6354510326576387,1.2090010344476243
35,1557187200,222,317,95,539,19,-0.28366466509790883,-0.6826399140139446
35,1557201600,27,85,58,112,19,-0.34956840229582903,-0.990665776694111
35,1557216000,559,809,250,1368,19,-0.007581441701216032,-0.0846224897472985
35,1557230400,937,1872,935,2809,19,1.212528287503523,0.9548746252927945
35,1557244800,700,831,131,1531,19,-0.21954210998641888,0.03296115338353784
35,1557259200,1449,805,0,2254,19,-0.452876963308785,0.554513141012953
35,1557273600,247,344,97,591,19,-0.28010230092504823,-0.6451285677390767
35,1557288000,30,108,78,138,19,-0.3139447605672235,-0.971910103556677
35,1557302400,534,771,237,1305,19,-0.03073680882480962,-0.1300689285033886
35,1557316800,931,1725,794,2656,19,0.961381613316854,0.8445047025994328
35,1557331200,679,735,56,1414,19,-0.35313076646868957,-0.05143937573491524
35,1557345600,1401,822,0,2223,19,-0.452876963308785,0.5321506076567817
35,1557360000,264,338,74,602,19,-0.3210694889129446,-0.6371934752578545
35,1557374400,36,111,75,147,19,-0.3192883068265143,-0.9654177551629498
35,1557388800,532,688,156,1220,19,-0.17501255782566197,-0.1913855522219229
35,1557403200,898,1814,916,2712,19,1.1786858278613477,0.8849015370492906
35,1557417600,703,930,227,1633,19,-0.04854862968911238,0.10654110184577899
35,1557432000,1414,837,0,2251,19,-0.452876963308785,0.5523490248817107
35,1557446400,235,362,127,597,19,-0.22666683833213996,-0.6408003354765919
35,1557460800,42,107,65,149,19,-0.3371001276908171,-0.9639750110754549
35,1557475200,610,711,101,1321,19,-0.27297757257932714,-0.11852697580342922
35,1557489600,891,1632,741,2523,19,0.8669789627360495,0.7485622207810203
35,1557504000,689,878,189,1567,19,-0.11623354897346287,0.058930546958446475
35,1557561600,718,155,0,873,19,-0.452876963308785,-0.4417016514022923
35,1557576000,1009,979,0,1988,19,-0.452876963308785,0.36262817737612807
35,1557590400,523,243,0,766,19,-0.452876963308785,-0.5188884600832707
35,1557604800,2536,251,0,2787,19,-0.452876963308785,0.9390044403303504
35,1557619200,185,208,23,393,19,-0.4119097753208887,-0.7879602324010742
35,1557633600,43,77,34,120,19,-0.39231677237015566,-0.9848948003441313
35,1557648000,168,40,0,208,19,-0.452876963308785,-0.9214140604943547
35,1557662400,323,96,0,419,19,-0.452876963308785,-0.7692045592636402
35,1557676800,383,153,0,536,19,-0.452876963308785,-0.6848040301451871
35,1557691200,246,196,0,442,19,-0.452876963308785,-0.7526130022574485
35,1557705600,777,3990,3213,4767,19,5.270061080391692,2.3673210869503256
35,1557720000,27,35,8,62,19,-0.4386275066173428,-1.0267343788814842
35,1557734400,529,641,112,1170,19,-0.2533845696285941,-0.227454154409296
35,1557748800,677,1801,1124,2478,19,1.5491717018388451,0.7161004788123846
35,1557763200,6275,854,0,7129,19,-0.452876963308785,4.071201854281831
35,1557777600,1366,761,0,2127,19,-0.452876963308785,0.4628988914570253
35,1557792000,216,305,89,521,20,-0.20597819235946602,-0.3684566478979457
35,1557806400,26,88,62,114,20,-0.3194371344163918,-0.616001538669961
35,1557820800,529,752,223,1281,20,0.35711433488601757,0.09378933978444158
35,1557820809,6343,4924,0,11267,20,-0.5799724828434066,6.1674583305690724
35,1557820885,2,2,0,4,20,-0.5799724828434066,-0.682905563202938
35,1557821776,66,189,123,255,20,-0.06310396902852242,-0.5302427435867813
35,1557821977,80,34,0,114,20,-0.5799724828434066,-0.616001538669961
35,1557822047,140,14,0,154,20,-0.5799724828434066,-0.5916728024761511
35,1557822450,50,7,0,57,20,-0.5799724828434066,-0.6506699877461399
35,1557835200,691,1641,950,2332,20,3.4121014043447233,0.7330268832767955
35,1557849600,721,933,212,1654,20,0.3108903214554182,0.3206548047917185
35,1557864000,1432,816,0,2248,20,-0.5799724828434066,0.6819365372697949
35,1557878400,204,370,166,574,20,0.11758990165472978,-0.33622107244114763
35,1557892800,25,104,79,129,20,-0.24800002275092,-0.6068782625972823
35,1557906837,260,139,0,399,20,-0.5799724828434066,-0.4426592932890657
35,1557906920,3013,2312,0,5325,20,-0.5799724828434066,2.553424568978618
35,1557907003,497,25,0,522,20,-0.5799724828434066,-0.3678484294931004
35,1557907200,27,79,52,106,20,-0.36145896480784584,-0.6208672859087229
35,1557908718,107,245,138,352,20,-7.122344134142114e-05,-0.4712455583167923
35,1557908877,99,29,0,128,20,-0.5799724828434066,-0.6074864810021275
35,1557908964,210,9,0,219,20,-0.5799724828434066,-0.55213860616121
35,1557921600,660,1337,677,1997,20,2.2649054346580293,0.529273717653638
35,1557922086,14,1,0,15,20,-0.5799724828434066,-0.6762151607496404
35,1557922153,34,21,0,55,20,-0.5799724828434066,-0.6518864245558305
35,1557922217,13,7,0,20,20,-0.5799724828434066,-0.6731740687254141
35,1557936000,670,840,170,1510,20,0.13439863381131137,0.23307135449400299
35,1557950400,1428,846,0,2274,20,-0.5799724828434066,0.6977502157957712
35,1557964800,251,417,166,668,20,0.11758990165472978,-0.27904854238569443
35,1557979200,27,87,60,114,20,-0.32784150049468264,-0.616001538669961
35,1557993600,503,710,207,1213,20,0.28987940625969116,0.052430488254964824
35,1558008000,887,1739,852,2626,20,3.000287466508474,0.911843094301298
35,1558022400,723,867,144,1590,20,0.02514187479353098,0.2817288268816227
35,1558036800,1389,913,0,2302,20,-0.5799724828434066,0.7147803311314381
35,1558051200,263,431,168,694,20,0.12599426773302058,-0.26323486385971806
35,1558065600,32,134,102,166,20,-0.15134981285057583,-0.5843741816180081
35,1558078561,358,23,0,381,20,-0.5799724828434066,-0.45360722457628017
35,1558080000,271,697,426,968,20,1.210157491832534,-0.09658302093212054
35,1558082640,279,15,0,294,20,-0.5799724828434066,-0.5065222257978166
35,1558094400,588,1596,1008,2184,20,3.6558280206151568,0.6430105593596991
35,1558108800,690,798,108,1488,20,-0.12613671461570342,0.21969054958740758
35,1558123200,1140,706,0,1846,20,-0.5799724828434066,0.43743273852200576
35,1558137600,227,351,124,578,20,-0.05890178598937702,-0.33378819882176664
35,1558152000,90,82,0,172,20,-0.5799724828434066,-0.5807248711889367
35,1558166400,213,264,51,477,20,-0.3656611478469912,-0.3952182577111365
35,1558180800,612,364,0,976,20,-0.5799724828434066,-0.09171727369335857
35,1558195200,649,508,0,1157,20,-0.5799724828434066,0.018370257583631023
35,1558209600,478,599,121,1077,20,-0.07150833510681322,-0.030287214803988684
35,1558224000,214,381,167,595,20,0.12179208469387517,-0.32344848593939746
35,1558238400,58,103,45,161,20,-0.3908742460818636,-0.5874152736422343
35,1558252800,143,155,12,298,20,-0.5295462863736619,-0.5040893521784356
35,1558267200,525,245,0,770,20,-0.5799724828434066,-0.21701026509147933
35,1558281600,560,428,0,988,20,-0.5799724828434066,-0.08441865283521562
35,1558296000,367,525,158,892,20,0.08397243734156658,-0.14280761970035927
35,1558310400,191,339,148,530,20,0.04195060695011258,-0.36298268225433844
35,1558324800,58,59,1,117,20,-0.5757702998042612,-0.6141768834554252
35,1558339200,504,613,109,1117,20,-0.12193453157655802,-0.005958478610178831
35,1558353600,938,1753,815,2691,20,2.8448066940600945,0.951377290616239
35,1558368000,714,924,210,1638,20,0.30248595537712736,0.3109233103141945
35,1558382400,1326,761,0,2087,20,-0.5799724828434066,0.5840133740897101
35,1558396800,241,323,82,564,21,-0.2027582504927292,-0.5423325921029556
35,1558411200,27,46,19,73,21,-0.4716139042297842,-1.1456450962954683
35,1558425600,527,724,197,1251,21,0.2880100063288792,0.30181341681813667
35,1558440000,902,1723,821,2625,21,2.9509612433435195,1.9901054346603213
35,1558454400,815,1170,355,1985,21,0.962282915701176,1.2037103171792454
35,1558468800,1608,798,0,2406,21,-0.5526973553568326,1.7210108553972656
35,1558483200,351,348,0,699,21,-0.5526973553568326,-0.37645237200929116
35,1558497600,28,64,36,92,21,-0.39906555322137255,-1.122298991245249
35,1558512000,515,720,205,1235,21,0.3221504068034259,0.2821535388811098
35,1558526400,927,1743,816,2670,21,2.929623493046928,2.0453988413582094
35,1558540800,688,935,247,1623,21,0.5013875092947959,0.7589055788540119
35,1558555200,1486,822,0,2308,21,-0.5526973553568326,1.600594103032976
35,1558569600,240,369,129,609,21,-0.0021833977047675084,-0.4870391854050674
35,1558584000,31,60,29,91,21,-0.4289384036366009,-1.1235277336163132
35,1558598400,534,709,175,1243,21,0.19412390502387586,0.2919834778496232
35,1558598882,51,2,0,53,21,-0.5526973553568326,-1.170219943716752
35,1558612800,915,1920,1005,2835,21,3.736190454258093,2.248141332583799
35,1558627200,789,832,43,1621,21,-0.36919270280614425,0.7564480941118835
35,1558641600,1470,754,0,2224,21,-0.5526973553568326,1.4973797438635847
35,1558656000,239,346,107,585,21,-0.09606949900977085,-0.5165290023106077
35,1558670400,27,63,36,90,21,-0.39906555322137255,-1.1247564759873772
35,1558684800,465,666,201,1131,21,0.30508020656615253,0.15436433229043495
35,1558699200,848,1412,564,2260,21,1.8542008780987078,1.5416144692218952
35,1558713600,815,815,0,1630,21,-0.5526973553568326,0.7675067754514612
35,1558728000,968,675,0,1643,21,-0.5526973553568326,0.7834804262752956
35,1558742400,232,355,123,587,21,-0.027788698060677512,-0.5140715175684794
35,1558756800,32,102,70,134,21,-0.2539688512045492,-1.0706918116605533
35,1558771200,149,197,48,346,21,-0.34785495250955256,-0.810198428994947
35,1558785600,573,236,0,809,21,-0.5526973553568326,-0.24129071119223125
35,1558800000,667,323,0,990,21,-0.5526973553568326,-0.018888342029614535
35,1558814400,475,399,0,874,21,-0.5526973553568326,-0.16142245707305952
35,1558828800,194,245,51,439,21,-0.33505230233159755,-0.6959253884859782
35,1558843200,26,70,44,96,21,-0.3649251527468259,-1.1173840217609923
35,1558857600,114,118,4,232,21,-0.5356271551195593,-0.9502750592962635
35,1558872000,513,138,0,651,21,-0.5526973553568326,-0.43543200582037184
35,1558886400,571,235,0,806,21,-0.5526973553568326,-0.2449769383054238
35,1558900800,356,323,0,679,21,-0.5526973553568326,-0.4010272194305748
35,1558915200,144,218,74,362,21,-0.2368986509672759,-0.79053855105792
35,1558929600,24,57,33,81,21,-0.41186820339932756,-1.1358151573269548
35,1558944000,130,157,27,287,21,-0.4374735037552376,-0.8826942288877336
35,1558958400,431,255,0,686,21,-0.5526973553568326,-0.3924260228331255
35,1558972800,578,300,0,878,21,-0.5526973553568326,-0.15650748758880278
35,1558987200,360,388,28,748,21,-0.43320595369591924,-0.3162439958271463
35,1559001600,116,242,126,358,22,-0.13630361807570207,-0.9676237787682932
35,1559016000,24,37,13,61,22,-0.5733961663103521,-1.3315000265858354
35,1559030400,547,701,154,1248,22,-0.027997499929063134,0.12277979213275901
35,1559044800,910,1720,810,2630,22,2.5094601252207633,1.8159682584083254
35,1559059200,641,733,92,1374,22,-0.26781819011090646,0.2771515336311102
35,1559073600,1369,803,0,2172,22,-0.6236811497355772,1.2548392297873345
35,1559088000,243,305,62,548,22,-0.3838604595537339,-0.7348409939691922
35,1559102400,25,44,19,69,22,-0.5501877124217865,-1.3216986461732416
35,1559116800,508,610,102,1118,22,-0.229137433629964,-0.03649263957188907
35,1559131200,884,1744,860,2628,22,2.702863907625476,1.813517913305177
35,1559145600,741,865,124,1606,22,-0.14403976937189056,0.5613915655963283
35,1559160000,1514,771,0,2285,22,-0.6236811497355772,1.393283728115221
35,1559174400,294,331,37,625,22,-0.4805623507560901,-0.6405027074979776
35,1559188800,30,46,16,76,22,-0.5617919393660693,-1.3131224383122222
35,1559203200,505,662,157,1167,22,-0.016393272984780393,0.023540815455247516
35,1559217600,849,1742,893,2591,22,2.830510404012586,1.7681865288969312
35,1559232000,692,905,213,1597,22,0.20021896330849745,0.5503650126321604
35,1559246400,1398,876,0,2274,22,-0.6236811497355772,1.3798068300479047
35,1559260800,260,309,49,569,22,-0.43414544297895913,-0.7091123703861336
35,1559275200,33,60,27,93,22,-0.5192431072370326,-1.2922945049354604
35,1559289600,502,690,188,1192,22,0.10351707210614128,0.05417012924460292
35,1559304000,824,1570,746,2394,22,2.2619032837427318,1.5268275362368104
35,1559318400,751,787,36,1538,22,-0.4844304264041843,0.4780798320892817
35,1559332800,1164,750,0,1914,22,-0.6236811497355772,0.9387447114811869
35,1559347200,271,360,89,631,22,-0.2794224170551892,-0.6331516721885323
35,1559361600,75,101,26,176,22,-0.5231111828851268,-1.1906051831548006
35,1559376000,190,264,74,454,22,-0.3374435517766029,-0.8500072138171685
35,1559390400,580,334,0,914,22,-0.6236811497355772,-0.28642784009302913
35,1559404800,623,476,0,1099,22,-0.6236811497355772,-0.059770918051799175
35,1559419200,470,534,64,1004,22,-0.3761243082575454,-0.1761623104513497
35,1559433600,213,382,169,595,22,0.030023634792350578,-0.677257884045204
35,1559448000,47,103,56,150,22,-0.4070689134422994,-1.2224596694957302
35,1559462400,139,184,45,323,22,-0.4496177455713361,-1.0105048180733909
35,1559476800,489,249,0,738,22,-0.6236811497355772,-0.5020582091700911
35,1559491200,551,485,0,1036,22,-0.6236811497355772,-0.13695678880097478
35,1559505600,361,431,70,792,22,-0.35291585436897993,-0.4358988913850835
35,1559520000,163,287,124,450,22,-0.14403976937189056,-0.8549079040234654
35,1559534400,51,64,13,115,22,-0.5733961663103521,-1.2653407088008277
35,1559548800,498,755,257,1253,22,0.37041429182464436,0.1289056548906301
35,1559563200,821,1711,890,2532,22,2.8189061770683033,1.6959013483540524
35,1559577600,698,869,171,1567,22,0.03775978608853907,0.5136098360849339
35,1559592000,1483,768,0,2251,22,-0.6236811497355772,1.3516278613616977
35,1559606400,254,298,44,552,23,-0.4935628565003836,-0.7198951471626932
35,1559620800,33,125,92,158,23,-0.31807384085580276,-1.1978419834815797
35,1559635200,462,748,286,1210,23,0.3911942640410448,0.07830033075057416
35,1559649600,874,1813,939,2687,23,2.7785760810391964,1.8699944354282274
35,1559664000,719,873,154,1592,23,-0.09140052898155251,0.5416904106333524
35,1559678400,1485,713,0,2198,23,-0.6544277875079161,1.2768066106568174
35,1559692800,245,344,99,589,23,-0.2924816927409681,-0.6750118148180262
35,1559707200,42,128,86,170,23,-0.3400099678113754,-1.1832852270454715
35,1559721600,601,749,148,1350,23,-0.11333665593712512,0.24812915583850337
35,1559736000,871,1695,824,2566,23,2.358133647724055,1.7232138080308028
35,1559750400,724,870,146,1594,23,-0.12064869825564932,0.5441165367060372
35,1559764800,1403,746,0,2149,23,-0.6544277875079161,1.2173665218760423
35,1559779200,247,334,87,581,23,-0.33635394665211327,-0.684716319108765
35,1559793600,29,63,34,92,23,-0.5301230680930046,-1.2779041438801748
35,1559808000,463,716,253,1179,23,0.27054556578539546,0.040695376623961256
35,1559822400,861,1786,925,2647,23,2.727391784809527,1.8214719139745335
35,1559836800,733,898,165,1631,23,-0.05118429622966941,0.5889998690507041
35,1559851200,1463,895,0,2358,23,-0.6544277875079161,1.4708966964715937
35,1559865600,271,350,79,621,23,-0.36560211592621006,-0.6361937976550709
35,1559880000,31,147,116,178,23,-0.23032933303351236,-1.1735807227547326
35,1559894400,471,697,226,1168,23,0.17183299448531875,0.02735168322419539
35,1559908800,835,1626,791,2461,23,2.2374849494684055,1.595842189214856
35,1559923200,805,878,73,1683,23,-0.3875382428817827,0.6520791469405065
35,1559937600,1224,684,0,1908,23,-0.6544277875079161,0.9250183301175355
35,1559952000,266,387,121,653,23,-0.21204922723720185,-0.5973757804921157
35,1559966400,30,78,48,108,23,-0.4789387718633352,-1.2584951352986973
35,1559980800,190,192,2,382,23,-0.6471157451893919,-0.9261158633408929
35,1559995200,559,261,0,820,23,-0.6544277875079161,-0.39479425342294294
35,1560009600,587,327,0,914,23,-0.6544277875079161,-0.28076632800676193
35,1560024000,447,348,0,795,23,-0.6544277875079161,-0.42512082933150175
35,1560038400,174,287,113,461,23,-0.24129739651129864,-0.8302838834698472
35,1560052800,28,113,85,141,23,-0.3436659889706375,-1.2184640550993997
35,1560067200,127,152,25,279,23,-0.5630272585263635,-1.051061356084155
35,1560081600,477,211,0,688,23,-0.6544277875079161,-0.5549185742201334
35,1560096000,560,328,0,888,23,-0.6544277875079161,-0.31230596695166307
35,1560110400,351,383,32,734,23,-0.5374351104115288,-0.4991176745483852
35,1560124800,123,231,108,354,23,-0.2595775023076092,-0.9600816283584788
35,1560139200,27,50,23,77,23,-0.5703393008448877,-1.29610008942531
35,1560153600,484,740,256,1224,23,0.28151362926318174,0.09528321325936707
35,1560168000,789,1764,975,2553,23,2.910192842772632,1.7074439885583523
35,1560182400,703,866,163,1569,23,-0.05849633854819361,0.5137899607974784
35,1560196800,1412,735,0,2147,23,-0.6544277875079161,1.2149403958033576
35,1560211200,243,290,47,533,24,-0.5369925261660025,-0.9876422718961468
35,1560225600,81,46,0,127,24,-0.6625079863301268,-1.4668052688726725
35,1560240000,509,755,246,1264,24,-0.005554726747688939,-0.1249128364531907
35,1560254400,871,1882,1011,2753,24,2.0374096780513553,1.6324115539360866
35,1560268800,737,918,181,1655,24,-0.17913993761296723,0.33654709413257655
35,1560283200,1485,889,0,2374,24,-0.6625079863301268,1.185114076462926
35,1560297600,289,359,70,648,24,-0.47557006693675014,-0.851918762900333
35,1560312000,54,90,36,144,24,-0.5663684849278188,-1.446741793629813
35,1560326400,536,734,198,1270,24,-0.1337407286174329,-0.11783160989688737
35,1560333041,577,53,0,630,24,-0.6625079863301268,-0.8731624425692429
35,1560340800,569,1841,1272,2410,24,2.7344210632180883,1.227601435800746
35,1560355200,721,877,156,1598,24,-0.24590348025345887,0.26927544184769486
35,1560369600,1481,733,0,2214,24,-0.6625079863301268,0.996281368294837
35,1560384000,272,427,155,699,24,-0.24857402195907854,-0.7917283371717546
35,1560398400,53,67,14,120,24,-0.6251204024514514,-1.4750666998550264
35,1560412800,522,741,219,1263,24,-0.07765935279941992,-0.12609304087924125
35,1560427200,762,1946,1184,2708,24,2.499413393123558,1.5793023547638116
35,1560441600,745,920,175,1665,24,-0.19516318784668524,0.34834913839308207
35,1560456000,1410,804,0,2214,24,-0.6625079863301268,0.996281368294837
35,1560470400,279,384,105,663,24,-0.38210110724006185,-0.8342156965095746
35,1560484800,43,74,31,117,24,-0.5797211934559171,-1.478607313133178
35,1560499200,486,712,226,1198,24,-0.058965560860082256,-0.20280632857252737
35,1560513600,816,1633,817,2449,24,1.5193245871611403,1.2736294084167177
35,1560528000,758,817,59,1575,24,-0.5049460256985665,0.24213074004853208
35,1560542400,1231,724,0,1955,24,-0.6625079863301268,0.6906084219477432
35,1561161600,8103,3394,0,11497,25,-0.5623027577447349,3.992314245678336
35,1561176000,57,132,75,189,25,-0.20557873379953187,-0.5190117122421934
35,1561190400,190,251,61,441,25,-0.2721672182693031,-0.41847632655100375
35,1561204800,563,357,0,920,25,-0.5623027577447349,-0.22737930374909948
35,1561219200,651,434,0,1085,25,-0.5623027577447349,-0.16155256311796334
35,1561233600,480,563,83,1043,25,-0.16752817124537686,-0.17830846073316164
35,1561248000,203,425,222,628,25,0.4936003531330661,-0.3438726871690495
35,1561262400,50,118,68,168,25,-0.23887297603441748,-0.5273896610497927
35,1561276800,155,162,7,317,25,-0.5290085155098493,-0.46794611951016063
35,1561291200,498,257,0,755,25,-0.5623027577447349,-0.2932060443802356
35,1561305600,531,402,0,933,25,-0.5623027577447349,-0.2221929544872524
35,1561320000,368,478,110,846,25,-0.03910752262510377,-0.256901599547306
35,1561334400,175,361,186,536,25,0.32237282163936865,-0.3805760819451981
35,1561348800,66,78,12,144,25,-0.5052269139135024,-0.5369644596870488
35,1561363200,450,713,263,1163,25,0.6886094862231105,-0.13043446754688082
35,1561377600,791,1711,920,2502,25,3.8135119359830894,0.4037595064233694
35,1561392000,672,793,121,1465,25,0.013212000886859343,-0.009951584694740742
35,1561406400,1429,758,0,2187,25,-0.5623027577447349,0.2780902743093822
35,1561420800,263,425,162,688,26,-0.12609157656034153,-0.5221458234863193
35,1561435200,41,95,54,136,26,-0.4871083962559186,-1.2031157831715544
35,1561449600,446,772,326,1218,26,0.4221191496440533,0.1316840291100114
35,1561464000,836,1801,965,2637,26,2.558135332842884,1.8822209363443385
35,1561478400,666,870,204,1536,26,0.014303853321271766,0.5239819406678099
35,1561492800,1511,729,0,2240,26,-0.6676168061037071,1.3924653675127474
35,1561507200,261,415,154,676,26,-0.15283356320445837,-0.5369495182620854
35,1561521600,43,82,39,125,26,-0.5372496212136376,-1.2166858367160065
35,1561536000,473,729,256,1202,26,0.1881267665080311,0.11194576940899009
35,1561550400,834,1895,1061,2729,26,2.879039172572286,1.995715929625211
35,1561564800,761,868,107,1629,26,-0.3099427347386447,0.6387105751799962
35,1561579200,1462,768,0,2230,26,-0.6676168061037071,1.380128955199609
35,1561593600,309,390,81,699,26,-0.3968541913320243,-0.5085757699418673
35,1561608000,48,95,47,143,26,-0.5105076345695209,-1.1944802945523576
35,1561622400,385,679,294,1064,26,0.315151203067586,-0.05829672051231867
35,1561636800,837,1731,894,2568,26,2.3208002013763473,1.797099691383684
35,1561651200,700,946,246,1646,26,0.15469928320288506,0.6596824761123313
35,1561665600,1420,825,0,2245,26,-0.6676168061037071,1.3986335736693165
35,1561680000,316,408,92,724,26,-0.3600839596963637,-0.4777347391590214
35,1561694400,46,102,56,148,26,-0.48042289959488943,-1.1883120883957885
35,1561708800,406,611,205,1017,26,0.01764660165178637,-0.11627785838406876
35,1561723200,831,1683,852,2514,26,2.180404771494734,1.7304830648927372
35,1561737600,797,864,67,1661,26,-0.44365266795922875,0.6781870945820389
35,1561752000,1181,702,0,1883,26,-0.6676168061037071,0.9520554479337094
35,1561766400,253,374,121,627,26,-0.26314425811144027,-0.5973979385964631
35,1561780800,39,124,85,163,26,-0.38348319800996594,-1.169807469926081
35,1561795200,170,182,12,352,26,-0.6275038261375319,-0.9366492772077668
35,1561807493,239,224,0,463,26,-0.6676168061037071,-0.7997151005319315
35,1561809600,515,210,0,725,26,-0.6676168061037071,-0.4765010979277076
35,1561824000,529,337,0,866,26,-0.6676168061037071,-0.30255768431245733
35,1561838400,359,413,54,772,26,-0.4871083962559186,-0.4185199600559575
35,1561852800,166,282,116,448,26,-0.27985799976401327,-0.8182197190016389
35,1561867200,32,99,67,131,26,-0.44365266795922875,-1.2092839893281235
35,1561881600,124,149,25,273,26,-0.5840480978408421,-1.0341069344815594
35,1561896000,419,212,0,631,26,-0.6676168061037071,-0.5924633736712077
35,1561910400,455,333,0,788,26,-0.6676168061037071,-0.3987817003549362
35,1561924800,257,379,122,636,26,-0.25980150978092564,-0.5862951675146386
35,1561939200,138,309,171,447,26,-0.09600684158571011,-0.8194533602329528
35,1561953600,33,79,46,112,26,-0.5138503829000354,-1.2327231727230863
35,1561968000,347,699,352,1046,26,0.5090306062374329,-0.08050226267596763
35,1561982400,642,1763,1121,2405,26,3.079604072403162,1.5960161706795295
35,1561996800,676,810,134,1486,26,-0.2196885298147504,0.4622998791021183
35,1562011200,1348,707,0,2055,26,-0.6676168061037071,1.1642417397196885
35,1562025600,226,306,80,532,27,-0.24611168575012726,-0.4235132224959468
35,1562040000,33,148,115,181,27,-0.1253912092361962,-0.9209235238282377
35,1562054400,399,739,340,1138,27,0.6506689969247892,0.43526353706920495
35,1562068800,838,1968,1130,2806,27,3.3755026096678047,2.799025310921801
35,1562083200,728,868,140,1596,27,-0.03916229744053117,1.0843060385227354
35,1562097600,1647,700,0,2347,27,-0.5220442034962554,2.1485656861026516
35,1562112000,272,333,61,605,27,-0.3116456587148327,-0.3200632168057553
35,1562126400,32,186,154,218,27,0.00912589316504125,-0.8684899593003323
35,1562140800,424,682,258,1106,27,0.3678381662350078,0.38991558936939497
35,1562155200,704,1716,1012,2420,27,2.9685021459922654,2.252015691792843
35,1562169600,841,829,0,1670,27,-0.5220442034962554,1.1891731675785462
35,1562184000,1226,685,0,1911,27,-0.5220442034962554,1.5306998986927403
35,1562198400,255,347,92,602,27,-0.20472180808820806,-0.32431458690261245
35,1562212800,28,71,43,99,27,-0.3737304752077115,-1.0371276398090008
35,1562227200,141,199,58,340,27,-0.3219931281303125,-0.6956009086948067
35,1562241600,409,209,0,618,27,-0.5220442034962554,-0.30164061305270745
35,1562256000,482,312,0,794,27,-0.5220442034962554,-0.05222690070375247
35,1562270400,385,323,0,708,27,-0.5220442034962554,-0.17409951014699182
35,1562284800,137,294,157,431,27,0.019473362580521056,-0.5666426824234722
35,1562299200,34,96,62,130,27,-0.3081965022430061,-0.9931968154748099
35,1562313600,278,532,254,810,27,0.3540415403477014,-0.029552926853847476
35,1562328000,530,1158,628,1688,27,1.6440260608108506,1.2146813881596892
35,1562342400,569,573,4,1142,27,-0.508247577608949,0.44093203053168123
35,1562356800,789,537,0,1326,27,-0.5220442034962554,0.7016827298055887
35,1562371200,194,262,68,456,27,-0.28750156341204647,-0.5312145982829956
35,1562385600,66,102,36,168,27,-0.39787457051049774,-0.9393461275812854
35,1562400000,213,246,33,459,27,-0.40822203992597755,-0.5269632281861384
35,1562414400,450,327,0,777,27,-0.5220442034962554,-0.07631799791927653
35,1562428800,503,429,0,932,27,-0.5220442034962554,0.14333612375167812
35,1562443200,401,442,41,843,27,-0.38062878815136475,0.01721214421158158
35,1562457600,194,319,125,513,27,-0.0908996445179302,-0.45043856644270897
35,1562472000,39,94,55,133,27,-0.3323405975457923,-0.9889454453779527
35,1562486400,164,170,6,334,27,-0.5013492646652958,-0.7041036488885212
35,1562500800,427,247,0,674,27,-0.5220442034962554,-0.22228170457803995
35,1562515200,390,394,4,784,27,-0.508247577608949,-0.0663981343599431
35,1562529600,270,438,168,708,27,0.057414083770613675,-0.17409951014699182
35,1562544000,158,364,206,522,27,0.18848202970002453,-0.4376844561521374
35,1562558400,53,78,25,131,27,-0.43581529170059036,-0.9917796921091908
35,1562572800,308,674,366,982,27,0.7403470651922808,0.21419229203263124
35,1562574362,93,65,0,158,27,-0.5220442034962554,-0.9535173612374761
35,1562574443,3,0,0,3,27,-0.5220442034962554,-1.1731714829084308
35,1562574522,4,5,1,9,27,-0.5185950470244288,-1.1646687427147164
35,1562587200,571,1919,1348,2490,27,4.127418720526004,2.3512143273861774
35,1562601600,626,809,183,1435,27,0.1091514308480127,0.8561491766580664
35,1562604640,414,163,0,577,27,-0.5220442034962554,-0.359742671043089
35,1562604702,13,3,0,16,27,-0.5220442034962554,-1.154748879155383
35,1562604778,11,23,12,34,27,-0.4806543258343362,-1.1292406585742398
35,1562616000,944,581,0,1525,27,-0.5220442034962554,0.9836902795637821
35,1562630400,173,244,71,417,28,-0.40446887554758093,-0.7897372095523358
35,1562644800,42,145,103,187,28,-0.3142387933185311,-1.0691158238623018
35,1562659200,381,748,367,1129,28,0.4301593850711298,0.07512180518112418
35,1562673600,690,2073,1383,2763,28,3.294964495843461,2.0599246564093177
35,1562685800,398,63,0,461,28,-0.6046668704932852,-0.7362908659452119
35,1562688000,697,831,134,1528,28,-0.22682840115913913,0.5597829665275434
35,1562702400,1652,810,0,2462,28,-0.6046668704932852,1.6943030785514925
35,1562716800,240,323,83,563,28,-0.37063259471168725,-0.6123925239468792
35,1562731200,34,220,186,254,28,-0.0802045175369332,-0.9877316188241814
35,1562745600,436,764,328,1200,28,0.3201914723544753,0.16136476872898325
35,1562748894,339,33,0,372,28,-0.6046668704932852,-0.8443982427868945
35,1562760000,571,1892,1321,2463,28,3.1201437115246775,1.695517768178927
35,1562774400,678,869,191,1547,28,-0.06610606718864416,0.5828620694488016
35,1562788800,1499,818,0,2317,28,-0.6046668704932852,1.5181730825734705
35,1562803200,263,345,82,608,28,-0.37345228478134507,-0.5577314907123205
35,1562817600,37,209,172,246,28,-0.11968017851214248,-0.9974491358436584
35,1562832000,430,750,320,1180,28,0.29763395179721286,0.13707097618029057
35,1562846400,767,1772,1005,2539,28,2.2291216495128103,1.7878341798639594
35,1562859838,414,105,0,519,28,-0.6046668704932852,-0.6658388675540031
35,1562860800,695,847,152,1542,28,-0.1760739799052986,0.5767886213116283
35,1562875200,1540,815,0,2355,28,-0.6046668704932852,1.5643312884159866
35,1562889600,241,315,74,556,28,-0.3960098053386075,-0.6208953513389216
35,1562904000,31,191,160,222,28,-0.15351645934803615,-1.0266016869020897
35,1562918400,396,637,241,1033,28,0.07487843629424616,-0.041488399052600766
35,1562932800,771,1687,916,2458,28,1.9781692333132654,1.689444320041754
35,1562947200,788,807,19,1595,28,-0.5510927591697868,0.641167171565664
35,1562961600,1267,732,0,1999,28,-0.6046668704932852,1.1319017810492564
35,1562976000,252,328,76,580,28,-0.3903704251992919,-0.5917428002804903
35,1562990400,33,86,53,119,28,-0.45522329680142143,-1.1517147185278571
35,1563004800,171,215,44,386,28,-0.4806005074283417,-0.8273925880028096
35,1563019200,518,281,0,799,28,-0.6046668704932852,-0.32572577187230534
35,1563033600,506,389,0,895,28,-0.6046668704932852,-0.20911556763858039
35,1563048000,381,377,0,758,28,-0.6046668704932852,-0.37552804659712535
35,1563062400,11,9,0,20,28,-0.6046668704932852,-1.2719689916438859
35,1563076800,31,68,37,99,28,-0.5003383379159464,-1.1760085110765497
35,1563091200,106,153,47,259,28,-0.4721414372193683,-0.9816581706870081
35,1563105600,361,213,0,574,28,-0.6046668704932852,-0.5990309380450982
35,1563120000,369,344,0,713,28,-0.6046668704932852,-0.4301890798316839
35,1563134400,273,419,146,692,28,-0.19299212032324545,-0.45569756200781125
35,1563148800,137,300,163,437,28,-0.14505738913906274,-0.7654434170036432
35,1563163200,26,67,41,93,28,-0.4890595776373151,-1.1832966488411576
35,1563177600,341,740,399,1081,28,0.5203894673001795,0.01681670306426171
35,1563192000,602,1771,1169,2373,28,2.6915508209366905,1.58619570170981
35,1563206400,640,807,167,1447,28,-0.13377862886043151,0.46139310670533806
35,1563220800,1443,739,0,2182,28,-0.6046668704932852,1.3541899828697948
35,1563235200,230,306,76,536,29,-0.3734836562532435,-0.6553952176874981
35,1563249600,29,66,37,95,29,-0.4941714110259428,-1.2105090928479079
35,1563264000,387,693,306,1080,29,0.33826464112421395,0.029371104505841687
35,1563278400,629,1812,1183,2441,29,3.052191844602606,1.7425456716108703
35,1563292800,681,836,155,1517,29,-0.12901358889316028,0.5794499331795356
35,1563307200,1427,762,0,2189,29,-0.6086700501692729,1.425337742947779
35,1563321600,258,366,108,624,29,-0.2744578061833364,-0.544624194979752
35,1563336000,27,76,49,103,29,-0.4570367172497276,-1.2004389998744764
35,1563350400,400,720,320,1120,29,0.3815884505297983,0.07972156937299903
35,1563364800,614,1849,1235,2463,29,3.213108850966205,1.7702384272878067
35,1563379200,768,854,86,1622,29,-0.3425380781063975,0.7116199034558236
35,1563393600,1516,765,0,2281,29,-0.6086700501692729,1.5411438121422407
35,1563408000,244,318,74,562,29,-0.37967277188261267,-0.6226674155238459
35,1563422400,20,55,35,75,29,-0.5003605266553119,-1.2356843252814864
35,1563436800,393,743,350,1136,29,0.4744251849703362,0.09986175531986197
35,1563451200,781,1896,1115,2677,29,2.8417619132040537,2.0396134143270985
35,1563465600,671,814,143,1485,29,-0.16614828266937545,0.5391695612858097
35,1563480000,1532,810,0,2342,29,-0.6086700501692729,1.6179282710646559
35,1563494400,237,339,102,576,29,-0.29302515307144394,-0.6050447528203408
35,1563508800,39,80,41,119,29,-0.48179317976720437,-1.1802988139276134
35,1563523200,380,643,263,1023,29,0.20519865509277624,-0.04237830792985752
35,1563537600,781,1719,938,2500,29,2.29402518000488,1.8168126072899273
35,1563552000,745,775,30,1520,29,-0.5158333157287349,0.5832262180445724
35,1563566400,1234,681,0,1915,29,-0.6086700501692729,1.0804370586077512
35,1563580800,261,405,144,666,29,-0.16305372485469086,-0.49175620686923677
35,1563595200,30,116,86,146,29,-0.3425380781063975,-1.1463122501422822
35,1563609600,154,223,69,377,29,-0.39514556095603565,-0.8555383155344486
35,1563624000,421,248,0,669,29,-0.6086700501692729,-0.4879799220042
35,1563638400,451,333,0,784,29,-0.6086700501692729,-0.34322233551112263
35,1563652800,358,343,0,701,29,-0.6086700501692729,-0.44769955011047413
35,1563667200,140,307,167,447,29,-0.09187889511694511,-0.7674250020169232
35,1563681600,27,74,47,101,29,-0.4632258328790968,-1.2029565231178343
35,1563696000,116,116,0,232,29,-0.6086700501692729,-1.038058750677894
35,1563710400,428,200,0,628,29,-0.6086700501692729,-0.5395891484930363
35,1563724800,386,295,0,681,29,-0.6086700501692729,-0.4728747825440528
35,1563739200,287,338,51,625,29,-0.4508476016203584,-0.5433654333580731
35,1563753600,113,300,187,413,29,-0.029987738823253163,-0.810222897154007
35,1563768000,24,46,22,70,29,-0.5405897782462118,-1.2419781333898812
35,1563782400,371,676,305,1047,29,0.33517008330952935,-0.01216802900956312
35,1563796800,755,1292,537,2047,29,1.053107496316356,1.2465935926693703
35,1563811200,656,303,0,959,29,-0.6086700501692729,-0.12293905171730926
35,1563825600,1324,462,0,1786,29,-0.6086700501692729,0.9180568094111687
35,1563840000,259,268,9,527,30,-0.22918354069025362,-0.351915765595617
35,1563854400,41,46,5,87,30,-0.35141476239172226,-1.1470014490979097
35,1563868800,408,156,0,564,30,-0.5042037895185579,-0.2850562876647424
35,1563875970,0,0,0,0,30,-0.5042037895185579,-1.3042115728813175
35,1563879194,0,0,0,0,30,-0.5042037895185579,-1.3042115728813175
35,1563883200,872,610,0,1482,30,-0.5042037895185579,1.373781570187768
35,1563888289,0,0,0,0,30,-0.5042037895185579,-1.3042115728813175
35,1563897600,721,311,0,1032,30,-0.5042037895185579,0.5606257575149688
35,1563912000,1335,457,0,1792,30,-0.5042037895185579,1.9339555744734742
35,1563926400,284,340,56,624,30,1.2070333143020024,-0.1766355126417025
35,1563940800,44,75,31,119,30,0.4430881786678237,-1.0891770357522883
35,1563955200,421,202,0,623,30,-0.5042037895185579,-0.17844252555875317
35,1563969600,873,572,0,1445,30,-0.5042037895185579,1.3069220922568934
35,1563984000,791,323,0,1114,30,-0.5042037895185579,0.7088008167131233
35,1563998400,1414,441,0,1855,30,-0.5042037895185579,2.047797388247666
35,1564012800,291,402,111,693,30,2.8877126126971957,-0.05195162136520662
35,1564027200,49,75,26,124,30,0.29029915154098795,-1.080141971167035
35,1564041600,415,230,0,645,30,-0.5042037895185579,-0.13868824138363853
35,1564046803,0,0,0,0,30,-0.5042037895185579,-1.3042115728813175
35,1564056000,878,593,0,1471,30,-0.5042037895185579,1.3539044281002108
35,1564070400,742,345,0,1087,30,-0.5042037895185579,0.6600114679527553
35,1564084800,1393,403,0,1796,30,-0.5042037895185579,1.9411836261416768
35,1564099200,284,407,123,691,30,3.2544062778016016,-0.05556564719930795
35,1564113600,49,97,48,146,30,0.9625708708990652,-1.0403876869919204
35,1564127756,0,0,0,0,30,-0.5042037895185579,-1.3042115728813175
35,1564128000,391,167,0,558,30,-0.5042037895185579,-0.2958983651670464
35,1564129067,0,0,0,0,30,-0.5042037895185579,-1.3042115728813175
35,1564142400,879,556,0,1435,30,-0.5042037895185579,1.2888519630863868
35,1564156800,785,311,0,1096,30,-0.5042037895185579,0.6762745842062113
35,1564171200,1121,393,0,1514,30,-0.5042037895185579,1.4316059835333894
35,1564185600,264,382,118,646,30,3.101617250674766,-0.13688122846658787
35,1564200000,64,122,58,186,30,1.2681489251527367,-0.9681071703098938
35,1564214400,209,96,0,305,30,-0.5042037895185579,-0.7530726331808646
35,1564228800,599,204,0,803,30,-0.5042037895185579,0.14681979951036653
35,1564243200,560,284,0,844,30,-0.5042037895185579,0.2209073291094438
35,1564257600,468,322,0,790,30,-0.5042037895185579,0.12332863158870788
35,1564272000,255,330,75,585,30,1.7876316173839784,-0.24710901640667843
35,1564286400,60,121,61,181,30,1.3598223414288382,-0.9771422348951471
35,1564300800,171,68,0,239,30,-0.5042037895185579,-0.8723354857062086
35,1564315200,499,202,0,701,30,-0.5042037895185579,-0.0374955180288013
35,1564329600,527,257,0,784,30,-0.5042037895185579,0.1124865540864039
35,1564344000,401,327,0,728,30,-0.5042037895185579,0.011293830731566656
35,1564358400,201,255,54,456,30,1.1459177034512682,-0.48021368270621423
35,1564372800,53,70,17,123,30,0.015278902712683576,-1.0819489840840857
35,1564387200,406,228,0,634,30,-0.5042037895185579,-0.15856538347119586
35,1564401600,859,582,0,1441,30,-0.5042037895185579,1.2996940405886908
35,1564416000,638,289,0,927,30,-0.5042037895185579,0.370889401224649
35,1564430400,1394,357,0,1751,30,-0.5042037895185579,1.859868044874397
35,1564444800,268,309,41,577,31,0.6869857161188764,-0.6610676477322034
35,1564459200,45,126,81,171,31,1.9626265042699815,-1.4378002124859222
35,1564473600,438,197,0,635,31,-0.6205460917360063,-0.5501058527673864
35,1564488000,895,666,0,1561,31,-0.6205460917360063,1.221456597877795
35,1564502400,711,304,0,1015,31,-0.6205460917360063,0.17688521769175933
35,1564516800,1431,325,0,1756,31,-0.6205460917360063,1.5945178050870934
35,1564531200,268,296,28,564,31,0.27240245996976725,-0.6859383948794899
35,1564545600,49,125,76,174,31,1.8031714057510935,-1.4320608092980869
35,1564560000,372,233,0,605,31,-0.6205460917360063,-0.60749988464574
35,1564574400,831,620,0,1451,31,-0.6205460917360063,1.0110118143238318
35,1564588800,738,295,0,1033,31,-0.6205460917360063,0.21132163681877147
35,1564603200,1354,361,0,1715,31,-0.6205460917360063,1.5160792948533435
35,1564617600,255,268,13,523,31,-0.20596283558689713,-0.7643769051132399
35,1564632000,46,129,83,175,31,2.0264085436775368,-1.4301476749021418
35,1564646400,439,241,0,680,31,-0.6205460917360063,-0.464014804949856
35,1564660800,853,647,0,1500,31,-0.6205460917360063,1.1047553997251427
35,1564675200,728,349,0,1077,31,-0.6205460917360063,0.2954995502403568
35,1564689600,1347,371,0,1718,31,-0.6205460917360063,1.521818698041179
35,1564704000,292,352,60,644,31,1.2929150904906515,-0.5328876432038803
35,1564718400,52,137,85,189,31,2.090190583085092,-1.40336379335891
35,1564732800,377,172,0,549,31,-0.6205460917360063,-0.7146354108186668
35,1564747200,729,565,0,1294,31,-0.6205460917360063,0.7106497141604479
35,1564761600,764,314,0,1078,31,-0.6205460917360063,0.2974126846363019
35,1564776000,1150,307,0,1457,31,-0.6205460917360063,1.0224906206995026
35,1565395200,9839,4156,0,13995,32,-0.5175359909638563,4.089442715033836
35,1565409600,46,108,62,154,32,1.7563623000426931,-0.3925410220133834
35,1565424000,211,88,0,299,32,-0.5175359909638563,-0.3455872150722775
35,1565438400,558,179,0,737,32,-0.5175359909638563,-0.20375433617431626
35,1565452800,580,266,0,846,32,-0.5175359909638563,-0.1684580261289332
35,1565467200,456,298,0,754,32,-0.5175359909638563,-0.19824940708466937
35,1565481600,181,280,99,461,32,3.113366118869182,-0.2931284790415247
35,1565496000,48,89,41,137,32,0.9861709434114426,-0.39804595110303037
35,1565510400,147,55,0,202,32,-0.5175359909638563,-0.37699769281908635
35,1565524800,456,157,0,613,32,-0.5175359909638563,-0.24390793659291718
35,1565539200,514,206,0,720,32,-0.5175359909638563,-0.20925926526396316
35,1565553600,344,327,0,671,32,-0.5175359909638563,-0.2251264138164748
35,1565568000,172,210,38,382,32,0.8761436067498354,-0.3187102083404721
35,1565582400,34,48,14,82,32,-0.004075086543022475,-0.4158560158048291
35,1565596800,402,204,0,606,32,-0.5175359909638563,-0.24617467210041882
35,1565611200,816,494,0,1310,32,-0.5175359909638563,-0.018205843917394302
35,1565625600,708,317,0,1025,32,-0.5175359909638563,-0.11049436100853349
35,1565640000,1274,324,0,1598,32,-0.5175359909638563,0.07505413124838846
35,1565654400,245,277,32,522,33,1.0998320374534256,-0.4414737833690807
35,1565668800,43,46,3,89,33,-0.32637292168333365,-1.2956383533647877
35,1565683200,433,204,0,637,33,-0.4739113657319639,-0.21461714237714927
35,1565697600,847,562,0,1409,33,-0.4739113657319639,1.3082813519339034
35,1565712000,636,327,0,963,33,-0.4739113657319639,0.42847211817389114
35,1565726400,1320,309,0,1629,33,-0.4739113657319639,1.7422679694836853
35,1565740800,270,225,0,495,33,-0.4739113657319639,-0.4947357773410994
35,1565755200,41,61,20,102,33,0.5096782612589046,-1.2699936896004824
35,1565769600,482,197,0,679,33,-0.4739113657319639,-0.1317651517540091
35,1565772543,0,0,0,0,33,-0.4739113657319639,-1.4712056668281086
35,1565784000,853,615,0,1468,33,-0.4739113657319639,1.4246686720949813
35,1565798400,707,249,0,956,33,-0.4739113657319639,0.41466345307003444
35,1565812800,1332,396,0,1728,33,-0.4739113657319639,1.9375619473810872
35,1565827200,265,212,0,477,33,-0.4739113657319639,-0.5302437733224452
35,1565841600,47,74,27,121,33,0.8539346307057085,-1.2325130271757285
35,1565856000,430,220,0,650,33,-0.4739113657319639,-0.188972478612844
35,1565870400,863,655,0,1518,33,-0.4739113657319639,1.5233019942653863
35,1565884800,668,276,0,944,33,-0.4739113657319639,0.39099145574913724
35,1565899200,1286,386,0,1672,33,-0.4739113657319639,1.8270926265502336
35,1565913600,281,235,0,516,33,-0.4739113657319639,-0.4533097820295293
35,1565928000,45,79,34,124,33,1.1981910001525125,-1.2265950278455042
35,1565942400,384,199,0,583,33,-0.4739113657319639,-0.32114113032118663
35,1565945941,0,0,0,0,33,-0.4739113657319639,-1.4712056668281086
35,1565956800,807,543,0,1350,33,-0.4739113657319639,1.1918940317728255
35,1565971200,756,319,0,1075,33,-0.4739113657319639,0.6494107598355983
35,1565985600,1084,348,0,1432,33,-0.4739113657319639,1.3536526801322897
35,1566000000,264,290,26,554,33,0.8047551493561651,-0.3783484571800215
35,1566014400,63,87,24,150,33,0.7063961866570783,-1.1753057003168936
35,1566028800,193,94,0,287,33,-0.4739113657319639,-0.9050503975699841
35,1566043200,591,237,0,828,33,-0.4739113657319639,0.16216214831379772
35,1566057600,613,304,0,917,33,-0.4739113657319639,0.33772946177711854
35,1566072000,477,385,0,862,33,-0.4739113657319639,0.22923280738967308
35,1566086400,232,303,71,535,33,3.0178318100856187,-0.4158291196047754
35,1566100800,46,103,57,149,33,2.329319071192011,-1.1772783667603017
35,1566115200,162,68,0,230,33,-0.4739113657319639,-1.0174923848442456
35,1566129600,517,175,0,692,33,-0.4739113657319639,-0.1061204879897038
35,1566144000,515,284,0,799,33,-0.4739113657319639,0.10495482145496282
35,1566158400,376,294,0,670,33,-0.4739113657319639,-0.149519149744682
35,1566172800,175,262,87,437,33,3.804703511678314,-0.6091504310587692
35,1566187200,24,67,43,91,33,1.640806332298403,-1.2916930204779715
35,1566201600,401,186,0,587,33,-0.4739113657319639,-0.31325046454755423
35,1566216000,781,586,0,1367,33,-0.4739113657319639,1.2254293613107632
35,1566230400,622,284,0,906,33,-0.4739113657319639,0.31603013089962945
35,1566244800,1210,405,0,1615,33,-0.4739113657319639,1.714650639275972
35,1566259200,285,271,0,556,34,-0.38441274635894485,-0.4695299635467115
35,1566273600,37,66,29,103,34,0.6378901467965024,-1.4317528293846837
35,1566288000,419,230,0,649,34,-0.38441274635894485,-0.2719875208912338
35,1566302400,855,551,0,1406,34,-0.38441274635894485,1.3359654800786227
35,1566316800,668,272,0,940,34,-0.38441274635894485,0.3461291545146159
35,1566331200,1305,385,0,1690,34,-0.38441274635894485,1.939213369478146
35,1566345600,279,288,9,567,34,-0.0671463312417371,-0.4461647283939131
35,1566360000,46,54,8,100,34,-0.10239815514364907,-1.4381251662445378
35,1566374400,405,213,0,618,34,-0.38441274635894485,-0.33783500177639303
35,1566388800,827,531,0,1358,34,-0.38441274635894485,1.2340080903209567
35,1566403200,652,297,0,949,34,-0.38441274635894485,0.36524616509417823
35,1566417600,1285,320,0,1605,34,-0.38441274635894485,1.7586638251156126
35,1566432000,263,235,0,498,34,-0.38441274635894485,-0.5927284761705578
35,1566446400,44,58,14,102,34,0.10911278826782275,-1.4338769416713018
35,1566460800,431,237,0,668,34,-0.38441274635894485,-0.23162938744549103
35,1566475200,836,591,0,1427,34,-0.38441274635894485,1.3805718380976015
35,1566489600,653,303,0,956,34,-0.38441274635894485,0.38011495110050453
35,1566504000,1270,328,0,1598,34,-0.38441274635894485,1.7437950391092862
35,1566518400,258,267,9,525,34,-0.0671463312417371,-0.5353774444318707
35,1566532800,49,46,0,95,34,-0.38441274635894485,-1.448745727677628
35,1566547200,391,210,0,601,34,-0.38441274635894485,-0.37394491064889973
35,1566561600,807,510,0,1317,34,-0.38441274635894485,1.146919486569617
35,1566576000,694,340,0,1034,34,-0.38441274635894485,0.5457957094567116
35,1566590400,1033,314,0,1347,34,-0.38441274635894485,1.2106428551681583
35,1566604800,280,311,31,591,34,0.7083937946003263,-0.39518603351508014
35,1566619200,61,104,43,165,34,1.1314156814232699,-1.3000578676143653
35,1566633600,210,116,0,326,34,-0.38441274635894485,-0.9580757894688607
35,1566648000,603,229,0,832,34,-0.38441274635894485,0.11672502755986756
35,1566662400,638,390,0,1028,34,-0.38441274635894485,0.5330510357370034
35,1566676800,496,357,0,853,34,-0.38441274635894485,0.1613313855788464
35,1566691200,217,330,113,547,34,3.599043354557108,-0.4886469741262739
35,1566705600,51,114,63,165,34,1.8364521594615093,-1.3000578676143653
35,1566720000,169,50,0,219,34,-0.38441274635894485,-1.1853558041369912
35,1566734400,486,184,0,670,34,-0.38441274635894485,-0.22738116287225493
35,1566748800,612,266,0,878,34,-0.38441274635894485,0.2144341927442974
35,1566763200,396,358,0,754,34,-0.38441274635894485,-0.04895573079633957
35,1566777600,172,306,134,478,34,4.33933165649726,-0.6352107219029186
35,1566792000,34,39,5,73,34,-0.208153626849385,-1.495476197983225
35,1566806400,361,173,0,534,34,-0.38441274635894485,-0.5162604338523084
35,1566820800,733,536,0,1269,34,-0.38441274635894485,1.044962096811951
35,1566835200,656,289,0,945,34,-0.38441274635894485,0.3567497159477061
35,1566849600,1319,281,0,1600,34,-0.38441274635894485,1.7480432636825225
35,1566864000,293,261,0,554,35,-0.3587572362064322,-0.19121051646056042
35,1566878400,86,47,0,133,35,-0.3587572362064322,-1.1287061775230132
35,1566892800,412,226,0,638,35,-0.3587572362064322,-0.004156750357838287
35,1566907200,848,527,0,1375,35,-0.3587572362064322,1.6370173641386643
35,1566921600,712,290,0,1002,35,-0.3587572362064322,0.8064095694206244
35,1566936000,1293,311,0,1604,35,-0.3587572362064322,2.1469615598234664
35,1566950400,281,318,37,599,35,4.419889150063245,-0.09100314176267357
35,1566964800,62,68,6,130,35,0.41615839399946136,-1.135386669169539
35,1566979200,383,194,0,577,35,-0.3587572362064322,-0.13999341383719602
35,1566993600,892,508,0,1400,35,-0.3587572362064322,1.6926881278597126
35,1567008000,678,283,0,961,35,-0.3587572362064322,0.7151095169181052
35,1567022400,1338,313,0,1651,35,-0.3587572362064322,2.251622595619037
35,1567036800,288,254,0,542,35,-0.3587572362064322,-0.2179324830466636
35,1567051200,83,88,5,171,35,0.2870057889651458,-1.0440866166670197
35,1567065600,399,155,0,554,35,-0.3587572362064322,-0.19121051646056042
35,1567075117,684,107,0,791,35,-0.3587572362064322,0.33654832361497705
35,1567075203,7,1,0,8,35,-0.3587572362064322,-1.4070599961282544
35,1567075287,7,0,0,7,35,-0.3587572362064322,-1.4092868266770964
35,1567080000,634,496,0,1130,35,-0.3587572362064322,1.0914438796723913
35,1567094400,688,362,0,1050,35,-0.3587572362064322,0.913297435765037
35,1567108800,1243,304,0,1547,35,-0.3587572362064322,2.0200322185394763
35,1567123200,308,254,0,562,35,-0.3587572362064322,-0.17339587206982499
35,1567137600,67,81,14,148,35,1.449379234273986,-1.095303719290384
35,1567152000,361,205,0,566,35,-0.3587572362064322,-0.16448854987445727
35,1567166400,812,446,0,1258,35,-0.3587572362064322,1.3764781899241585
35,1567180800,821,269,0,1090,35,-0.3587572362064322,1.0023706577187141
35,1567195200,910,350,0,1260,35,-0.3587572362064322,1.3809318510218422
35,1567209600,269,227,0,496,35,-0.3587572362064322,-0.3203666882933924
35,1567224000,48,79,31,127,35,3.644973519857351,-1.1420671608160646
35,1567238400,169,53,0,222,35,-0.3587572362064322,-0.9305182586760813
35,1567252800,548,91,0,639,35,-0.3587572362064322,-0.0019299198089963564
35,1567267200,555,170,0,725,35,-0.3587572362064322,0.18957750739140963
35,1567281600,456,229,0,685,35,-0.3587572362064322,0.10050428543773243
35,1567296000,173,149,0,322,35,-0.3587572362064322,-0.7078352037918882
35,1567310400,42,61,19,103,35,2.095142259445564,-1.195511093988271
35,1567324800,117,43,0,160,35,-0.3587572362064322,-1.068581752704281
35,1567339200,449,95,0,544,35,-0.3587572362064322,-0.21347882194897974
35,1567353600,457,144,0,601,35,-0.3587572362064322,-0.0865494806649897
35,1567368000,348,238,0,586,35,-0.3587572362064322,-0.11995193889761865
35,1567382400,152,161,9,313,35,0.8036162091024082,-0.7278766787314657
35,1567396800,43,47,4,90,35,0.1578531839308302,-1.224459891123216
35,1567411200,137,68,0,205,35,-0.3587572362064322,-0.968374378006394
35,1567425600,405,109,0,514,35,-0.3587572362064322,-0.28028373841423765
35,1567440000,475,148,0,623,35,-0.3587572362064322,-0.03755920859046724
35,1567454400,340,191,0,531,35,-0.3587572362064322,-0.24242761908392482
35,1567468800,145,146,1,291,36,-0.3527751609876058,-1.0197664364050303
35,1567483200,32,28,0,60,36,-0.38301303192940056,-1.4404200914221053
35,1567497600,483,219,0,702,36,-0.38301303192940056,-0.2713307125434813
35,1567512000,877,611,0,1488,36,-0.38301303192940056,1.159984321410722
35,1567526400,707,280,0,987,36,-0.38301303192940056,0.24765756312693593
35,1567540800,1348,360,0,1708,36,-0.38301303192940056,1.5606068499984125
35,1567555200,257,285,28,542,36,0.46364735444085337,-0.562692551516347
35,1567569600,38,45,7,83,36,-0.1713479353368371,-1.3985368270697558
35,1567584000,498,270,0,768,36,-0.38301303192940056,-0.15114395396717412
35,1567598400,909,617,0,1526,36,-0.38301303192940056,1.2291827581667776
35,1567612800,739,334,0,1073,36,-0.38301303192940056,0.4042645515748513
35,1567627200,1348,325,0,1673,36,-0.38301303192940056,1.496871447723098
35,1567641600,291,305,14,596,36,0.040317161255726396,-0.46435793086300486
35,1567656000,47,57,10,104,36,-0.08063432251145274,-1.360295585704567
35,1567670400,482,217,0,699,36,-0.38301303192940056,-0.2767937470242225
35,1567684800,882,644,0,1526,36,-0.38301303192940056,1.2291827581667776
35,1567699200,740,315,0,1055,36,-0.38301303192940056,0.37148634469040387
35,1567713600,1317,380,0,1697,36,-0.38301303192940056,1.5405757235690278
35,1567728000,283,281,0,564,36,-0.38301303192940056,-0.522630298657578
35,1567742400,57,52,0,109,36,-0.38301303192940056,-1.3511905282366652
35,1567756800,502,218,0,720,36,-0.38301303192940056,-0.23855250565903385
35,1567771200,888,613,0,1501,36,-0.38301303192940056,1.1836574708272674
35,1567785600,833,353,0,1186,36,-0.38301303192940056,0.6100388503494377
35,1567800000,1221,327,0,1548,36,-0.38301303192940056,1.2692450110255467
35,1567814400,1726,312,0,2038,36,-0.38301303192940056,2.161540642879948
35,1567828800,44,195,151,239,36,4.182905480281612,-1.1144590340712117
35,1567843200,176,84,0,260,36,-0.38301303192940056,-1.076217792706023
35,1567857600,598,225,0,823,36,-0.38301303192940056,-0.050988321820251516
35,1567872000,670,294,0,964,36,-0.38301303192940056,0.20577429877458647
35,1567886400,473,370,0,843,36,-0.38301303192940056,-0.014568091948643289
35,1567900800,200,267,67,467,36,1.64292432117085,-0.6992684135348779
35,1567915200,59,156,97,215,36,2.5500604494246932,-1.1581633099171416
35,1567929600,133,73,0,206,36,-0.38301303192940056,-1.1745524133593652
35,1567944000,543,157,0,700,36,-0.38301303192940056,-0.2749727355306421
35,1567958400,524,222,0,746,36,-0.38301303192940056,-0.19120620682594316
35,1567972800,327,251,0,578,36,-0.38301303192940056,-0.49713613774745224
35,1567987200,150,264,114,414,36,3.0641042554352045,-0.7957820226946397
35,1568001600,27,70,43,97,36,0.9172154185677751,-1.37304266615963
35,1568016000,525,221,0,746,36,-0.38301303192940056,-0.19120620682594316
35,1568030400,836,646,0,1482,36,-0.38301303192940056,1.1490582524492394
35,1568044800,692,324,0,1016,36,-0.38301303192940056,0.30046689644076785
35,1568059200,1390,312,0,1702,36,-0.38301303192940056,1.54968078103693
35,1568073600,301,254,0,555,37,-0.4175145252913525,-0.6197625973374898
35,1568088000,38,44,6,82,37,-0.05719377058785652,-1.518923026659521
35,1568102400,493,235,0,728,37,-0.4175145252913525,-0.29089419506960107
35,1568116800,937,703,0,1640,37,-0.4175145252913525,1.442793567174992
35,1568131200,745,360,0,1105,37,-0.4175145252913525,0.4257727855951046
35,1568145600,1429,422,0,1851,37,-0.4175145252913525,1.8438989595364055
35,1568160000,279,329,50,608,37,2.5851584305711146,-0.519011005891258
35,1568174400,42,61,19,103,37,0.7235011979363848,-1.479002584765731
35,1568188800,549,239,0,788,37,-0.4175145252913525,-0.17683578965877259
35,1568203200,918,580,0,1498,37,-0.4175145252913525,1.1728553410360312
35,1568217600,904,363,0,1267,37,-0.4175145252913525,0.7337304802043415
35,1568232000,1395,343,0,1738,37,-0.4175145252913525,1.6290889626793452
35,1568246400,296,265,0,561,37,-0.4175145252913525,-0.608356756796407
35,1568260800,43,68,25,111,37,1.083821952639881,-1.4637947973776206
35,1568275200,555,239,0,794,37,-0.4175145252913525,-0.1654299491176897
35,1568289600,943,525,0,1468,37,-0.4175145252913525,1.115826138330617
35,1568304000,773,337,0,1110,37,-0.4175145252913525,0.43527765271267366
35,1568318400,1414,361,0,1775,37,-0.4175145252913525,1.699424979349356
35,1568332800,281,283,2,564,37,-0.2974076070568539,-0.6026538365258656
35,1568347200,46,68,22,114,37,0.9036615752881328,-1.4580918771070792
35,1568361600,510,239,0,749,37,-0.4175145252913525,-0.2509737531758111
35,1568376000,951,607,0,1558,37,-0.4175145252913525,1.2869137464468596
35,1568390400,860,344,0,1204,37,-0.4175145252913525,0.6139691545229716
35,1568404800,1215,416,0,1631,37,-0.4175145252913525,1.4256848063633678
35,1568419200,310,311,1,621,37,-0.35746106617410317,-0.49429835138557854
35,1568433600,108,120,12,228,37,0.3031269841156395,-1.2413809068265051
35,1568448000,304,84,0,388,37,-0.4175145252913525,-0.9372251590642958
35,1568462400,702,216,0,918,37,-0.4175145252913525,0.07029075539802249
35,1568476800,737,390,0,1127,37,-0.4175145252913525,0.4675942009124084
35,1568491200,562,336,0,898,37,-0.4175145252913525,0.03227128692774633
35,1568505600,268,320,52,588,37,2.705265348805613,-0.5570304743615342
35,1568520000,84,108,24,192,37,1.0237684935226314,-1.3098159500730022
35,1568534400,184,82,0,266,37,-0.4175145252913525,-1.1691439167329805
35,1568548800,559,192,0,751,37,-0.4175145252913525,-0.24717180632878347
35,1568563200,653,225,0,878,37,-0.4175145252913525,-0.0057481815425298385
35,1568577600,437,349,0,786,37,-0.4175145252913525,-0.1806377365058002
35,1568592000,240,319,79,559,37,4.326708744971345,-0.6121587036434346
35,1568606400,64,57,0,121,37,-0.4175145252913525,-1.4447850631424826
35,1568620800,546,243,0,789,37,-0.4175145252913525,-0.17493481623525878
35,1568635200,816,698,0,1514,37,-0.4175145252913525,1.203270915812252
35,1568649600,717,329,0,1046,37,-0.4175145252913525,0.3136153536077899
35,1568664000,1374,357,0,1731,37,-0.4175145252913525,1.6157821487147486
35,1568678400,280,317,37,597,38,1.564779460649234,-0.48026937234537675
35,1568692800,61,49,0,110,38,-0.4154056222896175,-1.4018783170824378
35,1568707200,576,230,0,806,38,-0.4154056222896175,-0.0847534186491842
35,1568721600,944,602,0,1546,38,-0.4154056222896175,1.3156379963516889
35,1568736000,760,334,0,1094,38,-0.4154056222896175,0.46026378070250695
35,1568750400,1486,349,0,1835,38,-0.4154056222896175,1.8625476165344623
35,1568764800,322,277,0,599,38,-0.4154056222896175,-0.4764845306832122
35,1568779200,59,54,0,113,38,-0.4154056222896175,-1.396201054589191
35,1568793600,571,246,0,817,38,-0.4154056222896175,-0.06393678950727934
35,1568808000,936,607,0,1543,38,-0.4154056222896175,1.309960733858442
35,1568822400,732,337,0,1069,38,-0.4154056222896175,0.41295325992545046
35,1568836800,1459,338,0,1797,38,-0.4154056222896175,1.7906356249533364
35,1568851200,308,239,0,547,38,-0.4154056222896175,-0.5748904138994898
35,1568865600,45,70,25,115,38,0.9225572715879848,-1.3924162129270266
35,1568880000,548,234,0,782,38,-0.4154056222896175,-0.13017151859515846
35,1568894400,942,628,0,1570,38,-0.4154056222896175,1.3610560962976632
35,1568908800,761,346,0,1107,38,-0.4154056222896175,0.48486525150657633
35,1568923200,1450,327,0,1777,38,-0.4154056222896175,1.752787208331691
35,1568937600,310,316,6,626,38,-0.09429452775899293,-0.4253891682439912
35,1568952000,56,91,35,147,38,1.4577424291390257,-1.331858746332394
35,1568966400,521,219,0,740,38,-0.4154056222896175,-0.20965319350061343
35,1568980800,929,563,0,1492,38,-0.4154056222896175,1.213447271473247
35,1568995200,737,354,0,1091,38,-0.4154056222896175,0.45458651820926016
35,1569009600,1212,327,0,1539,38,-0.4154056222896175,1.3023910505341132
35,1569024000,283,258,0,541,38,-0.4154056222896175,-0.5862449388859834
35,1569038400,57,74,17,131,38,0.4944091455471521,-1.3621374796297103
35,1569052800,178,83,0,261,38,-0.4154056222896175,-1.1161227715890165
35,1569067200,683,299,0,982,38,-0.4154056222896175,0.24831264762129374
35,1569081600,673,267,0,940,38,-0.4154056222896175,0.16883097271583877
35,1569096000,599,316,0,915,38,-0.4154056222896175,0.12152045193878223
35,1569110400,211,285,74,496,38,3.544964543588086,-0.6714038762846851
35,1569124800,41,94,53,135,38,2.4210757127308997,-1.3545677963053813
35,1569139200,142,66,0,208,38,-0.4154056222896175,-1.2164210756363762
35,1569153600,598,144,0,742,38,-0.4154056222896175,-0.2058683518384489
35,1569168000,568,241,0,809,38,-0.4154056222896175,-0.07907615615593742
35,1569182400,390,304,0,694,38,-0.4154056222896175,-0.29670455173039745
35,1569196800,165,238,73,403,38,3.491446027832982,-0.8473990135753354
35,1569211200,37,43,6,80,38,-0.09429452775899293,-1.4586509420149056
35,1569225600,529,224,0,753,38,-0.4154056222896175,-0.18505172269654405
35,1569240000,810,625,0,1435,38,-0.4154056222896175,1.105579284101558
35,1569254400,714,332,0,1046,38,-0.4154056222896175,0.36942758081055843
35,1569268800,1326,377,0,1703,38,-0.4154056222896175,1.6127480668316039
35,1569283200,264,296,32,560,39,2.103579441140792,-0.5359188460444357
35,1569297600,38,40,2,78,39,-0.2994215523654618,-1.461692471722698
35,1569312000,548,236,0,784,39,-0.459621618599212,-0.10568380008607312
35,1569326400,943,572,0,1515,39,-0.459621618599212,1.2983421757869762
35,1569340800,757,345,0,1102,39,-0.459621618599212,0.5050963098012452
35,1569355200,1484,278,0,1762,39,-0.459621618599212,1.7727531416428493
35,1569369600,289,281,0,570,39,-0.459621618599212,-0.5167119243498659
35,1569384000,49,57,8,106,39,0.18117864633578898,-1.4079130909779027
35,1569398400,566,267,0,833,39,-0.459621618599212,-0.011569883782681296
35,1569412800,923,625,0,1548,39,-0.459621618599212,1.3617250173790565
35,1569427200,733,318,0,1051,39,-0.459621618599212,0.4071410091589394
35,1569441600,1429,333,0,1762,39,-0.459621618599212,1.7727531416428493
35,1569456000,284,268,0,552,39,-0.459621618599212,-0.5512843834000914
35,1569470400,51,59,8,110,39,0.18117864633578898,-1.4002303223000747
35,1569484800,540,261,0,801,39,-0.459621618599212,-0.07303203320530452
35,1569499200,973,650,0,1623,39,-0.459621618599212,1.5057769300883295
35,1569513600,749,365,0,1114,39,-0.459621618599212,0.5281446158347289
35,1569528000,1428,312,0,1740,39,-0.459621618599212,1.7304979139147958
35,1569542400,271,293,22,564,39,1.3025791099720407,-0.5282360773666078
35,1569556800,53,51,0,104,39,-0.459621618599212,-1.4117544753168167
35,1569571200,511,205,0,716,39,-0.459621618599212,-0.23629086760914747
35,1569585600,931,595,0,1526,39,-0.459621618599212,1.319469789651003
35,1569600000,789,307,0,1096,39,-0.459621618599212,0.49357215678450334
35,1569614400,1255,355,0,1610,39,-0.459621618599212,1.4808079318853888
35,1569628800,276,294,18,570,39,0.9821789775045403,-0.5167119243498659
35,1569643200,49,73,24,122,39,1.4627791762057911,-1.377182016266591
35,1569657600,181,93,0,274,39,-0.459621618599212,-1.0852368065091307
35,1569672000,632,216,0,848,39,-0.459621618599212,0.017240498759173342
35,1569686400,694,238,0,932,39,-0.459621618599212,0.1785786409935593
35,1569700800,552,319,0,871,39,-0.459621618599212,0.061416418656683784
35,1569715200,228,270,42,498,39,2.904579772309543,-0.6550017605507682
35,1569729600,46,91,45,137,39,3.1448798716601685,-1.3483716337247365
35,1569744000,129,55,0,184,39,-0.459621618599212,-1.2580991017602585
35,1569758400,550,132,0,682,39,-0.459621618599212,-0.30159440137068466
35,1569772800,625,279,0,904,39,-0.459621618599212,0.12479926024876399
35,1569787200,445,108,0,553,39,-0.459621618599212,-0.5493636912306346
35,1569801600,451,491,40,942,39,2.744379706075793,0.19778556268812905
35,1569816000,40,33,0,73,39,-0.459621618599212,-1.4712959325699828
35,1569830400,394,200,0,594,39,-0.459621618599212,-0.4706153122828985
35,1569844800,817,541,0,1358,39,-0.459621618599212,0.996793505182231
35,1569859200,687,272,0,959,39,-0.459621618599212,0.23043732956889765
35,1569873600,1196,315,0,1511,39,-0.459621618599212,1.2906594071091484
35,1569888000,242,237,0,479,40,-0.3869659285453137,-0.6666937367733193
35,1569902400,45,56,11,101,40,0.35794348390441516,-1.3866250226536905
35,1569916800,444,247,0,691,40,-0.3869659285453137,-0.2629227510414709
35,1569931200,866,625,0,1491,40,-0.3869659285453137,1.2607413460598438
35,1569945600,723,335,0,1058,40,-0.3869659285453137,0.4360581535037572
35,1569960000,1348,356,0,1704,40,-0.3869659285453137,1.666416911913069
35,1569974400,259,228,0,487,40,-0.3869659285453137,-0.6514570958023062
35,1569988800,36,58,22,94,40,1.102852896354144,-1.399957083503327
35,1570003200,546,252,0,798,40,-0.3869659285453137,-0.05913267805417005
35,1570017600,930,634,0,1564,40,-0.3869659285453137,1.3997756949203388
35,1570032000,765,312,0,1077,40,-0.3869659285453137,0.47224517580991343
35,1570046400,1406,361,0,1767,40,-0.3869659285453137,1.7864054595597973
35,1570060800,281,257,0,538,40,-0.3869659285453137,-0.5543235096120973
35,1570075200,42,44,2,86,40,-0.2515278535544539,-1.4151937244743402
35,1570089600,533,193,0,726,40,-0.3869659285453137,-0.1962624467932884
35,1570104000,910,591,0,1501,40,-0.3869659285453137,1.2797871472736102
35,1570118400,762,300,0,1062,40,-0.3869659285453137,0.4436764739892638
35,1570132800,1362,350,0,1712,40,-0.3869659285453137,1.681653552884082
35,1570147200,269,251,0,520,40,-0.3869659285453137,-0.5886059517968769
35,1570161600,56,61,5,117,40,-0.04837074106816422,-1.356151740711664
35,1570176000,517,225,0,742,40,-0.3869659285453137,-0.16578916485126208
35,1570190400,935,554,0,1489,40,-0.3869659285453137,1.2569321858170905
35,1570204800,767,349,0,1116,40,-0.3869659285453137,0.5465238005436025
35,1570219200,1228,361,0,1589,40,-0.3869659285453137,1.447390197954755
35,1570233600,271,305,34,576,40,1.9154813462993026,-0.48194946499978486
35,1570248000,57,68,11,125,40,0.35794348390441516,-1.3409150997406512
35,1570262400,209,67,0,276,40,-0.3869659285453137,-1.053323501412778
35,1570276800,616,347,0,963,40,-0.3869659285453137,0.2551230419729761
35,1570291200,717,331,0,1048,40,-0.3869659285453137,0.4170123522899908
35,1570305600,567,342,0,909,40,-0.3869659285453137,0.15227571541863738
35,1570320000,198,245,47,443,40,2.795828833739891,-0.7352586211428784
35,1570334400,45,82,37,127,40,2.1186384587855924,-1.3371059394978977
35,1570348800,152,48,0,200,40,-0.3869659285453137,-1.1980715906374029
35,1570363200,586,221,0,807,40,-0.3869659285453137,-0.04199145696178026
35,1570377600,610,300,0,910,40,-0.3869659285453137,0.154180295540014
35,1570392000,395,273,0,668,40,-0.3869659285453137,-0.3067280938331337
35,1570406400,137,208,71,345,40,4.421085733630209,-0.9219074730377895
35,1570420800,42,35,0,77,40,-0.3869659285453137,-1.43233494556673
35,1570435200,514,226,0,740,40,-0.3869659285453137,-0.16959832509401537
35,1570449600,775,558,0,1333,40,-0.3869659285453137,0.9598176868823342
35,1570464000,725,348,0,1073,40,-0.3869659285453137,0.4646268553244069
35,1570478400,1385,306,0,1691,40,-0.3869659285453137,1.6416573703351725
35,1570492800,268,227,0,495,41,-0.3743860368444262,-0.6040528424542144
35,1570507200,42,34,0,76,41,-0.3743860368444262,-1.4318150229174804
35,1570521600,498,247,0,745,41,-0.3743860368444262,-0.11016132666467615
35,1570536000,895,708,0,1603,41,-0.3743860368444262,1.584874355525019
35,1570550400,757,327,0,1084,41,-0.3743860368444262,0.5595555687459377
35,1570564800,1416,291,0,1707,41,-0.3743860368444262,1.790333226093467
35,1570579200,256,266,10,522,41,0.21898051211655117,-0.5507125587489442
35,1570593600,45,38,0,83,41,-0.3743860368444262,-1.4179860604753733
35,1570608000,427,212,0,639,41,-0.3743860368444262,-0.3195713293594404
35,1570622400,891,540,0,1431,41,-0.3743860368444262,1.2450769926618168
35,1570636800,663,298,0,961,41,-0.3743860368444262,0.3165609429774849
35,1570651200,1299,307,0,1606,41,-0.3743860368444262,1.5908010537144934
35,1570665600,280,276,0,556,41,-0.3743860368444262,-0.4835433126015671
35,1570680000,58,40,0,98,41,-0.3743860368444262,-1.388352569528001
35,1570694400,500,264,0,764,41,-0.3743860368444262,-0.07262557146467125
35,1570708800,859,645,0,1504,41,-0.3743860368444262,1.3892933152723619
35,1570723200,704,329,0,1033,41,-0.3743860368444262,0.4588016995248719
35,1570737600,1355,376,0,1731,41,-0.3743860368444262,1.8377468116092626
35,1570752000,268,289,21,557,41,0.8716837159736263,-0.4815677465384089
35,1570766400,51,40,0,91,41,-0.3743860368444262,-1.402181531970108
35,1570780800,473,211,0,684,41,-0.3743860368444262,-0.23067085651732347
35,1570795200,798,618,0,1416,41,-0.3743860368444262,1.2154435017144445
35,1570809600,803,309,0,1112,41,-0.3743860368444262,0.614871418514366
35,1570824000,1269,324,0,1593,41,-0.3743860368444262,1.5651186948934375
35,1570838400,270,275,5,545,41,-0.0777027623639375,-0.5052745392963067
35,1570852800,52,106,54,158,41,2.8297933275448512,-1.269818605738512
35,1570867200,190,73,0,263,41,-0.3743860368444262,-1.0623841691069058
35,1570881600,619,203,0,822,41,-0.3743860368444262,0.041957260198501614
35,1570896000,642,259,0,901,41,-0.3743860368444262,0.1980269791879957
35,1570910400,553,374,0,927,41,-0.3743860368444262,0.24939169683010767
35,1570924800,204,277,73,481,41,3.957189770570708,-0.6317107673384286
35,1570939200,45,88,43,133,41,2.177090123687776,-1.3192077573174656
35,1570953600,158,66,0,224,41,-0.3743860368444262,-1.139431245570074
35,1570968000,589,162,0,751,41,-0.3743860368444262,-0.09830793028572724
35,1570982400,593,238,0,831,41,-0.3743860368444262,0.059737354766924995
35,1570996800,433,320,0,753,41,-0.3743860368444262,-0.09435679815941093
35,1571011200,160,214,54,374,41,2.8297933275448512,-0.8430963360963509
35,1571025600,42,47,5,89,41,-0.0777027623639375,-1.4061326640964245
35,1571040000,341,193,0,534,41,-0.3743860368444262,-0.5270057659910464
35,1571054400,687,545,0,1232,41,-0.3743860368444262,0.8519393460933443
35,1571068800,628,314,0,942,41,-0.3743860368444262,0.27902518777748
35,1571083200,1252,329,0,1581,41,-0.3743860368444262,1.5414119021355397
35,1571097600,241,248,7,489,42,0.14316101375164136,-0.6526203759599334
35,1571112000,39,47,8,86,42,0.22124883943435486,-1.4266553057824989
35,1571126400,526,250,0,776,42,-0.40345376602735306,-0.10138458226495504
35,1571140800,889,665,0,1554,42,-0.40345376602735306,1.3929061755562755
35,1571155200,730,343,0,1073,42,-0.40345376602735306,0.4690580335099877
35,1571169600,1378,318,0,1696,42,-0.40345376602735306,1.66564304909177
35,1571184000,285,261,0,546,42,-0.40345376602735306,-0.5431414901041363
35,1571198400,47,63,16,110,42,0.8459514448960627,-1.3805589327905843
35,1571212800,520,267,0,787,42,-0.40345376602735306,-0.0802570779769942
35,1571227200,873,685,0,1558,42,-0.40345376602735306,1.4005889043882611
35,1571241600,779,344,0,1123,42,-0.40345376602735306,0.5650921439098097
35,1571256000,1305,281,0,1586,42,-0.40345376602735306,1.4543680062121616
35,1571270400,341,97,0,438,42,-0.40345376602735306,-0.7505751685677519
35,1571284800,200,182,0,382,42,-0.40345376602735306,-0.8581333722155525
35,1571299200,518,230,0,748,42,-0.40345376602735306,-0.15516368408885536
35,1571313600,845,648,0,1493,42,-0.40345376602735306,1.2757445608684925
35,1571328000,725,355,0,1080,42,-0.40345376602735306,0.48250280896596276
35,1571342400,1397,363,0,1760,42,-0.40345376602735306,1.788566710403542
35,1571356800,283,262,0,545,42,-0.40345376602735306,-0.5450621723121327
35,1571371200,47,67,20,114,42,1.1583027476269168,-1.3728762039585984
35,1571385600,505,211,0,716,42,-0.40345376602735306,-0.21662551474474145
35,1571400000,900,570,0,1470,42,-0.40345376602735306,1.2315688700845744
35,1571414400,793,351,0,1144,42,-0.40345376602735306,0.605426470277735
35,1571428800,1151,432,0,1583,42,-0.40345376602735306,1.4486059595881722
35,1571443200,263,224,0,487,42,-0.40345376602735306,-0.6564617403759263
35,1571457600,40,67,27,107,42,1.7049175274059112,-1.3863209794145734
35,1571472000,205,79,0,284,42,-0.40345376602735306,-1.0463602285992035
35,1571486400,706,313,0,1019,42,-0.40345376602735306,0.3653411942781799
35,1571500800,690,308,0,998,42,-0.40345376602735306,0.3250068679102547
35,1571515200,524,287,0,811,42,-0.40345376602735306,-0.034160704985079636
35,1571529600,226,281,55,507,42,3.891376646521889,-0.6180480962159974
35,1571544000,45,100,55,145,42,3.891376646521889,-1.3133350555107088
35,1571558400,146,49,0,195,42,-0.40345376602735306,-1.2173009451108867
35,1571572800,519,177,0,696,42,-0.40345376602735306,-0.25503915890467027
35,1571587200,522,233,0,755,42,-0.40345376602735306,-0.14171890863288028
35,1571601600,342,287,0,629,42,-0.40345376602735306,-0.3837248668404318
35,1571616000,134,153,19,287,42,1.0802149219442032,-1.0405981819752144
35,1571630400,29,39,10,68,42,0.37742449079978185,-1.4612275855264347
35,1571644800,516,221,0,737,42,-0.40345376602735306,-0.1762911883768162
35,1571659200,839,585,0,1424,42,-0.40345376602735306,1.1432174885167383
35,1571673600,732,318,0,1050,42,-0.40345376602735306,0.42488234272606956
35,1571688000,1379,374,0,1753,42,-0.40345376602735306,1.775121934947567
35,1571702400,259,233,0,492,43,-0.49059686555313764,-0.6297433191730021
35,1571716800,53,65,12,118,43,0.3679476491648533,-1.329666057273159
35,1571731200,516,207,0,723,43,-0.49059686555313764,-0.19743809858172873
35,1571745600,887,669,0,1556,43,-0.49059686555313764,1.3614807271868024
35,1571760000,773,288,0,1061,43,-0.49059686555313764,0.43511239734835955
35,1571774400,1425,305,0,1730,43,-0.49059686555313764,1.6871132310088004
35,1571788800,252,220,0,472,43,-0.49059686555313764,-0.6671723426008179
35,1571803200,45,60,15,105,43,0.5825837778443509,-1.3539949225012393
35,1571817600,549,221,0,770,43,-0.49059686555313764,-0.10947989352636144
35,1571832000,885,638,0,1523,43,-0.49059686555313764,1.2997228385309063
35,1571846400,771,357,0,1128,43,-0.49059686555313764,0.5604996258315427
35,1571860800,1377,335,0,1712,43,-0.49059686555313764,1.6534271099237663
35,1571875200,293,324,31,617,43,1.7273097974683387,-0.3958119227491529
35,1571889600,43,71,28,114,43,1.5126736687888411,-1.3371518619587222
35,1571904000,542,225,0,767,43,-0.49059686555313764,-0.11509424704053381
35,1571918400,928,553,0,1481,43,-0.49059686555313764,1.2211218893324929
35,1571932800,722,306,0,1028,43,-0.49059686555313764,0.37335450869246334
35,1571947200,1364,427,0,1791,43,-0.49059686555313764,1.801271752463639
35,1571961600,278,320,42,598,43,2.5143089359598307,-0.4313694950055779
35,1571976000,46,60,14,106,43,0.5110384016178517,-1.3521234713298484
35,1571990400,534,216,0,750,43,-0.49059686555313764,-0.1469089169541773
35,1572004800,907,578,0,1485,43,-0.49059686555313764,1.2286076940180561
35,1572019200,808,346,0,1154,43,-0.49059686555313764,0.6091573562877033
35,1572033600,1276,353,0,1629,43,-0.49059686555313764,1.4980966626983303
35,1572048000,264,282,18,546,43,0.7972199065238487,-0.5286849559178992
35,1572062400,50,83,33,133,43,1.8704005499213372,-1.301594289702297
35,1572076800,196,91,0,287,43,-0.49059686555313764,-1.0133908093081148
35,1572091200,641,225,0,866,43,-0.49059686555313764,0.07017941892715476
35,1572105600,706,274,0,980,43,-0.49059686555313764,0.28352485246570525
35,1572120000,607,374,0,981,43,-0.49059686555313764,0.28539630363709606
35,1572134400,266,241,0,507,43,-0.49059686555313764,-0.6016715516021401
35,1572148800,42,99,57,141,43,3.587489579357319,-1.2866226803311707
35,1572163200,126,56,0,182,43,-0.49059686555313764,-1.209893182304148
35,1572177600,457,123,0,580,43,-0.49059686555313764,-0.46505561609061224
35,1572192000,407,191,0,598,43,-0.49059686555313764,-0.4313694950055779
35,1572206400,353,246,0,599,43,-0.49059686555313764,-0.42949804383418716
35,1572220800,152,190,38,342,43,2.2281274310538333,-0.9104609948816211
35,1572235200,36,34,0,70,43,-0.49059686555313764,-1.419495713499917
35,1572249600,509,195,0,704,43,-0.49059686555313764,-0.2329956708381538
35,1572264000,879,666,0,1545,43,-0.49059686555313764,1.3408947643015037
35,1572278400,799,331,0,1130,43,-0.49059686555313764,0.5642425281743243
35,1572292800,1395,301,0,1696,43,-0.49059686555313764,1.6234838911815135
35,1572307200,271,217,0,488,44,-0.4015391425430458,-0.6495506750643454
35,1572321600,40,53,13,93,44,0.192271388360559,-1.3806233817085642
35,1572336000,567,248,0,815,44,-0.4015391425430458,-0.04433352298166298
35,1572350400,906,639,0,1545,44,-0.4015391425430458,1.3067628715760071
35,1572364800,751,330,0,1081,44,-0.4015391425430458,0.44798379339140587
35,1572379200,1455,397,0,1852,44,-0.4015391425430458,1.8749636840817672
35,1572393600,296,240,0,536,44,-0.4015391425430458,-0.5607114600797314
35,1572408000,41,49,8,90,44,-0.036117277371596694,-1.3861758326451026
35,1572422400,507,211,0,718,44,-0.4015391425430458,-0.22386276992973694
35,1572436800,877,622,0,1499,44,-0.4015391425430458,1.2216252905490854
35,1572451200,815,333,0,1148,44,-0.4015391425430458,0.5719885309740962
35,1572465600,1388,338,0,1726,44,-0.4015391425430458,1.6417607447471556
35,1572480000,293,237,0,530,44,-0.4015391425430458,-0.5718163619528082
35,1572494400,42,49,7,91,44,-0.08179501051802783,-1.3843250156662563
35,1572508800,521,222,0,743,44,-0.4015391425430458,-0.17759234545858388
35,1572523200,927,655,0,1582,44,-0.4015391425430458,1.3752430997933138
35,1572537600,780,310,0,1090,44,-0.4015391425430458,0.464641146201021
35,1572552000,1284,303,0,1587,44,-0.4015391425430458,1.3844971846875445
35,1572566400,276,266,0,542,44,-0.4015391425430458,-0.5496065582066547
35,1572580800,50,78,28,128,44,0.8774373855570261,-1.3158447874489498
35,1572595200,455,174,0,629,44,-0.4015391425430458,-0.38858548104704194
35,1572609600,890,613,0,1503,44,-0.4015391425430458,1.22902855846447
35,1572624000,785,310,0,1095,44,-0.4015391425430458,0.4738952310952516
35,1572638400,1232,340,0,1572,44,-0.4015391425430458,1.3567349300048526
35,1572652800,288,283,0,571,44,-0.4015391425430458,-0.4959328658201171
35,1572667200,58,137,79,195,44,3.2070017760250136,-1.1918400498662596
35,1572681600,173,74,0,247,44,-0.4015391425430458,-1.0955975669662612
35,1572696000,606,318,0,924,44,-0.4015391425430458,0.15740552771256447
35,1572710400,683,376,0,1059,44,-0.4015391425430458,0.40726581985679117
35,1572724800,576,385,0,961,44,-0.4015391425430458,0.22588575592987106
35,1572739200,244,292,48,536,44,1.7909920484856487,-0.5607114600797314
35,1572750000,41,120,79,161,44,3.2070017760250136,-1.2547678271470277
35,1572764400,85,61,0,146,44,-0.4015391425430458,-1.2825300818297196
35,1572778800,316,280,0,596,44,-0.4015391425430458,-0.44966244134896405
35,1572793200,1055,349,0,1404,44,-0.4015391425430458,1.0457976775587037
35,1572807600,406,329,0,735,44,-0.4015391425430458,-0.19239888128935287
35,1572822000,174,206,32,380,44,1.0601483181427507,-0.8494389087797267
35,1572836400,61,145,84,206,44,3.4353904417571695,-1.1714810630989523
35,1572850800,219,120,0,339,44,-0.4015391425430458,-0.9253224049124178
35,1572865200,1088,597,0,1685,44,-0.4015391425430458,1.5658772486144645
35,1572879600,606,269,0,875,44,-0.4015391425430458,0.06671549574910443
35,1572894000,1417,333,0,1750,44,-0.4015391425430458,1.6861803522394625
35,1572908400,360,262,0,622,44,-0.4015391425430458,-0.4015411998989648
35,1572922800,69,73,4,142,45,-0.05947367404095808,-0.7319424053156607
35,1572937200,222,99,0,321,45,-0.2753410835229541,-0.5149377123389279
35,1572951600,1057,484,0,1541,45,-0.2753410835229541,0.9640886867203672
35,1572966000,603,313,0,916,45,-0.2753410835229541,0.20639073638261352
35,1572980400,1121,374,0,1495,45,-0.2753410835229541,0.9083221175755085
35,1572994800,347,288,0,635,45,-0.2753410835229541,-0.13427026208924053
35,1573009200,73,70,0,143,45,-0.2753410835229541,-0.7307300885951202
35,1573023600,258,113,0,371,45,-0.2753410835229541,-0.4543218763119077
35,1573038000,1148,1211,63,2359,45,3.124570615818483,1.9557637641224193
35,1573052400,640,533,0,1173,45,-0.2753410835229541,0.5179561335614978
35,1573066800,1511,518,0,2029,45,-0.2753410835229541,1.5556992463440853
35,1573081200,350,192,0,542,45,-0.2753410835229541,-0.24701571709949827
35,1573095600,2,2,0,4,45,-0.2753410835229541,-0.8992421127502367
35,1573110000,230,90,0,320,45,-0.2753410835229541,-0.5161500290594684
35,1573124400,1104,622,0,1726,45,-0.2753410835229541,1.1883672800203422
35,1573138800,636,389,0,1025,45,-0.2753410835229541,0.33853325892151775
35,1573153200,1557,320,0,1877,45,-0.2753410835229541,1.3714271048219435
35,1573167600,352,262,0,614,45,-0.2753410835229541,-0.15972891322058905
35,1573182000,11,4,0,15,45,-0.2753410835229541,-0.8859066288242922
35,1573196400,219,13,0,232,45,-0.2753410835229541,-0.6228339004670241
35,1573210800,1007,106,0,1113,45,-0.2753410835229541,0.4452171303290735
35,1573225200,603,59,0,662,45,-0.2753410835229541,-0.10153771063464957
35,1573239600,1028,122,0,1150,45,-0.2753410835229541,0.4900728489890685
35,1573252196,264,103,0,367,45,-0.2753410835229541,-0.4591711431940693
35,1573252277,0,2,2,2,45,-0.16740737878195608,-0.9016667461913175
35,1573252357,2,2,0,4,45,-0.2753410835229541,-0.8992421127502367
35,1573252437,1,1,0,2,45,-0.2753410835229541,-0.9016667461913175
35,1573252526,3,0,0,3,45,-0.2753410835229541,-0.900454429470777
35,1573252606,1,0,0,1,45,-0.2753410835229541,-0.9028790629118578
35,1573252687,1,0,0,1,45,-0.2753410835229541,-0.9028790629118578
35,1573254000,8,10,2,18,45,-0.16740737878195608,-0.8822696786626709
35,1573268400,3112,1510,0,4622,45,-0.2753410835229541,4.699236502705357
35,1573282800,113,56,0,169,45,-0.2753410835229541,-0.6992098538610697
35,1573297200,494,294,0,788,45,-0.2753410835229541,0.05121419615344157
35,1573311600,633,344,0,977,45,-0.2753410835229541,0.2803420563355783
35,1573326000,528,297,0,825,45,-0.2753410835229541,0.09606991481343659
35,1573340400,259,258,0,517,45,-0.2753410835229541,-0.27732363511300845
35,1573354800,68,177,109,245,45,5.607045824861437,-0.6070737830999988
35,1573369200,60,64,4,124,45,-0.05947367404095808,-0.7537641062853879
35,1573383600,399,163,0,562,45,-0.2753410835229541,-0.22276938268869015
35,1573398000,542,199,0,741,45,-0.2753410835229541,-0.005764689711957508
35,1573412400,418,310,0,728,45,-0.2753410835229541,-0.021524807078982786
35,1573426800,168,197,29,365,45,1.289697635221517,-0.4615957766351501
35,1573441200,67,104,37,171,45,1.721432454185509,-0.6967852204199889
35,1573455600,193,87,0,280,45,-0.2753410835229541,-0.5646426978810846
35,1573470000,837,665,0,1502,45,-0.2753410835229541,0.9168083346192913
35,1573484400,591,308,0,899,45,-0.2753410835229541,0.1857813521334266
35,1573498800,1378,335,0,1713,45,-0.2753410835229541,1.172607162653317
35,1573513200,315,196,0,511,45,-0.2753410835229541,-0.2845975354362509
35,1573527600,2,3,1,5,46,-0.16278318360460903,-1.2818437217067682
35,1573542000,199,70,0,269,46,-0.2968399230436988,-0.8502680017212022
35,1573556400,1133,614,0,1747,46,-0.2968399230436988,1.565902127591929
35,1573570800,603,328,0,931,46,-0.2968399230436988,0.2319408112729066
35,1573585200,1546,319,0,1865,46,-0.2968399230436988,1.758803396373356
35,1573599600,381,244,0,625,46,-0.2968399230436988,-0.26829468234672676
35,1573614000,3,6,3,9,46,0.10533029527357052,-1.2753046956463807
35,1573628400,208,90,0,298,46,-0.2968399230436988,-0.8028600627833937
35,1573642800,1093,716,0,1809,46,-0.2968399230436988,1.6672570315279331
35,1573657200,595,322,0,917,46,-0.2968399230436988,0.20905422006155083
35,1573671600,1477,312,0,1789,46,-0.2968399230436988,1.6345619012259962
35,1573686000,351,265,0,616,46,-0.2968399230436988,-0.2830074909825983
35,1573700400,6,2,0,8,46,-0.2968399230436988,-1.2769394521614776
35,1573714800,209,77,0,286,46,-0.2968399230436988,-0.8224771409645558
35,1573729200,1097,620,0,1717,46,-0.2968399230436988,1.5168594321390236
35,1573743600,613,328,0,941,46,-0.2968399230436988,0.24828837642387502
35,1573758000,1533,300,0,1833,46,-0.2968399230436988,1.706491187890257
35,1573772400,394,273,0,667,46,-0.2968399230436988,-0.19963490871265943
35,1573786800,3,7,4,10,46,0.2393870347126603,-1.273669939131284
35,1573801200,235,82,0,317,46,-0.2968399230436988,-0.7717996889965538
35,1573815600,1044,608,0,1652,46,-0.2968399230436988,1.410600258657729
35,1573830000,720,326,0,1046,46,-0.2968399230436988,0.41993781050904333
35,1573844400,1373,300,0,1673,46,-0.2968399230436988,1.4449301454747627
35,1573858800,380,266,0,646,46,-0.2968399230436988,-0.2339647955296931
35,1573873200,72,82,10,154,46,1.043727471347199,-1.0382650009573389
35,1573887600,99,51,0,150,46,-0.2968399230436988,-1.0448040270177263
35,1573902000,561,241,0,802,46,-0.2968399230436988,0.021057220825414117
35,1573916400,695,256,0,951,46,-0.2968399230436988,0.26463594157484344
35,1573930800,583,340,0,923,46,-0.2968399230436988,0.21886275915213188
35,1573945200,272,247,0,519,46,-0.2968399230436988,-0.4415788729469919
35,1573959600,67,101,34,168,46,4.261089217885353,-1.015378409745983
35,1573974000,65,30,0,95,46,-0.2968399230436988,-1.1347156353480525
35,1573988400,441,106,0,547,46,-0.2968399230436988,-0.39580569052428033
35,1574002800,588,175,0,763,46,-0.2968399230436988,-0.04269828326336268
35,1574017200,437,302,0,739,46,-0.2968399230436988,-0.08193243962568687
35,1574031600,185,220,35,405,46,4.395145957324443,-0.6279411156680318
35,1574046000,56,62,6,118,46,0.5075005135908398,-1.097116235500825
35,1574060400,207,77,0,284,46,-0.2968399230436988,-0.8257466539947496
35,1574074800,1048,612,0,1660,46,-0.2968399230436988,1.4236783107785038
35,1574089200,606,298,0,904,46,-0.2968399230436988,0.1878023853652919
35,1574103600,1459,294,0,1753,46,-0.2968399230436988,1.57571066668251
35,1574118000,294,238,0,532,46,-0.2968399230436988,-0.420327038250733
35,1574132400,9,5,0,14,47,-0.2585029080296965,-1.1495095475622972
35,1574146800,213,83,0,296,47,-0.2585029080296965,-0.6983586988699905
35,1574161200,874,681,0,1555,47,-0.2585029080296965,1.3158218631995628
35,1574175600,621,317,0,938,47,-0.2585029080296965,0.3287294034720693
35,1574190000,1524,389,0,1913,47,-0.2585029080296965,1.8885594654401507
35,1574204400,383,265,0,648,47,-0.2585029080296965,-0.13522005085689853
35,1574218800,2,2,0,4,47,-0.2585029080296965,-1.1655078046081238
35,1574233200,248,70,0,318,47,-0.2585029080296965,-0.6631625333691723
35,1574247600,1089,826,0,1915,47,-0.2585029080296965,1.8917591168493162
35,1574262000,727,283,0,1010,47,-0.2585029080296965,0.44391685420201993
35,1574276400,1506,403,0,1909,47,-0.2585029080296965,1.8821601626218203
35,1574290800,375,221,0,596,47,-0.2585029080296965,-0.21841098749519622
35,1574305200,1,2,1,3,47,-0.19316700819801494,-1.1671076303127064
35,1574319600,239,72,0,311,47,-0.2585029080296965,-0.6743613133012508
35,1574334000,1135,588,0,1723,47,-0.2585029080296965,1.5845925815694477
35,1574348400,624,530,0,1154,47,-0.2585029080296965,0.6742917556619212
35,1574362800,1523,479,0,2002,47,-0.2585029080296965,2.0309439531480065
35,1574377200,399,208,0,607,47,-0.2585029080296965,-0.20081290474478708
35,1574391600,5,4,0,9,47,-0.2585029080296965,-1.1575086760852105
35,1574406000,217,63,0,280,47,-0.2585029080296965,-0.7239559101433128
35,1574420400,1249,588,0,1837,47,-0.2585029080296965,1.7669727118918697
35,1574434800,706,334,0,1040,47,-0.2585029080296965,0.4919116253394994
35,1574449200,1310,348,0,1658,47,-0.2585029080296965,1.4806039107715756
35,1574463600,436,251,0,687,47,-0.2585029080296965,-0.07282684837817527
35,1574478000,61,142,81,203,47,5.033704978336507,-0.8471424893961768
35,1574492400,96,46,0,142,47,-0.2585029080296965,-0.9447318573757183
35,1574506800,503,203,0,706,47,-0.2585029080296965,-0.04243015999110496
35,1574521200,672,256,0,928,47,-0.2585029080296965,0.31273114642624283
35,1574535600,598,315,0,913,47,-0.2585029080296965,0.28873376085750313
35,1574550000,251,233,0,484,47,-0.2585029080296965,-0.3975914664084527
35,1574564400,66,107,41,173,47,2.4202689850692463,-0.8951372605336562
35,1574578800,59,36,0,95,47,-0.2585029080296965,-1.0199236654911028
35,1574593200,428,123,0,551,47,-0.2585029080296965,-0.29040314420141533
35,1574607600,512,203,0,715,47,-0.2585029080296965,-0.02803172864986113
35,1574622000,416,220,0,636,47,-0.2585029080296965,-0.15441795931189028
35,1574636400,173,230,57,403,47,3.4656433823761508,-0.5271773484796473
35,1574650800,67,62,0,129,47,-0.2585029080296965,-0.9655295915352927
35,1574665200,225,85,0,310,47,-0.2585029080296965,-0.6759611390058334
35,1574679600,960,667,0,1627,47,-0.2585029080296965,1.4310093139295135
35,1574694000,563,254,0,817,47,-0.2585029080296965,0.13515049321756895
35,1574697344,229,64,0,293,47,-0.2585029080296965,-0.7031581759837384
35,1574697424,12,2,0,14,47,-0.2585029080296965,-1.1495095475622972
35,1574697504,8,0,0,8,47,-0.2585029080296965,-1.159108501789793
35,1574697584,9,11,2,20,47,-0.1278311083663334,-1.1399105933348013
35,1574708400,1184,214,0,1398,47,-0.2585029080296965,1.0646492275800872
35,1574722800,414,290,0,704,47,-0.2585029080296965,-0.045629811400270254
35,1574737200,85,84,0,169,48,-0.40256097174015687,-0.9641005421437818
35,1574751600,238,83,0,321,48,-0.40256097174015687,-0.6531255087441302
35,1574766000,1252,643,0,1895,48,-0.40256097174015687,2.5671027976443668
35,1574780400,659,296,0,955,48,-0.40256097174015687,0.6439677226728375
35,1574794800,1463,350,0,1813,48,-0.40256097174015687,2.3993399506787654
35,1574809200,408,334,0,742,48,-0.40256097174015687,0.20819349823779942
35,1574823600,88,79,0,167,48,-0.40256097174015687,-0.9681923188990403
35,1574838000,231,85,0,316,48,-0.40256097174015687,-0.6633549506322767
35,1574852400,1009,482,0,1491,48,-0.40256097174015687,1.7405638930821352
35,1574866800,808,287,0,1095,48,-0.40256097174015687,0.9303920955409376
35,1574881200,1074,334,0,1408,48,-0.40256097174015687,1.5707551577389043
35,1574895600,310,272,0,582,48,-0.40256097174015687,-0.11914864218288644
35,1574910000,76,79,3,155,48,-0.09327632272028025,-0.9927429794305919
35,1574924400,112,24,0,136,48,-0.40256097174015687,-1.0316148586055482
35,1574938800,370,131,0,501,48,-0.40256097174015687,-0.28486560077085865
35,1574953200,396,223,0,619,48,-0.40256097174015687,-0.04345077221060283
35,1574967600,317,268,0,585,48,-0.40256097174015687,-0.11301097704999857
35,1574982000,168,181,13,349,48,0.9376725073459752,-0.5958406341705103
35,1574996400,55,69,14,124,48,1.0407673903526007,-1.0561655191370998
35,1575010800,90,43,0,133,48,-0.40256097174015687,-1.0377525237384362
35,1575025200,608,158,0,766,48,-0.40256097174015687,0.2572948193009023
35,1575039600,549,209,0,758,48,-0.40256097174015687,0.240927712279868
35,1575054000,484,275,0,759,48,-0.40256097174015687,0.2429736006574973
35,1575068400,238,254,16,492,48,1.246957156365852,-0.30327859616952224
35,1575082800,63,86,23,149,48,1.9686213374122308,-1.0050183096963676
35,1575097200,85,46,0,131,48,-0.40256097174015687,-1.0418443004936948
35,1575111600,380,162,0,542,48,-0.40256097174015687,-0.2009841772880579
35,1575126000,610,228,0,838,48,-0.40256097174015687,0.4045987824902109
35,1575140400,487,343,0,830,48,-0.40256097174015687,0.38823167546917664
35,1575154800,233,253,20,486,48,1.659336688392354,-0.31555392643529795
35,1575169200,72,120,48,192,48,4.54599341257787,-0.9170451094583082
35,1575183600,60,37,0,97,48,-0.40256097174015687,-1.1114045053330905
35,1575198000,383,133,0,516,48,-0.40256097174015687,-0.25417727510641935
35,1575212400,508,178,0,686,48,-0.40256097174015687,0.09362374909055937
35,1575226800,383,191,0,574,48,-0.40256097174015687,-0.13551574920392073
35,1575241200,148,175,27,323,48,2.381000869438733,-0.6490337319888717
35,1575255600,60,52,0,112,48,-0.40256097174015687,-1.080716179668651
35,1575270000,227,87,0,314,48,-0.40256097174015687,-0.6674467273875353
35,1575284400,1055,582,0,1637,48,-0.40256097174015687,2.039263596216011
35,1575298800,631,255,0,886,48,-0.40256097174015687,0.5028014246164167
35,1575313200,1312,300,0,1612,48,-0.40256097174015687,1.9881163867752787
35,1575327600,369,265,0,634,48,-0.40256097174015687,-0.012762446546163535
35,1575342000,86,109,23,195,49,1.0614642059706287,-1.1200120403313556
35,1575356400,250,97,0,347,49,-0.3646476479481854,-0.8543945632528842
35,1575370800,1141,640,0,1781,49,-0.3646476479481854,1.6514966349742746
35,1575385200,629,310,0,939,49,-0.3646476479481854,0.18011561063168907
35,1575399600,1577,267,0,1844,49,-0.3646476479481854,1.7615880892896938
35,1575414000,461,302,0,763,49,-0.3646476479481854,-0.12744146809075163
35,1575428400,90,151,61,241,49,3.417649008097365,-1.0396278038470814
35,1575442800,244,117,0,361,49,-0.3646476479481854,-0.8299297956272355
35,1575457200,1033,722,0,1755,49,-0.3646476479481854,1.6060620665266414
35,1575471600,633,298,0,931,49,-0.3646476479481854,0.16613574341703266
35,1575486000,1479,336,0,1815,49,-0.3646476479481854,1.7109110706365644
35,1575500400,481,260,0,741,49,-0.3646476479481854,-0.1658861029310567
35,1575514800,96,163,67,259,49,3.7896781873805336,-1.0081731026141045
35,1575529200,243,104,0,347,49,-0.3646476479481854,-0.8543945632528842
35,1575543600,1069,719,0,1788,49,-0.3646476479481854,1.663729018787099
35,1575558000,643,329,0,972,49,-0.3646476479481854,0.2377825628921467
35,1575572400,1517,323,0,1840,49,-0.3646476479481854,1.7545981556823655
35,1575586800,465,307,0,772,49,-0.3646476479481854,-0.11171411747426319
35,1575601200,102,157,55,259,49,3.045619828814196,-1.0081731026141045
35,1575615600,234,93,0,327,49,-0.3646476479481854,-0.8893442312895252
35,1575630000,1025,593,0,1618,49,-0.3646476479481854,1.3666568404756505
35,1575644400,726,277,0,1003,49,-0.3646476479481854,0.29195454834894025
35,1575658800,1318,299,0,1617,49,-0.3646476479481854,1.3649093570738187
35,1575673200,402,307,0,709,49,-0.3646476479481854,-0.2218055717896823
35,1575687600,96,114,18,210,49,0.7514398899013212,-1.093799789303875
35,1575702000,91,47,0,138,49,-0.3646476479481854,-1.2196185942357824
35,1575716400,518,258,0,776,49,-0.3646476479481854,-0.104724183866935
35,1575730800,660,231,0,891,49,-0.3646476479481854,0.09623640734375069
35,1575745200,627,335,0,962,49,-0.3646476479481854,0.2203077288738262
35,1575759600,313,279,0,592,49,-0.3646476479481854,-0.4262611298040321
35,1575774000,74,89,15,163,49,0.5654253002597368,-1.1759315091899813
35,1575788400,64,33,0,97,49,-0.3646476479481854,-1.2912654137108965
35,1575802800,407,147,0,554,49,-0.3646476479481854,-0.49266549907365
35,1575817200,638,230,0,868,49,-0.3646476479481854,0.056044289101613555
35,1575831600,459,292,0,751,49,-0.3646476479481854,-0.14841126891273623
35,1575846000,195,203,8,398,49,0.13139125776270644,-0.7652729097594496
35,1575860400,82,74,0,156,49,-0.3646476479481854,-1.1881638930028056
35,1575874800,221,103,0,324,49,-0.3646476479481854,-0.8945866814950213
35,1575889200,1026,678,0,1704,49,-0.3646476479481854,1.516940413033207
35,1575903600,647,287,0,934,49,-0.3646476479481854,0.17137819362252882
35,1575918000,1397,257,0,1654,49,-0.3646476479481854,1.4295662429416043
35,1575932400,366,347,0,713,49,-0.3646476479481854,-0.2148156381823541
35,1575946800,21,145,124,166,50,5.754280797451457,-1.138727463611502
35,1575961200,229,99,0,328,50,-0.2901513108839985,-0.8591207634161695
35,1575975600,1021,606,0,1627,50,-0.2901513108839985,1.382910740001958
35,1575990000,627,313,0,940,50,-0.2901513108839985,0.19717121509953023
35,1576004400,1534,358,0,1892,50,-0.2901513108839985,1.8402920705683965
35,1576018800,446,299,0,745,50,-0.2901513108839985,-0.13939240550596235
35,1576033200,78,88,10,166,50,0.19730289140111895,-1.138727463611502
35,1576047600,227,68,0,295,50,-0.2901513108839985,-0.9160776838263298
35,1576062000,1068,725,0,1793,50,-0.2901513108839985,1.6694213093379158
35,1576076400,700,307,0,1007,50,-0.2901513108839985,0.3128110232050072
35,1576090800,1490,314,0,1804,50,-0.2901513108839985,1.6884069494746359
35,1576105200,464,265,0,729,50,-0.2901513108839985,-0.1670078820684643
35,1576119600,110,93,0,203,50,-0.2901513108839985,-1.074866674060716
35,1576134000,272,106,0,378,50,-0.2901513108839985,-0.7728223991583509
35,1576148400,1099,705,0,1804,50,-0.2901513108839985,1.6884069494746359
35,1576162800,674,302,0,976,50,-0.2901513108839985,0.2593060373651596
35,1576177200,1537,302,0,1839,50,-0.2901513108839985,1.7488158044551088
35,1576191600,475,334,0,809,50,-0.2901513108839985,-0.028930499255954523
35,1576206000,98,78,0,176,50,-0.2901513108839985,-1.1214677907599382
35,1576220400,227,92,0,319,50,-0.2901513108839985,-0.8746544689825769
35,1576234800,1031,535,0,1566,50,-0.2901513108839985,1.2776267356074191
35,1576249200,691,318,0,1009,50,-0.2901513108839985,0.31626295777531993
35,1576263600,1359,319,0,1678,50,-0.2901513108839985,1.470935071544933
35,1576278000,481,280,0,761,50,-0.2901513108839985,-0.11177692894346039
35,1576292400,79,105,26,184,50,0.9772296150573068,-1.107660052478687
35,1576306800,83,38,0,121,50,-0.2901513108839985,-1.2163959914435385
35,1576321200,535,243,0,778,50,-0.2901513108839985,-0.08243548509580206
35,1576335600,644,251,0,895,50,-0.2901513108839985,0.11950268726749348
35,1576350000,607,286,0,893,50,-0.2901513108839985,0.11605075269718074
35,1576364400,320,286,0,606,50,-0.2901513108839985,-0.37930185814269807
35,1576378800,74,114,40,188,50,1.6596654982564714,-1.1007561833380617
35,1576393200,58,46,0,104,50,-0.2901513108839985,-1.245737435291197
35,1576407600,439,118,0,557,50,-0.2901513108839985,-0.4638742551153603
35,1576422000,560,233,0,793,50,-0.2901513108839985,-0.056545975818456475
35,1576436400,435,284,0,719,50,-0.2901513108839985,-0.18426755492002803
35,1576450800,184,218,34,402,50,1.3671929768854008,-0.731399184314598
35,1576465200,57,73,16,130,50,0.4897754127721894,-1.2008622858771312
35,1576479600,209,94,0,303,50,-0.2901513108839985,-0.9022699455450789
35,1576494000,1083,570,0,1653,50,-0.2901513108839985,1.4277858894160236
35,1576508400,703,257,0,960,50,-0.2901513108839985,0.23169056080265768
35,1576522800,1415,273,0,1688,50,-0.2901513108839985,1.4881947443964967
35,1576537200,405,293,0,698,50,-0.2901513108839985,-0.22051286790831184
35,1576551600,78,67,0,145,51,-0.21605846663848077,-0.7512877893488983
35,1576566000,239,111,0,350,51,-0.21605846663848077,-0.5423936760196897
35,1576580400,1075,607,0,1682,51,-0.21605846663848077,0.8149085627827782
35,1576594800,599,244,0,843,51,-0.21605846663848077,-0.04002880835481226
35,1576609200,1480,309,0,1789,51,-0.21605846663848077,0.9239410999838774
35,1576613775,0,0,0,0,51,-0.21605846663848077,-0.8990421621915093
35,1576613859,0,0,0,0,51,-0.21605846663848077,-0.8990421621915093
35,1576613950,0,0,0,0,51,-0.21605846663848077,-0.8990421621915093
35,1576616841,0,0,0,0,51,-0.21605846663848077,-0.8990421621915093
35,1576623600,416,268,0,684,51,-0.21605846663848077,-0.20204912064429603
35,1576638000,67,45,0,112,51,-0.21605846663848077,-0.784914646616527
35,1576652400,244,178,0,422,51,-0.21605846663848077,-0.46902598743577245
35,1576666800,1063,647,0,1710,51,-0.21605846663848077,0.8434404416765239
35,1576681200,631,261,0,892,51,-0.21605846663848077,0.009901979709242491
35,1576695600,1439,270,0,1709,51,-0.21605846663848077,0.8424214460017472
35,1576710000,385,227,0,612,51,-0.21605846663848077,-0.2754168092282132
35,1576724400,396,64,0,460,51,-0.21605846663848077,-0.4303041517942606
35,1576738800,225,70,0,295,51,-0.21605846663848077,-0.5984384381324042
35,1576753200,899,541,0,1440,51,-0.21605846663848077,0.5683116094868343
35,1576767600,688,245,0,933,51,-0.21605846663848077,0.05168080237508422
35,1576782000,1934,242,0,2176,51,-0.21605846663848077,1.3182924261224325
35,1576787379,0,0,0,0,51,-0.21605846663848077,-0.8990421621915093
35,1576796400,524,259,0,783,51,-0.21605846663848077,-0.10116854884140991
35,1576810800,304,80,0,384,51,-0.21605846663848077,-0.5077478230772843
35,1576897200,4125,1552,0,5677,51,-0.21605846663848077,4.885796283515406
35,1576911600,2888,457,0,3345,51,-0.21605846663848077,2.50949836993631
35,1576926000,392,150,0,542,51,-0.21605846663848077,-0.34674650646257715
35,1576940400,551,202,0,753,51,-0.21605846663848077,-0.13173841908470874
35,1576954800,502,306,0,808,51,-0.21605846663848077,-0.07569365697199422
35,1576969200,258,280,22,538,51,-0.10934730595612716,-0.3508224891616837
35,1576983600,610,405,0,1015,51,-0.21605846663848077,0.13523844770676768
35,1576998000,767,720,0,1487,51,-0.21605846663848077,0.6162044062013359
35,1577012400,336,836,500,1172,51,2.209195185233192,0.2952207686466982
35,1577026800,483,170,0,653,51,-0.21605846663848077,-0.2336379865623715
35,1577041200,398,253,0,651,51,-0.21605846663848077,-0.23567597791192474
35,1577055600,169,218,49,387,51,0.021616391244943182,-0.5046908360529544
35,1577070000,42,75,33,117,51,-0.05599172561495035,-0.7798196682426438
35,1577084307,104,1440,1336,1544,51,6.26421929116263,0.6742871596636036
35,1577084400,241,57,0,298,51,-0.21605846663848077,-0.5953814511080743
35,1577088532,85,168,83,253,51,0.18653363957221694,-0.6412362564730225
35,1577088620,107,73,0,180,51,-0.21605846663848077,-0.7156229407317163
35,1577088704,190,19,0,209,51,-0.21605846663848077,-0.6860720661631942
35,1577098800,459,485,26,944,51,-0.08994527674115377,0.06288975479762712
35,1577113200,601,316,0,917,51,-0.21605846663848077,0.03537687157865818
35,1577127600,810,357,0,1167,51,-0.21605846663848077,0.29012579027281504
35,1577142000,265,242,0,507,51,-0.21605846663848077,-0.3824113550797591
35,1577156400,64,99,35,163,52,0.04484128376315446,-0.7864620811018966
35,1577168700,157,7,0,164,52,-0.38862445928067213,-0.7839940148372115
35,1577170800,101,118,17,219,52,-0.17808395551652778,-0.648250370279531
35,1577185200,509,416,0,925,52,-0.38862445928067213,1.0942044125881492
35,1577199600,427,270,0,697,52,-0.38862445928067213,0.5314853042399464
35,1577214000,404,304,0,708,52,-0.38862445928067213,0.5586340331514825
35,1577228400,178,221,43,399,52,0.14391916788745768,-0.20399844263621317
35,1577242800,57,51,0,108,52,-0.38862445928067213,-0.9222057256595771
35,1577257200,39,52,13,91,52,-0.22762289757867937,-0.9641628521592238
35,1577271600,126,95,0,221,52,-0.38862445928067213,-0.6433142377501608
35,1577286000,226,147,0,373,52,-0.38862445928067213,-0.26816816551802575
35,1577300400,214,215,1,429,52,-0.3762397237651342,-0.1299564546956602
35,1577301796,17,18,1,35,52,-0.3762397237651342,-1.1023745629815893
35,1577302949,25,15,0,40,52,-0.38862445928067213,-1.090034231658164
35,1577314800,106,167,61,273,52,0.3668444071671399,-0.5149747919865357
35,1577329200,47,62,15,109,52,-0.20285342654760358,-0.919737659394892
35,1577343600,149,150,1,299,52,-0.3762397237651342,-0.4508050691047231
35,1577358000,504,764,260,1268,52,2.8314067747591825,1.9407511413751384
35,1577372400,468,323,0,791,52,-0.38862445928067213,0.7634835331203458
35,1577386800,797,342,0,1139,52,-0.38862445928067213,1.6223705932307606
35,1577401200,282,271,0,553,52,-0.38862445928067213,0.17608376212529214
35,1577415600,71,83,12,154,52,-0.24000763309421727,-0.8086746774840625
35,1577430000,144,168,24,312,52,-0.09139080690776247,-0.4187202076638168
35,1577437059,206,159,0,365,52,-0.38862445928067213,-0.28791269563550653
35,1577437923,14,24,10,38,52,-0.2647771041252931,-1.0949703641875341
35,1577444400,580,954,374,1534,52,4.243266623530504,2.5972567677813747
35,1577458800,500,335,0,835,52,-0.38862445928067213,0.8720784487664902
35,1577473200,792,373,0,1165,52,-0.38862445928067213,1.6865403161125732
35,1577487600,259,302,43,561,52,0.14391916788745768,0.19582829224277296
