remote_unit_id,time_stamp,entries,exits,num_people_exited,sum_exit_entry,week_num,z_score_num_people_exited,z_score_sum_exit_entry
314,1546300800,0,0,0,0,1,-0.6593378175776405,-1.4627948840873595
314,1546315200,77,170,93,247,1,2.146079955252712,-0.6466256737650734
314,1546329600,39,37,0,76,1,-0.6593378175776405,-1.2116658962958868
314,1546344000,194,70,0,264,1,-0.6593378175776405,-0.590452084390665
314,1546358400,362,160,0,522,1,-0.6593378175776405,0.26206474258565016
314,1546372800,250,191,0,441,1,-0.6593378175776405,-0.005585889139472025
314,1546387200,85,134,49,219,1,0.8187855250964163,-0.7391468797935107
314,1546401600,13,32,19,45,1,-0.0861879500101491,-1.314100088684514
314,1546416000,330,81,0,411,1,-0.6593378175776405,-0.10471575274136914
314,1546430400,777,154,0,931,1,-0.6593378175776405,1.6135352163581809
314,1546444800,451,230,0,681,1,-0.6593378175776405,0.7874530196757049
314,1546459200,418,462,44,880,1,0.6679566125786554,1.4450144482349556
314,1546473600,109,214,105,323,1,2.5080693452953384,-0.39549668597360066
314,1546488000,14,31,17,45,1,-0.14651951501725347,-1.314100088684514
314,1546502400,340,96,0,436,1,-0.6593378175776405,-0.022107533073121542
314,1546516800,826,169,0,995,1,-0.6593378175776405,1.8250122587088948
314,1546531200,444,241,0,685,1,-0.6593378175776405,0.8006703348226245
314,1546545600,432,468,36,900,1,0.42663035255023796,1.5111010239695537
314,1546560000,121,243,122,364,1,3.020887647855725,-0.2600192057176746
314,1546574400,18,34,16,52,1,-0.17668529752080564,-1.2909697871774046
314,1546588800,342,79,0,421,1,-0.6593378175776405,-0.0716724648740701
314,1546603200,805,202,0,1007,1,-0.6593378175776405,1.8646642041496537
314,1546617600,485,243,0,728,1,-0.6593378175776405,0.9427564726520103
314,1546632000,418,427,9,845,1,-0.3878457750456709,1.3293629406994092
314,1546646400,124,201,77,325,1,1.663427435195877,-0.38888802840014086
314,1546660800,22,57,35,79,1,0.3964645700466858,-1.2017529099356972
314,1546675200,66,149,83,215,1,1.8444221302171904,-0.7523641949404303
314,1546689600,414,104,0,518,1,-0.6593378175776405,0.24884742743873056
314,1546704000,322,167,0,489,1,-0.6593378175776405,0.15302189262356336
314,1546718400,274,189,0,463,1,-0.6593378175776405,0.06710934416858585
314,1546732800,143,179,36,322,1,0.42663035255023796,-0.3988010147603306
314,1546747200,21,58,37,79,1,0.45679613505379013,-1.2017529099356972
314,1546761600,41,27,0,68,1,-0.6593378175776405,-1.238100526589726
314,1546776000,241,101,0,342,1,-0.6593378175776405,-0.3327144390257325
314,1546790400,306,208,0,514,1,-0.6593378175776405,0.23563011229181094
314,1546804800,195,189,0,384,1,-0.6593378175776405,-0.19393262998307653
314,1546819200,80,133,53,213,1,0.939448655110625,-0.7589728525138901
314,1546833600,15,29,14,44,1,-0.23701686252791,-1.3174044174712438
314,1546848000,374,96,0,470,1,-0.6593378175776405,0.09023964567569519
314,1546862400,780,171,0,951,1,-0.6593378175776405,1.679621792092779
314,1546876800,394,264,0,658,1,-0.6593378175776405,0.711453457580917
314,1546891200,434,507,73,941,1,1.5427643051816684,1.64657850422548
314,1546905600,130,183,53,313,2,0.9976137353528279,-0.567324575382951
314,1546920000,7,39,32,46,2,0.3511072588052936,-1.4025586292551333
314,1546934400,432,70,0,502,2,-0.6340454673623778,0.023908518931065756
314,1546948800,855,207,0,1062,2,-0.6340454673623778,1.7757102798614857
314,1546963200,435,247,0,682,2,-0.6340454673623778,0.5869876563729864
314,1546977600,418,517,99,935,2,2.413770779218855,1.3784266662219082
314,1546992000,119,231,112,350,2,2.8139890742244718,-0.45158053046433394
314,1547006400,12,35,23,47,2,0.07403305457063603,-1.3994304118249006
314,1547020800,385,96,0,481,2,-0.6340454673623778,-0.041784047103824995
314,1547035200,858,189,0,1047,2,-0.6340454673623778,1.728787018407992
314,1547049600,463,269,0,732,2,-0.6340454673623778,0.7433985278846311
314,1547064000,438,424,0,862,2,-0.6340454673623778,1.1500667938149072
314,1547078400,135,226,91,361,2,2.1674825976769374,-0.4171701387317721
314,1547092800,18,29,11,47,2,-0.29539921774224076,-1.3994304118249006
314,1547107200,361,97,0,458,2,-0.6340454673623778,-0.11373304799918153
314,1547121600,751,215,0,966,2,-0.6340454673623778,1.475401406559128
314,1547136000,437,267,0,704,2,-0.6340454673623778,0.6558084398381101
314,1547150400,408,486,78,894,2,1.7672643026713213,1.2501697515823598
314,1547164800,113,228,115,341,2,2.906347142302691,-0.47973448733643
314,1547179200,14,41,27,55,2,0.19717714534159494,-1.3744046723830374
314,1547193600,348,79,0,427,2,-0.6340454673623778,-0.2107077883364012
314,1547208000,779,214,0,993,2,-0.6340454673623778,1.5598632771754162
314,1547222400,460,259,0,719,2,-0.6340454673623778,0.7027317012916034
314,1547236800,425,436,11,861,2,-0.29539921774224076,1.1469385763846742
314,1547251200,168,205,37,373,2,0.5050373722689923,-0.37963152956897744
314,1547265600,21,54,33,75,2,0.38189328149803337,-1.3118403237783796
314,1547280000,59,30,0,89,2,-0.6340454673623778,-1.268045279755119
314,1547294400,301,78,0,379,2,-0.6340454673623778,-0.3608622249875801
314,1547308800,349,187,0,536,2,-0.6340454673623778,0.13026791155898412
314,1547323200,316,204,0,520,2,-0.6340454673623778,0.08021643267525783
314,1547337600,126,160,34,286,2,0.4126793041907731,-0.6517864459992391
314,1547352000,20,53,33,73,2,0.38189328149803337,-1.3180967586388452
314,1547366400,45,29,0,74,2,-0.6340454673623778,-1.3149685412086123
314,1547380800,263,65,0,328,2,-0.6340454673623778,-0.5204013139294575
314,1547395200,382,172,0,554,2,-0.6340454673623778,0.18657582530317618
314,1547409600,204,184,0,388,2,-0.6340454673623778,-0.33270826811548404
314,1547424000,85,118,33,203,2,0.38189328149803337,-0.9114284927085692
314,1547438400,20,33,13,53,2,-0.2338271723567613,-1.380661107243503
314,1547452800,353,94,0,447,2,-0.6340454673623778,-0.14814343973174335
314,1547467200,788,179,0,967,2,-0.6340454673623778,1.4785296239893608
314,1547481600,407,250,0,657,2,-0.6340454673623778,0.5087822206171642
314,1547496000,423,453,30,876,2,0.28953521341981414,1.1938618378381676
314,1547510400,98,211,113,309,3,2.0702080351465693,-0.5259868963071785
314,1547524800,15,35,20,50,3,-0.09420111508964582,-1.3829114819039268
314,1547539200,380,86,0,466,3,-0.5596654484737781,-0.006538402335404514
314,1547553600,830,173,0,1003,3,-0.5596654484737781,1.7701739623960773
314,1547568000,433,219,0,652,3,-0.5596654484737781,0.6088591765101367
314,1547582400,468,472,4,940,3,-0.46657258179695166,1.561732846980652
314,1547596800,101,238,137,339,3,2.6287652352075277,-0.4267292222998332
314,1547611200,10,30,20,40,3,-0.09420111508964582,-1.4159973732397084
314,1547625600,380,104,0,484,3,-0.5596654484737781,0.0530162020690027
314,1547640000,840,214,0,1054,3,-0.5596654484737781,1.9389120082085645
314,1547654400,480,262,0,742,3,-0.5596654484737781,0.9066321985321727
314,1547668800,453,424,0,877,3,-0.5596654484737781,1.3532917315652269
314,1547683200,97,228,131,325,3,2.489125935192288,-0.47304947016992765
314,1547697600,11,42,31,53,3,0.16180426827162694,-1.3729857145031923
314,1547712000,397,81,0,478,3,-0.5596654484737781,0.03316466726753363
314,1547726400,838,188,0,1026,3,-0.5596654484737781,1.8462715124683753
314,1547740800,454,239,0,693,3,-0.5596654484737781,0.744511330986842
314,1547755200,454,437,0,891,3,-0.5596654484737781,1.3996119794353212
314,1547769600,87,251,164,338,3,3.2571420852761066,-0.43003781143341135
314,1547784000,7,58,51,65,3,0.6272686016557593,-1.333282644900254
314,1547798400,341,86,0,427,3,-0.5596654484737781,-0.13557337854495347
314,1547812800,789,187,0,976,3,-0.5596654484737781,1.6808420557894665
314,1547827200,426,255,0,681,3,-0.5596654484737781,0.7048082613839038
314,1547841600,440,417,0,857,3,-0.5596654484737781,1.2871199488936633
314,1547856000,136,218,82,354,3,1.348738318401164,-0.37710038529616047
314,1547870400,17,55,38,72,3,0.32471678495607326,-1.3101225209652068
314,1547884800,64,33,0,97,3,-0.5596654484737781,-1.2274077926257523
314,1547899200,340,129,0,469,3,-0.5596654484737781,0.003387365065330022
314,1547913600,363,154,0,517,3,-0.5596654484737781,0.16219964347708257
314,1547928000,323,217,0,540,3,-0.5596654484737781,0.2382971935493807
314,1547942400,118,160,42,278,3,0.4178096516328997,-0.6285531594481021
314,1547956800,19,54,35,73,3,0.2548971349484534,-1.3068139318316285
314,1547971200,40,138,98,178,3,1.72110978510847,-0.9594120728059199
314,1547985600,409,85,0,494,3,-0.5596654484737781,0.08610209340478449
314,1548000000,307,140,0,447,3,-0.5596654484737781,-0.0694015958733899
314,1548014400,201,181,0,382,3,-0.5596654484737781,-0.2844598895559715
314,1548028800,100,130,30,230,3,0.13853105160242032,-0.7873654378598546
314,1548043200,10,24,14,34,3,-0.23384041510488549,-1.4358489080411776
314,1548057600,115,59,0,174,3,-0.5596654484737781,-0.9726464293402326
314,1548072000,378,127,0,505,3,-0.5596654484737781,0.12249657387414445
314,1548086400,329,187,0,516,3,-0.5596654484737781,0.1588910543435044
314,1548100800,286,243,0,529,3,-0.5596654484737781,0.20190271308002072
314,1548115200,75,100,25,175,4,0.36198460764249324,-0.9844646254888826
314,1548129600,7,12,5,19,4,-0.3707071283085774,-1.4887026043978224
314,1548144000,323,75,0,398,4,-0.553880062296345,-0.2636628992280262
314,1548158400,777,172,0,949,4,-0.553880062296345,1.5173315006362422
314,1548172800,430,229,0,659,4,-0.553880062296345,0.5799660270234693
314,1548187200,454,412,0,866,4,-0.553880062296345,1.2490510374987935
314,1548201600,90,195,105,285,4,3.292751551446776,-0.6289122044633481
314,1548216000,13,12,0,25,4,-0.553880062296345,-1.4693088359782478
314,1548230400,332,69,0,401,4,-0.553880062296345,-0.2539660150182389
314,1548244800,819,224,0,1043,4,-0.553880062296345,1.8211672058762445
314,1548259200,450,215,0,665,4,-0.553880062296345,0.599359795443044
314,1548273600,451,451,0,902,4,-0.553880062296345,1.365413648016241
314,1548288000,99,147,48,246,4,1.2045801039862245,-0.754971699190583
314,1548302400,12,30,18,42,4,0.10554250005961853,-1.4143598254561198
314,1548316800,353,82,0,435,4,-0.553880062296345,-0.14406799397398276
314,1548331200,748,184,0,932,4,-0.553880062296345,1.4623824901141143
314,1548345600,383,247,0,630,4,-0.553880062296345,0.4862294796621921
314,1548360000,421,415,0,836,4,-0.553880062296345,1.1520821954009204
314,1548374400,108,195,87,303,4,2.633328989090812,-0.5707308992046242
314,1548388800,14,34,20,48,4,0.17881167365472558,-1.3949660570365452
314,1548403200,349,98,0,447,4,-0.553880062296345,-0.10528045713483355
314,1548417600,740,189,0,929,4,-0.553880062296345,1.452685605904327
314,1548432000,461,249,0,710,4,-0.553880062296345,0.7448130585898536
314,1548446400,449,397,0,846,4,-0.553880062296345,1.184405142766878
314,1548460800,151,233,82,384,4,2.4501560551030446,-0.308915025540367
314,1548475200,26,56,30,82,4,0.5451575416302609,-1.285068035992289
314,1548489600,64,38,0,102,4,-0.553880062296345,-1.2204221412603737
314,1548504000,328,90,0,418,4,-0.553880062296345,-0.19901700449611084
314,1548518400,349,172,0,521,4,-0.553880062296345,0.13390935337325333
314,1548532800,349,255,0,604,4,-0.553880062296345,0.4021898165107021
314,1548547200,173,214,41,387,4,0.9481379964033497,-0.29921814133057967
314,1548561600,23,69,46,92,4,1.1313109303911173,-1.2527450886263314
314,1548576000,46,34,0,80,4,-0.553880062296345,-1.2915326254654806
314,1548590400,311,87,0,398,4,-0.553880062296345,-0.2636628992280262
314,1548604800,352,203,0,555,4,-0.553880062296345,0.24380737441750944
314,1548619200,266,247,0,513,4,-0.553880062296345,0.10805099548048717
314,1548633600,98,162,64,260,4,1.7907334927470808,-0.7097195728782423
314,1548648000,19,28,9,47,4,-0.22416878111836328,-1.398198351773141
314,1548662400,350,90,0,440,4,-0.553880062296345,-0.12790652029100394
314,1548676800,804,168,0,972,4,-0.553880062296345,1.5916742795779448
314,1548691200,421,206,0,627,4,-0.553880062296345,0.4765325954524048
314,1548705600,407,462,55,869,4,1.4610222115690992,1.2587479217085809
314,1548720000,98,235,137,333,5,2.961399688459899,-0.3447084186333625
314,1548734400,9,25,16,34,5,-0.14490377978594,-1.2584302020675413
314,1548748800,391,75,0,466,5,-0.5556546516201005,0.06172969908150636
314,1548763200,832,179,0,1011,5,-0.5556546516201005,1.7272092040033376
314,1548777600,423,241,0,664,5,-0.5556546516201005,0.6668029871081532
314,1548792000,416,452,36,868,5,0.36853481000676064,1.2902118293174258
314,1548806400,99,235,136,334,5,2.935727758970264,-0.3416524929362582
314,1548820800,6,36,30,42,5,0.21450323306895044,-1.233982796490707
314,1548835200,382,87,0,469,5,-0.5556546516201005,0.07089747617281919
314,1548849600,851,196,0,1047,5,-0.5556546516201005,1.8372225290990916
314,1548862088,329,206,0,535,5,-0.5556546516201005,0.2725885721817015
314,1548862265,6,0,0,6,5,-0.5556546516201005,-1.343996121586461
314,1548864000,68,53,0,121,5,-0.5556546516201005,-0.9925646664194693
314,1548878400,421,495,74,916,5,1.3440681306128919,1.4368962627784312
314,1548892800,108,235,127,343,5,2.7046803935635486,-0.3141491616623197
314,1548907200,8,35,27,43,5,0.13748744460004536,-1.230926870793603
314,1548921600,339,77,0,416,5,-0.5556546516201005,-0.09106658577370749
314,1548936000,797,217,0,1014,5,-0.5556546516201005,1.7363769810946503
314,1548950400,431,215,0,646,5,-0.5556546516201005,0.6117963245602762
314,1548964800,410,439,29,849,5,0.18883130357931543,1.2321492410724446
314,1548979200,92,224,132,316,5,2.833040041011724,-0.3966591554841352
314,1548993600,11,48,37,59,5,0.3942067394963957,-1.1820320596399345
314,1549008000,328,85,0,413,5,-0.5556546516201005,-0.10023436286502033
314,1549020995,793,166,0,959,5,-0.5556546516201005,1.568301067753915
314,1549022400,26,27,1,53,5,-0.5299827221304655,-1.20036761382256
314,1549036800,462,232,0,694,5,-0.5556546516201005,0.7584807580212816
314,1549051200,474,419,0,893,5,-0.5556546516201005,1.3666099717450326
314,1549065600,165,230,65,395,5,1.1130207652061765,-0.1552410254128973
314,1549080000,13,57,44,70,5,0.5739102459238409,-1.1484168769717873
314,1549094400,56,38,0,94,5,-0.5556546516201005,-1.0750746602412848
314,1549108800,245,78,0,323,5,-0.5556546516201005,-0.37526767560440527
314,1549123200,306,132,0,438,5,-0.5556546516201005,-0.023836220437413395
314,1549137600,229,154,0,383,5,-0.5556546516201005,-0.19191213377814864
314,1549152000,102,116,14,218,5,-0.19624763876521006,-0.6961398738003544
314,1549166400,17,39,22,56,5,0.0091277971518702,-1.1911998367312473
314,1549180800,46,44,0,90,5,-0.5556546516201005,-1.087298363029702
314,1549195200,265,143,0,408,5,-0.5556546516201005,-0.11551399135054172
314,1549209600,258,117,0,375,5,-0.5556546516201005,-0.21635953935498287
314,1549224000,200,168,0,368,5,-0.5556546516201005,-0.2377510192347128
314,1549238400,74,97,23,171,5,0.034799726641505234,-0.8397683815642554
314,1549252800,14,29,15,43,5,-0.17057570927557503,-1.230926870793603
314,1549267200,374,90,0,464,5,-0.5556546516201005,0.05561784768729781
314,1549281600,808,172,0,980,5,-0.5556546516201005,1.632475507393105
314,1549296000,403,267,0,670,5,-0.5556546516201005,0.6851385412907789
314,1549310400,481,490,9,971,5,-0.3246072862133852,1.6049721761191664
314,1549324800,108,165,57,273,6,1.8854803513000107,-0.6544298239723396
314,1549339200,12,22,10,34,6,-0.10273450632083393,-1.353872602191499
314,1549353600,347,82,0,429,6,-0.525758944112503,-0.19788976789623552
314,1549368000,869,185,0,1054,6,-0.525758944112503,1.6311969952291816
314,1549382400,438,230,0,668,6,-0.525758944112503,0.501553010322924
314,1549396800,453,456,3,909,6,-0.39885161277500225,1.2068488661840848
314,1549411200,128,196,68,324,6,2.3508072328708467,-0.5051763441013056
314,1549425600,12,12,0,24,6,-0.525758944112503,-1.3831379904015058
314,1549440000,397,81,0,478,6,-0.525758944112503,-0.054489365667202826
314,1549454400,914,196,0,1110,6,-0.525758944112503,1.795083169205219
314,1549468800,469,252,0,721,6,-0.525758944112503,0.6566595678359594
314,1549483200,482,538,56,1020,6,1.8431779075208437,1.531694675315159
314,1549497600,151,183,32,334,6,0.827919256820838,-0.47591095589129895
314,1549512000,6,17,11,23,6,-0.06043206254166702,-1.3860645292225064
314,1549526400,375,105,0,480,6,-0.525758944112503,-0.048636288025201486
314,1549540800,861,209,0,1070,6,-0.525758944112503,1.6780216163651922
314,1549555200,467,269,0,736,6,-0.525758944112503,0.7005576501509694
314,1549569600,470,445,0,915,6,-0.525758944112503,1.2244080991100887
314,1549584000,122,226,104,348,6,3.8736952089208554,-0.4349394123972896
314,1549598400,10,24,14,34,6,0.0664752687958337,-1.353872602191499
314,1549612800,376,103,0,479,6,-0.525758944112503,-0.051562826846202156
314,1549627200,813,198,0,1011,6,-0.525758944112503,1.5053558259261528
314,1549641600,499,267,0,766,6,-0.525758944112503,0.7883538147809894
314,1549656000,496,439,0,935,6,-0.525758944112503,1.282938875530102
314,1549670400,150,211,61,361,6,2.0546901264166784,-0.3968944077242809
314,1549684800,26,59,33,85,6,0.8702217006000048,-1.2046191223204652
314,1549699200,70,43,0,113,6,-0.525758944112503,-1.1226760353324465
314,1549713600,275,89,0,364,6,-0.525758944112503,-0.3881147912612789
314,1549728000,286,142,0,428,6,-0.525758944112503,-0.2008163067172362
314,1549742400,305,191,0,496,6,-0.525758944112503,-0.0018116668891908101
314,1549756800,143,124,0,267,6,-0.525758944112503,-0.6719890568983437
314,1549771200,28,60,32,88,6,0.827919256820838,-1.1958395058574631
314,1549785600,46,27,0,73,6,-0.525758944112503,-1.239737588172473
314,1549800000,237,73,0,310,6,-0.525758944112503,-0.546147887595315
314,1549814400,305,118,0,423,6,-0.525758944112503,-0.21544900082223953
314,1549828800,209,180,0,389,6,-0.525758944112503,-0.3149513207362622
314,1549843200,81,107,26,188,6,0.5741045941458366,-0.9031856237573964
314,1549857600,17,19,2,36,6,-0.44115405655416917,-1.348019524549498
314,1549872000,373,90,0,463,6,-0.525758944112503,-0.09838744798221284
314,1549886400,818,178,0,996,6,-0.525758944112503,1.461457743611143
314,1549900800,420,238,0,658,6,-0.525758944112503,0.4722876221129173
314,1549915200,466,479,13,945,6,0.024172825016666795,1.3122042637401088
314,1549929600,116,244,128,360,7,3.219180598997264,0.058245940190641644
314,1549944000,15,25,10,40,7,-0.136078927528591,-0.7926512730291659
314,1549958400,408,103,0,511,7,-0.4204229552002736,0.45976306267873834
314,1549972800,791,172,0,963,7,-0.4204229552002736,1.6616553763517166
314,1549987200,379,250,0,629,7,-0.4204229552002736,0.7735314100535423
314,1550001600,392,450,58,842,7,1.2287724052954856,1.3399098676029768
314,1550016000,103,221,118,324,7,2.9348365713255813,-0.0374799962965867
314,1550030400,18,27,9,45,7,-0.16451333029575926,-0.7793560040726064
314,1550044800,413,79,0,492,7,-0.4204229552002736,0.4092410406438123
314,1550059200,826,187,0,1013,7,-0.4204229552002736,1.7946080659173114
314,1550073600,433,230,0,663,7,-0.4204229552002736,0.863939238958147
314,1550088000,452,441,0,893,7,-0.4204229552002736,1.4755216109598837
314,1550102400,116,249,133,365,7,3.3613526128331053,0.07154120914720113
314,1550116800,17,30,13,47,7,-0.05077571922708621,-0.7740378964899826
314,1550131200,383,109,0,492,7,-0.4204229552002736,0.4092410406438123
314,1550145600,862,188,0,1050,7,-0.4204229552002736,1.8929930561958517
314,1550160000,410,252,0,662,7,-0.4204229552002736,0.861280185166835
314,1550174400,525,513,0,1038,7,-0.4204229552002736,1.8610844107001088
314,1550188800,159,241,82,400,7,1.9111980717075239,0.1646080918431176
314,1550203200,15,37,22,52,7,0.20513390567742815,-0.7607426275334231
314,1550217600,369,102,0,471,7,-0.4204229552002736,0.35340091102626237
314,1550232000,796,175,0,971,7,-0.4204229552002736,1.6829278066822118
314,1550246400,492,259,0,751,7,-0.4204229552002736,1.097935972593594
314,1550260800,436,432,0,868,7,-0.4204229552002736,1.409045266177086
314,1550275200,103,150,47,253,7,0.9159939748566348,-0.2262728154797315
314,1550289600,0,0,0,0,7,-0.4204229552002736,-0.8990134246816418
314,1550304000,0,0,0,0,7,-0.4204229552002736,-0.8990134246816418
314,1550318400,0,0,0,0,7,-0.4204229552002736,-0.8990134246816418
314,1550332800,0,0,0,0,7,-0.4204229552002736,-0.8990134246816418
314,1550347200,0,0,0,0,7,-0.4204229552002736,-0.8990134246816418
314,1550361600,0,0,0,0,7,-0.4204229552002736,-0.8990134246816418
314,1550376000,0,0,0,0,7,-0.4204229552002736,-0.8990134246816418
314,1550390400,0,0,0,0,7,-0.4204229552002736,-0.8990134246816418
314,1550404800,0,0,0,0,7,-0.4204229552002736,-0.8990134246816418
314,1550419200,0,0,0,0,7,-0.4204229552002736,-0.8990134246816418
314,1550433600,0,0,0,0,7,-0.4204229552002736,-0.8990134246816418
314,1550448000,0,0,0,0,7,-0.4204229552002736,-0.8990134246816418
314,1550462400,0,1,1,1,7,-0.3919885524331054,-0.89635437089033
314,1550476800,0,0,0,0,7,-0.4204229552002736,-0.8990134246816418
314,1550491200,0,0,0,0,7,-0.4204229552002736,-0.8990134246816418
314,1550505600,0,0,0,0,7,-0.4204229552002736,-0.8990134246816418
314,1550520000,2,2,0,4,7,-0.4204229552002736,-0.8883772095163942
314,1550534400,4,6,2,10,8,-0.4160882817238295,-1.5548208660798426
314,1550548800,4,20,16,24,8,-0.11735823330672113,-1.5127445282091252
314,1550563200,298,72,0,370,8,-0.4587640029262735,-0.4728578922613955
314,1550577600,729,167,0,896,8,-0.4587640029262735,1.1080102305955577
314,1550592000,403,232,0,635,8,-0.4587640029262735,0.3235870745771836
314,1550606400,429,405,0,834,8,-0.4587640029262735,0.9216721628823807
314,1550620800,101,269,168,370,8,3.1259965780790266,-0.4728578922613955
314,1550635200,13,28,15,41,8,-0.13869609390794316,-1.4616518322232541
314,1550649600,320,86,0,406,8,-0.4587640029262735,-0.3646615948795508
314,1550664000,792,179,0,971,8,-0.4587640029262735,1.333419183474401
314,1550678400,360,246,0,606,8,-0.4587640029262735,0.2364289461306976
314,1550692800,393,402,9,795,8,-0.2667232575152753,0.8044595073853823
314,1550707200,104,211,107,315,8,1.8243870814044831,-0.6381577910392139
314,1550721600,9,32,23,41,8,0.03200679090183304,-1.4616518322232541
314,1550736000,304,77,0,381,8,-0.4587640029262735,-0.43979791250583183
314,1550750400,798,187,0,985,8,-0.4587640029262735,1.3754955213451183
314,1550764800,419,211,0,630,8,-0.4587640029262735,0.3085598110519274
314,1550779200,450,453,3,903,8,-0.39475042112260744,1.1290483995309164
314,1550793600,130,280,150,410,8,2.74191508725703,-0.3526397840593458
314,1550808000,15,38,23,53,8,0.03200679090183304,-1.4255863997626392
314,1550822400,315,75,0,390,8,-0.4587640029262735,-0.41274883816037067
314,1550836800,841,189,0,1030,8,-0.4587640029262735,1.5107408930724242
314,1550851200,419,269,0,688,8,-0.4587640029262735,0.48287606794489946
314,1550865600,473,399,0,872,8,-0.4587640029262735,1.035879365674328
314,1551484800,8832,6335,0,15167,9,-0.689041917625163,4.113640780678196
314,1551499200,10,62,52,72,9,0.7602687225931574,-0.3131378502302465
314,1551513600,51,35,0,86,9,-0.689041917625163,-0.309032192672597
314,1551528000,175,109,0,284,9,-0.689041917625163,-0.2509664643572693
314,1551542400,198,169,0,367,9,-0.689041917625163,-0.22662578026549055
314,1551556800,145,249,104,394,9,2.2095793628114775,-0.2187077264043095
314,1551571200,78,187,109,265,9,2.348936155140162,-0.25653842818550787
314,1551585600,14,59,45,73,9,0.5651692133329989,-0.31284458897612866
314,1551600000,40,39,0,79,9,-0.689041917625163,-0.31108502145142175
314,1551614400,149,98,0,247,9,-0.689041917625163,-0.26181713075962854
314,1551628800,174,158,0,332,9,-0.689041917625163,-0.23688992415961413
314,1551643200,156,191,35,347,9,0.28645562867562957,-0.2324910053478469
314,1551657600,57,128,71,185,9,1.289824533442159,-0.2799993285149332
314,1551672000,6,26,20,32,9,-0.13161474831042436,-0.3248683003949591
314,1551686400,265,84,0,349,9,-0.689041917625163,-0.23190448283961126
314,1551700800,713,191,0,904,9,-0.689041917625163,-0.06914448680422301
314,1551715200,368,190,0,558,9,-0.689041917625163,-0.17061288072898756
314,1551729600,383,392,9,775,9,-0.43819969143353055,-0.10697518858542136
314,1551744000,93,209,116,302,10,1.7331929185210952,-0.5760194041432434
314,1551758400,16,26,10,42,10,-0.47837912884374173,-1.3545010740992107
314,1551772800,400,105,0,505,10,-0.6870180012366509,0.031795130476223496
314,1551787200,849,176,0,1025,10,-0.6870180012366509,1.5887584703881583
314,1551801600,416,252,0,668,10,-0.6870180012366509,0.5198432543332338
314,1551816000,428,487,59,915,10,0.5439513458815132,1.2594008407914028
314,1551830400,95,278,183,373,10,3.1310733635535866,-0.36343402503988304
314,1551844800,15,37,22,52,10,-0.22801248197225077,-1.3245594714085966
314,1551859200,413,95,0,508,10,-0.6870180012366509,0.04077761128340773
314,1551873600,871,161,0,1032,10,-0.6870180012366509,1.609717592271588
314,1551888000,435,236,0,671,10,-0.6870180012366509,0.5288257351404181
314,1551902400,442,466,24,908,10,-0.18628470749366893,1.2384417189079728
314,1551916800,111,255,144,366,10,2.317381761221241,-0.3843931469233129
314,1551931200,10,32,22,42,10,-0.22801248197225077,-1.3545010740992107
314,1551945600,415,103,0,518,10,-0.6870180012366509,0.07071921397402187
314,1551960000,881,189,0,1070,10,-0.6870180012366509,1.7234956824959218
314,1551974400,443,205,0,648,10,-0.6870180012366509,0.45996004895200554
314,1551988800,498,466,0,964,10,-0.6870180012366509,1.406114693975412
314,1552003200,134,251,117,385,10,1.7540568057603863,-0.32750410181114603
314,1552017600,13,38,25,51,10,-0.16542082025437801,-1.327553631677658
314,1552032000,378,87,0,465,10,-0.6870180012366509,-0.08797128028623302
314,1552046400,875,189,0,1064,10,-0.6870180012366509,1.7055307208815533
314,1552060800,445,253,0,698,10,-0.6870180012366509,0.6096680624050762
314,1552075200,485,461,0,946,10,-0.6870180012366509,1.3522198091323065
314,1552089600,119,224,105,343,10,1.5036901588888953,-0.4532588331117254
314,1552104000,9,76,67,85,10,0.7108624437958404,-1.2257521825295699
314,1552118400,42,49,7,91,10,-0.5409707905616145,-1.2077872209152014
314,1552132800,202,126,0,328,10,-0.6870180012366509,-0.4981712371476466
314,1552147200,199,207,8,406,10,-0.5201069033223236,-0.2646267361608564
314,1552161600,187,224,37,411,10,0.08494582661711297,-0.24965593481554932
314,1552176000,79,172,93,251,10,1.2533235120174042,-0.7287215778653754
314,1552194000,12,85,73,97,10,0.836045767231586,-1.189822259300833
314,1552208400,54,53,0,107,10,-0.6870180012366509,-1.1598806566102189
314,1552222800,175,74,0,249,10,-0.6870180012366509,-0.7347098984034982
314,1552237200,187,187,0,374,10,-0.6870180012366509,-0.3604398647708216
314,1552251600,115,180,65,295,10,0.6691346693172586,-0.5969785260266732
314,1552266000,34,122,88,156,10,1.1490040758209497,-1.0131668034262096
314,1552280400,10,19,9,29,10,-0.4992430160830327,-1.3934251575970091
314,1552294800,752,159,0,911,10,-0.6870180012366509,1.2474241997151572
314,1552309200,576,171,0,747,10,-0.6870180012366509,0.7563819155890854
314,1552323600,534,277,0,811,10,-0.6870180012366509,0.9480081728090158
314,1552338000,373,482,109,855,10,1.587145707846059,1.079751224647718
314,1552352400,68,192,124,260,11,2.002418581271847,-0.8926527801289015
314,1552366800,26,28,2,54,11,-0.6284513701222412,-1.5199967695428611
314,1552381200,835,156,0,991,11,-0.6715803857188656,1.3335047745390813
314,1552395600,615,200,0,815,11,-0.6715803857188656,0.7975215602824944
314,1552410000,505,301,0,806,11,-0.6715803857188656,0.7701133277352826
314,1552424400,389,515,126,904,11,2.0455475968684715,1.0685585265827002
314,1552438800,89,217,128,306,11,2.088676612465096,-0.7525662582209299
314,1552453200,11,36,25,47,11,-0.13246769076106063,-1.5413142837462481
314,1552467600,845,175,0,1020,11,-0.6715803857188656,1.4218201905245416
314,1552482000,555,207,0,762,11,-0.6715803857188656,0.636117524171136
314,1552496400,545,329,0,874,11,-0.6715803857188656,0.9771977514253276
314,1552510800,392,476,84,868,11,1.1398382693393592,0.958925596393853
314,1552525200,104,208,104,312,11,1.5711284253056033,-0.7342941031894554
314,1552539600,16,32,16,48,11,-0.3265482609458704,-1.5382689245743357
314,1552554000,782,185,0,967,11,-0.6715803857188656,1.260416154413183
314,1552568400,617,191,0,808,11,-0.6715803857188656,0.7762040460791075
314,1552582800,529,311,0,840,11,-0.6715803857188656,0.8736555395803051
314,1552597200,399,464,65,863,11,0.7301126211714274,0.9436988005342909
314,1552611600,76,221,145,297,11,2.455273245036403,-0.7799744907681417
314,1552626000,16,29,13,45,11,-0.39124178434080703,-1.547405002090073
314,1552640400,749,164,0,913,11,-0.6715803857188656,1.095966759129912
314,1552654800,629,201,0,830,11,-0.6715803857188656,0.8432019478611809
314,1552669200,495,327,0,822,11,-0.6715803857188656,0.8188390744858814
314,1552683600,431,425,0,856,11,-0.6715803857188656,0.9223812863309039
314,1552698000,125,191,66,316,11,0.7516771289697396,-0.7221126665018057
314,1552712400,15,60,45,75,11,0.29882246520518335,-1.4560442269327
314,1552726800,149,69,0,218,11,-0.6715803857188656,-1.0205578653492233
314,1552741200,413,135,0,548,11,-0.6715803857188656,-0.015589338618123047
314,1552755600,371,212,0,583,11,-0.6715803857188656,0.09099823239881183
314,1552770000,296,260,0,556,11,-0.6715803857188656,0.008773534757176354
314,1552784400,123,213,90,336,11,1.2692253161292324,-0.6612054830635572
314,1552798800,25,52,27,77,11,-0.08933867516443625,-1.4499535085888753
314,1552813200,120,34,0,154,11,-0.6715803857188656,-1.2154608523516186
314,1552827600,316,166,0,482,11,-0.6715803857188656,-0.2165830439643431
314,1552842000,336,188,0,524,11,-0.6715803857188656,-0.08867795874402125
314,1552856400,219,248,29,467,11,-0.046209659567811846,-0.2622634315430295
314,1552870800,52,165,113,217,11,1.7652089954904129,-1.0236032245211357
314,1552885200,20,24,4,44,11,-0.5853223545256169,-1.5504503612619853
314,1552899600,745,172,0,917,11,-0.6715803857188656,1.1081481958175619
314,1552914000,558,177,0,735,11,-0.6715803857188656,0.5538928265295004
314,1552928400,486,344,0,830,11,-0.6715803857188656,0.8432019478611809
314,1552942800,371,473,102,844,11,1.5279994097089789,0.8858369762679548
314,1552957200,70,139,69,209,12,0.7185034565684432,-1.0748838348246517
314,1552971600,18,22,4,40,12,-0.5601891356296336,-1.6060029061497738
314,1552986000,773,137,0,910,12,-0.6388779105341306,1.128160360435174
314,1553000400,581,179,0,760,12,-0.6388779105341306,0.6567529006791485
314,1553014800,498,336,0,834,12,-0.6388779105341306,0.8893139141587877
314,1553029200,431,466,35,897,12,0.049648869880218396,1.0873050472563184
314,1553043600,98,208,110,306,12,1.5250633993395375,-0.7700403441824218
314,1553058000,19,16,0,35,12,-0.6388779105341306,-1.6217164881416413
314,1553072400,818,151,0,969,12,-0.6388779105341306,1.3135806279392106
314,1553086800,626,193,0,819,12,-0.6388779105341306,0.8421731681831852
314,1553101200,548,326,0,874,12,-0.6388779105341306,1.0150225700937279
314,1553115600,384,480,96,864,12,1.249652687173798,0.9835954061099929
314,1553130000,95,262,167,357,12,2.6463784417286202,-0.6097618078653733
314,1553144400,15,18,3,33,12,-0.5798613293557578,-1.6280019209383882
314,1553158800,722,181,0,903,12,-0.6388779105341306,1.1061613456465595
314,1553173200,574,181,0,755,12,-0.6388779105341306,0.641039318687281
314,1553187600,494,314,0,808,12,-0.6388779105341306,0.8076032878010766
314,1553202000,355,420,65,775,12,0.6398146816639461,0.7038936466547511
314,1553216400,81,221,140,302,12,2.1152292111232653,-0.7826112097759159
314,1553230800,15,34,19,49,12,-0.2651062297377697,-1.5777184585644122
314,1553245200,643,138,0,781,12,-0.6388779105341306,0.722749945044992
314,1553259600,622,189,0,811,12,-0.6388779105341306,0.8170314369961972
314,1553274000,482,314,0,796,12,-0.6388779105341306,0.7698906910205946
314,1553288400,428,390,0,818,12,-0.6388779105341306,0.8390304517848117
314,1553302800,125,226,101,351,12,1.3480136558044191,-0.6286181062556142
314,1553317200,23,48,25,71,12,-0.14707306738102416,-1.5085786978001952
314,1553331600,173,55,0,228,12,-0.6388779105341306,-1.0151722232555551
314,1553346000,381,139,0,520,12,-0.6388779105341306,-0.09749903493049224
314,1553360400,355,301,0,656,12,-0.6388779105341306,0.3299103952483042
314,1553374800,336,304,0,640,12,-0.6388779105341306,0.27962693287432816
314,1553389200,116,230,114,346,12,1.6037521742440346,-0.6443316882474818
314,1553403600,17,52,35,69,12,0.049648869880218396,-1.5148641305969421
314,1553418000,133,45,0,178,12,-0.6388779105341306,-1.1723080431742303
314,1553432400,339,171,0,510,12,-0.6388779105341306,-0.12892619891422727
314,1553446800,362,260,0,622,12,-0.6388779105341306,0.22305803770360508
314,1553461200,225,357,132,582,12,1.9578516613142711,0.09734938176866496
314,1553475600,58,159,101,217,12,1.3480136558044191,-1.0497421036376637
314,1553490000,18,22,4,40,12,-0.5601891356296336,-1.6060029061497738
314,1553504400,776,179,0,955,12,-0.6388779105341306,1.2695825983619815
314,1553518800,576,177,0,753,12,-0.6388779105341306,0.6347538858905339
314,1553533200,472,346,0,818,12,-0.6388779105341306,0.8390304517848117
314,1553547600,369,513,144,882,12,2.1939179860277624,1.0401643012807158
314,1553562000,72,156,84,228,13,1.170337619596492,-0.9492231524004944
314,1553576400,12,21,9,33,13,-0.39309049818508135,-1.531642812136788
314,1553590800,811,188,0,999,13,-0.5807018723188702,1.353574579172236
314,1553605200,563,196,0,759,13,-0.5807018723188702,0.6367503825737206
314,1553619600,479,329,0,808,13,-0.5807018723188702,0.7831019893792509
314,1553634000,356,543,187,899,13,3.31744556801652,1.0548978305895211
314,1553648400,97,196,99,293,13,1.4830232431528068,-0.7550832658217298
314,1553662800,15,22,7,37,13,-0.43478191465925664,-1.5196957421934794
314,1553677200,750,196,0,946,13,-0.5807018723188702,1.1952759024233972
314,1553691600,634,178,0,812,13,-0.5807018723188702,0.7950490593225594
314,1553706000,496,319,0,815,13,-0.5807018723188702,0.8040093617800409
314,1553720400,392,480,88,872,13,1.2537204525448427,0.9742551084721882
314,1553734800,86,169,83,255,13,1.1494919113594044,-0.8685804302831613
314,1553749200,16,22,6,38,13,-0.4556276228963443,-1.5167089747076523
314,1553763600,760,161,0,921,13,-0.5807018723188702,1.1206067152777184
314,1553778000,649,193,0,842,13,-0.5807018723188702,0.8846520838973738
314,1553792400,516,312,0,828,13,-0.5807018723188702,0.8428373390957938
314,1553806800,470,508,38,978,13,0.2114350406904604,1.2908524619698658
314,1553821200,92,167,75,259,13,0.9827262454627033,-0.8566333603398528
314,1553835600,16,23,7,39,13,-0.43478191465925664,-1.513722207221825
314,1553850000,702,166,0,868,13,-0.5807018723188702,0.9623080385288797
314,1553864400,669,181,0,850,13,-0.5807018723188702,0.908546223783991
314,1553878800,535,359,0,894,13,-0.5807018723188702,1.0399639931603855
314,1553893200,490,421,0,911,13,-0.5807018723188702,1.090739040419447
314,1553907600,141,219,78,360,13,1.0452633701739662,-0.5549698442713109
314,1553922000,19,48,29,67,13,0.023823666556671588,-1.430092717618665
314,1553936400,156,51,0,207,13,-0.5807018723188702,-1.0119452696028644
314,1553950800,402,128,0,530,13,-0.5807018723188702,-0.047219371680695975
314,1553965200,374,218,0,592,13,-0.5807018723188702,0.13796021244058712
314,1553979600,385,243,0,628,13,-0.5807018723188702,0.2454838419303644
314,1553994000,115,218,103,333,13,1.5664060761011573,-0.6356125663886439
314,1554008400,21,51,30,72,13,0.04466937479375924,-1.4151588801895292
314,1554022800,130,34,0,164,13,-0.5807018723188702,-1.1403762714934318
314,1554037200,319,116,0,435,13,-0.5807018723188702,-0.3309622828342749
314,1554051600,284,170,0,454,13,-0.5807018723188702,-0.27421370060355915
314,1554066000,211,208,0,419,13,-0.5807018723188702,-0.3787505626075093
314,1554080400,68,116,48,184,13,0.4198921230613369,-1.0806409217768889
314,1554094800,12,25,13,37,13,-0.30970766523673077,-1.5196957421934794
314,1554109200,761,135,0,896,13,-0.5807018723188702,1.0459375281320398
314,1554123600,537,185,0,722,13,-0.5807018723188702,0.5262399855981162
314,1554138000,477,289,0,766,13,-0.5807018723188702,0.6576577549745107
314,1554152400,344,530,186,874,13,3.296599859779432,0.9802286434438425
314,1554166800,74,197,123,271,14,1.9793423176957523,-0.8683325006701106
314,1554181200,18,23,5,41,14,-0.5243893123451228,-1.5741631937425835
314,1554195600,818,141,0,959,14,-0.6304796356519395,1.243021920346678
314,1554210000,587,212,0,799,14,-0.6304796356519395,0.7520092642962619
314,1554224400,503,321,0,824,14,-0.6304796356519395,0.8287299918041394
314,1554238800,383,467,84,850,14,1.1518377959025818,0.9085195484123321
314,1554253200,74,209,135,283,14,2.2339590936321123,-0.8315065514663293
314,1554267600,23,19,0,42,14,-0.6304796356519395,-1.5710943646422684
314,1554282000,855,164,0,1019,14,-0.6304796356519395,1.4271516663655839
314,1554296400,606,188,0,794,14,-0.6304796356519395,0.7366651187946864
314,1554310800,528,322,0,850,14,-0.6304796356519395,0.9085195484123321
314,1554325200,411,484,73,895,14,0.918439084627585,1.0466168579265116
314,1554339600,76,243,167,319,14,2.9129371627957394,-0.7210287038549857
314,1554354000,24,33,9,57,14,-0.43951705369966937,-1.5250619281375417
314,1554368400,780,169,0,949,14,-0.6304796356519395,1.212333629343527
314,1554382800,595,198,0,793,14,-0.6304796356519395,0.7335962896943713
314,1554397200,516,298,0,814,14,-0.6304796356519395,0.7980417008009885
314,1554411600,456,478,22,934,14,-0.16368221310194586,1.1663011928388003
314,1554426000,99,238,139,337,14,2.3188313522775656,-0.665789780049314
314,1554440400,17,47,30,64,14,0.006062304188960936,-1.5035801244353362
314,1554454800,709,134,0,843,14,-0.6304796356519395,0.8870377447101263
314,1554469200,626,204,0,830,14,-0.6304796356519395,0.84714296640603
314,1554483600,485,318,0,803,14,-0.6304796356519395,0.7642845806975224
314,1554498000,405,479,74,884,14,0.9396571492889483,1.0128597378230455
314,1554512400,123,177,54,300,14,0.5152958560616813,-0.7793364567609726
314,1554526800,16,40,24,56,14,-0.12124608377921915,-1.5281307572378569
314,1554541200,156,46,0,202,14,-0.6304796356519395,-1.0800817085918524
314,1554555600,442,143,0,585,14,-0.6304796356519395,0.09527983682883068
314,1554570000,375,217,0,592,14,-0.6304796356519395,0.11676164053103637
314,1554584400,383,244,0,627,14,-0.6304796356519395,0.22417065904206485
314,1554598800,112,179,67,291,14,0.7911306966594048,-0.8069559186638086
314,1554613200,17,54,37,71,14,0.15458875681850437,-1.4820983207331304
314,1554627600,128,39,0,167,14,-0.6304796356519395,-1.187490727102881
314,1554642000,374,142,0,516,14,-0.6304796356519395,-0.11646937109291118
314,1554656400,360,238,0,598,14,-0.6304796356519395,0.13517461513292697
314,1554670800,223,231,8,454,14,-0.46073511836103276,-0.30673677531244736
314,1554685200,81,136,55,217,14,0.5365139207230446,-1.034049272087126
314,1554699600,19,27,8,46,14,-0.46073511836103276,-1.5588190482410078
314,1554714000,684,161,0,845,14,-0.6304796356519395,0.8931754029107565
314,1554728400,594,215,0,809,14,-0.6304796356519395,0.782697555299413
314,1554742800,459,321,0,780,14,-0.6304796356519395,0.693701511390275
314,1554757200,361,495,134,856,14,2.212741028970749,0.9269325230142226
314,1554771600,80,174,94,254,15,1.4355603828870052,-0.930106811452931
314,1554786000,25,16,0,41,15,-0.6313952668715275,-1.5820998795659162
314,1554800400,810,140,0,950,15,-0.6313952668715275,1.2003494111134438
314,1554814800,584,192,0,776,15,-0.6313952668715275,0.6677353554718501
314,1554829200,492,331,0,823,15,-0.6313952668715275,0.811602370501476
314,1554843600,395,483,88,878,15,1.3036270435407158,0.9799573880893361
314,1554858000,74,174,100,248,15,1.5674937222332943,-0.9484728133716066
314,1554872400,15,16,1,31,15,-0.6094063769804793,-1.612709882763709
314,1554886800,807,192,0,999,15,-0.6313952668715275,1.3503384267826282
314,1554901200,635,205,0,840,15,-0.6313952668715275,0.8636393759377237
314,1554915600,503,292,0,795,15,-0.6313952668715275,0.7258943615476563
314,1554930000,425,521,96,946,15,1.4795381626691015,1.1881054098343267
314,1554944400,85,226,141,311,15,2.4690382077662716,-0.7556297932255124
314,1554958800,19,23,4,42,15,-0.5434397073073346,-1.579038879246137
314,1554973200,786,160,0,946,15,-0.6313952668715275,1.1881054098343267
314,1554987600,593,182,0,775,15,-0.6313952668715275,0.6646743551520709
314,1555002000,480,337,0,817,15,-0.6313952668715275,0.7932363685828003
314,1555016400,395,437,42,832,15,0.2921381085524978,0.8391513733794894
314,1555030800,102,232,130,334,15,2.227160418964741,-0.685226785870589
314,1555045200,25,34,9,59,15,-0.43349525785209353,-1.5270018738098894
314,1555059600,733,144,0,877,15,-0.6313952668715275,0.9768963877695568
314,1555074000,601,211,0,812,15,-0.6313952668715275,0.777931366983904
314,1555088400,502,366,0,868,15,-0.6313952668715275,0.9493473848915434
314,1555102800,499,447,0,946,15,-0.6313952668715275,1.1881054098343267
314,1555117200,123,246,123,369,15,2.0732381897274035,-0.5780917746783144
314,1555131600,25,37,12,62,15,-0.36752858817894885,-1.5178188728505515
314,1555146000,157,106,0,263,15,-0.6313952668715275,-0.9025578085749175
314,1555160400,397,151,0,548,15,-0.6313952668715275,-0.030172717437824372
314,1555174800,412,190,0,602,15,-0.6313952668715275,0.13512129983025642
314,1555189200,333,286,0,619,15,-0.6313952668715275,0.1871583052665041
314,1555203600,126,220,94,346,15,1.4355603828870052,-0.6484947820332377
314,1555218000,32,69,37,101,15,0.18219365909725665,-1.39843986037916
314,1555232400,118,46,0,164,15,-0.6313952668715275,-1.2055968402330657
314,1555246800,372,154,0,526,15,-0.6313952668715275,-0.0975147244729684
314,1555261200,396,185,0,581,15,-0.6313952668715275,0.07084029311489168
314,1555275600,229,255,26,484,15,-0.05968412970427376,-0.22607673790369792
314,1555290000,58,144,86,202,15,1.2596492637586194,-1.0892788280814532
314,1555304400,16,23,7,39,15,-0.47747303763418997,-1.5882218802054748
314,1555318800,791,143,0,934,15,-0.6313952668715275,1.1513734059969754
314,1555333200,546,178,0,724,15,-0.6313952668715275,0.5085633388433278
314,1555347600,458,310,0,768,15,-0.6313952668715275,0.6432473529136159
314,1555362000,391,507,116,898,15,1.9193159604900658,1.0411773944849216
314,1555376400,61,160,99,221,16,1.5042703502251527,-0.997027231150356
314,1555390800,22,19,0,41,16,-0.5491623865562606,-1.5689618140091988
314,1555405200,814,139,0,953,16,-0.5491623865562606,1.3288400724756049
314,1555419600,616,246,0,862,16,-0.5491623865562606,1.0396953666969677
314,1555434000,491,336,0,827,16,-0.5491623865562606,0.928485864474415
314,1555448400,395,491,96,886,16,1.442045115777231,1.1159533110781468
314,1555462800,81,255,174,336,16,3.059901211423193,-0.6316245809905396
314,1555477200,23,24,1,47,16,-0.5284206417402867,-1.549897327913904
314,1555491600,781,171,0,952,16,-0.5491623865562606,1.325662658126389
314,1555506000,623,204,0,827,16,-0.5491623865562606,0.928485864474415
314,1555520400,497,324,0,821,16,-0.5491623865562606,0.9094213783791202
314,1555534800,432,506,74,938,16,0.985726729825806,1.2811788572373681
314,1555549200,82,221,139,303,16,2.3339401428641073,-0.7364792545146609
314,1555563600,23,25,2,48,16,-0.5076788969243129,-1.5467199135646883
314,1555578000,766,161,0,927,16,-0.5491623865562606,1.2462272993959944
314,1555592400,627,188,0,815,16,-0.5491623865562606,0.8903568922838254
314,1555606800,523,306,0,829,16,-0.5491623865562606,0.9348406931728466
314,1555621200,428,417,0,845,16,-0.5491623865562606,0.9856793227602992
314,1555635600,102,232,130,334,16,2.1472644395203426,-0.6379794096889713
314,1555650000,16,46,30,62,16,0.07308995792295558,-1.5022361126756671
314,1555664400,524,115,0,639,16,-0.5491623865562606,0.33113196682184576
314,1555678800,579,244,0,823,16,-0.5491623865562606,0.9157762070775518
314,1555693200,497,345,0,842,16,-0.5491623865562606,0.9761470797126518
314,1555707600,471,377,0,848,16,-0.5491623865562606,0.9952115658079466
314,1555722000,136,198,62,334,16,0.7368257920341195,-0.6379794096889713
314,1555736400,21,37,16,58,16,-0.21729446950067863,-1.5149457700725304
314,1555750800,122,56,0,178,16,-0.5491623865562606,-1.1336560481666351
314,1555765200,387,129,0,516,16,-0.5491623865562606,-0.05968999813169685
314,1555779600,390,191,0,581,16,-0.5491623865562606,0.14684193456732975
314,1555794000,316,246,0,562,16,-0.5491623865562606,0.08647106193222966
314,1555808400,123,171,48,294,16,0.4464413646104853,-0.765075983657603
314,1555822800,17,48,31,65,16,0.09383170273892946,-1.4927038696280197
314,1555837200,114,61,0,175,16,-0.5491623865562606,-1.1431882912142826
314,1555851600,334,150,0,484,16,-0.5491623865562606,-0.16136725730660223
314,1555866000,347,214,0,561,16,-0.5491623865562606,0.08329364758301386
314,1555880400,275,187,0,462,16,-0.5491623865562606,-0.2312703729893497
314,1555894800,86,129,43,215,16,0.3427326405306159,-1.0160917172456507
314,1555909200,27,33,6,60,16,-0.4247119176604173,-1.5085909413740988
314,1555923600,632,120,0,752,16,-0.5491623865562606,0.6901797882832305
314,1555938000,550,183,0,733,16,-0.5491623865562606,0.6298089156481304
314,1555952400,369,287,0,656,16,-0.5491623865562606,0.38514801075851424
314,1555966800,294,455,161,749,16,2.790258528815533,0.680647545235583
314,1555981200,87,157,70,244,17,0.9827749502684453,-0.8984668012253583
314,1555995600,19,18,0,37,17,-0.6487091568965626,-1.543759685971601
314,1556010000,624,125,0,749,17,-0.6487091568965626,0.6757984490009823
314,1556024400,566,224,0,790,17,-0.6487091568965626,0.8036100831777743
314,1556038800,491,304,0,795,17,-0.6487091568965626,0.8191968678334807
314,1556053200,389,472,83,861,17,1.2857648558848038,1.0249424252888044
314,1556067600,94,220,126,314,17,2.2879622360004515,-0.6802518160454695
314,1556082000,24,21,0,45,17,-0.6487091568965626,-1.5188208305224706
314,1556096400,702,139,0,841,17,-0.6487091568965626,0.9625952866659789
314,1556110800,571,191,0,762,17,-0.6487091568965626,0.7163240891058188
314,1556125200,459,272,0,731,17,-0.6487091568965626,0.6196860242404394
314,1556139600,379,436,57,815,17,0.6797850446520867,0.881544006456306
314,1556154000,90,220,130,310,17,2.3811898992670235,-0.6927212437700345
314,1556168400,17,21,4,38,17,-0.5554814936299908,-1.5406423290404596
314,1556182800,638,144,0,782,17,-0.6487091568965626,0.7786712277286442
314,1556197200,593,184,0,777,17,-0.6487091568965626,0.7630844430729378
314,1556211600,488,267,0,755,17,-0.6487091568965626,0.6945025905878299
314,1556226000,381,485,104,866,17,1.7752100880343062,1.0405292099445107
314,1556240400,99,226,127,325,17,2.3112691518170947,-0.6459608898029155
314,1556254800,28,40,12,68,17,-0.369026167096847,-1.4471216211062214
314,1556269200,579,110,0,689,17,-0.6487091568965626,0.4887570331325062
314,1556283600,559,193,0,752,17,-0.6487091568965626,0.6851505197944061
314,1556298000,166,276,110,442,17,1.915051582934164,-0.28123012885938714
314,1556312400,772,594,0,1366,17,-0.6487091568965626,2.599207675515145
314,1556326800,113,178,65,291,17,0.8662403711852305,-0.7519510254617187
314,1556341200,20,43,23,63,17,-0.11265009311377433,-1.462708405761928
314,1556355600,165,69,0,234,17,-0.6487091568965626,-0.929640370536771
314,1556370000,441,168,0,609,17,-0.6487091568965626,0.2393684786412047
314,1556384400,442,243,0,685,17,-0.6487091568965626,0.4762876054079411
314,1556398800,349,221,0,570,17,-0.6487091568965626,0.11779155832669522
314,1556413200,133,185,52,318,17,0.5632504655688718,-0.6677823883209044
314,1556427600,21,58,37,79,17,0.21364672831922724,-1.4128306948636675
314,1556442000,124,45,0,169,17,-0.6487091568965626,-1.1322685710609535
314,1556456400,360,127,0,487,17,-0.6487091568965626,-0.14094906695803006
314,1556470800,350,210,0,560,17,-0.6487091568965626,0.08661798901528255
314,1556485200,243,235,0,478,17,-0.6487091568965626,-0.16900527933830148
314,1556499600,67,145,78,212,17,1.169230276801589,-0.9982222230218789
314,1556514000,27,29,2,56,17,-0.6020953252632767,-1.4845299042799167
314,1556528400,813,142,0,955,17,-0.6487091568965626,1.3179739768160836
314,1556542800,554,188,0,742,17,-0.6487091568965626,0.6539769504829934
314,1556557200,478,326,0,804,17,-0.6487091568965626,0.847253080213752
314,1556571600,399,488,89,887,17,1.4256063507846617,1.1059937054984774
314,1556586000,85,200,115,285,18,1.9567611347593548,-0.8607831967402868
314,1556600400,19,31,12,50,18,-0.36494722206153624,-1.5697226286350323
314,1556614800,848,140,0,988,18,-0.6354375160600867,1.2600015718639943
314,1556629200,593,183,0,776,18,-0.6354375160600867,0.6204477013887346
314,1556643600,497,296,0,793,18,-0.6354375160600867,0.6717326815683545
314,1556658000,412,511,99,923,18,1.5961074094279541,1.0639119417654477
314,1556672400,93,235,142,328,18,2.565364296256093,-0.7310623645212483
314,1556686800,13,30,17,43,18,-0.25224293289547356,-1.590839973414876
314,1556701200,782,145,0,927,18,-0.6354375160600867,1.0759789959253583
314,1556715600,620,201,0,821,18,-0.6354375160600867,0.7562020606877284
314,1556730000,500,333,0,833,18,-0.6354375160600867,0.7924032231674601
314,1556744400,445,478,33,923,18,0.10841079243592697,1.0639119417654477
314,1556758800,86,242,156,328,18,2.8809363059210686,-0.7310623645212483
314,1556773200,16,29,13,45,18,-0.3424063642283237,-1.5848064463349205
314,1556787600,791,152,0,943,18,-0.6354375160600867,1.1242472125650005
314,1556802000,641,195,0,836,18,-0.6354375160600867,0.801453513787393
314,1556816400,539,371,0,910,18,-0.6354375160600867,1.0246940157457385
314,1556830800,436,464,28,900,18,-0.004293496730135705,0.994526380345962
314,1556845200,104,223,119,327,18,2.046924566092205,-0.734079128061226
314,1556859600,21,45,24,66,18,-0.09445692806298585,-1.52145441199539
314,1556874000,765,156,0,921,18,-0.6354375160600867,1.0578784146854925
314,1556888400,624,176,0,800,18,-0.6354375160600867,0.6928500263481979
314,1556902800,536,337,0,873,18,-0.6354375160600867,0.9130737647665658
314,1556917200,473,461,0,934,18,-0.6354375160600867,1.097096340705202
314,1556931600,140,245,105,385,18,1.7313525564272294,-0.5591068427425228
314,1556946000,16,66,50,82,18,0.4916053756005401,-1.473186195355748
314,1556960400,168,62,0,230,18,-0.6354375160600867,-1.026705191439057
314,1556974800,435,167,0,602,18,-0.6354375160600867,0.09553084543262516
314,1556989200,453,227,0,680,18,-0.6354375160600867,0.3308384015508811
314,1557003600,363,276,0,639,18,-0.6354375160600867,0.20715109641179785
314,1557018000,138,222,84,360,18,1.2579945419297662,-0.6345259312419638
314,1557032400,16,62,46,78,18,0.4014419442676899,-1.4852532495156585
314,1557046800,122,45,0,167,18,-0.6354375160600867,-1.2167612944576485
314,1557061200,360,127,0,487,18,-0.6354375160600867,-0.25139696166480346
314,1557075600,322,239,0,561,18,-0.6354375160600867,-0.02815645970645809
314,1557090000,225,235,10,460,18,-0.41002893772796134,-0.3328495772441998
314,1557104400,61,116,55,177,18,0.6043096647666027,-1.186593659057872
314,1557118800,17,19,2,36,18,-0.5903558003936616,-1.6119573181947193
314,1557133200,771,148,0,919,18,-0.6354375160600867,1.0518448876055373
314,1557147600,566,170,0,736,18,-0.6354375160600867,0.499777159789629
314,1557162000,518,354,0,872,18,-0.6354375160600867,0.9100570012265881
314,1557176400,418,492,74,910,18,1.0325859635976409,1.0246940157457385
314,1557190800,73,231,158,304,19,2.489512145702487,-0.7801347076631577
314,1557205200,22,27,5,49,19,-0.5012534269810391,-1.5593962931017342
314,1557219600,798,140,0,938,19,-0.5989908639968407,1.1573235086821658
314,1557234000,609,245,0,854,19,-0.5989908639968407,0.9006255746553407
314,1557248400,513,355,0,868,19,-0.5989908639968407,0.9434085636598115
314,1557262800,422,526,104,948,19,1.4339478259318308,1.1878827865425021
314,1557277200,88,244,156,332,19,2.4504171708961664,-0.694568729654216
314,1557291600,25,29,4,54,19,-0.5208009143841995,-1.544116654171566
314,1557306000,827,145,0,972,19,-0.5989908639968407,1.2612250534073095
314,1557320400,647,201,0,848,19,-0.5989908639968407,0.8822900079391389
314,1557334800,480,312,0,792,19,-0.5989908639968407,0.7111580519212554
314,1557349200,451,471,20,922,19,-0.20804111593363464,1.1084286641056278
314,1557363600,95,244,149,339,19,2.3135847590740446,-0.6731772351519806
314,1557378000,23,20,0,43,19,-0.5989908639968407,-1.577731859817936
314,1557392400,773,181,0,954,19,-0.5989908639968407,1.206218353258704
314,1557406800,628,200,0,828,19,-0.5989908639968407,0.8211714522184662
314,1557421200,521,339,0,860,19,-0.5989908639968407,0.9189611413715425
314,1557435600,407,508,101,915,19,1.3753053637223498,1.0870371696033923
314,1557450000,100,231,131,331,19,1.9617299858171589,-0.6976246574402496
314,1557464400,25,33,8,58,19,-0.44261096477155826,-1.5318929430274315
314,1557478800,752,154,0,906,19,-0.5989908639968407,1.0595338195290895
314,1557493200,588,187,0,775,19,-0.5989908639968407,0.6592072795586836
314,1557507600,485,296,0,781,19,-0.5989908639968407,0.6775428462748855
314,1557522000,454,445,0,899,19,-0.5989908639968407,1.0381423250268542
314,1557536400,140,213,73,353,19,0.8279757164338615,-0.6303942461475097
314,1557550800,20,62,42,82,19,0.22200360693589202,-1.4585506761626243
314,1557565200,181,58,0,239,19,-0.5989908639968407,-0.9787700137553439
314,1557579600,436,177,0,613,19,-0.5989908639968407,0.16414697822123503
314,1557594000,395,238,0,633,19,-0.5989908639968407,0.22526553394190768
314,1557608400,362,242,0,604,19,-0.5989908639968407,0.13664362814693232
314,1557622800,125,183,58,308,19,0.5347634053864568,-0.7679109965190232
314,1557637200,22,48,26,70,19,-0.09075619151467282,-1.495221809595028
314,1557651600,115,39,0,154,19,-0.5989908639968407,-1.2385238755682026
314,1557666000,349,123,0,472,19,-0.5989908639968407,-0.2667388396095073
314,1557680400,279,173,0,452,19,-0.5989908639968407,-0.32785739533018
314,1557694800,185,226,41,411,19,0.2024561195327317,-0.45315043455755893
314,1557709200,76,133,57,209,19,0.5152159179832966,-1.0704478473363528
314,1557723600,21,23,2,44,19,-0.55989588919052,-1.5746759320319024
314,1557738000,707,153,0,860,19,-0.5989908639968407,0.9189611413715425
314,1557752400,604,160,0,764,19,-0.5989908639968407,0.6255920739123136
314,1557766800,515,307,0,822,19,-0.5989908639968407,0.8028358855022644
314,1557781200,339,491,152,830,19,2.3722272212835254,0.8272833077905335
314,1557795600,84,165,81,249,20,1.5149317943592764,-1.0161537642313128
314,1557810000,19,23,4,42,20,-0.4718035758588501,-1.6333425881957555
314,1557824400,773,142,0,915,20,-0.5750106080779736,0.9695841911325462
314,1557838800,618,197,0,815,20,-0.5750106080779736,0.6714253389758106
314,1557853200,519,313,0,832,20,-0.5750106080779736,0.7221123438424557
314,1557867600,358,488,130,846,20,2.779217939043539,0.7638545831443987
314,1557882000,87,169,82,256,20,1.5407335524140573,-0.9952826445803413
314,1557896400,24,22,0,46,20,-0.5750106080779736,-1.621416234109486
314,1557910800,798,149,0,947,20,-0.5750106080779736,1.0649950238227015
314,1557925200,636,184,0,820,20,-0.5750106080779736,0.6863332815836474
314,1557939600,571,325,0,896,20,-0.5750106080779736,0.9129340092227665
314,1557954000,480,475,0,955,20,-0.5750106080779736,1.0888477319952405
314,1557968400,96,208,112,304,20,2.3147862940574835,-0.8521663955451082
314,1557982800,21,28,7,49,20,-0.39439830169450746,-1.612471468544784
314,1557997200,774,155,0,929,20,-0.5750106080779736,1.011326430434489
314,1558011600,660,224,0,884,20,-0.5750106080779736,0.8771549469639581
314,1558026000,586,330,0,916,20,-0.5750106080779736,0.9725657796541136
314,1558040400,460,436,0,896,20,-0.5750106080779736,0.9129340092227665
314,1558054800,113,231,118,344,20,2.4695968423861685,-0.732902854682414
314,1558069200,19,43,24,62,20,0.04423158523676722,-1.5737108177644084
314,1558083600,704,152,0,856,20,-0.5750106080779736,0.7936704683600723
314,1558098000,670,181,0,851,20,-0.5750106080779736,0.7787625257522355
314,1558112400,563,395,0,958,20,-0.5750106080779736,1.0977924975599425
314,1558126800,499,432,0,931,20,-0.5750106080779736,1.0172896074776239
314,1558141200,114,219,105,333,20,2.1341739876740173,-0.7657003284196549
314,1558155600,30,65,35,95,20,0.32805092383935675,-1.4753183965526855
314,1558170000,196,53,0,249,20,-0.5750106080779736,-1.0161537642313128
314,1558184400,451,177,0,628,20,-0.5750106080779736,0.11386828544271509
314,1558198800,493,257,0,750,20,-0.5750106080779736,0.4776220850739325
314,1558213200,412,266,0,678,20,-0.5750106080779736,0.26294771152108287
314,1558227600,155,206,51,361,20,0.7408790527158505,-0.6822158498157689
314,1558242000,18,75,57,93,20,0.8956896010445358,-1.4812815735958202
314,1558256400,126,53,0,179,20,-0.5750106080779736,-1.2248649607410278
314,1558270800,479,163,0,642,20,-0.5750106080779736,0.15561052474465806
314,1558285200,456,252,0,708,20,-0.5750106080779736,0.35239536716810355
314,1558299600,397,212,0,609,20,-0.5750106080779736,0.05721810353293532
314,1558314000,121,169,48,290,20,0.6634737785515079,-0.8939086348470512
314,1558328400,15,18,3,33,20,-0.49760533391363093,-1.6601768848898617
314,1558342800,806,181,0,987,20,-0.5750106080779736,1.1842585646853958
314,1558357200,604,183,0,787,20,-0.5750106080779736,0.5879408603719246
314,1558371600,535,337,0,872,20,-0.5750106080779736,0.8413758847051499
314,1558386000,400,479,79,879,20,1.4633282782497148,0.8622470043561214
314,1558400400,97,199,102,296,21,1.9837979368308374,-0.7579067045529017
314,1558414800,22,36,14,58,21,-0.231343203509578,-1.500655275014745
314,1558429200,798,170,0,968,21,-0.5837520212910077,1.3392657296923034
314,1558443600,614,188,0,802,21,-0.5837520212910077,0.821214205756732
314,1558458000,569,322,0,891,21,-0.5837520212910077,1.098964721601707
314,1558472400,477,484,7,961,21,-0.40754761240029286,1.3174201835022492
314,1558486800,110,214,104,324,21,2.034142053656756,-0.6705245197926847
314,1558501200,19,21,2,40,21,-0.5334079044650892,-1.5568295366463132
314,1558515600,763,178,0,941,21,-0.5837520212910077,1.2550043372449515
314,1558530000,620,207,0,827,21,-0.5837520212910077,0.8992340135783542
314,1558544400,577,312,0,889,21,-0.5837520212910077,1.0927231369759773
314,1558558800,467,493,26,960,21,0.07072149744593319,1.3142993911893843
314,1558573200,106,220,114,326,21,2.2858626377863485,-0.6642829351669549
314,1558587600,23,19,0,42,21,-0.5837520212910077,-1.5505879520205832
314,1558602000,727,157,0,884,21,-0.5837520212910077,1.077119175411653
314,1558616400,622,184,0,806,21,-0.5837520212910077,0.8336973750081915
314,1558630800,541,330,0,871,21,-0.5837520212910077,1.0365488753444092
314,1558645200,383,509,126,892,21,2.58792733874186,1.102085513914572
314,1558659600,77,213,136,290,21,2.8396479228714524,-0.776631458430091
314,1558674000,25,49,24,74,21,0.02037738062001466,-1.450722598008907
314,1558688400,667,147,0,814,21,-0.5837520212910077,0.8586637135111107
314,1558702800,549,196,0,745,21,-0.5837520212910077,0.6433290439234334
314,1558717200,575,403,0,978,21,-0.5837520212910077,1.3704736528209525
314,1558731600,501,364,0,865,21,-0.5837520212910077,1.01782412146722
314,1558746000,134,191,57,325,21,0.8510553082476704,-0.6674037274798198
314,1558760400,25,58,33,83,21,0.24692590633664804,-1.422635467193123
314,1558774800,161,53,0,214,21,-0.5837520212910077,-1.0138116742078225
314,1558789200,377,174,0,551,21,-0.5837520212910077,0.037895335227644975
314,1558803600,398,267,0,665,21,-0.5837520212910077,0.39366565889424227
314,1558818000,404,259,0,663,21,-0.5837520212910077,0.3874240742685125
314,1558832400,107,182,75,289,21,1.3041523596809372,-0.7797522507429558
314,1558846800,18,58,40,76,21,0.42313031522736294,-1.4444810133831771
314,1558861200,124,43,0,167,21,-0.5837520212910077,-1.1604889129124722
314,1558875600,367,129,0,496,21,-0.5837520212910077,-0.1337482419799239
314,1558890000,361,234,0,595,21,-0.5837520212910077,0.17521019699370008
314,1558904400,281,266,0,547,21,-0.5837520212910077,0.02541216597618542
314,1558918800,103,179,76,282,21,1.3293244180938966,-0.80159779693301
314,1558933200,22,60,38,82,21,0.3727861984014444,-1.4257562595059878
314,1558947600,168,53,0,221,21,-0.5837520212910077,-0.9919661280177683
314,1558962000,404,159,0,563,21,-0.5837520212910077,0.07534484298202364
314,1558976400,432,268,0,700,21,-0.5837520212910077,0.5028933898445134
314,1558990800,320,249,0,569,21,-0.5837520212910077,0.09406959685921297
314,1559005200,83,169,86,252,22,1.3079393580052339,-1.0171554742401578
314,1559019600,16,25,9,41,22,-0.42348752852318455,-1.6582216724277885
314,1559034000,746,180,0,926,22,-0.6258620996758568,1.0306104858473455
314,1559048400,588,190,0,778,22,-0.6258620996758568,0.580952678587775
314,1559062800,511,349,0,860,22,-0.6258620996758568,0.8300874096369965
314,1559077200,391,476,85,867,22,1.285453294543826,0.8513550086290032
314,1559091600,68,182,114,250,22,1.9375491349246587,-1.0232319310950169
314,1559106000,12,23,11,35,22,-0.3785154016003685,-1.6764510429923658
314,1559120400,744,142,0,886,22,-0.6258620996758568,0.9090813487501642
314,1559134800,567,231,0,798,22,-0.6258620996758568,0.6417172471363656
314,1559149200,547,317,0,864,22,-0.6258620996758568,0.8422403233467145
314,1559163600,363,527,164,890,22,3.06185230799506,0.9212342624598824
314,1559178000,98,160,62,258,22,0.7682738349314412,-0.9989261036755807
314,1559192400,11,37,26,48,22,-0.04122444967924803,-1.636954073435782
314,1559206800,776,173,0,949,22,-0.6258620996758568,1.1004897396782245
314,1559221200,615,195,0,810,22,-0.6258620996758568,0.67817598826552
314,1559235600,541,361,0,902,22,-0.6258620996758568,0.9576930035890366
314,1559250000,365,499,134,864,22,2.387270404152819,0.8422403233467145
314,1559264400,73,199,126,272,22,2.207381896461555,-0.9563909056915672
314,1559278800,10,41,31,51,22,0.07120586762779213,-1.6278393881534934
314,1559293200,674,141,0,815,22,-0.6258620996758568,0.6933671304026676
314,1559307600,570,228,0,798,22,-0.6258620996758568,0.6417172471363656
314,1559322000,510,364,0,874,22,-0.6258620996758568,0.8726226076210098
314,1559336400,492,472,0,964,22,-0.6258620996758568,1.1460631660896676
314,1559350800,150,184,34,334,22,0.13866405801201623,-0.7680207431909364
314,1559365200,32,80,48,112,22,0.45346894647172864,-1.442507454080292
314,1559379600,213,64,0,277,22,-0.6258620996758568,-0.9411997635544196
314,1559394000,528,170,0,698,22,-0.6258620996758568,0.33789440439341256
314,1559408400,516,303,0,819,22,-0.6258620996758568,0.7055200441123857
314,1559422800,424,293,0,717,22,-0.6258620996758568,0.39562074451457363
314,1559437200,188,207,19,395,22,-0.19862689390910424,-0.582688809117735
314,1559451600,21,73,52,94,22,0.5434132003173607,-1.4971955657740235
314,1559466000,133,61,0,194,22,-0.6258620996758568,-1.1933727230310704
314,1559480400,480,233,0,713,22,-0.6258620996758568,0.3834678308048555
314,1559494800,475,292,0,767,22,-0.6258620996758568,0.5475321658860501
314,1559509200,351,297,0,648,22,-0.6258620996758568,0.18598298302193608
314,1559523600,124,165,41,289,22,0.2960665022418724,-0.9047410224252652
314,1559538000,23,35,12,58,22,-0.3560293381389605,-1.6065717891614866
314,1559552400,772,161,0,933,22,-0.6258620996758568,1.051878084839352
314,1559566800,615,189,0,804,22,-0.6258620996758568,0.6599466177009428
314,1559581200,514,346,0,860,22,-0.6258620996758568,0.8300874096369965
314,1559595600,383,498,115,881,22,1.9600351983860669,0.8938902066130165
314,1559610000,91,194,103,285,23,1.9653616994164662,-0.8944747970097364
314,1559624400,19,38,19,57,23,-0.107522030192291,-1.5966793105500903
314,1559638800,690,152,0,842,23,-0.576388588079986,0.8209985101919174
314,1559653200,627,227,0,854,23,-0.576388588079986,0.8579566424835149
314,1559667600,518,309,0,827,23,-0.576388588079986,0.7748008448274204
314,1559682000,435,457,22,892,23,-0.03349046842054966,0.9749907280735739
314,1559696400,116,264,148,380,23,3.0758351259925862,-0.601889583034589
314,1559710800,31,32,1,63,23,-0.551711400822739,-1.5782002444042913
314,1559725200,777,166,0,943,23,-0.576388588079986,1.1320627903128635
314,1559739600,656,197,0,853,23,-0.576388588079986,0.8548767981258818
314,1559754000,566,292,0,858,23,-0.576388588079986,0.8702760199140475
314,1559768400,473,561,88,1034,23,1.5952038905577595,1.4123286268574784
314,1559782800,92,213,121,305,23,2.409551070046914,-0.8328779098570738
314,1559797200,23,26,3,49,23,-0.5023570263082447,-1.6213180654111552
314,1559811600,733,164,0,897,23,-0.576388588079986,0.9903899498617396
314,1559826000,647,206,0,853,23,-0.576388588079986,0.8548767981258818
314,1559840400,494,315,0,809,23,-0.576388588079986,0.719363646390024
314,1559854800,463,467,4,930,23,-0.47767983905099765,1.0920248136636328
314,1559869200,142,231,89,373,23,1.6198810778150066,-0.6234484935380209
314,1559883600,13,39,26,52,23,0.06521828060843878,-1.6120785323382558
314,1559898000,677,168,0,845,23,-0.576388588079986,0.8302380432648168
314,1559912400,687,231,0,918,23,-0.576388588079986,1.0550666813720353
314,1559926800,567,355,0,922,23,-0.576388588079986,1.0673860588025679
314,1559941200,499,466,0,965,23,-0.576388588079986,1.1998193661807923
314,1559955600,186,231,45,417,23,0.5340848384961339,-0.4879353418021632
314,1559970000,24,47,23,71,23,-0.008813281163302551,-1.5535614895432264
314,1559984400,195,66,0,261,23,-0.576388588079986,-0.9683910615929315
314,1559998800,401,146,0,547,23,-0.576388588079986,-0.08755557530985619
314,1560013200,427,252,0,679,23,-0.576388588079986,0.31898387989771704
314,1560027600,360,209,0,569,23,-0.576388588079986,-0.01979899944192732
314,1560042000,155,187,32,342,23,0.21328140415192146,-0.718923668624648
314,1560056400,18,66,48,84,23,0.6081164002678752,-1.5135235128939957
314,1560070800,136,41,0,177,23,-0.576388588079986,-1.2270979876341146
314,1560085200,376,128,0,504,23,-0.576388588079986,-0.2199888826880808
314,1560099600,376,225,0,601,23,-0.576388588079986,0.07875602000233287
314,1560114000,280,237,0,517,23,-0.576388588079986,-0.1799509060388501
314,1560128400,104,165,61,269,23,0.9289198346120876,-0.9437523067318665
314,1560142800,15,30,15,45,23,-0.20623077922127944,-1.6336374428416878
314,1560157200,702,150,0,852,23,-0.576388588079986,0.8517969537682486
314,1560171600,597,176,0,773,23,-0.576388588079986,0.6084892495152313
314,1560186000,451,362,0,813,23,-0.576388588079986,0.7316830238205565
314,1560200400,354,487,133,841,23,2.7056773171338797,0.8179186658342842
314,1560214800,89,181,92,270,24,1.1814530956952076,-1.0064582566807803
314,1560229200,26,27,1,53,24,-0.5536915501240732,-1.6376762962753737
314,1560243600,775,140,0,915,24,-0.5727590737045049,0.8697428287501541
314,1560258000,624,207,0,831,24,-0.5727590737045049,0.6254003618103114
314,1560272400,520,321,0,841,24,-0.5727590737045049,0.6544887507317213
314,1560286800,438,538,100,976,24,1.3339932843386608,1.047182001170754
314,1560301200,141,277,136,418,24,2.0204241332342003,-0.5759501006439147
314,1560315600,24,27,3,51,24,-0.5155565029632099,-1.6434939740596557
314,1560330000,799,168,0,967,24,-0.5727590737045049,1.0210024511414852
314,1560333105,224,51,0,275,24,-0.5727590737045049,-0.9919140622200753
314,1560340934,281,99,0,380,24,-0.5727590737045049,-0.686485978545272
314,1560344400,122,74,0,196,24,-0.5727590737045049,-1.221712334699213
314,1560358800,545,354,0,899,24,-0.5727590737045049,0.8232014064758983
314,1560373200,477,543,66,1020,24,0.6856974826039846,1.1751709124249572
314,1560387600,137,288,151,425,24,2.3064369869406756,-0.5555882283989279
314,1560402000,22,26,4,48,24,-0.4964889793827782,-1.6522204907360785
314,1560416400,747,149,0,896,24,-0.5727590737045049,0.8144748897994754
314,1560430800,606,177,0,783,24,-0.5727590737045049,0.4857760949875442
314,1560445200,480,343,0,823,24,-0.5727590737045049,0.6021296506731836
314,1560459600,434,491,57,925,24,0.5140897703800996,0.8988312176715638
314,1560474000,124,290,166,414,24,2.5924498406471503,-0.5875854562124786
314,1560488400,31,36,5,67,24,-0.4774214558023466,-1.5969525517854
314,1560502800,756,162,0,918,24,-0.5727590737045049,0.878469345426577
314,1560517200,590,214,0,804,24,-0.5727590737045049,0.5468617117225049
314,1560531600,528,360,0,888,24,-0.5727590737045049,0.7912041786623475
314,1560546000,490,443,0,933,24,-0.5727590737045049,0.9221019288086917
314,1561165200,5802,9682,3880,15484,25,4.119075045810099,4.108942704843564
314,1561179600,21,83,62,104,25,-0.1994499495865943,-0.36972816051473234
314,1561194000,194,71,0,265,25,-0.26957790917658775,-0.32284480490207396
314,1561208400,469,172,0,641,25,-0.26957790917658775,-0.2133532414836917
314,1561222800,527,266,0,793,25,-0.26957790917658775,-0.1690906945698776
314,1561237200,446,282,0,728,25,-0.26957790917658775,-0.1880187573948639
314,1561251600,211,267,56,478,25,-0.20623652632110978,-0.26081899902942657
314,1561266000,33,88,55,121,25,-0.20736762244352905,-0.36477774408358205
314,1561280400,166,58,0,224,25,-0.26957790917658775,-0.33478404453014227
314,1561294800,473,173,0,646,25,-0.26957790917658775,-0.21189723665100044
314,1561309200,475,258,0,733,25,-0.26957790917658775,-0.18656275256217264
314,1561323600,330,263,0,593,25,-0.26957790917658775,-0.22733088787752773
314,1561338000,124,210,86,334,25,-0.17230364264853232,-0.30275193821093466
314,1561352400,25,35,10,60,25,-0.25826694795239524,-0.38254100304241534
314,1561366800,736,159,0,895,25,-0.26957790917658775,-0.13938819598297603
314,1561381200,638,202,0,840,25,-0.26957790917658775,-0.1554042491425798
314,1561395600,523,295,0,818,25,-0.26957790917658775,-0.16181067040642133
314,1561410000,414,555,141,969,25,-0.1100933559154736,-0.11783932445914547
314,1561424400,83,247,164,330,26,2.5280050942089383,-0.8057767741468495
314,1561438800,18,35,17,53,26,-0.31807503920571983,-1.7075956284445355
314,1561453200,675,139,0,814,26,-0.6472135580359865,0.7699644730736561
314,1561467600,650,207,0,857,26,-0.6472135580359865,0.9099580136325026
314,1561482000,449,302,0,751,26,-0.6472135580359865,0.5648576578362763
314,1561496400,416,485,69,901,26,0.6887016066280368,1.0532072179252758
314,1561510800,106,261,155,367,26,2.3537552901223266,-0.6853172159915628
314,1561525200,24,36,12,60,26,-0.41488048592050414,-1.6848059823070487
314,1561539600,738,160,0,898,26,-0.6472135580359865,1.043440226723496
314,1561554000,708,183,0,891,26,-0.6472135580359865,1.0206505805860093
314,1561568400,523,329,0,852,26,-0.6472135580359865,0.8936796949628694
314,1561582800,461,520,59,981,26,0.4950907131984682,1.313660316639409
314,1561597200,144,264,120,408,26,1.6761171631188365,-0.5518350029005696
314,1561611600,15,38,23,53,26,-0.2019085031479787,-1.7075956284445355
314,1561626000,695,148,0,843,26,-0.6472135580359865,0.8643787213575294
314,1561640400,575,214,0,789,26,-0.6472135580359865,0.6885728797254895
314,1561654800,568,298,0,866,26,-0.6472135580359865,0.9392589872378426
314,1561669200,432,455,23,887,26,-0.2019085031479787,1.0076279256503027
314,1561683600,120,305,185,425,26,2.934587970411032,-0.4964887194238163
314,1561698000,19,43,24,62,26,-0.18254741380502185,-1.6782946548391955
314,1561712400,659,149,0,808,26,-0.6472135580359865,0.7504304906700962
314,1561726800,676,227,0,903,26,-0.6472135580359865,1.0597185453931293
314,1561741200,505,345,0,850,26,-0.6472135580359865,0.887168367495016
314,1561755600,454,468,14,922,26,-0.3761583072345904,1.1215761563377358
314,1561770000,146,236,90,382,26,1.095284482830131,-0.6364822599826628
314,1561784400,19,92,73,111,26,0.7661459639998642,-1.5187671318767888
314,1561798800,157,56,0,213,26,-0.6472135580359865,-1.1866894310162692
314,1561813200,423,211,0,634,26,-0.6472135580359865,0.18394500096685654
314,1561827600,475,265,0,740,26,-0.6472135580359865,0.529045356763083
314,1561842000,316,214,0,530,26,-0.6472135580359865,-0.15464402736151656
314,1561856400,171,227,56,398,26,0.4370074451695976,-0.5843916402398363
314,1561870800,22,89,67,111,26,0.649979427942123,-1.5187671318767888
314,1561885200,129,58,0,187,26,-0.6472135580359865,-1.2713366880983623
314,1561899600,442,125,0,567,26,-0.6472135580359865,-0.03418446920622997
314,1561914000,412,221,0,633,26,-0.6472135580359865,0.18068933723292988
314,1561928400,271,284,13,555,26,-0.3955193965775473,-0.07325243401334995
314,1561942800,99,247,148,346,26,2.2182276647216286,-0.7536861544040228
314,1561957200,19,37,18,56,26,-0.298713949862763,-1.6978286372427553
314,1561971600,664,163,0,827,26,-0.6472135580359865,0.8122881016147028
314,1561986000,577,206,0,783,26,-0.6472135580359865,0.6690388973219296
314,1562000400,431,318,0,749,26,-0.6472135580359865,0.558346330368423
314,1562014800,394,468,74,862,26,0.7855070533428211,0.926236332302136
314,1562029200,111,234,123,345,27,1.9996769213034347,-0.3577604106516139
314,1562043600,21,28,7,49,27,-0.5291513756075492,-1.4727332721798787
314,1562058000,684,152,0,836,27,-0.6817530831797637,1.4917384914104739
314,1562063241,301,63,0,364,27,-0.6817530831797637,-0.28619120670216447
314,1562072400,283,119,0,402,27,-0.6817530831797637,-0.1430527988032656
314,1562086800,459,294,0,753,27,-0.6817530831797637,1.179094074157616
314,1562101200,401,497,96,898,27,1.4110703349534643,1.725280104298151
314,1562115600,115,237,122,352,27,1.9778766773645469,-0.33139280919655356
314,1562130000,25,40,15,65,27,-0.35474942409644683,-1.4124644688540264
314,1562143311,508,153,0,661,27,-0.6817530831797637,0.832548455033966
314,1562144400,94,23,0,117,27,-0.6817530831797637,-1.2165908580450069
314,1562158800,558,216,0,774,27,-0.6817530831797637,1.2581968785227968
314,1562173200,491,369,0,860,27,-0.6817530831797637,1.582141696399252
314,1562187600,414,393,0,807,27,-0.6817530831797637,1.3825012853823668
314,1562202000,128,212,84,340,27,1.149467407686811,-0.37659441169094265
314,1562216400,18,44,26,62,27,-0.11494674076868111,-1.4237648694776237
314,1562230800,135,51,0,186,27,-0.6817530831797637,-0.9566816437022696
314,1562245200,333,115,0,448,27,-0.6817530831797637,0.030220010758559308
314,1562259600,387,235,0,622,27,-0.6817530831797637,0.6856432469272014
314,1562274000,366,204,0,570,27,-0.6817530831797637,0.4897696361181819
314,1562288400,112,202,90,314,27,1.2802688713201378,-0.47453121709545243
314,1562302800,20,80,60,100,27,0.6262615531535038,-1.2806264615787248
314,1562317200,344,110,0,454,27,-0.6817530831797637,0.052820812005753864
314,1562331600,411,196,0,607,27,-0.6817530831797637,0.629141243809215
314,1562346000,438,287,0,725,27,-0.6817530831797637,1.0736236683373745
314,1562360400,355,275,0,630,27,-0.6817530831797637,0.7157776485901275
314,1562374800,89,192,103,281,27,1.563672042525679,-0.5988356239550224
314,1562389200,14,71,57,85,27,0.5608608213368405,-1.3371284646967112
314,1562403600,100,74,0,174,27,-0.6817530831797637,-1.0018832461966587
314,1562418000,244,170,0,414,27,-0.6817530831797637,-0.09785119630887651
314,1562432400,229,199,0,428,27,-0.6817530831797637,-0.045115993398755876
314,1562446800,202,277,75,479,27,0.9532652122368208,0.14699081720239784
314,1562461200,90,189,99,279,27,1.4764710667701277,-0.606369224370754
314,1562475600,11,78,67,89,27,0.7788632607257184,-1.3220612638652482
314,1562490000,87,59,0,146,27,-0.6817530831797637,-1.1073536520169
314,1562504400,182,135,0,317,27,-0.6817530831797637,-0.46323081647185516
314,1562518800,212,201,0,413,27,-0.6817530831797637,-0.10161799651674226
314,1562533200,190,244,54,434,27,0.4954600895201771,-0.02251519215156132
314,1562547600,66,196,130,262,27,2.1522786288756492,-0.6704048279044719
314,1562562000,10,27,17,37,27,-0.31114893621867123,-1.5179348746742678
314,1562576400,678,161,0,839,27,-0.6817530831797637,1.5030388920340712
314,1562590800,532,175,0,707,27,-0.6817530831797637,1.005821264595791
314,1562605200,448,285,0,733,27,-0.6817530831797637,1.1037580700003007
314,1562619600,375,526,151,901,27,2.6100837515922928,1.7365805049217482
314,1562634000,99,178,79,277,28,1.0828395783143718,-0.8489259440856584
314,1562648400,21,24,3,45,28,-0.5725358689938058,-1.561777926089334
314,1562662800,746,156,0,902,28,-0.6378796366507076,1.0714727143294165
314,1562677200,553,204,0,757,28,-0.6378796366507076,0.625940225577119
314,1562691600,485,340,0,825,28,-0.6378796366507076,0.8348795996126792
314,1562706000,409,548,139,957,28,2.3897149314524073,1.240467796269943
314,1562720400,105,257,152,362,28,2.672871257965648,-0.5877517265412081
314,1562734800,24,39,15,63,28,-0.3111607983661988,-1.5064704447269799
314,1562749200,738,161,0,899,28,-0.6378796366507076,1.062254800769024
314,1562763600,620,218,0,838,28,-0.6378796366507076,0.8748238917077128
314,1562778000,500,333,0,833,28,-0.6378796366507076,0.8594607024403922
314,1562792400,435,522,87,957,28,1.2570896253994432,1.240467796269943
314,1562806800,116,258,142,374,28,2.455058699109309,-0.5508800722996388
314,1562821200,19,32,13,51,28,-0.35472331013746666,-1.5433420989685493
314,1562835600,757,172,0,929,28,-0.6378796366507076,1.1544339363729477
314,1562850000,625,199,0,824,28,-0.6378796366507076,0.8318069617592151
314,1562864400,521,343,0,864,28,-0.6378796366507076,0.9547124758977799
314,1562878800,360,480,120,840,28,1.9758710696253627,0.880969167414641
314,1562893200,100,207,107,307,28,1.6927147431121217,-0.7567468084817347
314,1562907600,16,41,25,57,28,-0.09334823950985963,-1.5249062718477646
314,1562922000,629,140,0,769,28,-0.6378796366507076,0.6628118798186885
314,1562936400,574,231,0,805,28,-0.6378796366507076,0.7734268425433968
314,1562950800,517,379,0,896,28,-0.6378796366507076,1.0530368872086318
314,1562965200,480,426,0,906,28,-0.6378796366507076,1.083763265743273
314,1562979600,150,226,76,376,28,1.01749581065747,-0.5447347965927105
314,1562994000,29,72,43,101,28,0.2987143664315509,-1.3897102062953435
314,1563008400,163,69,0,232,28,-0.6378796366507076,-0.9871946474915437
314,1563022800,356,157,0,513,28,-0.6378796366507076,-0.1237834106681261
314,1563037200,454,271,0,725,28,-0.6378796366507076,0.5276158142662672
314,1563051600,235,201,0,436,28,-0.6378796366507076,-0.3603765253848633
314,1563066000,2,5,3,7,28,-0.5725358689938058,-1.6785381645209707
314,1563080400,19,56,37,75,28,0.16802683111774738,-1.4695987904854104
314,1563094800,128,52,0,180,28,-0.6378796366507076,-1.146971815871678
314,1563109200,351,164,0,515,28,-0.6378796366507076,-0.11763813496119788
314,1563123600,360,251,0,611,28,-0.6378796366507076,0.1773350989713576
314,1563138000,248,285,37,533,28,0.16802683111774738,-0.06233065359884372
314,1563152400,108,199,91,307,28,1.3442146489419788,-0.7567468084817347
314,1563166800,16,27,11,43,28,-0.39828582190873446,-1.5679232017962623
314,1563181200,702,180,0,882,28,-0.6378796366507076,1.010019957260134
314,1563195600,564,180,0,744,28,-0.6378796366507076,0.5859959334820856
314,1563210000,476,283,0,759,28,-0.6378796366507076,0.6320855012840473
314,1563224400,406,456,50,862,28,0.4511831576309883,0.9485672001908516
314,1563238800,98,210,112,308,29,1.5953553822712605,-0.7703634962643772
314,1563253200,19,39,20,58,29,-0.22092428687904903,-1.55393578249667
314,1563267600,750,157,0,907,29,-0.6157676932160728,1.1070757015481965
314,1563282000,627,198,0,825,29,-0.6157676932160728,0.8500639916640044
314,1563296400,460,289,0,749,29,-0.6157676932160728,0.6118580166493873
314,1563310800,452,455,3,907,29,-0.5565411822655192,1.1070757015481965
314,1563325200,99,237,138,336,29,2.108651810509391,-0.6826034002063603
314,1563339600,21,40,19,61,29,-0.2406664571959002,-1.5445329150618825
314,1563354000,733,157,0,890,29,-0.6157676932160728,1.0537927860844005
314,1563368400,599,210,0,809,29,-0.6157676932160728,0.7999153653451376
314,1563382800,480,290,0,770,29,-0.6157676932160728,0.6776780886928999
314,1563397200,438,545,107,983,29,1.4966445306870044,1.3452816765628135
314,1563411600,91,213,122,304,29,1.7927770854397722,-0.7829006528440938
314,1563426000,17,25,8,42,29,-0.4578303306812633,-1.6040844088155366
314,1563440400,714,155,0,869,29,-0.6157676932160728,0.9879727140408879
314,1563454800,603,181,0,784,29,-0.6157676932160728,0.7215581367219084
314,1563469200,517,256,0,773,29,-0.6157676932160728,0.6870809561276875
314,1563483600,403,510,107,913,29,1.4966445306870044,1.1258814364177714
314,1563498000,85,217,132,302,29,1.9901987886082841,-0.7891692311339522
314,1563512400,19,35,16,54,29,-0.2998929681464538,-1.5664729390763867
314,1563526800,655,165,0,820,29,-0.6157676932160728,0.8343925459393585
314,1563541200,569,227,0,796,29,-0.6157676932160728,0.7591696064610584
314,1563555600,505,325,0,830,29,-0.6157676932160728,0.8657354373886502
314,1563570000,684,532,0,1216,29,-0.6157676932160728,2.0755710473313105
314,1563584400,150,285,135,435,29,2.0494252995588376,-0.37230877485837244
314,1563598800,29,71,42,100,29,0.21340346009167716,-1.4222956384096448
314,1563613200,170,64,0,234,29,-0.6157676932160728,-1.0023008929891357
314,1563627600,393,138,0,531,29,-0.6157676932160728,-0.07141701694517198
314,1563642000,332,244,0,576,29,-0.6157676932160728,0.06962599457664072
314,1563656400,309,218,0,527,29,-0.6157676932160728,-0.08395417352488867
314,1563670800,167,236,69,403,29,0.7464420586466592,-0.4726060274961059
314,1563685200,25,55,30,80,29,-0.023502583710537116,-1.4849814213082282
314,1563699600,109,49,0,158,29,-0.6157676932160728,-1.2405068680037528
314,1563714000,301,147,0,448,29,-0.6157676932160728,-0.33156301597429316
314,1563728400,335,206,0,541,29,-0.6157676932160728,-0.04007412549588027
314,1563742800,237,234,0,471,29,-0.6157676932160728,-0.25947436564092224
314,1563757200,107,176,69,283,29,0.7464420586466592,-0.8487207248876064
314,1563771600,17,24,7,41,29,-0.4775725009981145,-1.607218697960466
314,1563786000,691,131,0,822,29,-0.6157676932160728,0.8406611242292168
314,1563800400,562,199,0,761,29,-0.6157676932160728,0.6494694863885374
314,1563814800,435,283,0,718,29,-0.6157676932160728,0.514695053156583
314,1563829200,325,499,174,824,29,2.819369941916034,0.8469297025190752
314,1563843600,60,156,96,216,30,0.9132607286534855,-0.9987404043353589
314,1563858000,12,28,16,40,30,-0.4962735149274567,-1.5580774047783448
314,1563872400,762,145,0,907,30,-0.7781803636436452,1.1972929326311372
314,1563886800,576,190,0,766,30,-0.7781803636436452,0.7491877220489722
314,1563901200,439,289,0,728,30,-0.7781803636436452,0.6284217787715094
314,1563915600,384,520,136,904,30,1.6180278504439567,1.1877587792144952
314,1563930000,70,204,134,274,30,1.5827894943544332,-0.814413438280284
314,1563944400,12,29,17,41,30,-0.47865433688269493,-1.5548993536394642
314,1563958800,733,168,0,901,30,-0.7781803636436452,1.1782246257978535
314,1563973200,566,211,0,777,30,-0.7781803636436452,0.7841462845766589
314,1563987600,500,303,0,803,30,-0.7781803636436452,0.8667756141875546
314,1564002000,413,552,139,965,30,1.670885384578242,1.381619898686212
314,1564016400,84,228,144,312,30,1.758981274802051,-0.6936474950028211
314,1564030800,14,36,22,50,30,-0.39055844665888606,-1.526296893389539
314,1564045200,714,146,0,860,30,-0.7781803636436452,1.047924529103749
314,1564059600,617,203,0,820,30,-0.7781803636436452,0.9208024835485248
314,1564074000,464,284,0,748,30,-0.7781803636436452,0.6919828015491214
314,1564088400,457,513,56,970,30,0.2084936068630144,1.397510154380615
314,1564102800,83,244,161,327,30,2.0585073015630013,-0.645976727919612
314,1564117200,10,37,27,47,30,-0.30246255643507713,-1.5358310468061807
314,1564131600,653,171,0,824,30,-0.7781803636436452,0.9335146881040471
314,1564146000,585,200,0,785,30,-0.7781803636436452,0.8095706936877036
314,1564160400,509,350,0,859,30,-0.7781803636436452,1.0447464779648683
314,1564174800,437,418,0,855,30,-0.7781803636436452,1.0320342734093457
314,1564189200,85,246,161,331,30,2.0585073015630013,-0.6332645233640897
314,1564203600,11,68,57,79,30,0.2261127849077762,-1.4341334103620014
314,1564218000,104,148,44,252,30,-0.002936529674126921,-0.8843305633356572
314,1564232400,329,190,0,519,30,-0.7781803636436452,-0.03579090925453648
314,1564246800,326,233,0,559,30,-0.7781803636436452,0.09133113630068761
314,1564261200,236,293,57,529,30,0.2261127849077762,-0.004010397865730456
314,1564275600,84,253,169,337,30,2.1994607259210954,-0.614196216530806
314,1564290000,13,73,60,86,30,0.27897031904206154,-1.4118870523898372
314,1564304400,62,58,0,120,30,-0.7781803636436452,-1.3038333136678968
314,1564318800,245,132,0,377,30,-0.7781803636436452,-0.487074170975582
314,1564333200,196,235,39,431,30,-0.09103241989793581,-0.31545940947602946
314,1564347600,201,271,70,472,30,0.4551620994896793,-0.18515931278192477
314,1564362000,69,198,129,267,30,1.4946936041306242,-0.8366597962524482
314,1564376400,8,25,17,33,30,-0.47865433688269493,-1.5803237627505091
314,1564390800,691,146,0,837,30,-0.7781803636436452,0.974829352909495
314,1564405200,561,179,0,740,30,-0.7781803636436452,0.6665583924380766
314,1564419600,420,311,0,731,30,-0.7781803636436452,0.6379559321881512
314,1564434000,344,448,104,792,30,1.0542141530115798,0.8318170516598679
314,1564448400,89,122,33,211,31,0.6481997643800057,-1.1107787403741562
314,1564462800,16,21,5,37,31,-0.3372985199262474,-1.6264092450209413
314,1564477200,716,161,0,877,31,-0.5132803564095069,0.8628414670669856
314,1564491600,563,202,0,765,31,-0.5132803564095069,0.5309413721219287
314,1564506000,499,300,0,799,31,-0.5132803564095069,0.6316967580873925
314,1564520400,413,493,80,906,31,2.302429027322645,0.9487798845081165
314,1564534800,95,103,8,198,31,-0.2317094180362917,-1.1493028585374219
314,1564549200,24,12,0,36,31,-0.5132803564095069,-1.6293726387258078
314,1564563600,724,158,0,882,31,-0.5132803564095069,0.8776584355913185
314,1564578000,619,177,0,796,31,-0.5132803564095069,0.6228065769727927
314,1564592400,437,285,0,722,31,-0.5132803564095069,0.4035154428126658
314,1564606800,360,451,91,811,31,2.689589067585816,0.6672574825457914
314,1564621200,78,100,22,178,31,0.2610397241168349,-1.2085707326347535
314,1564635600,20,26,6,46,31,-0.3021021526295955,-1.599738701677142
314,1564650000,704,147,0,851,31,-0.5132803564095069,0.7857932307404546
314,1564664400,559,187,0,746,31,-0.5132803564095069,0.4746368917294637
314,1564678800,494,280,0,774,31,-0.5132803564095069,0.557611915465728
314,1564693200,407,496,89,903,31,2.6191963329925123,0.9398897033935167
314,1564707600,87,100,13,187,31,-0.055727581553032195,-1.1819001892909542
314,1564722000,22,25,3,47,31,-0.4076912545195512,-1.5967753079722755
314,1564736400,641,150,0,791,31,-0.5132803564095069,0.6079896084484598
314,1564750800,551,207,0,758,31,-0.5132803564095069,0.5101976161878626
314,1564765200,515,335,0,850,31,-0.5132803564095069,0.782829837035588
314,1564779600,475,414,0,889,31,-0.5132803564095069,0.8984021915253846
314,1565398800,9326,6742,0,16068,32,-0.6198650836374578,4.107522739650674
314,1565413200,19,65,46,84,32,1.2533038552377798,-0.3658463107402487
314,1565427600,156,47,0,203,32,-0.6198650836374578,-0.3325423244416676
314,1565442000,368,192,0,560,32,-0.6198650836374578,-0.23263036554592437
314,1565456400,414,426,12,840,32,-0.13121231697435234,-0.15426804484338066
314,1565470800,735,434,0,1169,32,-0.6198650836374578,-0.062192318017891816
314,1565485200,181,205,24,386,32,0.3574404496887531,-0.2813269505539337
314,1565499600,15,62,47,77,32,1.294024919126372,-0.3678053687578123
314,1565514000,158,146,0,304,32,-0.6198650836374578,-0.3042759159025358
314,1565528400,504,136,0,640,32,-0.6198650836374578,-0.21024113105948333
314,1565542800,396,221,0,617,32,-0.6198650836374578,-0.21667803597433513
314,1565557200,303,238,0,541,32,-0.6198650836374578,-0.23794780873645413
314,1565571600,91,165,74,256,32,2.393493644118359,-0.3177094565944004
314,1565586000,24,28,4,52,32,-0.4569808280830893,-0.3748020045348251
314,1565600400,653,156,0,809,32,-0.6198650836374578,-0.1629438732068766
314,1565614800,549,231,0,780,32,-0.6198650836374578,-0.17105997070821147
314,1565629200,471,310,0,781,32,-0.6198650836374578,-0.17078010527713094
314,1565643600,404,471,67,875,32,2.1084461968982144,-0.1444727547555627
314,1565658000,89,234,145,323,33,1.9870487010479194,-0.9493884117820421
314,1565672400,24,21,0,45,33,-0.6721589939582574,-1.8008393139084231
314,1565686800,681,141,0,822,33,-0.6721589939582574,0.5789353298045193
314,1565701200,611,205,0,816,33,-0.6721589939582574,0.5605586916291299
314,1565715600,501,309,0,810,33,-0.6721589939582574,0.5421820534537404
314,1565730000,459,409,0,868,33,-0.6721589939582574,0.7198228891491724
314,1565744400,111,250,139,361,33,1.8770125205649053,-0.8330030366712419
314,1565758800,21,22,1,43,33,-0.6538196305444217,-1.8069648599668864
314,1565773200,654,149,0,803,33,-0.6721589939582574,0.5207426422491193
314,1565787600,595,207,0,802,33,-0.6721589939582574,0.5176798692198876
314,1565802000,472,346,0,818,33,-0.6721589939582574,0.566684237687593
314,1565816400,420,465,45,885,33,0.15311235966434922,0.7718900306461093
314,1565830800,98,214,116,312,33,1.4552071620466842,-0.9830789151035896
314,1565845200,17,30,13,47,33,-0.43374726957839327,-1.79471376784996
314,1565859600,669,141,0,810,33,-0.6721589939582574,0.5421820534537404
314,1565874000,602,185,0,787,33,-0.6721589939582574,0.47173827378141386
314,1565888400,456,346,0,802,33,-0.6721589939582574,0.5176798692198876
314,1565902800,438,505,67,943,33,0.5565783547687346,0.9495308663415413
314,1565917200,99,256,157,355,33,2.207121062013948,-0.8513796748466315
314,1565931600,12,38,26,50,33,-0.1953355451985291,-1.7855254487622652
314,1565942766,317,77,0,394,33,-0.6721589939582574,-0.7319315267065996
314,1565946000,297,52,0,349,33,-0.6721589939582574,-0.8697563130220209
314,1565960400,541,225,0,766,33,-0.6721589939582574,0.4074200401675505
314,1565974800,475,305,0,780,33,-0.6721589939582574,0.45029886257679275
314,1565989200,486,429,0,915,33,-0.6721589939582574,0.8637732215230569
314,1566003600,145,238,93,383,33,1.033401803528463,-0.765622030028147
314,1566018000,48,173,125,221,33,1.6202614327712055,-1.2617912607636639
314,1566032400,242,181,0,423,33,-0.6721589939582574,-0.6431111088588836
314,1566046800,701,319,0,1020,33,-0.6721589939582574,1.1853643895923733
314,1566061200,678,515,0,1193,33,-0.6721589939582574,1.7152241236494379
314,1566075600,646,522,0,1168,33,-0.6721589939582574,1.638654797918648
314,1566090000,310,450,140,760,33,1.895351883978741,0.38904340199216103
314,1566104400,44,160,116,204,33,1.4552071620466842,-1.313858402260601
314,1566118800,232,111,0,343,33,-0.6721589939582574,-0.8881329511974104
314,1566133200,715,298,0,1013,33,-0.6721589939582574,1.1639249783877523
314,1566147600,642,453,0,1095,33,-0.6721589939582574,1.4150723667847425
314,1566162000,411,497,86,908,33,0.905026259631613,0.8423338103184358
314,1566176400,214,343,129,557,33,1.6936188864265482,-0.232699522941851
314,1566190800,31,84,53,115,33,0.2998272669750348,-1.5864452018622122
314,1566205200,619,126,0,745,33,-0.6721589939582574,0.3431018065536872
314,1566219600,582,170,0,752,33,-0.6721589939582574,0.36454121775830833
314,1566234000,453,304,0,757,33,-0.6721589939582574,0.37985508290446623
314,1566248400,365,490,125,855,33,1.6202614327712055,0.6800068397691617
314,1566262800,99,198,99,297,34,1.260732158995612,-0.8937154619500349
314,1566277200,28,23,0,51,34,-0.618345046867704,-1.581045610886181
314,1566291377,626,135,0,761,34,-0.618345046867704,0.40271213604334627
314,1566291600,25,6,0,31,34,-0.618345046867704,-1.6369261107996889
314,1566306000,572,229,0,801,34,-0.618345046867704,0.5144731358703619
314,1566310014,114,71,0,185,34,-0.618345046867704,-1.2066462614656788
314,1566320400,338,239,0,577,34,-0.618345046867704,-0.11138846316092559
314,1566334800,412,462,50,874,34,0.3306838449824556,0.7184369605546654
314,1566349200,114,230,116,344,34,1.583401982224666,-0.7623962871532916
314,1566363600,22,31,9,53,34,-0.44751984633467523,-1.5754575608948302
314,1566375444,403,96,0,499,34,-0.618345046867704,-0.329322412823606
314,1566378000,277,52,0,329,34,-0.618345046867704,-0.8043066620884224
314,1566392400,573,195,0,768,34,-0.618345046867704,0.422270311013074
314,1566406800,468,282,0,750,34,-0.618345046867704,0.37197786109091696
314,1566421200,405,456,51,861,34,0.3496644228194588,0.6821146356108854
314,1566435600,90,208,118,298,34,1.6213631378986726,-0.8909214369543595
314,1566450000,28,33,5,61,34,-0.523442157682688,-1.5531053609294272
314,1566464400,637,139,0,776,34,-0.618345046867704,0.4446225109784771
314,1566478800,599,200,0,799,34,-0.618345046867704,0.5088850858790112
314,1566493200,463,340,0,803,34,-0.618345046867704,0.5200611858617127
314,1566507600,430,485,55,915,34,0.4255867341674716,0.8329919853773564
314,1566522000,99,237,138,336,34,2.0009746946387366,-0.7847484871186947
314,1566536400,22,27,5,49,34,-0.523442157682688,-1.5866336608775318
314,1566550800,550,130,0,680,34,-0.618345046867704,0.17639611139363964
314,1566565200,519,242,0,761,34,-0.618345046867704,0.40271213604334627
314,1566579600,472,285,0,757,34,-0.618345046867704,0.3915360360606447
314,1566594000,413,393,0,806,34,-0.618345046867704,0.5284432608487388
314,1566608400,193,239,46,432,34,0.25476153363444287,-0.5165220875338572
314,1566622800,39,160,121,199,34,1.6783048714096822,-1.1675299115262232
314,1566637200,311,158,0,469,34,-0.618345046867704,-0.41314316269386775
314,1566651600,827,349,0,1176,34,-0.618345046867704,1.5622325092486333
314,1566666000,756,534,0,1290,34,-0.618345046867704,1.880751358755628
314,1566680400,721,554,0,1275,34,-0.618345046867704,1.838840983820497
314,1566694800,350,507,157,857,34,2.361605673541797,0.6709385356281837
314,1566709200,43,147,104,190,34,1.3556350481806279,-1.1926761364873018
314,1566723600,244,139,0,383,34,-0.618345046867704,-0.6534293123219513
314,1566738000,745,313,0,1058,34,-0.618345046867704,1.2325375597589372
314,1566752400,805,489,0,1294,34,-0.618345046867704,1.8919274587383295
314,1566766800,537,588,51,1125,34,0.3496644228194588,1.4197372344691883
314,1566781200,224,387,163,611,34,2.475489140563816,-0.01639161330796231
314,1566795600,34,49,15,83,34,-0.33363637931265605,-1.4916368110245686
314,1566810000,620,117,0,737,34,-0.618345046867704,0.3356555361471369
314,1566824400,606,186,0,792,34,-0.618345046867704,0.4893269109092834
314,1566838800,439,292,0,731,34,-0.618345046867704,0.31889138617308455
314,1566853200,336,499,163,835,34,2.475489140563816,0.6094699857233251
314,1566867600,117,233,116,350,35,2.1776767046936496,-0.6309343119426378
314,1566882000,23,28,5,51,35,-0.5463181429805641,-1.7067351387417746
314,1566896400,670,130,0,800,35,-0.6690206135965198,0.9881639223704446
314,1566910800,568,191,0,759,35,-0.6690206135965198,0.8406460832441416
314,1566925200,442,307,0,749,35,-0.6690206135965198,0.8046661224816286
314,1566939600,399,480,81,879,35,1.3187594103819607,1.2724056123942968
314,1566954000,132,227,95,359,35,1.6623263281066363,-0.5985523472563762
314,1566968400,27,30,3,57,35,-0.5953991312269463,-1.6851471622842669
314,1566982800,688,142,0,830,35,-0.6690206135965198,1.0961038046579834
314,1566997200,579,193,0,772,35,-0.6690206135965198,0.8874200322354083
314,1567011600,441,298,0,739,35,-0.6690206135965198,0.7686861617191156
314,1567026000,388,467,79,855,35,1.2696784221355786,1.1860537065642658
314,1567040400,149,229,80,378,35,1.2942189162587696,-0.5301904218076016
314,1567054800,28,38,10,66,35,-0.42361567236460856,-1.6527651975980053
314,1567069200,613,139,0,752,35,-0.6690206135965198,0.8154601107103825
314,1567083600,598,232,0,830,35,-0.6690206135965198,1.0961038046579834
314,1567098000,488,351,0,839,35,-0.6690206135965198,1.1284857693442452
314,1567112400,407,448,41,855,35,0.337139645454316,1.1860537065642658
314,1567126800,159,267,108,426,35,1.9813527517081209,-0.3574866101475394
314,1567141200,25,52,27,77,35,-0.006427272270359599,-1.6131872407592411
314,1567155600,559,120,0,679,35,-0.6690206135965198,0.552806397144038
314,1567170000,568,209,0,777,35,-0.6690206135965198,0.9054100126166649
314,1567184400,501,360,0,861,35,-0.6690206135965198,1.2076416830217735
314,1567198800,487,334,0,821,35,-0.6690206135965198,1.0637218399717219
314,1567213200,144,242,98,386,35,1.7359478104762096,-0.5014064531975911
314,1567227600,35,77,42,112,35,0.3616801395775071,-1.487257378090446
314,1567242000,178,83,0,261,35,-0.6690206135965198,-0.9511559627290029
314,1567256400,439,221,0,660,35,-0.6690206135965198,0.48444447169526345
314,1567270800,395,280,0,675,35,-0.6690206135965198,0.5384144128390328
314,1567285200,347,313,0,660,35,-0.6690206135965198,0.48444447169526345
314,1567299600,117,248,131,365,35,2.5457841165415167,-0.5769643707988683
314,1567314000,20,49,29,69,35,0.04265371597602263,-1.6419712093692513
314,1567328400,138,54,0,192,35,-0.6690206135965198,-1.1994176919903423
314,1567342800,392,211,0,603,35,-0.6690206135965198,0.27935869534893965
314,1567357200,377,282,0,659,35,-0.6690206135965198,0.4808464756190121
314,1567371600,276,326,50,602,35,0.5580040925630361,0.27576069927268837
314,1567386000,126,237,111,363,35,2.054974234077694,-0.584160362951371
314,1567400400,25,37,12,62,35,-0.3745346841182263,-1.6671571819030104
314,1567414800,125,78,0,203,35,-0.6690206135965198,-1.1598397351515781
314,1567429200,361,154,0,515,35,-0.6690206135965198,-0.03726495936117424
314,1567443600,349,263,0,612,35,-0.6690206135965198,0.3117406600352013
314,1567458000,239,266,27,505,35,-0.006427272270359599,-0.07324492012368718
314,1567472400,101,147,46,248,36,0.36136422385311906,-1.0029153826306403
314,1567486800,13,21,8,34,36,-0.49560056258013196,-1.6868458423487125
314,1567501200,677,141,0,818,36,-0.6760142018292374,0.8187685521324496
314,1567515600,561,201,0,762,36,-0.6760142018292374,0.6397960953837951
314,1567530000,475,289,0,764,36,-0.6760142018292374,0.6461879688391042
314,1567544400,383,463,80,846,36,1.1281221906618173,0.9082547805067768
314,1567558800,100,196,96,296,36,1.488949469160028,-0.8495104197032222
314,1567573200,17,28,11,45,36,-0.4279454478617174,-1.6516905383445126
314,1567587600,686,140,0,826,36,-0.6760142018292374,0.8443360459536859
314,1567602000,581,193,0,774,36,-0.6760142018292374,0.6781473361156497
314,1567616400,471,306,0,777,36,-0.6760142018292374,0.6877351462986133
314,1567630800,413,484,71,897,36,0.9251568465065737,1.0712475536171586
314,1567645200,101,235,134,336,36,2.345914255593279,-0.7216729505970404
314,1567659600,30,23,0,53,36,-0.6760142018292374,-1.6261230445232762
314,1567674000,703,152,0,855,36,-0.6760142018292374,0.9370182110556677
314,1567688400,593,224,0,817,36,-0.6760142018292374,0.8155726154047951
314,1567702800,461,326,0,787,36,-0.6760142018292374,0.7196945135751588
314,1567717200,419,493,74,912,36,0.9928119612249882,1.1191866045319767
314,1567731600,99,227,128,326,36,2.21060402615645,-0.7536323178735859
314,1567746000,21,40,19,61,36,-0.24753180861261193,-1.60055555070204
314,1567760400,701,158,0,859,36,-0.6760142018292374,0.9498019579662859
314,1567774800,577,206,0,783,36,-0.6760142018292374,0.7069107666645406
314,1567789200,496,352,0,848,36,-0.6760142018292374,0.9146466539620859
314,1567803600,403,442,39,845,36,0.20350228951015176,0.9050588437791223
314,1567818000,137,225,88,362,36,1.3085358299109229,-0.6385785956780222
314,1567832400,24,61,37,85,36,0.1583988796978754,-1.5238530692383307
314,1567846800,154,61,0,215,36,-0.6760142018292374,-1.10838129464324
314,1567861200,432,177,0,609,36,-0.6760142018292374,0.15081777605264998
314,1567875600,458,316,0,774,36,-0.6760142018292374,0.6781473361156497
314,1567890000,388,311,0,699,36,-0.6760142018292374,0.4384520815415589
314,1567904400,129,224,95,353,36,1.46639776425389,-0.6673420262269132
314,1567918800,24,58,34,82,36,0.09074376497946082,-1.5334408794212944
314,1567933200,130,51,0,181,36,-0.6760142018292374,-1.2170431433834947
314,1567947600,382,176,0,558,36,-0.6760142018292374,-0.012174997057731732
314,1567962000,376,301,0,677,36,-0.6760142018292374,0.36814147353315896
314,1567976400,294,319,25,613,36,-0.11222157917578283,0.16360152296326816
314,1567990800,74,186,112,260,36,1.849776747658239,-0.9645641418987857
314,1568005200,17,27,10,44,36,-0.4504971527678556,-1.654886475072167
314,1568019600,784,144,0,928,36,-0.6760142018292374,1.1703215921744494
314,1568034000,556,271,0,827,36,-0.6760142018292374,0.8475319826813404
314,1568048400,526,324,0,850,36,-0.6760142018292374,0.921038527417395
314,1568062800,379,531,152,910,36,2.7518449439037664,1.1127947310766677
314,1568077200,67,184,117,251,37,1.5381391845948476,-1.0300064969469453
314,1568091600,19,31,12,50,37,-0.4464113724745725,-1.6440390403567406
314,1568106000,776,158,0,934,37,-0.6732171504253635,1.056482195336091
314,1568120400,599,194,0,793,37,-0.6732171504253635,0.6257429484665329
314,1568134800,519,327,0,846,37,-0.6732171504253635,0.787652027077076
314,1568149200,424,565,141,989,37,1.9917507404964294,1.2245010504979752
314,1568163600,86,227,141,313,37,1.9917507404964294,-0.8406034238553666
314,1568178000,16,21,5,37,37,-0.5787147429458672,-1.6837525879404587
314,1568192400,838,144,0,982,37,-0.6732171504253635,1.2031168325682808
314,1568206800,590,203,0,793,37,-0.6732171504253635,0.6257429484665329
314,1568221200,543,320,0,863,37,-0.6732171504253635,0.8395851277634766
314,1568235600,423,539,116,962,37,1.5192387030989483,1.1420190670548684
314,1568250000,95,223,128,318,37,1.7460444810497393,-0.8253289824770135
314,1568264400,19,37,18,56,37,-0.3330084834991771,-1.625709710702717
314,1568278800,803,131,0,934,37,-0.6732171504253635,1.056482195336091
314,1568293200,609,231,0,840,37,-0.6732171504253635,0.7693226974230523
314,1568307600,485,357,0,842,37,-0.6732171504253635,0.7754324739743935
314,1568322000,392,508,116,900,37,1.5192387030989483,0.9526159939632897
314,1568336400,82,263,181,345,37,2.747770000332399,-0.7428469990339066
314,1568350800,23,46,23,69,37,-0.2385060760196809,-1.5859961631189987
314,1568365200,758,137,0,895,37,-0.6732171504253635,0.9373415525849366
314,1568379600,591,211,0,802,37,-0.6732171504253635,0.6532369429475685
314,1568394000,499,330,0,829,37,-0.6732171504253635,0.7357189263906754
314,1568408400,488,453,0,941,37,-0.6732171504253635,1.0778664132657854
314,1568422800,141,227,86,368,37,0.9522242582219712,-0.6725845686934823
314,1568437200,17,64,47,81,37,0.21510547988190085,-1.5493375038109514
314,1568451600,177,59,0,236,37,-0.6732171504253635,-1.0758298210820045
314,1568466000,427,221,0,648,37,-0.6732171504253635,0.18278414849429245
314,1568480400,534,233,0,767,37,-0.6732171504253635,0.5463158532990967
314,1568494800,338,256,0,594,37,-0.6732171504253635,0.017820181608078755
314,1568509200,133,197,64,330,37,0.5364136653121879,-0.788670323168966
314,1568523600,21,70,49,91,37,0.25290644287369934,-1.5187886210542452
314,1568538000,145,186,41,331,37,0.10170259090650541,-0.7856154348932953
314,1568552400,609,160,0,769,37,-0.6732171504253635,0.552425629850438
314,1568566800,441,243,0,684,37,-0.6732171504253635,0.2927601264184349
314,1568581200,320,240,0,560,37,-0.6732171504253635,-0.08604601976472245
314,1568595600,85,165,80,250,37,0.8388213692465757,-1.0330613852226158
314,1568610000,22,26,4,48,37,-0.5976152244417664,-1.650148816908082
314,1568624400,794,141,0,935,37,-0.6732171504253635,1.0595370836117615
314,1568638800,586,216,0,802,37,-0.6732171504253635,0.6532369429475685
314,1568653200,483,285,0,768,37,-0.6732171504253635,0.5493707415747673
314,1568667600,365,492,127,857,37,1.72714399955384,0.8212557981094528
314,1568682000,77,193,116,270,38,1.9357608362027372,-0.9257850368980898
314,1568696400,15,30,15,45,38,-0.29018046690705174,-1.610880463576786
314,1568710800,788,160,0,948,38,-0.62076580895306,1.1386358488270478
314,1568725200,616,216,0,832,38,-0.62076580895306,0.7854310955171422
314,1568739600,530,366,0,896,38,-0.62076580895306,0.9803026835501936
314,1568754000,383,467,84,850,38,1.2305121065045863,0.8402387296514379
314,1568768400,94,216,122,310,38,2.0679949730211407,-0.8039902943774327
314,1568782800,22,25,3,47,38,-0.5546487405438584,-1.604790726450753
314,1568797200,822,179,0,1001,38,-0.62076580895306,1.3000138826669183
314,1568811600,595,241,0,836,38,-0.62076580895306,0.7976105697692079
314,1568826000,473,352,0,825,38,-0.62076580895306,0.7641170155760272
314,1568840400,407,511,104,918,38,1.6712925625659307,1.047289791936555
314,1568854800,91,228,137,319,38,2.3985803150671487,-0.7765864773102849
314,1568869200,26,25,0,51,38,-0.62076580895306,-1.5926112521986873
314,1568883600,794,157,0,951,38,-0.62076580895306,1.147770454516097
314,1568898000,579,203,0,782,38,-0.62076580895306,0.6331876673663208
314,1568912400,550,336,0,886,38,-0.62076580895306,0.9498539979200292
314,1568926800,399,487,88,886,38,1.318668197716855,0.9498539979200292
314,1568941200,93,220,127,313,38,2.1781900870364765,-0.7948556886883834
314,1568955600,17,29,12,46,38,-0.3562975353162534,-1.6078355950137695
314,1568970000,707,139,0,846,38,-0.62076580895306,0.8280592553993722
314,1568984400,588,220,0,808,38,-0.62076580895306,0.712354250004748
314,1568998800,525,326,0,851,38,-0.62076580895306,0.8432835982144543
314,1569013200,503,405,0,908,38,-0.62076580895306,1.0168411063063907
314,1569027600,128,227,99,355,38,1.5610974485505946,-0.6669712090416935
314,1569042000,19,49,30,68,38,0.04040487513895654,-1.5408484866274081
314,1569056400,207,62,0,269,38,-0.62076580895306,-0.9288299054611062
314,1569070800,431,182,0,613,38,-0.62076580895306,0.11860488021654467
314,1569085200,451,233,0,684,38,-0.62076580895306,0.33479054819071097
314,1569099600,419,210,0,629,38,-0.62076580895306,0.1673227772248075
314,1569114000,140,187,47,327,38,0.41506826279109926,-0.7522275288061535
314,1569128400,20,54,34,74,38,0.1285609663512254,-1.5225792752493095
314,1569142800,119,94,0,213,38,-0.62076580895306,-1.0993425449900263
314,1569157200,456,155,0,611,38,-0.62076580895306,0.11251514309051182
314,1569171600,391,209,0,600,38,-0.62076580895306,0.07902158889733112
314,1569186000,307,215,0,522,38,-0.62076580895306,-0.1584781590179502
314,1569200400,97,137,40,234,38,0.26079510316962873,-1.0354003051666811
314,1569214800,20,23,3,43,38,-0.5546487405438584,-1.6169702007028188
314,1569229200,800,179,0,979,38,-0.62076580895306,1.233026774280557
314,1569243600,591,185,0,776,38,-0.62076580895306,0.6149184559882223
314,1569258000,502,316,0,818,38,-0.62076580895306,0.7428029356349122
314,1569272400,374,496,122,870,38,2.0679949730211407,0.9011361009117664
314,1569286800,77,205,128,282,39,1.9475044968304758,-0.8877398869717844
314,1569301200,17,30,13,47,39,-0.3866013889489779,-1.6088915482402215
314,1569315600,866,160,0,1026,39,-0.6504568369066552,1.3953955852993527
314,1569330000,612,218,0,830,39,-0.6504568369066552,0.7939244124967413
314,1569344400,502,349,0,851,39,-0.6504568369066552,0.8583677524398782
314,1569358800,417,557,140,974,39,2.191063371868332,1.2358216006782516
314,1569373200,91,230,139,321,39,2.1707667989485104,-0.7680593985059587
314,1569387600,18,28,10,46,39,-0.4474911077084419,-1.6119602787137042
314,1569402000,775,160,0,935,39,-0.6504568369066552,1.1161411122124258
314,1569416400,638,194,0,832,39,-0.6504568369066552,0.8000618734437067
314,1569430800,502,332,0,834,39,-0.6504568369066552,0.8061993343906722
314,1569445200,416,485,69,901,39,0.7500066945610169,1.0118042761140138
314,1569459600,96,229,133,325,39,2.0489873614295826,-0.7557844766120279
314,1569474000,22,19,0,41,39,-0.6504568369066552,-1.627303931081118
314,1569488400,779,156,0,935,39,-0.6504568369066552,1.1161411122124258
314,1569502800,624,200,0,824,39,-0.6504568369066552,0.775512029655845
314,1569517200,550,350,0,900,39,-0.6504568369066552,1.0087355456405311
314,1569531600,425,554,129,979,39,1.967801069750297,1.2511652530456652
314,1569546000,85,225,140,310,39,2.191063371868332,-0.8018154337142686
314,1569560400,21,36,15,57,39,-0.3460082431093352,-1.5782042435053945
314,1569574800,739,161,0,900,39,-0.6504568369066552,1.0087355456405311
314,1569589200,586,225,0,811,39,-0.6504568369066552,0.7356185335005697
314,1569603600,520,347,0,867,39,-0.6504568369066552,0.9074674400156015
314,1569618000,509,447,0,956,39,-0.6504568369066552,1.1805844521555628
314,1569632400,130,225,95,355,39,1.2777175904763716,-0.6637225624075466
314,1569646800,26,68,42,94,39,0.20199922572584084,-1.4646612159865342
314,1569661200,174,86,0,260,39,-0.6504568369066552,-0.9552519573884041
314,1569675600,461,158,0,619,39,-0.6504568369066552,0.14642228259188922
314,1569690000,471,246,0,717,39,-0.6504568369066552,0.44715786899319493
314,1569704400,404,247,0,651,39,-0.6504568369066552,0.24462165774333597
314,1569718800,138,203,65,341,39,0.6688204028817316,-0.7066847890363045
314,1569733200,20,69,49,89,39,0.3440752361645902,-1.4800048683539477
314,1569747600,126,59,0,185,39,-0.6504568369066552,-1.1854067428996073
314,1569762000,405,167,0,572,39,-0.6504568369066552,0.002191950338201787
314,1569776400,399,203,0,602,39,-0.6504568369066552,0.09425386454268313
314,1569790800,287,231,0,518,39,-0.6504568369066552,-0.16351949522986461
314,1569805200,85,156,71,241,39,0.7905998404006596,-1.0135578363845756
314,1569819600,14,34,20,48,39,-0.24452537851022854,-1.6058228177667389
314,1569834000,568,130,0,698,39,-0.6504568369066552,0.3888519899970234
314,1569848400,530,223,0,753,39,-0.6504568369066552,0.5576321660385725
314,1569862800,454,287,0,741,39,-0.6504568369066552,0.52080740035678
314,1569877200,319,407,88,726,39,1.1356415800376223,0.4747764432545393
314,1569891600,99,186,87,285,40,1.2194749348834881,-0.9170530900511825
314,1569906000,14,29,15,43,40,-0.3043648184585235,-1.6751602561577477
314,1569920400,608,144,0,752,40,-0.6218314337381092,0.545905780080082
314,1569934800,550,221,0,771,40,-0.6218314337381092,0.6054265906421676
314,1569949200,488,283,0,771,40,-0.6218314337381092,0.6054265906421676
314,1569963600,378,462,84,840,40,1.155981611827571,0.821581113209742
314,1569978000,94,228,134,322,40,2.2142036627595236,-0.8011441431671208
314,1569992400,18,29,11,47,40,-0.38902258253307964,-1.6626295591973086
314,1570006800,814,154,0,968,40,-0.6218314337381092,1.2225634159437933
314,1570021200,550,205,0,755,40,-0.6218314337381092,0.5553038028004113
314,1570035600,458,337,0,795,40,-0.6218314337381092,0.6806107724048023
314,1570050000,393,531,138,924,40,2.2988614268340797,1.084725749378963
314,1570064400,98,208,110,306,40,1.7062570783121862,-0.8512669310088772
314,1570078800,23,37,14,60,40,-0.3255292594771625,-1.6219047940758815
314,1570093200,771,137,0,908,40,-0.6218314337381092,1.0346029615372068
314,1570107600,582,236,0,818,40,-0.6218314337381092,0.752662279927327
314,1570122000,504,355,0,859,40,-0.6218314337381092,0.8811019237718278
314,1570136400,396,514,118,910,40,1.8755726064612988,1.0408683100174263
314,1570150800,103,245,142,348,40,2.3835191909086357,-0.7196946129242667
314,1570165200,16,44,28,60,40,-0.029227085216215802,-1.6219047940758815
314,1570179600,757,168,0,925,40,-0.6218314337381092,1.087858423619073
314,1570194000,612,215,0,827,40,-0.6218314337381092,0.780856348088315
314,1570208400,557,383,0,940,40,-0.6218314337381092,1.1348485372207195
314,1570222800,507,457,0,964,40,-0.6218314337381092,1.210032718983354
314,1570237200,185,231,46,416,40,0.3517328531192871,-0.5066727645968021
314,1570251600,25,47,22,72,40,-0.1562137313280501,-1.5843127031945643
314,1570266000,236,61,0,297,40,-0.6218314337381092,-0.8794609991698652
314,1570280400,514,144,0,658,40,-0.6218314337381092,0.2514344015097632
314,1570294800,500,228,0,728,40,-0.6218314337381092,0.4707215983174474
314,1570309200,427,252,0,679,40,-0.6218314337381092,0.3172205605520685
314,1570323600,151,208,57,359,40,0.5845417043243166,-0.6852351962830592
314,1570338000,20,58,38,78,40,0.1824173249701747,-1.5655166577539057
314,1570352400,143,50,0,193,40,-0.6218314337381092,-1.2052591201412817
314,1570366800,471,128,0,599,40,-0.6218314337381092,0.06660662134328656
314,1570381200,454,245,0,699,40,-0.6218314337381092,0.37987404535426395
314,1570395600,345,263,0,608,40,-0.6218314337381092,0.09480068950427452
314,1570410000,113,145,32,258,40,0.055430678858340396,-1.0016352945341465
314,1570424400,19,27,8,46,40,-0.4525159055889968,-1.6657622334374185
314,1570438800,790,164,0,954,40,-0.6218314337381092,1.1787059765822563
314,1570453200,571,190,0,761,40,-0.6218314337381092,0.57409984824107
314,1570467600,463,323,0,786,40,-0.6218314337381092,0.6524167042438143
314,1570482000,363,513,150,876,40,2.5528347190577483,0.934357385853694
314,1570496400,70,132,62,202,41,1.407010460317319,-1.0449220613083725
314,1570510800,19,18,0,37,41,-0.6759089476794399,-1.5715244818499348
314,1570525200,749,157,0,906,41,-0.6759089476794399,1.2019149330022927
314,1570539600,604,194,0,798,41,-0.6759089476794399,0.8572297122841793
314,1570554000,455,351,0,806,41,-0.6759089476794399,0.8827619508558914
314,1570568400,404,484,80,888,41,2.01172899812283,1.1444673962159404
314,1570582800,82,112,30,194,41,0.3319552819964112,-1.0704542998800848
314,1570597200,20,18,0,38,41,-0.6759089476794399,-1.5683329520284708
314,1570611600,584,115,0,699,41,-0.6759089476794399,0.541268259959242
314,1570626000,511,205,0,716,41,-0.6759089476794399,0.5955242669241302
314,1570640400,401,298,0,699,41,-0.6759089476794399,0.541268259959242
314,1570654800,352,427,75,779,41,1.8437516265101879,0.7965906456763631
314,1570669200,61,109,48,170,41,0.9366738198019219,-1.147051015595221
314,1570683600,14,20,6,34,41,-0.47433610174426966,-1.5810990713143267
314,1570698000,812,144,0,956,41,-0.6759089476794399,1.3614914240754934
314,1570712400,611,227,0,838,41,-0.6759089476794399,0.9848909051427398
314,1570726800,508,325,0,833,41,-0.6759089476794399,0.9689332560354197
314,1570741200,439,497,58,936,41,1.2726285630272056,1.2976608276462132
314,1570755600,91,129,38,220,41,0.6007190765766381,-0.9874745245220203
314,1570770000,23,18,0,41,41,-0.6759089476794399,-1.5587583625640786
314,1570784400,719,150,0,869,41,-0.6759089476794399,1.0838283296081241
314,1570798800,620,202,0,822,41,-0.6759089476794399,0.9338264279993156
314,1570813200,533,321,0,854,41,-0.6759089476794399,1.035955382286164
314,1570827600,496,488,0,984,41,-0.6759089476794399,1.4508542590764857
314,1570842000,145,228,83,373,41,2.1125154210904147,-0.4991704618380263
314,1570856400,27,77,50,104,41,1.0038647684469786,-1.3576919838118457
314,1570870800,182,55,0,237,41,-0.6759089476794399,-0.9332185175571321
314,1570885200,441,138,0,579,41,-0.6759089476794399,0.1582846813835604
314,1570899600,452,232,0,684,41,-0.6759089476794399,0.49339531263728176
314,1570914000,349,244,0,593,41,-0.6759089476794399,0.2029660988840566
314,1570928400,143,195,52,338,41,1.0710557170920354,-0.6108740055892667
314,1570942800,23,76,53,99,41,1.1046511914145638,-1.3736496329191659
314,1570957200,129,60,0,189,41,-0.6759089476794399,-1.0864119489874047
314,1570971600,409,161,0,570,41,-0.6759089476794399,0.12956091299038427
314,1570986000,404,225,0,629,41,-0.6759089476794399,0.31786117245676104
314,1571000400,261,292,31,553,41,0.3655507563189396,0.07530490602549605
314,1571014800,82,156,74,238,41,1.8101561521876595,-0.930026987735668
314,1571029200,18,29,11,47,41,-0.3063587301316278,-1.5396091836352945
314,1571043600,470,118,0,588,41,-0.6759089476794399,0.1870084497767365
314,1571058000,456,161,0,617,41,-0.6759089476794399,0.2795628145991929
314,1571072400,448,262,0,710,41,-0.6759089476794399,0.5763750879953461
314,1571086800,337,431,94,768,41,2.4820656386382267,0.7614838176402589
314,1571101200,87,157,70,244,42,0.8665153791466268,-0.982236932766011
314,1571115600,21,29,8,50,42,-0.4886834480592689,-1.5698914248856568
314,1571130000,744,138,0,882,42,-0.6635478128600296,0.9503587681223087
314,1571144400,574,205,0,779,42,-0.6635478128600296,0.6383566408629091
314,1571158800,542,308,0,850,42,-0.6635478128600296,0.8534260683912331
314,1571173200,409,498,89,907,42,1.2818182455484335,1.0260874397872115
314,1571187600,70,180,110,250,42,1.7408372031504304,-0.9640620515664343
314,1571202000,23,34,11,57,42,-0.4231093112589836,-1.548687396819484
314,1571216400,782,166,0,948,42,-0.6635478128600296,1.150282461317652
314,1571230800,608,187,0,795,42,-0.6635478128600296,0.686822990728447
314,1571245200,477,351,0,828,42,-0.6635478128600296,0.7867848373261187
314,1571259600,359,486,127,845,42,2.112423978352047,0.8382803340582525
314,1571274000,81,190,109,271,42,1.7189791575503355,-0.9004499673679159
314,1571288400,23,24,1,47,42,-0.6416897672599345,-1.578978865485445
314,1571302800,800,159,0,959,42,-0.6635478128600296,1.1836030768502093
314,1571317200,606,196,0,802,42,-0.6635478128600296,0.7080270187946197
314,1571331600,487,335,0,822,42,-0.6635478128600296,0.7686099561265419
314,1571346000,413,539,126,952,42,2.090565932751952,1.1623990487840365
314,1571360400,98,227,129,325,42,2.1561400695522375,-0.7368760365717258
314,1571374800,16,35,19,51,42,-0.24824494645822284,-1.5668622780190606
314,1571389200,744,148,0,892,42,-0.6635478128600296,0.9806502367882698
314,1571403600,595,190,0,785,42,-0.6635478128600296,0.6565315220624858
314,1571418000,577,337,0,914,42,-0.6635478128600296,1.0472914678533842
314,1571432400,497,485,0,982,42,-0.6635478128600296,1.25327345478192
314,1571446800,132,232,100,364,42,1.5222567471494797,-0.6187393087744775
314,1571461200,20,66,46,86,42,0.34192228474434466,-1.4608421376881968
314,1571475600,186,67,0,253,42,-0.6635478128600296,-0.9549746109666459
314,1571490000,440,186,0,626,42,-0.6635478128600296,0.17489717027370394
314,1571504400,471,247,0,718,42,-0.6635478128600296,0.4535786820005463
314,1571518800,389,260,0,649,42,-0.6635478128600296,0.24456754820541454
314,1571533200,143,221,78,364,42,1.0413797439473875,-0.6187393087744775
314,1571547600,17,55,38,72,42,0.1670579199435839,-1.5032501938205423
314,1571562000,130,44,0,174,42,-0.6635478128600296,-1.1942772134277388
314,1571576400,473,160,0,633,42,-0.6635478128600296,0.19610119833987674
314,1571590800,356,216,0,572,42,-0.6635478128600296,0.011323239477513874
314,1571605200,198,237,39,435,42,0.188915965543679,-0.40366988124615355
314,1571619600,81,123,42,204,42,0.2544901023439643,-1.1034028074298554
314,1571634000,26,24,0,50,42,-0.6635478128600296,-1.5698914248856568
314,1571648400,743,142,0,885,42,-0.6635478128600296,0.9594462087220971
314,1571662800,640,211,0,851,42,-0.6635478128600296,0.8564552152578292
314,1571677200,460,325,0,785,42,-0.6635478128600296,0.6565315220624858
314,1571691600,388,521,133,909,42,2.243572251952618,1.0321457335204038
314,1571706000,87,187,100,274,43,1.6614389490525705,-0.8745610357579225
314,1571720400,23,23,0,46,43,-0.6034242726354515,-1.5617520161811496
314,1571734800,765,151,0,916,43,-0.6034242726354515,1.0604240933285323
314,1571749200,613,211,0,824,43,-0.6034242726354515,0.7831365047367039
314,1571763600,501,350,0,851,43,-0.6034242726354515,0.8645143839973493
314,1571778000,403,484,81,887,43,1.2311149369318464,0.973018223011543
314,1571792400,79,223,144,302,43,2.6579787665953,-0.7901691609691052
314,1571806800,23,26,3,49,43,-0.5354783759848109,-1.5527100295966334
314,1571821200,840,146,0,986,43,-0.6034242726354515,1.2714037803005758
314,1571835600,629,203,0,832,43,-0.6034242726354515,0.8072484689620804
314,1571850000,531,322,0,853,43,-0.6034242726354515,0.8705423750536934
314,1571864400,436,452,16,888,43,-0.24104615716536804,0.976032218539715
314,1571878800,92,207,115,299,43,2.0011684323057737,-0.7992111475536213
314,1571893200,27,38,11,65,43,-0.35428931824976917,-1.5044861011458805
314,1571907600,775,152,0,927,43,-0.6034242726354515,1.0935780441384249
314,1571922000,639,217,0,856,43,-0.6034242726354515,0.8795843616382095
314,1571936400,551,327,0,878,43,-0.6034242726354515,0.9458922632579946
314,1571950800,441,523,82,964,43,1.2537635691487266,1.2050958786807906
314,1571965200,117,250,133,367,43,2.408843812209618,-0.594259451637922
314,1571979600,20,51,31,71,43,0.09868332608783525,-1.4864021279768482
314,1571994000,735,161,0,896,43,-0.6034242726354515,1.0001441827650914
314,1572008400,623,221,0,844,43,-0.6034242726354515,0.8434164153001449
314,1572022800,537,327,0,864,43,-0.6034242726354515,0.9036963258635858
314,1572037200,474,428,0,902,43,-0.6034242726354515,1.0182281559341237
314,1572051600,120,254,134,374,43,2.431492444426498,-0.5731614829407177
314,1572066000,17,46,29,63,43,0.053386061654074814,-1.5105140922022247
314,1572080400,179,49,0,228,43,-0.6034242726354515,-1.0132048300538368
314,1572094800,469,191,0,660,43,-0.6034242726354515,0.28884123811648804
314,1572109200,472,205,0,677,43,-0.6034242726354515,0.3400791620954129
314,1572123600,371,184,0,555,43,-0.6034242726354515,-0.027628292341576995
314,1572138000,135,200,65,335,43,0.8687368214617628,-0.6907073085394275
314,1572152400,19,66,47,85,43,0.4610614415579188,-1.4442061905824395
314,1572166800,117,35,0,152,43,-0.6034242726354515,-1.2422684901949124
314,1572181200,316,110,0,426,43,-0.6034242726354515,-0.4164337154757712
314,1572195600,335,155,0,490,43,-0.6034242726354515,-0.2235380016727601
314,1572210000,215,187,0,402,43,-0.6034242726354515,-0.48876960815190035
314,1572224400,85,116,31,201,43,0.09868332608783525,-1.094582709314482
314,1572238800,21,22,1,43,43,-0.5807756404185713,-1.5707940027656657
314,1572253200,762,150,0,912,43,-0.6034242726354515,1.0483681112158443
314,1572267600,575,189,0,764,43,-0.6034242726354515,0.6022967730463811
314,1572282000,504,285,0,789,43,-0.6034242726354515,0.6776466612506823
314,1572296400,401,497,96,898,43,1.5708444201850496,1.0061721738214355
314,1572310800,80,183,103,263,44,2.0503951001877216,-0.9526422918367968
314,1572325200,21,23,2,44,44,-0.5797155786741819,-1.62255083926148
314,1572339600,776,154,0,930,44,-0.6317969782556058,1.0876727818265077
314,1572354000,653,199,0,852,44,-0.6317969782556058,0.8490752169903193
314,1572368400,491,337,0,828,44,-0.6317969782556058,0.7756605816561074
314,1572382800,404,465,61,869,44,0.9566857089778211,0.9010772503520527
314,1572397200,80,196,116,276,44,2.3889241974669764,-0.9128760310307654
314,1572411600,19,23,4,42,44,-0.5276341790927581,-1.628668725539331
314,1572426000,803,134,0,937,44,-0.6317969782556058,1.1090853837989862
314,1572440400,634,203,0,837,44,-0.6317969782556058,0.8031910699064368
314,1572454800,491,396,0,887,44,-0.6317969782556058,0.9561382268527115
314,1572469200,436,460,24,896,44,-0.006820183278519809,0.983668715103041
314,1572483600,107,205,98,312,44,1.920191601234162,-0.8027540780294475
314,1572498000,18,33,15,51,44,-0.24118648139492704,-1.6011382372890015
314,1572512400,738,123,0,861,44,-0.6317969782556058,0.8766057052406487
314,1572526800,554,225,0,779,44,-0.6317969782556058,0.6257723678487582
314,1572541200,529,306,0,835,44,-0.6317969782556058,0.7970731836285858
314,1572555600,411,421,10,832,44,-0.37138998034848664,0.7878963542118094
314,1572570000,129,217,88,346,44,1.659784603327043,-0.6987500113059808
314,1572584400,33,53,20,86,44,-0.11098298244136746,-1.4940752274266094
314,1572598800,704,137,0,841,44,-0.6317969782556058,0.8154268424621388
314,1572613200,592,208,0,800,44,-0.6317969782556058,0.6900101737661936
314,1572627600,527,349,0,876,44,-0.6317969782556058,0.9224898523245311
314,1572642000,475,471,0,946,44,-0.6317969782556058,1.1366158720493158
314,1572656400,136,227,91,363,44,1.7379067026991786,-0.6467479779442474
314,1572670800,18,65,47,83,44,0.5921159119078542,-1.5032520568433858
314,1572685200,151,62,0,213,44,-0.6317969782556058,-1.1055894487830715
314,1572699600,401,186,0,587,44,-0.6317969782556058,0.0384552851750633
314,1572714000,441,321,0,762,44,-0.6317969782556058,0.5737703344870247
314,1572728400,324,299,0,623,44,-0.6317969782556058,0.1485772381763811
314,1572742800,147,267,120,414,44,2.493086996629824,-0.49074187785904716
314,1572753600,21,58,37,79,44,0.3317089140007351,-1.5154878293990877
314,1572768000,92,41,0,133,44,-0.6317969782556058,-1.350304899897111
314,1572782400,403,168,0,571,44,-0.6317969782556058,-0.010487805047744601
314,1572796800,423,300,0,723,44,-0.6317969782556058,0.45447155206893053
314,1572811200,299,330,31,629,44,0.1754647152564636,0.16693089700993405
314,1572825600,105,215,110,320,44,2.232679998722705,-0.7782825329180436
314,1572840000,18,40,22,58,44,-0.05890158285994364,-1.5797256353165232
314,1572854400,429,94,0,523,44,-0.6317969782556058,-0.15731707571616832
314,1572868800,855,210,0,1065,44,-0.6317969782556058,1.5006301055814495
314,1572883200,470,274,0,744,44,-0.6317969782556058,0.5187093579863659
314,1572897600,495,515,20,1010,44,-0.11098298244136746,1.3323882329405474
314,1572912000,119,235,116,354,45,2.241503862990827,-0.5489360504478558
314,1572926400,17,31,14,48,45,-0.20939010052441115,-1.4315741238065247
314,1572940800,369,109,0,478,45,-0.5457873112029733,-0.19126572006721868
314,1572955200,845,212,0,1057,45,-0.5457873112029733,1.478823967758498
314,1572969600,529,282,0,811,45,-0.5457873112029733,0.7692521832936857
314,1572984000,498,516,18,1014,45,-0.11327661175910768,1.3547931273845675
314,1572998400,113,274,161,387,45,3.322780611600491,-0.4537495915562346
314,1573012800,19,31,12,50,45,-0.2574468449070629,-1.4258052475100629
314,1573027200,444,104,0,548,45,-0.5457873112029733,0.010644950308947408
314,1573041600,892,207,0,1099,45,-0.5457873112029733,1.5999703699841976
314,1573056000,473,275,0,748,45,-0.5457873112029733,0.5875325799551363
314,1573070400,507,538,31,1045,45,0.19909222672812857,1.4442107099797268
314,1573084800,72,161,89,233,45,1.5927378138250285,-0.8979530663838
314,1573099200,0,1,1,1,45,-0.5217589390116474,-1.5671427167733791
314,1573113600,396,93,0,489,45,-0.5457873112029733,-0.15953690043667831
314,1573128000,925,208,0,1133,45,-0.5457873112029733,1.69804126702405
314,1573142400,461,257,0,718,45,-0.5457873112029733,0.5009994355082079
314,1573156800,505,498,0,1003,45,-0.5457873112029733,1.323064307754027
314,1573171200,74,178,104,252,45,1.9531633966949167,-0.843148741567412
314,1573185600,0,6,6,6,45,-0.40161707805501806,-1.5527205260322243
314,1573200000,379,94,0,473,45,-0.5457873112029733,-0.2056879108083734
314,1573214400,855,194,0,1049,45,-0.5457873112029733,1.4557484625726504
314,1573228800,476,310,0,786,45,-0.5457873112029733,0.6971412295879121
314,1573243200,512,509,0,1021,45,-0.5457873112029733,1.3749841944221841
314,1573257600,140,259,119,399,45,2.3135889795648046,-0.4191363337774633
314,1573272000,20,76,56,96,45,0.7998015315112752,-1.2931210926914394
314,1573286400,108,35,0,143,45,-0.5457873112029733,-1.157552499724585
314,1573300800,396,183,0,579,45,-0.5457873112029733,0.10006253290410667
314,1573315200,441,248,0,689,45,-0.5457873112029733,0.41735072920951055
314,1573329600,349,311,0,660,45,-0.5457873112029733,0.33370202291081313
314,1573344000,157,242,85,399,45,1.4966243250597253,-0.4191363337774633
314,1573358400,28,60,32,88,45,0.22312059891945446,-1.316196597877287
314,1573372800,74,32,0,106,45,-0.5457873112029733,-1.26427671120913
314,1573387200,342,161,0,503,45,-0.5457873112029733,-0.11915476636144508
314,1573401600,398,270,0,668,45,-0.5457873112029733,0.3567775280966607
314,1573416000,289,278,0,567,45,-0.5457873112029733,0.06544927512533535
314,1573430400,102,196,94,298,45,1.712879674781658,-0.7104645867487887
314,1573444800,16,32,16,48,45,-0.16133335614175942,-1.4315741238065247
314,1573459200,288,88,0,376,45,-0.5457873112029733,-0.485478411186775
314,1573473600,722,185,0,907,45,-0.5457873112029733,1.0461582455238563
314,1573488000,433,256,0,689,45,-0.5457873112029733,0.41735072920951055
314,1573502400,429,414,0,843,45,-0.5457873112029733,0.8615542040370759
314,1573516800,59,130,71,189,46,1.7106938146572028,-0.9691844504053589
314,1573531200,0,2,2,2,46,-0.5285070321705179,-1.499450885339785
314,1573545600,416,83,0,499,46,-0.5934114045423359,-0.0901331411557754
314,1573560000,822,194,0,1016,46,-0.5934114045423359,1.3758975907217559
314,1573574400,480,300,0,780,46,-0.5934114045423359,0.7066843359382019
314,1573588800,448,508,60,956,46,1.3537197666122038,1.2057586276411911
314,1573603200,61,157,96,218,46,2.5219984693049278,-0.8869506182497527
314,1573617600,0,0,0,0,46,-0.5934114045423359,-1.5051221841091371
314,1573632000,402,90,0,492,46,-0.5934114045423359,-0.10998268684850794
314,1573646400,823,195,0,1018,46,-0.5934114045423359,1.381568889491108
314,1573660800,497,225,0,722,46,-0.5934114045423359,0.5422166716269895
314,1573675200,458,432,0,890,46,-0.5934114045423359,1.0186057682525702
314,1573689600,81,138,57,219,46,1.2563632080544769,-0.8841149688650766
314,1573704000,0,1,1,1,46,-0.5609592183564269,-1.5022865347244612
314,1573718400,427,88,0,515,46,-0.5934114045423359,-0.04476275100095819
314,1573732800,870,204,0,1074,46,-0.5934114045423359,1.540365255032968
314,1573747200,502,258,0,760,46,-0.5934114045423359,0.6499713482446804
314,1573761600,517,498,0,1015,46,-0.5934114045423359,1.3730619413370797
314,1573776000,74,172,98,246,46,2.586902841676746,-0.8075524354788226
314,1573790400,0,1,1,1,46,-0.5609592183564269,-1.5022865347244612
314,1573804800,337,90,0,427,46,-0.5934114045423359,-0.29429989685245284
314,1573819200,886,189,0,1075,46,-0.5934114045423359,1.5432009044176442
314,1573833600,543,265,0,808,46,-0.5934114045423359,0.786082518709132
314,1573848000,527,490,0,1017,46,-0.5934114045423359,1.3787332401064318
314,1573862400,177,236,59,413,46,1.3212675804262948,-0.3339989882379179
314,1573876800,17,67,50,84,46,1.029197904753114,-1.2669276357963468
314,1573891200,99,44,0,143,46,-0.5934114045423359,-1.0996243221004585
314,1573905600,410,140,0,550,46,-0.5934114045423359,0.05448497746270446
314,1573920000,448,254,0,702,46,-0.5934114045423359,0.485503683933468
314,1573934400,379,337,0,716,46,-0.5934114045423359,0.525202775318933
314,1573948800,148,221,73,369,46,1.7755981870290207,-0.45876756116366524
314,1573963200,26,83,57,109,46,1.2563632080544769,-1.1960364011794449
314,1573977600,67,63,0,130,46,-0.5934114045423359,-1.1364877641012474
314,1573992000,365,112,0,477,46,-0.5934114045423359,-0.15251742761864906
314,1574006400,468,190,0,658,46,-0.5934114045423359,0.36073511100772065
314,1574020800,265,242,0,507,46,-0.5934114045423359,-0.0674479460783668
314,1574035200,107,150,43,257,46,0.8020326014517509,-0.7763602922473858
314,1574049600,10,30,20,40,46,0.055632319175844026,-1.391696208722094
314,1574064000,369,95,0,464,46,-0.5934114045423359,-0.18938086961943806
314,1574078400,858,194,0,1052,46,-0.5934114045423359,1.4779809685700944
314,1574092800,469,261,0,730,46,-0.5934114045423359,0.5649018667043981
314,1574107200,436,516,80,952,46,2.0027634903303837,1.1944160301024869
314,1574121600,84,148,64,232,47,1.479432043216638,-0.7952024123909904
314,1574136000,0,1,1,1,47,-0.48374608434164895,-1.4384451841950083
314,1574150400,383,89,0,472,47,-0.5149076419219393,-0.1268982338933096
314,1574164800,899,201,0,1100,47,-0.5149076419219393,1.621831033175622
314,1574179200,471,266,0,737,47,-0.5149076419219393,0.6110209631978797
314,1574193600,477,488,11,965,47,-0.17213050853874629,1.2459099327706766
314,1574208000,60,181,121,241,47,3.255640825293183,-0.7701410056973275
314,1574222400,0,1,1,1,47,-0.48374608434164895,-1.4384451841950083
314,1574236800,382,104,0,486,47,-0.5149076419219393,-0.08791382348094488
314,1574251200,894,187,0,1081,47,-0.5149076419219393,1.5689236190445557
314,1574265600,520,291,0,811,47,-0.5149076419219393,0.8170814182346646
314,1574280000,481,475,0,956,47,-0.5149076419219393,1.2208485260770134
314,1574294400,61,141,80,202,47,1.9780169645012822,-0.8787404347032006
314,1574308800,0,3,3,3,47,-0.4214229691810684,-1.4328759827075277
314,1574323200,384,76,0,460,47,-0.5149076419219393,-0.16031344281819365
314,1574337600,958,224,0,1182,47,-0.5149076419219393,1.8501682941623296
314,1574352000,514,274,0,788,47,-0.5149076419219393,0.7530356011286369
314,1574366400,522,512,0,1034,47,-0.5149076419219393,1.4380473840887598
314,1574380800,73,177,104,250,47,2.7258943464282486,-0.7450795990036644
314,1574395200,0,3,3,3,47,-0.4214229691810684,-1.4328759827075277
314,1574409600,356,82,0,438,47,-0.5149076419219393,-0.22157465918048105
314,1574424000,834,207,0,1041,47,-0.5149076419219393,1.457539589294942
314,1574438400,458,271,0,729,47,-0.5149076419219393,0.588744157247957
314,1574452800,502,444,0,946,47,-0.5149076419219393,1.19300251863961
314,1574467200,175,228,53,403,47,1.1366549098334449,-0.31903568521139286
314,1574481600,13,75,62,88,47,1.4171089280560574,-1.196184919489599
314,1574496000,106,39,0,145,47,-0.5149076419219393,-1.0374626770963997
314,1574510400,382,100,0,482,47,-0.5149076419219393,-0.09905222645590622
314,1574524800,421,147,0,568,47,-0.5149076419219393,0.14042343750576275
314,1574539200,379,173,0,552,47,-0.5149076419219393,0.09586982560591736
314,1574553600,174,161,0,335,47,-0.5149076419219393,-0.5083885357857357
314,1574568000,30,108,78,138,47,1.9156938493407016,-1.056954882302582
314,1574582400,77,31,0,108,47,-0.5149076419219393,-1.1404929046147922
314,1574596800,291,102,0,393,47,-0.5149076419219393,-0.3468816926487962
314,1574611200,340,136,0,476,47,-0.5149076419219393,-0.11575983091834825
314,1574625600,253,169,0,422,47,-0.5149076419219393,-0.26612827108032644
314,1574640000,93,133,40,226,47,0.7315546612896715,-0.8119100168534326
314,1574654400,19,27,8,46,47,-0.2656151812796171,-1.3131381507266933
314,1574668800,374,93,0,467,47,-0.5149076419219393,-0.1408212376120113
314,1574683200,846,193,0,1039,47,-0.5149076419219393,1.4519703878074615
314,1574697600,442,272,0,714,47,-0.5149076419219393,0.5469751460918519
314,1574712000,456,521,65,977,47,1.510593600796928,1.2793251416955607
314,1574726400,125,212,87,337,48,2.427818818304996,-0.3577402172385242
314,1574740800,21,35,14,56,48,-0.1083626116517733,-1.322559697094343
314,1574755200,389,80,0,469,48,-0.5947535708215647,0.09548459180406674
314,1574769600,881,188,0,1069,48,-0.5947535708215647,2.1555973601794802
314,1574784000,463,264,0,727,48,-0.5947535708215647,0.9813330822054945
314,1574798400,503,469,0,972,48,-0.5947535708215647,1.8225457959587885
314,1574812800,139,225,86,364,48,2.393076606935725,-0.26503514266163064
314,1574827200,18,43,25,61,48,0.27380171341020565,-1.3053920906912144
314,1574841600,367,102,0,469,48,-0.5947535708215647,0.09548459180406674
314,1574856000,759,182,0,941,48,-0.5947535708215647,1.716106636259392
314,1574870400,539,305,0,844,48,-0.5947535708215647,1.3830550720387003
314,1574884800,481,406,0,887,48,-0.5947535708215647,1.5306964871056048
314,1574899200,130,213,83,343,48,2.288849972827913,-0.3371390895547701
314,1574913600,17,63,46,80,48,1.0033881521648926,-1.2401551863593263
314,1574928000,99,41,0,140,48,-0.5947535708215647,-1.034143909521785
314,1574942400,321,122,0,443,48,-0.5947535708215647,0.006213038507798819
314,1574956800,342,168,0,510,48,-0.5947535708215647,0.23625896430972
314,1574971200,266,155,0,421,48,-0.5947535708215647,-0.06932442966596634
314,1574985600,133,145,12,278,48,-0.1778470343903149,-0.5603179727954399
314,1575000000,23,47,24,70,48,0.23905950204093482,-1.2744903991655832
314,1575014400,135,60,0,195,48,-0.5947535708215647,-0.8453002390873721
314,1575028800,434,148,0,582,48,-0.5947535708215647,0.4834724965147696
314,1575043200,457,238,0,695,48,-0.5947535708215647,0.8714604012254725
314,1575057600,332,312,0,644,48,-0.5947535708215647,0.6963508159135623
314,1575072000,142,189,47,331,48,1.0381303635341634,-0.3783413449222784
314,1575086400,18,58,40,76,48,0.7949348839492678,-1.253889271481829
314,1575100800,71,30,0,101,48,-0.5947535708215647,-1.1680512394661868
314,1575115200,314,97,0,411,48,-0.5947535708215647,-0.10365964247222323
314,1575129600,378,158,0,536,48,-0.5947535708215647,0.3255305176059879
314,1575144000,302,193,0,495,48,-0.5947535708215647,0.18475614510033467
314,1575158400,145,199,54,344,48,1.2813258431190593,-0.3337055682741444
314,1575172800,25,65,40,90,48,0.7949348839492678,-1.2058199735530695
314,1575187200,65,31,0,96,48,-0.5947535708215647,-1.1852188458693154
314,1575201600,280,86,0,366,48,-0.5947535708215647,-0.25816810010037927
314,1575216000,313,141,0,454,48,-0.5947535708215647,0.043981772594681404
314,1575230400,187,195,8,382,48,-0.3168158798673982,-0.2032317596103682
314,1575244800,86,117,31,203,48,0.4822549816258305,-0.8178320688423666
314,1575259200,14,26,12,40,48,-0.1778470343903149,-1.377496037584354
314,1575273600,364,104,0,468,48,-0.5947535708215647,0.09205107052344105
314,1575288000,792,204,0,996,48,-0.5947535708215647,1.9049503066938052
314,1575302400,415,267,0,682,48,-0.5947535708215647,0.8268246245773385
314,1575316800,376,486,110,862,48,3.2268896797982247,1.4448584550899626
314,1575331200,114,173,59,287,49,1.6386569186291342,-0.7792255582589143
314,1575345600,17,23,6,40,49,-0.4059901110056488,-1.5148417145404665
314,1575360000,389,71,0,460,49,-0.6374595860586431,-0.2639964285556408
314,1575374400,881,202,0,1083,49,-0.6374595860586431,1.5914240789885172
314,1575388800,472,304,0,776,49,-0.6374595860586431,0.677115738994847
314,1575403200,446,487,41,933,49,0.9442484934701513,1.1446936197082223
314,1575417600,127,175,48,302,49,1.2142962143653113,-0.7345525123308848
314,1575432000,17,26,9,43,49,-0.29025537347915165,-1.5059071053548605
314,1575446400,418,94,0,512,49,-0.6374595860586431,-0.10912986933847194
314,1575460800,873,224,0,1097,49,-0.6374595860586431,1.633118921854678
314,1575475200,466,304,0,770,49,-0.6374595860586431,0.6592465206236352
314,1575489600,503,493,0,996,49,-0.6374595860586431,1.3323204126059462
314,1575504000,138,196,58,334,49,1.6000786727869685,-0.6392500143510885
314,1575518400,20,25,5,45,49,-0.4445683568478145,-1.4999506992311233
314,1575532800,377,100,0,477,49,-0.6374595860586431,-0.21336697650387407
314,1575547200,907,227,0,1134,49,-0.6374595860586431,1.7433124351438174
314,1575561600,439,255,0,694,49,-0.6374595860586431,0.4329030879216192
314,1575576000,493,481,0,974,49,-0.6374595860586431,1.2667999452448362
314,1575590400,126,219,93,345,49,2.950317277262769,-0.6064897806705336
314,1575604800,13,32,19,45,49,0.09552708494250552,-1.4999506992311233
314,1575619200,358,86,0,444,49,-0.6374595860586431,-0.31164767754553896
314,1575633600,847,195,0,1042,49,-0.6374595860586431,1.4693177534519033
314,1575648000,492,287,0,779,49,-0.6374595860586431,0.686050348180453
314,1575662400,507,422,0,929,49,-0.6374595860586431,1.1327808074607477
314,1575676800,205,271,66,476,49,1.9087046395242941,-0.2163451795657427
314,1575691200,25,89,64,114,49,1.8315481478399627,-1.2944546879621877
314,1575705600,109,46,0,155,49,-0.6374595860586431,-1.1723483624255737
314,1575720000,401,102,0,503,49,-0.6374595860586431,-0.13593369689528964
314,1575734400,407,185,0,592,49,-0.6374595860586431,0.12912637561101867
314,1575748800,425,271,0,696,49,-0.6374595860586431,0.43885949404535646
314,1575763200,193,228,35,421,49,0.712779018417157,-0.3801463479685175
314,1575777600,42,90,48,132,49,1.2142962143653113,-1.2408470328485524
314,1575792000,66,71,5,137,49,-0.4445683568478145,-1.2259560175392092
314,1575806400,511,250,0,761,49,-0.6374595860586431,0.6324426930668176
314,1575820800,449,199,0,648,49,-0.6374595860586431,0.2959057470756621
314,1575835200,305,236,0,541,49,-0.6374595860586431,-0.022761980544281593
314,1575849600,92,164,72,256,49,2.1401741145772886,-0.8715498531768419
314,1575864000,17,37,20,54,49,0.13410533078467124,-1.4731468716743057
314,1575878400,366,93,0,459,49,-0.6374595860586431,-0.26697463161750945
314,1575892800,811,197,0,1008,49,-0.6374595860586431,1.3680588493483699
314,1575907200,429,274,0,703,49,-0.6374595860586431,0.4597069154784369
314,1575921600,400,446,46,846,49,1.1371397226809798,0.8855899533256514
314,1575936000,99,277,178,376,50,3.025730332205589,-0.5309103986336358
314,1575950400,11,39,28,50,50,0.014815612114732767,-1.517102933987284
314,1575964800,400,84,0,484,50,-0.5472218023022271,-0.204196307166783
314,1575979200,896,193,0,1089,50,-0.5472218023022271,1.6260076311429017
314,1575993600,426,286,0,712,50,-0.5472218023022271,0.4855334414854618
314,1576008000,472,473,1,945,50,-0.5271490375016213,1.1903888425204312
314,1576022400,127,300,173,427,50,2.9253665082025604,-0.37662874432984417
314,1576036800,19,46,27,65,50,-0.00525715268587294,-1.47172597683911
314,1576051200,408,96,0,504,50,-0.5472218023022271,-0.14369369763588433
314,1576065600,842,203,0,1045,50,-0.5472218023022271,1.4929018901749245
314,1576080000,505,284,0,789,50,-0.5472218023022271,0.7184684881794217
314,1576094400,513,480,0,993,50,-0.5472218023022271,1.335595105394588
314,1576108800,150,312,162,462,50,2.7045660953958977,-0.2707491776507715
314,1576123200,25,48,23,73,50,-0.08554821188829577,-1.4475249330267506
314,1576137600,372,80,0,452,50,-0.5472218023022271,-0.30100048241622085
314,1576152000,918,199,0,1117,50,-0.5472218023022271,1.7107112844861598
314,1576166400,444,254,0,698,50,-0.5472218023022271,0.4431816148138327
314,1576180800,502,475,0,977,50,-0.5472218023022271,1.2871930177698692
314,1576195200,152,282,130,434,50,2.062237621776515,-0.35545283099402963
314,1576209600,18,50,32,68,50,0.0951066713171556,-1.4626505854094751
314,1576224000,377,68,0,445,50,-0.5472218023022271,-0.3221763957520354
314,1576238400,892,178,0,1070,50,-0.5472218023022271,1.568530152088548
314,1576252800,499,296,0,795,50,-0.5472218023022271,0.7366192710386913
314,1576267200,491,431,0,922,50,-0.5472218023022271,1.1208108415598979
314,1576281600,156,268,112,424,50,1.7009278553656122,-0.385704135759479
314,1576296000,31,85,54,116,50,0.5367074969304811,-1.3174443225353185
314,1576310400,98,43,0,141,50,-0.5472218023022271,-1.241816060621695
314,1576324800,398,110,0,508,50,-0.5472218023022271,-0.1315931757297046
314,1576339200,417,182,0,599,50,-0.5472218023022271,0.14369369763588433
314,1576353600,431,251,0,682,50,-0.5472218023022271,0.3947795271891138
314,1576368000,175,219,44,394,50,0.3359798489244241,-0.476458050055827
314,1576382400,34,90,56,124,50,0.5768530265316926,-1.2932432787229589
314,1576396800,59,44,0,103,50,-0.5472218023022271,-1.3567710187304025
314,1576411200,345,101,0,446,50,-0.5472218023022271,-0.3191512652754905
314,1576425600,414,162,0,576,50,-0.5472218023022271,0.07411569667535087
314,1576440000,318,267,0,585,50,-0.5472218023022271,0.10134187096425526
314,1576454400,88,165,77,253,50,0.9983810873444126,-0.9030014472486626
314,1576468800,16,37,21,53,50,-0.12569374148950718,-1.5080275425576493
314,1576483200,369,87,0,456,50,-0.5472218023022271,-0.28889996051004113
314,1576497600,830,199,0,1029,50,-0.5472218023022271,1.4444998025502056
314,1576512000,457,260,0,717,50,-0.5472218023022271,0.5006590938681864
314,1576526400,469,496,27,965,50,-0.00525715268587294,1.25089145205133
314,1576540800,137,248,111,385,51,3.026050855143184,-0.3878984835367163
314,1576555200,12,36,24,48,51,0.2017367236762123,-1.495933828840184
314,1576569600,376,61,0,437,51,-0.5773844160388143,-0.21692567061155213
314,1576584000,751,215,0,966,51,-0.5773844160388143,1.522393907030983
314,1576598400,437,238,0,675,51,-0.5773844160388143,0.5656037423920838
314,1576612800,492,472,0,964,51,-0.5773844160388143,1.5158180296107844
314,1576627200,152,207,55,359,51,1.208101529141455,-0.47338488999929834
314,1576641600,22,48,26,70,51,0.26666348531913114,-1.423599177217999
314,1576656000,350,99,0,449,51,-0.5773844160388143,-0.1774704060903604
314,1576670400,818,181,0,999,51,-0.5773844160388143,1.6308958844642603
314,1576684800,481,267,0,748,51,-0.5773844160388143,0.8056232682293334
314,1576699200,455,468,13,923,51,-0.15536046535984158,1.3810125424967128
314,1576713600,117,241,124,358,51,3.4480748058221566,-0.47667282870939764
314,1576728000,22,44,22,66,51,0.1368099620332934,-1.4367509320583962
314,1576742400,350,87,0,437,51,-0.5773844160388143,-0.21692567061155213
314,1576756800,815,192,0,1007,51,-0.5773844160388143,1.657199394145055
314,1576771200,465,248,0,713,51,-0.5773844160388143,0.6905454133758575
314,1576785600,460,450,0,910,51,-0.5773844160388143,1.3382693392654217
314,1576800000,172,263,91,435,51,2.3767832387139953,-0.22350154803175076
314,1576814400,17,49,32,66,51,0.46144377024788785,-1.4367509320583962
314,1576828800,324,76,0,400,51,-0.5773844160388143,-0.33857940288522664
314,1576843200,763,193,0,956,51,-0.5773844160388143,1.48951451992999
314,1576857600,478,268,0,746,51,-0.5773844160388143,0.7990473908091348
314,1576872000,462,437,0,899,51,-0.5773844160388143,1.3021020134543293
314,1576886400,173,211,38,384,51,0.6562240551766445,-0.3911864222468156
314,1576900800,32,68,36,100,51,0.5912972935337256,-1.3249610159150198
314,1576915200,93,37,0,130,51,-0.5773844160388143,-1.2263228546120404
314,1576929600,340,91,0,431,51,-0.5773844160388143,-0.236653302872148
314,1576944000,415,194,0,609,51,-0.5773844160388143,0.3485997875255292
314,1576958400,349,224,0,573,51,-0.5773844160388143,0.23023399396195407
314,1576972800,152,208,56,360,51,1.2405649099629144,-0.47009695128919904
314,1576987200,25,60,35,85,51,0.5588339127122661,-1.3742800965665094
314,1577001600,63,30,0,93,51,-0.5773844160388143,-1.347976586885715
314,1577016000,286,89,0,375,51,-0.5773844160388143,-0.4207778706377094
314,1577030400,350,142,0,492,51,-0.5773844160388143,-0.036089041556090065
314,1577044800,272,212,0,484,51,-0.5773844160388143,-0.06239255123688455
314,1577059200,123,182,59,305,51,1.3379550524272927,-0.6509335803446611
314,1577073600,19,44,25,63,51,0.23420010449767173,-1.4466147481886942
314,1577088000,233,83,0,316,51,-0.5773844160388143,-0.6147662545335687
314,1577102400,621,200,0,821,51,-0.5773844160388143,1.0456427940665831
314,1577116800,471,281,0,752,51,-0.5773844160388143,0.8187750230697306
314,1577131200,406,330,0,736,51,-0.5773844160388143,0.7661680037081416
314,1577145600,130,213,83,343,52,5.567416490127514,1.1018164639035373
314,1577160000,21,40,19,61,52,1.0359356345748243,-0.24374359161777995
314,1577174400,188,56,0,244,52,-0.3093477444173804,0.6294389976035004
314,1577188800,428,172,0,600,52,-0.3093477444173804,2.3280892804601985
314,1577203200,374,240,0,614,52,-0.3093477444173804,2.3948901342804056
314,1577204429,46,27,0,73,52,-0.3093477444173804,-0.18648571691474516
314,1577204507,2,3,1,5,52,-0.23854335604936963,-0.5109470068986088
314,1577204930,27,12,0,39,52,-0.3093477444173804,-0.34871636190667704
314,1577204993,2,0,0,2,52,-0.3093477444173804,-0.5252614755743675
314,1577205056,2,1,0,3,52,-0.3093477444173804,-0.5204899860157813
314,1577205119,4,8,4,12,52,-0.02613019094533728,-0.47754657998850525
314,1577205182,2,1,0,3,52,-0.3093477444173804,-0.5204899860157813
314,1577205248,2,0,0,2,52,-0.3093477444173804,-0.5252614755743675
314,1577205314,3,0,0,3,52,-0.3093477444173804,-0.5204899860157813
314,1577205443,4,8,4,12,52,-0.02613019094533728,-0.47754657998850525
314,1577205508,0,0,0,0,52,-0.3093477444173804,-0.53480445469154
314,1577205602,5,4,0,9,52,-0.3093477444173804,-0.49186104866426394
314,1577205673,2,3,1,5,52,-0.23854335604936963,-0.5109470068986088
314,1577205739,1,0,0,1,52,-0.3093477444173804,-0.5300329651329538
314,1577205807,1,1,0,2,52,-0.3093477444173804,-0.5252614755743675
314,1577205873,4,0,0,4,52,-0.3093477444173804,-0.5157184964571951
314,1577205938,3,1,0,4,52,-0.3093477444173804,-0.5157184964571951
314,1577206002,2,8,6,10,52,0.11547858579068428,-0.4870895591056777
314,1577206082,2,0,0,2,52,-0.3093477444173804,-0.5252614755743675
314,1577206170,4,0,0,4,52,-0.3093477444173804,-0.5157184964571951
314,1577206254,4,1,0,5,52,-0.3093477444173804,-0.5109470068986088
314,1577206338,2,0,0,2,52,-0.3093477444173804,-0.5252614755743675
314,1577206418,3,2,0,5,52,-0.3093477444173804,-0.5109470068986088
314,1577206499,2,2,0,4,52,-0.3093477444173804,-0.5157184964571951
314,1577206579,1,7,6,8,52,0.11547858579068428,-0.4966325382228502
314,1577206660,3,1,0,4,52,-0.3093477444173804,-0.5157184964571951
314,1577206739,3,0,0,3,52,-0.3093477444173804,-0.5204899860157813
314,1577206819,2,1,0,3,52,-0.3093477444173804,-0.5204899860157813
314,1577206899,8,3,0,11,52,-0.3093477444173804,-0.4823180695470915
314,1577206981,3,3,0,6,52,-0.3093477444173804,-0.5061755173400226
314,1577207059,2,0,0,2,52,-0.3093477444173804,-0.5252614755743675
314,1577207139,3,0,0,3,52,-0.3093477444173804,-0.5204899860157813
314,1577207220,2,1,0,3,52,-0.3093477444173804,-0.5204899860157813
314,1577207299,2,0,0,2,52,-0.3093477444173804,-0.5252614755743675
314,1577207379,3,1,0,4,52,-0.3093477444173804,-0.5157184964571951
314,1577207460,2,1,0,3,52,-0.3093477444173804,-0.5204899860157813
314,1577207539,0,10,10,10,52,0.3986961392627274,-0.4870895591056777
314,1577207619,1,2,1,3,52,-0.23854335604936963,-0.5204899860157813
314,1577207700,4,0,0,4,52,-0.3093477444173804,-0.5157184964571951
314,1577207782,3,1,0,4,52,-0.3093477444173804,-0.5157184964571951
314,1577207859,3,1,0,4,52,-0.3093477444173804,-0.5157184964571951
314,1577207939,1,5,4,6,52,-0.02613019094533728,-0.5061755173400226
314,1577208019,5,2,0,7,52,-0.3093477444173804,-0.5014040277814364
314,1577208102,3,4,1,7,52,-0.23854335604936963,-0.5014040277814364
314,1577208179,3,1,0,4,52,-0.3093477444173804,-0.5157184964571951
314,1577208259,3,1,0,4,52,-0.3093477444173804,-0.5157184964571951
314,1577208339,2,6,4,8,52,-0.02613019094533728,-0.4966325382228502
314,1577208421,3,5,2,8,52,-0.16773896768135885,-0.4966325382228502
314,1577208500,2,0,0,2,52,-0.3093477444173804,-0.5252614755743675
314,1577208580,1,0,0,1,52,-0.3093477444173804,-0.5300329651329538
314,1577208660,2,6,4,8,52,-0.02613019094533728,-0.4966325382228502
314,1577208740,3,0,0,3,52,-0.3093477444173804,-0.5204899860157813
314,1577208821,1,0,0,1,52,-0.3093477444173804,-0.5300329651329538
314,1577208900,1,0,0,1,52,-0.3093477444173804,-0.5300329651329538
314,1577208980,3,4,1,7,52,-0.23854335604936963,-0.5014040277814364
314,1577209060,3,1,0,4,52,-0.3093477444173804,-0.5157184964571951
314,1577209142,2,1,0,3,52,-0.3093477444173804,-0.5204899860157813
314,1577209224,2,0,0,2,52,-0.3093477444173804,-0.5252614755743675
314,1577209306,3,4,1,7,52,-0.23854335604936963,-0.5014040277814364
314,1577209387,2,4,2,6,52,-0.16773896768135885,-0.5061755173400226
314,1577217600,172,163,0,335,52,-0.3093477444173804,1.0636445474348475
314,1577232000,113,147,34,260,52,2.098001460094986,0.7057828305408801
314,1577246400,24,45,21,69,52,1.1775444113108458,-0.20557167514909008
314,1577260800,53,32,0,85,52,-0.3093477444173804,-0.1292278422117104
314,1577275200,194,64,0,258,52,-0.3093477444173804,0.6962398514237076
314,1577289600,257,143,0,400,52,-0.3093477444173804,1.3737913687429524
314,1577304000,254,174,0,428,52,-0.3093477444173804,1.507393076383367
314,1577318400,102,135,33,237,52,2.027197071726975,0.5960385706933967
314,1577332800,21,41,20,62,52,1.1067400229428352,-0.2389721020591937
314,1577347200,158,59,0,217,52,-0.3093477444173804,0.500608779521672
314,1577361600,517,155,0,672,52,-0.3093477444173804,2.6716365286784067
314,1577376000,398,233,0,631,52,-0.3093477444173804,2.4760054567763716
314,1577390400,345,342,0,687,52,-0.3093477444173804,2.7432088720572003
314,1577404800,111,197,86,308,52,5.779829655231547,0.9348143293530191
314,1577419200,23,42,19,65,52,1.0359356345748243,-0.22465763338343503
314,1577433600,180,75,0,255,52,-0.3093477444173804,0.6819253827479489
314,1577448000,576,163,0,739,52,-0.3093477444173804,2.9913263291036842
314,1577462400,458,265,0,723,52,-0.3093477444173804,2.9149824961663047
314,1577476800,395,350,0,745,52,-0.3093477444173804,3.019955266455202
