remote_unit_id,time_stamp,entries,exits,num_people_exited,sum_exit_entry,week_num,z_score_num_people_exited,z_score_sum_exit_entry
571,1546300800,0,0,0,0,1,-0.5363789340397365,-1.3778009927155268
571,1546315200,208,351,143,559,1,-0.08876299992237406,-0.7843683802228624
571,1546329600,67,85,18,152,1,-0.48003566960538313,-1.216438278764033
571,1546344000,388,263,0,651,1,-0.5363789340397365,-0.6867014744101162
571,1546358400,712,629,0,1341,1,-0.5363789340397365,0.045800319185480325
571,1546372800,523,918,395,1441,1,0.7000427021585722,0.1519599994167262
571,1546387200,285,379,94,664,1,-0.24214188643811363,-0.6729007159800542
571,1546401600,33,36,3,69,1,-0.5269883899673442,-1.3045508133559671
571,1546416000,526,386,0,912,1,-0.5363789340397365,-0.40962470900656445
571,1546430400,1552,819,0,2371,1,-0.5363789340397365,1.1392450255673128
571,1546444800,824,807,0,1631,1,-0.5363789340397365,0.35366339185609336
571,1546459200,911,2030,1119,2941,1,2.9662940049625606,1.7443552028854143
571,1546473600,378,657,279,1035,1,0.3369416646927398,-0.279048302322132
571,1546488000,46,42,0,88,1,-0.5363789340397365,-1.2843804741120304
571,1546502400,548,407,0,955,1,-0.5363789340397365,-0.3639760465071287
571,1546516800,1728,872,0,2600,1,-0.5363789340397365,1.3823506932968659
571,1546531200,856,938,82,1794,1,-0.2797040627276825,0.5267036706330241
571,1546545600,971,2107,1136,3078,1,3.01950708803945,1.889793964802221
571,1546560000,454,780,326,1234,1,0.4840601884935512,-0.06779053866195275
571,1546574400,45,62,17,107,1,-0.4831658509628472,-1.2642101348680936
571,1546588800,539,412,0,951,1,-0.5363789340397365,-0.3682224337163786
571,1546603200,1689,986,0,2675,1,-0.5363789340397365,1.4619704534703002
571,1546617600,922,1004,82,1926,1,-0.2797040627276825,0.6668344485382687
571,1546632000,1087,2054,967,3141,1,2.4905064386280213,1.956674563347906
571,1546646400,545,838,293,1383,1,0.3807642036972368,0.09038738488260359
571,1546660800,88,120,32,208,1,-0.4362131306008861,-1.1569888578345353
571,1546675200,96,103,7,199,1,-0.5144676645374879,-1.1665432290553475
571,1546689600,717,492,0,1209,1,-0.5363789340397365,-0.09433045871976423
571,1546704000,957,970,13,1927,1,-0.49568657639270347,0.6678960453405811
571,1546718400,946,1113,167,2059,1,-0.013638647343236329,0.8080268232458256
571,1546732800,511,638,127,1149,1,-0.13884590164179922,-0.15802626685851173
571,1546747200,73,165,92,238,1,-0.24840224915304177,-1.1251409537651615
571,1546761600,76,50,0,126,1,-0.5363789340397365,-1.244039795624157
571,1546776000,597,400,0,997,1,-0.5363789340397365,-0.31938898081000544
571,1546790400,976,969,0,1945,1,-0.5363789340397365,0.6870047877822054
571,1546804800,689,1088,399,1777,1,0.7125634275884285,0.5086565249937123
571,1546819200,312,428,116,740,1,-0.17327789657390402,-0.5922193590043073
571,1546833600,28,35,7,63,1,-0.5144676645374879,-1.310920394169842
571,1546848000,646,415,0,1061,1,-0.5363789340397365,-0.2514467854620081
571,1546862400,1754,782,0,2536,1,-0.5363789340397365,1.3144084979488684
571,1546876800,686,816,130,1502,1,-0.12945535756940701,0.21671740435778616
571,1546891200,961,2114,1153,3075,1,3.072720171116339,1.8866091743952838
571,1546905600,420,705,285,1125,2,0.4309172530460169,-0.3580092544352163
571,1546920000,31,45,14,76,2,-0.5083206202151405,-1.43072223946696
571,1546934400,656,437,0,1093,2,-0.5568421339629493,-0.3907326248079673
571,1546948800,1637,821,0,2458,2,-0.5568421339629493,1.0051236426546926
571,1546963200,715,677,0,1392,2,-0.5568421339629493,-0.08497363288757512
571,1546977600,1060,1115,55,2175,2,-0.3662219013822717,0.7157263359206759
571,1546992000,445,585,140,1030,2,-0.07162699648486068,-0.45515676022932083
571,1547006400,42,43,1,85,2,-0.5533763115523916,-1.4215187915496237
571,1547020800,684,201,0,885,2,-0.5568421339629493,-0.6034345322308488
571,1547035200,1973,509,0,2482,2,-0.5568421339629493,1.0296661704342558
571,1547049600,826,909,83,1735,2,-0.26917887388665396,0.2657799932953497
571,1547064000,1048,2223,1175,3271,2,3.515499198442438,1.8365017711873977
571,1547078400,429,844,415,1273,2,0.8814741664185278,-0.2066636664612429
571,1547092800,43,65,22,108,2,-0.4805940409306783,-1.3979988690942091
571,1547107200,623,419,0,1042,2,-0.5568421339629493,-0.44288549633953916
571,1547121600,1884,914,0,2798,2,-0.5568421339629493,1.352809452865172
571,1547136000,837,847,10,1684,2,-0.5221839098573716,0.21362712176377777
571,1547150400,1119,2009,890,3128,2,2.527739811433472,1.6902692098341667
571,1547164800,429,867,438,1296,2,0.9611880818613568,-0.1831437440058281
571,1547179200,49,53,4,102,2,-0.5429788443207183,-1.4041345010390998
571,1547193600,558,432,0,990,2,-0.5568421339629493,-0.49606097319525955
571,1547208000,1710,1116,0,2826,2,-0.5568421339629493,1.3814424019413292
571,1547222400,905,1038,133,1943,2,-0.09588775335876512,0.47848190071823116
571,1547236800,1086,2047,961,3133,2,2.773813202583074,1.695382236454909
571,1547251200,523,833,310,1356,2,0.5175628133099613,-0.12178742455692
571,1547265600,101,122,21,223,2,-0.4840598633412361,-1.2803992568171352
571,1547280000,102,86,0,188,2,-0.5568421339629493,-1.3161904431623315
571,1547294400,757,562,0,1319,2,-0.5568421339629493,-0.15962382155041335
571,1547308800,1073,1072,0,2145,2,-0.5568421339629493,0.6850481761962218
571,1547323200,1016,1285,269,2301,2,0.3754640944770925,0.844574606763383
571,1547337600,562,663,101,1225,2,-0.20679407049661397,-0.2557487220203694
571,1547352000,95,156,61,251,2,-0.345426966918925,-1.251766307740978
571,1547366400,74,68,0,142,2,-0.5568421339629493,-1.363230288073161
571,1547380800,607,409,0,1016,2,-0.5568421339629493,-0.4694732347673994
571,1547395200,893,946,53,1839,2,-0.37315354620338725,0.3721309470067904
571,1547409600,663,1122,459,1785,2,1.0339703524830701,0.31691025950277313
571,1547424000,341,422,81,763,2,-0.2761105187077695,-0.728192381776962
571,1547438400,46,44,0,90,2,-0.5568421339629493,-1.4164057649288815
571,1547452800,727,424,0,1151,2,-0.5568421339629493,-0.3314215160073561
571,1547467200,2250,671,0,2921,2,-0.5568421339629493,1.4785899077354336
571,1547481600,946,902,0,1848,2,-0.5568421339629493,0.38133439492412663
571,1547496000,1247,2014,767,3261,2,2.101443654934865,1.826275717945913
571,1547510400,477,751,274,1228,3,4.603053851389171,0.11204918557026894
571,1547524800,34,44,10,78,3,-0.19175871247299353,-1.4400046593736524
571,1547539200,698,311,0,1009,3,-0.3733804004980755,-0.18351585098861695
571,1547553600,2005,522,0,2527,3,-0.3733804004980755,1.8651952243373593
571,1547568000,734,712,0,1446,3,-0.3733804004980755,0.40626461009007314
571,1547582400,1199,987,0,2186,3,-0.3733804004980755,1.4049775190105094
571,1547596800,426,653,227,1079,3,3.7494319176712856,-0.0890430082529
571,1547611200,40,74,34,114,3,0.2441333387872032,-1.3914186259667123
571,1547625600,676,264,0,940,3,-0.3733804004980755,-0.27663908168525225
571,1547640000,2117,371,0,2488,3,-0.3733804004980755,1.8125603548131741
571,1547654400,878,604,0,1482,3,-0.3733804004980755,0.4548506434970133
571,1547668800,1180,926,0,2106,3,-0.3733804004980755,1.297008555883976
571,1547683200,461,569,108,1030,3,1.5881338301728098,-0.15517399816790187
571,1547688763,15,14,0,29,3,-0.3733804004980755,-1.5061356492886542
571,1547697600,40,56,16,96,3,-0.08278569965794436,-1.4157116426701823
571,1547712000,699,264,0,963,3,-0.3733804004980755,-0.2455980047863738
571,1547726400,2145,335,0,2480,3,-0.3733804004980755,1.8017634585005207
571,1547740800,896,592,0,1488,3,-0.3733804004980755,0.4629483157315033
571,1547755200,1180,866,0,2046,3,-0.3733804004980755,1.2160318335390756
571,1547769600,520,568,48,1088,3,0.49840370202231793,-0.07689649990116497
571,1547784000,43,71,28,114,3,0.135160325972154,-1.3914186259667123
571,1547798400,630,236,0,866,3,-0.3733804004980755,-0.37651037257729586
571,1547812800,1889,382,0,2271,3,-0.3733804004980755,1.5196945423324515
571,1547827200,816,643,0,1459,3,-0.3733804004980755,0.42380956659813485
571,1547841600,1230,947,0,2177,3,-0.3733804004980755,1.3928310106587745
571,1547856000,598,486,0,1084,3,-0.3733804004980755,-0.08229494805749164
571,1547870400,80,113,33,193,3,0.225971169984695,-1.2847992748792603
571,1547884800,108,100,0,208,3,-0.3733804004980755,-1.2645550942930353
571,1547899200,802,372,0,1174,3,-0.3733804004980755,0.039170135459858715
571,1547913600,1089,726,0,1815,3,-0.3733804004980755,0.9042714525112097
571,1547928000,1016,730,0,1746,3,-0.3733804004980755,0.8111482218145744
571,1547942400,495,497,2,992,3,-0.3370560628930591,-0.20645925565300535
571,1547956800,84,144,60,228,3,0.7163497276524163,-1.2375628535114018
571,1547971200,63,55,0,118,3,-0.3733804004980755,-1.3860201778103856
571,1547985600,516,327,0,843,3,-0.3733804004980755,-0.4075514494761743
571,1548000000,905,611,0,1516,3,-0.3733804004980755,0.5007374528257901
571,1548014400,719,624,0,1343,3,-0.3733804004980755,0.2672545700646611
571,1548028800,329,351,22,680,3,0.026187313157104826,-0.6275382118464866
571,1548043200,49,71,22,120,3,0.026187313157104826,-1.3833209537322222
571,1548057600,212,187,0,399,3,-0.3733804004980755,-1.0067791948284361
571,1548072000,869,400,0,1269,3,-0.3733804004980755,0.16738327917261744
571,1548086400,749,524,0,1273,3,-0.3733804004980755,0.17278172732894412
571,1548100800,731,712,0,1443,3,-0.3733804004980755,0.40221577397282815
571,1548115200,294,327,33,621,4,0.4355888579405946,-0.7647907424109165
571,1548129600,38,27,0,65,4,-0.38357824803724005,-1.5067063878404496
571,1548144000,651,206,0,857,4,-0.38357824803724005,-0.4498769073005391
571,1548158400,1757,388,0,2145,4,-0.38357824803724005,1.268805379234063
571,1548172800,854,570,0,1424,4,-0.38357824803724005,0.3067169253587151
571,1548187200,1168,1007,0,2175,4,-0.38357824803724005,1.3088367989514837
571,1548201600,456,532,76,988,4,1.502988420275349,-0.2750730412011347
571,1548216000,37,47,10,84,4,-0.13534579168032046,-1.4813531553527497
571,1548230400,664,217,0,881,4,-0.38357824803724005,-0.4178517715266024
571,1548244800,2064,347,0,2411,4,-0.38357824803724005,1.623750634061861
571,1548259200,872,480,0,1352,4,-0.38357824803724005,0.210641518036905
571,1548273600,1194,977,0,2171,4,-0.38357824803724005,1.3034992763224944
571,1548288000,394,534,140,928,4,3.0916761409596343,-0.3551358806359764
571,1548302400,39,27,0,66,4,-0.38357824803724005,-1.5053720071832022
571,1548316800,671,220,0,891,4,-0.38357824803724005,-0.4045079649541288
571,1548331200,2052,346,0,2398,4,-0.38357824803724005,1.6064036855176453
571,1548345600,822,585,0,1407,4,-0.38357824803724005,0.28403245418550993
571,1548360000,1214,812,0,2026,4,-0.38357824803724005,1.1100140810216268
571,1548374400,448,657,209,1105,4,4.80448008982238,-0.11895050430319334
571,1548388800,43,57,14,100,4,-0.03605280913755261,-1.4600030648367919
571,1548403200,587,236,0,823,4,-0.38357824803724005,-0.4952458496469494
571,1548417600,1978,367,0,2345,4,-0.38357824803724005,1.5356815106835353
571,1548432000,974,563,0,1537,4,-0.38357824803724005,0.45750193962766694
571,1548446400,1316,886,0,2202,4,-0.38357824803724005,1.3448650766971626
571,1548460800,589,452,0,1041,4,-0.38357824803724005,-0.20435086636702451
571,1548475200,94,139,45,233,4,0.7334678055688981,-1.2825304374228927
571,1548489600,116,89,0,205,4,-0.38357824803724005,-1.319893095825819
571,1548504000,831,375,0,1206,4,-0.38357824803724005,0.01582194207879019
571,1548518400,1119,636,0,1755,4,-0.38357824803724005,0.7483969229075919
571,1548532800,1164,718,0,1882,4,-0.38357824803724005,0.9178632663780067
571,1548547200,564,481,0,1045,4,-0.38357824803724005,-0.19901334373803506
571,1548561600,92,159,67,251,4,1.2795792095541214,-1.2585115855924403
571,1548576000,78,68,0,146,4,-0.38357824803724005,-1.3986215546034133
571,1548590400,697,316,0,1013,4,-0.38357824803724005,-0.24171352476995064
571,1548604800,987,609,0,1596,4,-0.38357824803724005,0.5362303984052613
571,1548619200,741,761,20,1502,4,0.11288666467659915,0.4107986166240093
571,1548633600,303,331,28,634,4,0.3114726297621348,-0.7474437938667008
571,1548648000,24,31,7,55,4,-0.20981552858739633,-1.5200501944129232
571,1548662400,658,218,0,876,4,-0.38357824803724005,-0.4245236748128392
571,1548676800,1982,314,0,2296,4,-0.38357824803724005,1.4702968584784146
571,1548691200,815,555,0,1370,4,-0.38357824803724005,0.23466036986735753
571,1548705600,1114,932,0,2046,4,-0.38357824803724005,1.1367016941665742
571,1548720000,401,460,59,861,5,1.0777492213324762,-0.4808835061620055
571,1548734400,38,38,0,76,5,-0.4571143249099813,-1.5130924383339663
571,1548748800,699,221,0,920,5,-0.4571143249099813,-0.4033034717694632
571,1548763200,2055,344,0,2399,5,-0.4571143249099813,1.5414570513927406
571,1548777600,890,585,0,1475,5,-0.4571143249099813,0.3264748178552989
571,1548792000,1172,986,0,2158,5,-0.4571143249099813,1.224562334636763
571,1548806400,399,592,193,991,5,4.563710495849243,-0.30994444733098014
571,1548820800,44,57,13,101,5,-0.11892405200910085,-1.480219542404923
571,1548835200,716,180,0,896,5,-0.4571143249099813,-0.43486145186134484
571,1548849600,2057,338,0,2395,5,-0.4571143249099813,1.5361973880440938
571,1548864000,872,604,0,1476,5,-0.4571143249099813,0.3277897336924606
571,1548878400,1085,899,0,1984,5,-0.4571143249099813,0.9957669789706213
571,1548892800,375,474,99,849,5,2.118334676412108,-0.4966624962079463
571,1548907200,39,38,0,77,5,-0.4571143249099813,-1.5117775224968046
571,1548921600,649,167,0,816,5,-0.4571143249099813,-0.5400547188342835
571,1548936000,1998,325,0,2323,5,-0.4571143249099813,1.4415234477684489
571,1548950400,762,534,0,1296,5,-0.4571143249099813,0.0911048830033486
571,1548964800,1054,856,0,1910,5,-0.4571143249099813,0.898463207020653
571,1548979200,437,498,61,935,5,1.1297784940864577,-0.3835797342120372
571,1548993600,38,57,19,95,5,0.03716376625284396,-1.4881090374278934
571,1549008000,607,188,0,795,5,-0.4571143249099813,-0.5676679514146798
571,1549022400,1939,394,0,2333,5,-0.4571143249099813,1.4546726061400663
571,1549036800,893,541,0,1434,5,-0.4571143249099813,0.27256326853166785
571,1549051200,1185,978,0,2163,5,-0.4571143249099813,1.2311369138225716
571,1549065600,501,553,52,1054,5,0.8956467666935405,-0.2271047495897909
571,1549080000,73,86,13,159,5,-0.11892405200910085,-1.4039544238495425
571,1549094400,111,118,7,229,5,-0.2750118702710457,-1.311910315248221
571,1549108800,733,514,0,1247,5,-0.4571143249099813,0.026674006982423653
571,1549123200,1124,857,0,1981,5,-0.4571143249099813,0.9918222314591361
571,1549137600,1159,843,0,2002,5,-0.4571143249099813,1.0194354640395324
571,1549152000,727,533,0,1260,5,-0.4571143249099813,0.043767912865526185
571,1549166400,78,179,101,257,5,2.1703639491660898,-1.2750926718076925
571,1549180800,72,93,21,165,5,0.08919303900682557,-1.396064928826572
571,1549195200,621,491,0,1112,5,-0.4571143249099813,-0.15083963103441037
571,1549209600,919,799,0,1718,5,-0.4571143249099813,0.6459993662856002
571,1549224000,816,895,79,1711,5,1.5980419488722921,0.636794955425468
571,1549238400,507,359,0,866,5,-0.4571143249099813,-0.4743089269761968
571,1549252800,32,53,21,85,5,0.08919303900682557,-1.5012581957995108
571,1549267200,659,196,0,855,5,-0.4571143249099813,-0.4887730011849759
571,1549281600,2225,302,0,2527,5,-0.4571143249099813,1.7097662785494425
571,1549296000,873,535,0,1408,5,-0.4571143249099813,0.23837545676546276
571,1549310400,1120,1008,0,2128,5,-0.4571143249099813,1.185114859521911
571,1549324800,480,491,11,971,6,-0.09317185649319991,-0.35012402677506943
571,1549339200,32,45,13,77,6,-0.02627924157500512,-1.5169347978188525
571,1549353600,697,202,0,899,6,-0.46108123854327127,-0.44409536404034056
571,1549368000,2177,338,0,2515,6,-0.46108123854327127,1.6650390945801892
571,1549382400,903,556,0,1459,6,-0.46108123854327127,0.286792814689546
571,1549396800,1191,1001,0,2192,6,-0.46108123854327127,1.2434732343484867
571,1549411200,458,573,115,1031,6,3.385244119252929,-0.2718145790540102
571,1549425600,33,67,34,100,6,0.6760932150660403,-1.4869161761924465
571,1549440000,749,204,0,953,6,-0.46108123854327127,-0.37361686109138725
571,1549454400,2089,408,0,2497,6,-0.46108123854327127,1.6415462602638715
571,1549468800,844,647,0,1491,6,-0.46108123854327127,0.32855785347411093
571,1549483200,1245,966,0,2211,6,-0.46108123854327127,1.2682712261268223
571,1549497600,414,539,125,953,6,3.719707193843903,-0.37361686109138725
571,1549512000,41,47,6,88,6,-0.2604033937886869,-1.5025780657366585
571,1549526400,726,209,0,935,6,-0.46108123854327127,-0.397109695407705
571,1549540800,2156,358,0,2514,6,-0.46108123854327127,1.6637339371181716
571,1549555200,880,572,0,1452,6,-0.46108123854327127,0.2776567124554224
571,1549569600,1233,791,0,2024,6,-0.46108123854327127,1.0242067807295208
571,1549584000,474,514,40,988,6,0.8767710598206246,-0.3279363499207693
571,1549598400,45,61,16,106,6,0.07405968080228706,-1.4790852314203407
571,1549612800,662,182,0,844,6,-0.46108123854327127,-0.5158790244513116
571,1549627200,2047,392,0,2439,6,-0.46108123854327127,1.5658471274668475
571,1549641600,937,694,0,1631,6,-0.46108123854327127,0.5112798981565826
571,1549656000,1260,943,0,2203,6,-0.46108123854327127,1.257829966430681
571,1549670400,557,554,0,1111,6,-0.46108123854327127,-0.16740198209259782
571,1549684800,77,140,63,217,6,1.6460361313798646,-1.334212753136381
571,1549699200,148,115,0,263,6,-0.46108123854327127,-1.274175509883569
571,1549713600,837,479,0,1316,6,-0.46108123854327127,0.10015529762102138
571,1549728000,1023,763,0,1786,6,-0.46108123854327127,0.713579304769319
571,1549742400,1087,739,0,1826,6,-0.46108123854327127,0.7657856032500252
571,1549756800,535,502,0,1037,6,-0.46108123854327127,-0.26398363428190424
571,1549771200,90,173,83,263,6,2.3149622805618124,-1.274175509883569
571,1549785600,78,92,14,170,6,0.007167065884092274,-1.3955551538512108
571,1549800000,658,376,0,1034,6,-0.46108123854327127,-0.2678991066679572
571,1549814400,916,718,0,1634,6,-0.46108123854327127,0.5151953705426355
571,1549828800,752,695,0,1447,6,-0.46108123854327127,0.2711309251453341
571,1549843200,316,362,46,678,6,1.077448904575209,-0.7325351631462422
571,1549857600,29,42,13,71,6,-0.02627924157500512,-1.5247657425909587
571,1549872000,690,182,0,872,6,-0.46108123854327127,-0.47933461551481726
571,1549886400,1939,399,0,2338,6,-0.46108123854327127,1.4340262238030643
571,1549900800,774,609,0,1383,6,-0.46108123854327127,0.18760084757620424
571,1549915200,1170,860,0,2030,6,-0.46108123854327127,1.0320377255016266
571,1549929600,422,443,21,865,7,0.07677080921436141,-0.46308051286959706
571,1549944000,39,52,13,91,7,-0.1396977020130182,-1.5404079020298043
571,1549958400,718,194,0,912,7,-0.4914590327575101,-0.3976614078430728
571,1549972800,1968,330,0,2298,7,-0.4914590327575101,1.5315062425135775
571,1549987200,842,508,0,1350,7,-0.4914590327575101,0.21198897517006773
571,1550001600,1154,846,0,2000,7,-0.4914590327575101,1.1167212787283813
571,1550016000,404,461,57,865,7,1.0508791097375698,-0.46308051286959706
571,1550030400,39,50,11,89,7,-0.19381482981986312,-1.5431916937330608
571,1550044800,784,188,0,972,7,-0.4914590327575101,-0.31414765674538236
571,1550059200,2267,329,0,2596,7,-0.4914590327575101,1.9462912062987736
571,1550073600,874,611,0,1485,7,-0.4914590327575101,0.39989491513987135
571,1550088000,1227,866,0,2093,7,-0.4914590327575101,1.2461675929298015
571,1550102400,405,578,173,983,7,4.189672522534575,-0.2988368023774724
571,1550116800,32,48,16,80,7,-0.058522010302750845,-1.5557187563977142
571,1550131200,730,197,0,927,7,-0.4914590327575101,-0.3767829700686502
571,1550145600,2142,303,0,2445,7,-0.4914590327575101,1.736114932702919
571,1550160000,869,575,0,1444,7,-0.4914590327575101,0.34282718522311617
571,1550174400,1225,1028,0,2253,7,-0.4914590327575101,1.4688709291903095
571,1550188800,466,570,104,1036,7,2.3226316131984253,-0.22506632224117915
571,1550203200,52,59,7,111,7,-0.3020490854335529,-1.512569984997241
571,1550217600,616,203,0,819,7,-0.4914590327575101,-0.5271077220444931
571,1550228132,1789,272,0,2061,7,-0.4914590327575101,1.2016269256777
571,1550232000,1372,294,0,1666,7,-0.4914590327575101,0.651828064284571
571,1550246400,915,546,0,1461,7,-0.4914590327575101,0.36648941470079516
571,1550260800,1260,895,0,2155,7,-0.4914590327575101,1.3324651357307484
571,1550275200,564,506,0,1070,7,-0.4914590327575101,-0.1777418632858212
571,1550289600,73,154,81,227,7,1.7002846434197085,-1.3511100662083726
571,1550304000,130,149,19,279,7,0.022653681407516512,-1.2787314819237074
571,1550318400,748,486,0,1234,7,-0.4914590327575101,0.05052905638119946
571,1550332800,1048,700,0,1748,7,-0.4914590327575101,0.7659635241180813
571,1550347200,1118,744,0,1862,7,-0.4914590327575101,0.9246396512036932
571,1550361600,552,598,46,1150,7,0.7532349067999228,-0.06639019515556722
571,1550376000,74,179,105,253,7,2.3496901771018477,-1.31492077406604
571,1550390400,87,97,10,184,7,-0.22087339372328557,-1.410961587828384
571,1550404800,669,380,0,1049,7,-0.4914590327575101,-0.20697167617001289
571,1550419200,976,643,0,1619,7,-0.4914590327575101,0.5864089592580467
571,1550433600,772,779,7,1551,7,-0.3020490854335529,0.49176004134733087
571,1550448000,355,438,83,793,7,1.7544017712265536,-0.5632970141868257
571,1550462400,59,87,28,146,7,0.2661807565383186,-1.4638536301902547
571,1550476800,211,203,0,414,7,-0.4914590327575101,-1.090825541953904
571,1550491200,1023,415,0,1438,7,-0.4914590327575101,0.3344758101133471
571,1550505600,932,750,0,1682,7,-0.4914590327575101,0.6740983979106218
571,1550520000,966,779,0,1745,7,-0.4914590327575101,0.7617878365631968
571,1550534400,375,423,48,798,8,0.8351271332252693,-0.6361144079333658
571,1550548800,43,63,20,106,8,0.04912512548383938,-1.537529773714709
571,1550563200,609,187,0,796,8,-0.5123048800457535,-0.6387196546552771
571,1550577600,1641,496,0,2137,8,-0.5123048800457535,1.108098272386314
571,1550592000,827,599,0,1426,8,-0.5123048800457535,0.1819330627468126
571,1550606400,1100,916,0,2016,8,-0.5123048800457535,0.9504808457106745
571,1550620800,436,555,119,991,8,2.828203652855324,-0.3847080992689161
571,1550635200,37,55,18,92,8,-0.007017875069119911,-1.5557665007680885
571,1550649600,640,193,0,833,8,-0.5123048800457535,-0.5905225902999164
571,1550664000,2043,407,0,2450,8,-0.5123048800457535,1.5158193843654475
571,1550678400,779,639,0,1418,8,-0.5123048800457535,0.171512075859167
571,1550692800,1046,872,0,1918,8,-0.5123048800457535,0.822823756337016
571,1550707200,387,493,106,880,8,2.4632741492610886,-0.5292992923349985
571,1550721600,43,58,15,101,8,-0.09123237589855884,-1.5440428905194874
571,1550736000,648,200,0,848,8,-0.5123048800457535,-0.5709832398855809
571,1550750400,2054,417,0,2471,8,-0.5123048800457535,1.543174474945517
571,1550764800,882,607,0,1489,8,-0.5123048800457535,0.2639983344870216
571,1550779200,1204,888,0,2092,8,-0.5123048800457535,1.0494802211433074
571,1550793600,476,574,98,1050,8,2.2387021470492514,-0.3078533209725299
571,1550808000,48,62,14,110,8,-0.11930387617503849,-1.532319280270886
571,1550822400,573,210,0,783,8,-0.5123048800457535,-0.6556537583477012
571,1550836800,1977,403,0,2380,8,-0.5123048800457535,1.4246357490985486
571,1550851200,884,694,0,1578,8,-0.5123048800457535,0.3799318136120787
571,1550865600,1242,867,0,2109,8,-0.5123048800457535,1.0716248182795545
571,1551484800,8392,9386,994,17778,9,4.1095177196704125,4.064405127251372
571,1551499200,86,107,21,193,9,-0.1830864040432873,-0.45857054733808783
571,1551513600,131,124,0,255,9,-0.27573253620977,-0.4426237465519322
571,1551528000,757,521,0,1278,9,-0.27573253620977,-0.17950153358036455
571,1551542400,1051,703,0,1754,9,-0.27573253620977,-0.05707125657697629
571,1551556800,1172,717,0,1889,9,-0.27573253620977,-0.022348383897443896
571,1551571200,621,524,0,1145,9,-0.27573253620977,-0.21370999333131127
571,1551585600,90,167,77,257,9,0.06396994840066665,-0.44210933362334653
571,1551600000,93,82,0,175,9,-0.27573253620977,-0.4632002636953588
571,1551614400,711,394,0,1105,9,-0.27573253620977,-0.22399825190302458
571,1551628800,951,685,0,1636,9,-0.27573253620977,-0.08742161936353052
571,1551643200,767,632,0,1399,9,-0.27573253620977,-0.14837955140093181
571,1551657600,297,323,26,620,9,-0.1610278011465057,-0.3487433870850484
571,1551672000,30,37,7,67,9,-0.2448504921542758,-0.49097856183898475
571,1551686400,552,156,0,708,9,-0.27573253620977,-0.32610921822727906
571,1551700800,1788,302,0,2090,9,-0.27573253620977,0.029350115425415435
571,1551715200,771,499,0,1270,9,-0.27573253620977,-0.18155918529470721
571,1551729600,1110,837,0,1947,9,-0.27573253620977,-0.007430408968459612
571,1551744000,402,501,99,903,10,2.1128681716628894,-0.3485018493828276
571,1551758400,33,61,28,94,10,0.27246091744725925,-1.4344566406848764
571,1551772800,744,183,0,927,10,-0.4533334926659471,-0.31628563802158016
571,1551787200,2030,381,0,2411,10,-0.4533334926659471,1.6757500978155526
571,1551801600,857,547,0,1404,10,-0.4533334926659471,0.3240115627832125
571,1551816000,1232,935,0,2167,10,-0.4533334926659471,1.3482186156428704
571,1551830400,421,554,133,975,10,2.994189955371783,-0.2518532152990853
571,1551844800,37,48,11,85,10,-0.16819997440718745,-1.4465377199453442
571,1551859200,736,182,0,918,10,-0.4533334926659471,-0.32836671728204797
571,1551873600,2024,394,0,2418,10,-0.4533334926659471,1.6851464927959166
571,1551888000,832,565,0,1397,10,-0.4533334926659471,0.3146151678028487
571,1551891249,218,132,0,350,10,-0.4533334926659471,-1.0908170528315706
571,1551902400,1185,791,0,1976,10,-0.4533334926659471,1.091831266892943
571,1551916800,420,544,124,964,10,2.7608988949782525,-0.266618978839657
571,1551931200,42,49,7,91,10,-0.2718848901376455,-1.4384836671050323
571,1551945600,705,211,0,916,10,-0.4533334926659471,-0.3310514015621519
571,1551946203,137,30,0,167,10,-0.4533334926659471,-1.3364656644610822
571,1551960000,1904,382,0,2286,10,-0.4533334926659471,1.5079573303090557
571,1551962584,65,38,0,103,10,-0.4533334926659471,-1.4223755614244087
571,1551974400,899,554,0,1453,10,-0.4533334926659471,0.3897863276457594
571,1551988800,1296,767,0,2063,10,-0.4533334926659471,1.208615033077465
571,1552003200,485,618,133,1103,10,2.994189955371783,-0.08003342137243233
571,1552017600,50,73,23,123,10,0.14285477278418668,-1.3955287186233691
571,1552032000,670,191,0,861,10,-0.4533334926659471,-0.4048802192650106
571,1552046400,1983,349,0,2332,10,-0.4533334926659471,1.5697050687514467
571,1552060800,1005,647,0,1652,10,-0.4533334926659471,0.6569124135161026
571,1552075200,1344,778,0,2122,10,-0.4533334926659471,1.2878132193405316
571,1552089600,610,562,0,1172,10,-0.4533334926659471,0.012588186291154034
571,1552104000,86,165,79,251,10,1.5944435930105993,-1.223708924696716
571,1552118400,158,127,0,285,10,-0.4533334926659471,-1.178069291934949
571,1552132800,819,459,0,1278,10,-0.4533334926659471,0.1548764531366635
571,1552147200,1153,692,0,1845,10,-0.4533334926659471,0.9159844465461341
571,1552161600,1131,771,0,1902,10,-0.4533334926659471,0.9924979485290968
571,1552176000,602,555,0,1157,10,-0.4533334926659471,-0.00754694580962561
571,1552194000,73,178,105,251,10,2.268395545258577,-1.223708924696716
571,1552208400,158,106,0,264,10,-0.4533334926659471,-1.2062584768760405
571,1552222800,681,481,0,1162,10,-0.4533334926659471,-0.0008352351093657284
571,1552237200,904,686,0,1590,10,-0.4533334926659471,0.5736872008328802
571,1552251600,679,588,0,1267,10,-0.4533334926659471,0.1401106895960918
571,1552266000,271,256,0,527,10,-0.4533334926659471,-0.8532224940423707
571,1552280400,22,30,8,52,10,-0.24596366120503096,-1.4908350105670594
571,1552294800,1598,251,0,1849,10,-0.4533334926659471,0.921353815106342
571,1552309200,1220,436,0,1656,10,-0.4533334926659471,0.6622817820763106
571,1552323600,970,590,0,1560,10,-0.4533334926659471,0.5334169366313208
571,1552338000,976,1013,37,1989,10,0.5057519778407898,1.1092817147136187
571,1552352400,283,440,157,723,11,3.7947665907809642,-0.735700903677721
571,1552366800,26,28,2,54,11,-0.40385575657889566,-1.7131819147658456
571,1552381200,1662,303,0,1965,11,-0.45803152880289383,1.078994785068842
571,1552395600,1300,389,0,1689,11,-0.45803152880289383,0.6757290764584946
571,1552410000,949,600,0,1549,11,-0.45803152880289383,0.4711740068735358
571,1552424400,1152,846,0,1998,11,-0.45803152880289383,1.1272113371852963
571,1552438800,394,370,0,764,11,-0.45803152880289383,-0.675795490442126
571,1552453200,30,17,0,47,11,-0.45803152880289383,-1.7234096682450935
571,1552467600,1715,279,0,1994,11,-0.45803152880289383,1.1213669066257261
571,1552482000,1290,464,0,1754,11,-0.45803152880289383,0.7707010730515111
571,1552496400,1069,590,0,1659,11,-0.45803152880289383,0.6318958472617177
571,1552510800,1119,811,0,1930,11,-0.45803152880289383,1.0278560176726022
571,1552525200,330,360,30,690,11,0.3546050545570791,-0.7839174557941756
571,1552539600,22,27,5,49,11,-0.32259209824289836,-1.7204874529653083
571,1552552088,810,242,0,1052,11,-0.45803152880289383,-0.2549964901530679
571,1552552172,1074,196,0,1270,11,-0.45803152880289383,0.06352497534351077
571,1552554000,548,79,0,627,11,-0.45803152880289383,-0.8759672371074071
571,1552568400,1346,473,0,1819,11,-0.45803152880289383,0.8656730696445277
571,1552582800,1067,481,0,1548,11,-0.45803152880289383,0.4697128992336432
571,1552597200,1230,760,0,1990,11,-0.45803152880289383,1.115522476066156
571,1552611600,344,471,127,815,11,2.9821300074209915,-0.6012790008076052
571,1552626000,25,32,7,57,11,-0.26841632601890014,-1.708798591846168
571,1552640400,1514,283,0,1797,11,-0.45803152880289383,0.8335287015668913
571,1552654800,1255,424,0,1679,11,-0.45803152880289383,0.6611180000595689
571,1552669200,1102,621,0,1723,11,-0.45803152880289383,0.7254067362148416
571,1552683600,1170,828,0,1998,11,-0.45803152880289383,1.1272113371852963
571,1552698000,436,457,21,893,11,0.11081407954908719,-0.4873126048959854
571,1552712400,53,98,45,151,11,0.7609233462370655,-1.571454473696267
571,1552726800,282,223,0,505,11,-0.45803152880289383,-1.0542223691742998
571,1552741200,854,551,0,1405,11,-0.45803152880289383,0.26077450672900676
571,1552755600,1230,933,0,2163,11,-0.45803152880289383,1.3682940977675693
571,1552770000,1171,800,0,1971,11,-0.45803152880289383,1.0877614309081973
571,1552784400,445,546,101,991,11,2.277844968509015,-0.3441240561865142
571,1552798800,48,83,35,131,11,0.49004448511707455,-1.6006766264941181
571,1552813200,335,117,0,452,11,-0.45803152880289383,-1.1316610740886055
571,1552827600,878,587,0,1465,11,-0.45803152880289383,0.3484409651225605
571,1552842000,995,743,0,1738,11,-0.45803152880289383,0.7473233508132301
571,1552856400,637,709,72,1346,11,1.4922962712610413,0.17456915597534553
571,1552870800,266,286,20,552,11,0.08372619343708809,-0.9855503100993492
571,1552885200,20,37,17,57,11,0.0024625351010908007,-1.708798591846168
571,1552899600,1589,244,0,1833,11,-0.45803152880289383,0.8861285766030236
571,1552914000,1222,457,0,1679,11,-0.45803152880289383,0.6611180000595689
571,1552928400,940,560,0,1500,11,-0.45803152880289383,0.3995797325188002
571,1552942800,895,1000,105,1895,11,2.3861965129570115,0.9767172502763625
571,1552957200,287,329,42,616,12,0.005617785818480128,-0.8564905715203985
571,1552971600,27,27,0,54,12,-0.2421265687764944,-1.6425782708036822
571,1552986000,1715,245,0,1960,12,-0.2421265687764944,1.0234059904666715
571,1553000400,1272,484,0,1756,12,-0.2421265687764944,0.7380645480222053
571,1553014800,978,638,0,1616,12,-0.2421265687764944,0.5422419894818856
571,1553029200,1047,823,0,1870,12,-0.2421265687764944,0.8975200599764658
571,1553043600,289,364,75,653,12,0.20027406442881726,-0.804737466763314
571,1553058000,26,38,12,64,12,-0.17134246746364454,-1.6285909451936595
571,1553072400,1667,261,0,1928,12,-0.2421265687764944,0.9786465485145983
571,1553086800,1282,443,0,1725,12,-0.2421265687764944,0.6947038386311346
571,1553101200,992,553,0,1545,12,-0.2421265687764944,0.44293197765072345
571,1553115600,1022,886,0,1908,12,-0.2421265687764944,0.9506718972945526
571,1553130000,312,432,120,744,12,0.46571444435200426,-0.6774528037121061
571,1553144400,23,31,8,54,12,-0.19493716790126114,-1.6425782708036822
571,1553158800,1698,230,0,1928,12,-0.2421265687764944,0.9786465485145983
571,1553173200,1406,425,0,1831,12,-0.2421265687764944,0.8429694900973767
571,1553187600,937,676,0,1613,12,-0.2421265687764944,0.5380457917988788
571,1553202000,973,914,0,1887,12,-0.2421265687764944,0.9212985135135047
571,1553216400,323,441,118,764,12,0.4539170941331959,-0.6494781524920605
571,1553230800,23,36,13,59,12,-0.1654437923542404,-1.635584607998671
571,1553245200,1453,240,0,1693,12,-0.2421265687764944,0.6499443966790615
571,1553259600,1218,527,0,1745,12,-0.2421265687764944,0.7226784898511802
571,1553274000,1055,541,0,1596,12,-0.2421265687764944,0.5142673382618399
571,1553288400,1144,790,0,1934,12,-0.2421265687764944,0.987038943880612
571,1553302800,405,425,20,830,12,-0.1241530665884113,-0.5571618034659097
571,1553317200,58,86,28,144,12,-0.07696366571317804,-1.5166923403134767
571,1553331600,228,240,12,468,12,-0.17134246746364454,-1.0635029905487365
571,1553346000,881,572,0,1453,12,-0.2421265687764944,0.3142485820385133
571,1553360400,1070,570,0,1640,12,-0.2421265687764944,0.5758115709459404
571,1553374800,1006,658,0,1664,12,-0.2421265687764944,0.6093811524099952
571,1553389200,440,438,0,878,12,-0.2421265687764944,-0.4900226405378001
571,1553403600,43,97,54,140,12,0.07640188713132999,-1.522287270557486
571,1553418000,176,151,0,327,12,-0.2421265687764944,-1.2607242816500588
571,1553432400,786,441,0,1227,12,-0.2421265687764944,-0.0018649767480029395
571,1553446800,930,640,0,1570,12,-0.2421265687764944,0.4779002916757805
571,1553461200,631,561,0,1192,12,-0.2421265687764944,-0.050820616383082884
571,1553475600,278,214,0,492,12,-0.2421265687764944,-1.029933409084682
571,1553490000,16,32,16,48,12,-0.1477477670260279,-1.650970666169696
571,1553504400,1694,246,0,1940,12,-0.2421265687764944,0.9954313392466256
571,1553518800,1213,477,0,1690,12,-0.2421265687764944,0.6457481989960546
571,1553533200,761,859,98,1620,12,0.3359435919451128,0.5478369197258948
571,1553547600,808,1916,1108,2724,12,6.29360545244331,2.0920376670724163
571,1553562000,297,384,87,681,13,2.0136481446331,-0.703969484035789
571,1553576400,26,36,10,62,13,-0.2114790288884077,-1.5823108128735164
571,1553590800,1763,265,0,2028,13,-0.500456583891201,1.2073807097354854
571,1553605200,1314,430,0,1744,13,-0.500456583891201,0.8043937349537171
571,1553619600,1049,543,0,1592,13,-0.500456583891201,0.5887105653522073
571,1553634000,1009,897,0,1906,13,-0.500456583891201,1.0342665867658527
571,1553648400,317,386,69,703,13,1.4934885456280722,-0.6727521831724126
571,1553662800,21,34,13,55,13,-0.12478576238756975,-1.5922435904209544
571,1553677200,1728,271,0,1999,13,-0.500456583891201,1.166230631324671
571,1553691600,1361,483,0,1844,13,-0.500456583891201,0.9462905570599736
571,1553706000,1063,582,0,1645,13,-0.500456583891201,0.6639158810685233
571,1553720400,1023,876,0,1899,13,-0.500456583891201,1.0243338092184147
571,1553734800,319,406,87,725,13,2.0136481446331,-0.6415348823090361
571,1553749200,19,38,19,57,13,0.04860077061410618,-1.5894056539788293
571,1553763600,1620,258,0,1878,13,-0.500456583891201,0.9945354765761008
571,1553778000,1346,487,0,1833,13,-0.500456583891201,0.9306819066282854
571,1553792400,1014,606,0,1620,13,-0.500456583891201,0.6284416755419592
571,1553806800,1106,943,0,2049,13,-0.500456583891201,1.2371790423777993
571,1553821200,339,390,51,729,13,0.9733289466230445,-0.6358590094247859
571,1553835600,23,51,28,74,13,0.30868057011662003,-1.5652831942207657
571,1553850000,1487,262,0,1749,13,-0.500456583891201,0.81148857605903
571,1553853011,365,59,0,424,13,-0.500456583891201,-1.0686443168488682
571,1553857378,240,94,0,334,13,-0.500456583891201,-1.1963514567444988
571,1553864400,1356,414,0,1770,13,-0.500456583891201,0.8412869087013438
571,1553878800,1089,736,0,1825,13,-0.500456583891201,0.9193301608597849
571,1553893200,1164,790,0,1954,13,-0.500456583891201,1.1023770613768558
571,1553907600,385,556,171,941,13,4.441059606656563,-0.3350377465595222
571,1553922000,37,95,58,132,13,1.1756132351249997,-1.4829830373991368
571,1553936400,266,194,0,460,13,-0.500456583891201,-1.0175614608906158
571,1553950800,942,477,0,1419,13,-0.500456583891201,0.34322906310838364
571,1553965200,1055,601,0,1656,13,-0.500456583891201,0.6795245315002114
571,1553979600,1018,677,0,1695,13,-0.500456583891201,0.7348642921216515
571,1553994000,368,445,77,813,13,1.7246705896303067,-0.5166656788555305
571,1554008400,39,88,49,127,13,0.9155334356224858,-1.4900778785044497
571,1554022800,195,99,0,294,13,-0.500456583891201,-1.2531101855870015
571,1554037200,756,421,0,1177,13,-0.500456583891201,-0.00016124638875696296
571,1554051600,803,549,0,1352,13,-0.500456583891201,0.24815819229719183
571,1554066000,528,542,14,1070,13,-0.09588800688729042,-0.15199084604245136
571,1554080400,209,238,29,447,13,0.3375783256168994,-1.0360080477644291
571,1554094800,18,17,0,35,13,-0.500456583891201,-1.6206229548422058
571,1554109200,1685,316,0,2001,13,-0.500456583891201,1.1690685677667962
571,1554123600,1173,453,0,1626,13,-0.500456583891201,0.6369554848683345
571,1554138000,998,569,0,1567,13,-0.500456583891201,0.5532363598256432
571,1554152400,984,818,0,1802,13,-0.500456583891201,0.8866938917753459
571,1554166800,285,352,67,637,14,0.1845728266685085,-0.8197391587480748
571,1554181200,26,23,0,49,14,-0.2699180396836051,-1.6050636847327036
571,1554195600,1744,272,0,2016,14,-0.2699180396836051,1.0220338367158759
571,1554210000,1291,490,0,1781,14,-0.2699180396836051,0.7081711435077335
571,1554224400,1043,638,0,1681,14,-0.2699180396836051,0.5746125506532047
571,1554238800,1097,771,0,1868,14,-0.2699180396836051,0.8243671192911735
571,1554253200,350,399,49,749,14,0.06247080287241827,-0.6701535347510026
571,1554267600,28,38,10,66,14,-0.20208358201911056,-1.5823587239474335
571,1554282000,1719,313,0,2032,14,-0.2699180396836051,1.0434032115726004
571,1554296400,1329,491,0,1820,14,-0.2699180396836051,0.7602589947209997
571,1554310800,1069,623,0,1692,14,-0.2699180396836051,0.589303995867203
571,1554325200,1104,954,0,2058,14,-0.2699180396836051,1.078128445714778
571,1554339600,351,365,14,716,14,-0.17494979895331272,-0.7142278703929971
571,1554354000,28,40,12,68,14,-0.18851669048621164,-1.579687552090343
571,1554368400,1670,301,0,1971,14,-0.2699180396836051,0.961932469931338
571,1554382800,1127,525,0,1652,14,-0.2699180396836051,0.5358805587253914
571,1554397200,822,962,140,1784,14,0.6797643676193189,0.7121779012933693
571,1554411600,1037,2002,965,3039,14,6.27610712494012,2.3883382416177046
571,1554426000,333,452,119,785,14,0.5373120065238803,-0.6220724413233722
571,1554440400,17,38,21,55,14,-0.12746567858816651,-1.5970501691614318
571,1554454800,1407,285,0,1692,14,-0.2699180396836051,0.589303995867203
571,1554469200,1266,490,0,1756,14,-0.2699180396836051,0.6747814952941013
571,1554483600,1038,723,0,1761,14,-0.2699180396836051,0.6814594249368278
571,1554498000,1196,792,0,1988,14,-0.2699180396836051,0.9846374307166078
571,1554512400,441,438,0,879,14,-0.2699180396836051,-0.4965273640401153
571,1554526800,42,67,25,109,14,-0.1003318955223687,-1.5249285290199863
571,1554541200,256,215,0,471,14,-0.2699180396836051,-1.0414464228865923
571,1554555600,845,580,0,1425,14,-0.2699180396836051,0.23270255294561132
571,1554570000,905,802,0,1707,14,-0.2699180396836051,0.6093377847953823
571,1554584400,752,905,153,1657,14,0.7679491625831618,0.5425584883681178
571,1554613200,512,572,60,1084,14,0.13708870630336228,-0.22273224868833152
571,1554627600,195,155,0,350,14,-0.2699180396836051,-1.203052320240572
571,1554642000,648,416,0,1064,14,-0.2699180396836051,-0.24944396725923726
571,1554656400,870,680,0,1550,14,-0.2699180396836051,0.3996507940137722
571,1554670800,661,635,0,1296,14,-0.2699180396836051,0.060411968163269304
571,1554673340,38,57,19,95,14,-0.14103257012106543,-1.5436267320196202
571,1554685200,225,263,38,488,14,-0.012147100558525758,-1.0187414621013224
571,1554699600,20,39,19,59,14,-0.14103257012106543,-1.5917078254472505
571,1554709390,353,190,0,543,14,-0.2699180396836051,-0.9452842360313317
571,1554714000,1592,268,0,1860,14,-0.2699180396836051,0.8136824318628111
571,1554728400,1060,503,0,1563,14,-0.2699180396836051,0.4170134110848609
571,1554742800,1144,719,0,1863,14,-0.2699180396836051,0.817689189648447
571,1554757200,1132,872,0,2004,14,-0.2699180396836051,1.0060068055733324
571,1554771600,294,335,41,629,15,1.291263812424778,-0.8869147254118741
571,1554786000,23,30,7,53,15,-0.17917057684362947,-1.6930554316473738
571,1554800400,1882,336,0,2218,15,-0.48190706875183104,1.3369699659218217
571,1554814800,1309,522,0,1831,15,-0.48190706875183104,0.7953441789198454
571,1554829200,1051,662,0,1713,15,-0.48190706875183104,0.6301972981285452
571,1554843600,1098,872,0,1970,15,-0.48190706875183104,0.9898816062926483
571,1554858000,347,392,45,739,15,1.4642560935151792,-0.7329642433182891
571,1554872400,14,11,0,25,15,-0.48190706875183104,-1.7322428270893773
571,1554886800,1681,303,0,1984,15,-0.48190706875183104,1.0094753040136502
571,1554901200,1296,470,0,1766,15,-0.48190706875183104,0.7043734395009089
571,1554915600,1058,587,0,1645,15,-0.48190706875183104,0.5350279091979654
571,1554930000,1187,827,0,2014,15,-0.48190706875183104,1.0514617991300823
571,1554944400,336,438,102,774,15,3.929396099053392,-0.6839799990157849
571,1554958800,32,31,0,63,15,-0.48190706875183104,-1.6790599332752296
571,1554973200,1733,312,0,2045,15,-0.48190706875183104,1.094847844083729
571,1554987600,1397,449,0,1846,15,-0.48190706875183104,0.8163374264780616
571,1555002000,1030,616,0,1646,15,-0.48190706875183104,0.5364274590351799
571,1555016400,1159,854,0,2013,15,-0.48190706875183104,1.050062249292868
571,1555030800,366,442,76,808,15,2.804946271965786,-0.636395304550495
571,1555045200,23,42,19,65,15,0.33980626642757317,-1.676260833600801
571,1555059600,1523,273,0,1796,15,-0.48190706875183104,0.7463599346173412
571,1555074000,1325,440,0,1765,15,-0.48190706875183104,0.7029738896636945
571,1555088400,1102,595,0,1697,15,-0.48190706875183104,0.6078045007331146
571,1555102800,1164,830,0,1994,15,-0.48190706875183104,1.0234708023857941
571,1555117200,470,411,0,881,15,-0.48190706875183104,-0.5342281664338431
571,1555131600,48,79,31,127,15,0.8587831096987758,-1.5894887436935075
571,1555146000,321,161,0,482,15,-0.48190706875183104,-1.0926485514823923
571,1555160400,1000,593,0,1593,15,-0.48190706875183104,0.46225131766281613
571,1555174800,1111,669,0,1780,15,-0.48190706875183104,0.7239671372219106
571,1555189200,1041,677,0,1718,15,-0.48190706875183104,0.6371950473146173
571,1555203600,421,473,52,894,15,1.7669925854233806,-0.5160340185500557
571,1555218000,50,103,53,153,15,1.810240655695981,-1.5531004479259327
571,1555232400,211,135,0,346,15,-0.48190706875183104,-1.2829873293435519
571,1555246800,839,388,0,1227,15,-0.48190706875183104,-0.049983922757657555
571,1555261200,945,685,0,1630,15,-0.48190706875183104,0.5140346616397493
571,1555275600,654,621,0,1275,15,-0.48190706875183104,0.017194469428634077
571,1555290000,273,297,24,570,15,0.5560466177905743,-0.9694881658075243
571,1555304400,20,38,18,58,15,0.296558196154973,-1.6860576824613016
571,1555318800,1652,276,0,1928,15,-0.48190706875183104,0.9311005131296431
571,1555333200,1242,452,0,1694,15,-0.48190706875183104,0.6036058512214715
571,1555347600,1043,649,0,1692,15,-0.48190706875183104,0.6008067515470427
571,1555362000,1037,850,0,1887,15,-0.48190706875183104,0.8737189698038523
571,1555376400,306,333,27,639,16,1.215765947760303,-0.7789377665526485
571,1555390800,29,27,0,56,16,-0.46966019497830774,-1.6239258115556678
571,1555405200,1770,306,0,2076,16,-0.46966019497830774,1.3038200733604544
571,1555419600,1298,477,0,1775,16,-0.46966019497830774,0.8675569489249331
571,1555434000,1010,623,0,1633,16,-0.46966019497830774,0.6617451094902354
571,1555448400,1163,835,0,1998,16,-0.46966019497830774,1.1907684995864654
571,1555462800,346,394,48,740,16,2.5266529476681114,-0.6325504723068424
571,1555477200,28,40,12,68,16,0.27941809068329704,-1.606533261744285
571,1555491600,1760,271,0,2031,16,-0.46966019497830774,1.2385980115677684
571,1555506000,1372,492,0,1864,16,-0.46966019497830774,0.9965516933593563
571,1555520400,1115,593,0,1708,16,-0.46966019497830774,0.7704485458113786
571,1555534800,1101,862,0,1963,16,-0.46966019497830774,1.1400402293032652
571,1555549200,364,384,20,748,16,0.7788036144577002,-0.6209554390992538
571,1555563600,30,34,4,64,16,-0.21996743309110617,-1.6123307783480794
571,1555578000,1690,296,0,1986,16,-0.46966019497830774,1.1733759497750824
571,1555592400,1363,497,0,1860,16,-0.46966019497830774,0.990754176755562
571,1555606800,1118,666,0,1784,16,-0.46966019497830774,0.8806013612834702
571,1555621200,1182,774,0,1956,16,-0.46966019497830774,1.1298945752466252
571,1555635600,368,437,69,805,16,3.8375399475759195,-0.538340827495185
571,1555650000,28,54,26,82,16,1.1533427572885024,-1.586241953631005
571,1555664400,1058,234,0,1292,16,-0.46966019497830774,0.1675068190167712
571,1555678800,1243,526,0,1769,16,-0.46966019497830774,0.8588606740192416
571,1555693200,1072,650,0,1722,16,-0.46966019497830774,0.7907398539246586
571,1555707600,1067,614,0,1681,16,-0.46966019497830774,0.731315308735767
571,1555722000,431,332,0,763,16,-0.46966019497830774,-0.5992147518350252
571,1555736400,37,79,42,116,16,2.1521138048373087,-1.5369630624987534
571,1555750800,226,138,0,364,16,-0.46966019497830774,-1.1775170330635067
571,1555765200,771,437,0,1208,16,-0.46966019497830774,0.04575897033709088
571,1555779600,956,594,0,1550,16,-0.46966019497830774,0.5414466399615037
571,1555794000,828,600,0,1428,16,-0.46966019497830774,0.3646223835457775
571,1555808400,391,378,0,769,16,-0.46966019497830774,-0.5905184769293337
571,1555822800,53,82,29,135,16,1.3406123287039038,-1.5094248586307304
571,1555837200,167,74,0,241,16,-0.46966019497830774,-1.3557906686301815
571,1555851600,749,297,0,1046,16,-0.46966019497830774,-0.18904045211657833
571,1555866000,721,497,0,1218,16,-0.46966019497830774,0.06025276184657663
571,1555880400,511,474,0,985,16,-0.46966019497830774,-0.2774525803244414
571,1555894800,237,276,39,513,16,1.9648442334219076,-0.961559539572169
571,1555909200,26,18,0,44,16,-0.46966019497830774,-1.6413183613670508
571,1555923600,1415,240,0,1655,16,-0.46966019497830774,0.693631450811104
571,1555938000,1247,489,0,1736,16,-0.46966019497830774,0.8110311620379387
571,1555952400,1019,578,0,1597,16,-0.46966019497830774,0.6095674600560866
571,1555966800,934,808,0,1742,16,-0.46966019497830774,0.8197274369436301
571,1555981200,281,314,33,595,17,1.4137955009817342,-0.9187897955057743
571,1555995600,27,24,0,51,17,-0.41241192153521233,-1.7155299369858081
571,1556010000,1564,274,0,1838,17,-0.41241192153521233,0.9017028439421708
571,1556024400,1235,455,0,1690,17,-0.41241192153521233,0.6849426583924557
571,1556038800,1055,491,0,1546,17,-0.41241192153521233,0.4740408562359762
571,1556053200,1018,925,0,1943,17,-0.41241192153521233,1.0554854080146039
571,1556067600,346,319,0,665,17,-0.41241192153521233,-0.8162680861241522
571,1556082000,32,35,3,67,17,-0.24639306494276264,-1.692096403412866
571,1556096400,1645,297,0,1942,17,-0.41241192153521233,1.054020812166295
571,1556110800,1404,377,0,1781,17,-0.41241192153521233,0.8182208805885643
571,1556125200,1060,579,0,1639,17,-0.41241192153521233,0.6102482701287025
571,1556139600,1115,826,0,1941,17,-0.41241192153521233,1.052556216317986
571,1556154000,321,352,31,673,17,1.3031162632534343,-0.8045513193376812
571,1556168400,23,37,14,60,17,0.3623427425628862,-1.7023485743510283
571,1556182800,1558,277,0,1835,17,-0.41241192153521233,0.8973090563972442
571,1556197200,1379,454,0,1833,17,-0.41241192153521233,0.8943798647006265
571,1556211600,1088,541,0,1629,17,-0.41241192153521233,0.5956023116456137
571,1556226000,1120,881,0,2001,17,-0.41241192153521233,1.1404319672165193
571,1556240400,381,386,5,767,17,-0.13571382721446285,-0.666879309596646
571,1556254800,44,43,0,87,17,-0.41241192153521233,-1.6628044864466884
571,1556269200,1370,262,0,1632,17,-0.41241192153521233,0.5999960991905404
571,1556283600,1265,472,0,1737,17,-0.41241192153521233,0.7537786632629734
571,1556298000,1091,635,0,1726,17,-0.41241192153521233,0.7376681089315756
571,1556312400,1035,657,0,1692,17,-0.41241192153521233,0.6878718500890735
571,1556326800,428,424,0,852,17,-0.41241192153521233,-0.5423886624903906
571,1556341200,49,72,23,121,17,0.8603993123402353,-1.6130082276041862
571,1556355600,250,280,30,530,17,1.2477766443892846,-1.0139885256458518
571,1556370000,1003,574,0,1577,17,-0.41241192153521233,0.5194433275335516
571,1556384400,1067,792,0,1859,17,-0.41241192153521233,0.9324593567566575
571,1556398800,1045,710,0,1755,17,-0.41241192153521233,0.7801413885325333
571,1556413200,445,548,103,993,17,5.2875688214722265,-0.3358806478788377
571,1556427600,61,88,27,149,17,1.0817577877968347,-1.5719995438515375
571,1556442000,211,138,0,349,17,-0.41241192153521233,-1.2790803741897603
571,1556456400,857,487,0,1344,17,-0.41241192153521233,0.17819249487758124
571,1556470800,915,770,0,1685,17,-0.41241192153521233,0.6776196791509114
571,1556485200,601,607,6,1208,17,-0.08037420835031295,-0.020992540492427252
571,1556499600,256,286,30,542,17,1.2477766443892846,-0.9964133754661453
571,1556514000,21,29,8,50,17,0.030305029377986837,-1.7169945328341172
571,1556528400,1640,306,0,1946,17,-0.41241192153521233,1.0598791955595306
571,1556542800,1223,340,0,1563,17,-0.41241192153521233,0.4989389856572272
571,1556557200,1043,551,0,1594,17,-0.41241192153521233,0.5443414569548027
571,1556571600,1012,839,0,1851,17,-0.41241192153521233,0.9207425899701864
571,1556586000,311,352,41,663,18,1.4758624543190835,-0.7854910246244696
571,1556600400,18,40,22,58,18,0.5850169584268425,-1.662505162511534
571,1556614800,1678,316,0,1994,18,-0.4464883526062787,1.1439400787270717
571,1556629200,1372,415,0,1787,18,-0.4464883526062787,0.8438707786566216
571,1556643600,1109,618,0,1727,18,-0.4464883526062787,0.7568941699405491
571,1556658000,1099,831,0,1930,18,-0.4464883526062787,1.0511650294299277
571,1556672400,403,373,0,776,18,-0.4464883526062787,-0.6216850782091998
571,1556686800,36,33,0,69,18,-0.4464883526062787,-1.6465594509135872
571,1556701200,1742,302,0,2044,18,-0.4464883526062787,1.2164205859904655
571,1556715600,1350,382,0,1732,18,-0.4464883526062787,0.7641422206668885
571,1556730000,1059,590,0,1649,18,-0.4464883526062787,0.6438245786096549
571,1556744400,1157,806,0,1963,18,-0.4464883526062787,1.0990021642237677
571,1556758800,351,417,66,768,18,2.648027580493085,-0.6332819593713428
571,1556773200,33,36,3,69,18,-0.30582853746539856,-1.6465594509135872
571,1556787600,1662,289,0,1951,18,-0.4464883526062787,1.0816068424805532
571,1556802000,1320,400,0,1720,18,-0.4464883526062787,0.7467468989236741
571,1556816400,1054,567,0,1621,18,-0.4464883526062787,0.6032354945421544
571,1556830800,1118,823,0,1941,18,-0.4464883526062787,1.0671107410278744
571,1556845200,380,418,38,798,18,1.3352026391782035,-0.5897936550133066
571,1556859600,43,67,24,110,18,0.6787901685207626,-1.5871254349576045
571,1556874000,1513,281,0,1794,18,-0.4464883526062787,0.8540180496734968
571,1556878272,502,121,0,623,18,-0.4464883526062787,-0.8434754304351847
571,1556883649,248,91,0,339,18,-0.4464883526062787,-1.2551647116912612
571,1556888400,1340,455,0,1795,18,-0.4464883526062787,0.8554676598187646
571,1556902800,1102,565,0,1667,18,-0.4464883526062787,0.6699175612244767
571,1556917200,1209,727,0,1936,18,-0.4464883526062787,1.059862690301535
571,1556931600,430,463,33,893,18,1.1007696139434031,-0.45208069121285843
571,1556946000,45,87,42,132,18,1.5227490593660435,-1.5552340117617112
571,1556960400,268,231,0,499,18,-0.4464883526062787,-1.0232270884484012
571,1556974800,941,527,0,1468,18,-0.4464883526062787,0.3814451423161696
571,1556989200,1116,583,0,1699,18,-0.4464883526062787,0.7163050858730486
571,1557003600,998,641,0,1639,18,-0.4464883526062787,0.6293284771569762
571,1557018000,458,559,101,1017,18,4.2890587571366865,-0.27232903319964197
571,1557032400,54,103,49,157,18,1.850955294694764,-1.5189937581300144
571,1557046800,164,124,0,288,18,-0.4464883526062787,-1.3290948290999227
571,1557061200,809,505,0,1314,18,-0.4464883526062787,0.15820517994491687
571,1557075600,894,710,0,1604,18,-0.4464883526062787,0.5785921220726006
571,1557090000,632,587,0,1219,18,-0.4464883526062787,0.020492216144468743
571,1557104400,285,247,0,532,18,-0.4464883526062787,-0.9753899536545613
571,1557118800,29,26,0,55,18,-0.4464883526062787,-1.6668539929473376
571,1557133200,1606,270,0,1876,18,-0.4464883526062787,0.9728860815854625
571,1557147600,1249,369,0,1618,18,-0.4464883526062787,0.5988866641063508
571,1557162000,1035,525,0,1560,18,-0.4464883526062787,0.514809275680814
571,1557176400,963,957,0,1920,18,-0.4464883526062787,1.036668927977249
571,1557190800,351,326,0,677,19,-0.48604200060564345,-0.700476746160815
571,1557205200,31,19,0,50,19,-0.48604200060564345,-1.579538766039274
571,1557219600,1729,291,0,2020,19,-0.48604200060564345,1.1824264319839544
571,1557226522,650,150,0,800,19,-0.48604200060564345,-0.5280291728832226
571,1557227125,16,27,11,43,19,0.07740247316436477,-1.589352855575397
571,1557229060,63,39,0,102,19,-0.48604200060564345,-1.5066341009137878
571,1557234000,1337,389,0,1726,19,-0.48604200060564345,0.7702346714667823
571,1557248400,1109,591,0,1700,19,-0.48604200060564345,0.7337823389040391
571,1557262800,1100,846,0,1946,19,-0.48604200060564345,1.078677485459224
571,1557277200,357,396,39,753,19,1.5116247700334768,-0.593923774054335
571,1557291600,29,49,20,78,19,0.5384024971580079,-1.5402824078947814
571,1557306000,1739,287,0,2026,19,-0.48604200060564345,1.1908385087292028
571,1557320400,1307,407,0,1714,19,-0.48604200060564345,0.7534105179762854
571,1557334800,1055,551,0,1606,19,-0.48604200060564345,0.601993136561814
571,1557349200,1137,817,0,1954,19,-0.48604200060564345,1.089893587786222
571,1557363600,371,431,60,802,19,2.587291492685311,-0.5252251473014731
571,1557378000,25,30,5,55,19,-0.22993087616473062,-1.5725287020849004
571,1557392400,1672,284,0,1956,19,-0.48604200060564345,1.0926976133679713
571,1557406800,1336,436,0,1772,19,-0.48604200060564345,0.83472725984702
571,1557421200,1103,607,0,1710,19,-0.48604200060564345,0.7478024668127865
571,1557435600,1229,834,0,2063,19,-0.48604200060564345,1.242712981991568
571,1557450000,392,457,65,849,19,2.8434026171262237,-0.4593305461303605
571,1557464400,33,42,9,75,19,-0.025041976612000368,-1.5444884462674056
571,1557478800,1518,258,0,1776,19,-0.48604200060564345,0.840335311010519
571,1557493200,1321,388,0,1709,19,-0.48604200060564345,0.7464004540219118
571,1557507600,1166,503,0,1669,19,-0.48604200060564345,0.6903199423869223
571,1557522000,1291,727,0,2018,19,-0.48604200060564345,1.179622406402205
571,1557536400,460,478,18,938,19,0.43595804738164273,-0.3345514077425091
571,1557550800,39,81,42,120,19,1.6652914446980245,-1.4813978706780424
571,1557565200,275,237,0,512,19,-0.48604200060564345,-0.9318088566551462
571,1557579600,1016,499,0,1515,19,-0.48604200060564345,0.4744099725922131
571,1557594000,1141,646,0,1787,19,-0.48604200060564345,0.8557574517101411
571,1557608400,1035,656,0,1691,19,-0.48604200060564345,0.7211642237861665
571,1557622800,407,484,77,891,19,3.458069315784414,-0.40044600891362164
571,1557637200,56,86,30,142,19,1.0506247460398337,-1.4505535892787984
571,1557651600,190,121,0,311,19,-0.48604200060564345,-1.213613427620968
571,1557666000,736,530,0,1266,19,-0.48604200060564345,0.12530878766440406
571,1557680400,799,604,0,1403,19,-0.48604200060564345,0.31738454001424277
571,1557694800,582,630,48,1212,19,1.9726247940271198,0.049600096957168355
571,1557709200,256,259,3,515,19,-0.33237532594109576,-0.9276028182825221
571,1557723600,34,18,0,52,19,-0.48604200060564345,-1.5767347404575245
571,1557738000,1641,301,0,1942,19,-0.48604200060564345,1.073069434295725
571,1557752400,1204,429,0,1633,19,-0.48604200060564345,0.6398474819154318
571,1557766800,967,571,0,1538,19,-0.48604200060564345,0.506656266782332
571,1557781200,980,851,0,1831,19,-0.48604200060564345,0.9174460145086294
571,1557795600,332,324,0,656,20,-0.4209367916568064,-0.8469731473421358
571,1557810000,28,21,0,49,20,-0.4209367916568064,-1.7368353265788257
571,1557824400,1683,284,0,1967,20,-0.4209367916568064,1.0749532397736803
571,1557838800,1332,384,0,1716,20,-0.4209367916568064,0.7069871656576849
571,1557853200,1061,518,0,1579,20,-0.4209367916568064,0.5061451252039345
571,1557867600,1074,839,0,1913,20,-0.4209367916568064,0.9957892238284063
571,1557882000,362,441,79,803,20,2.5705324159962717,-0.6314711039355569
571,1557896400,33,34,1,67,20,-0.38307009282575477,-1.7104473212637343
571,1557910800,1710,312,0,2022,20,-0.4209367916568064,1.155583256014237
571,1557925200,1380,367,0,1747,20,-0.4209367916568064,0.7524331748114532
571,1557939600,1024,550,0,1574,20,-0.4209367916568064,0.49881512372752024
571,1557954000,1169,808,0,1977,20,-0.4209367916568064,1.0896132427265086
571,1557968400,361,448,87,809,20,2.8734660066446844,-0.6226751021638598
571,1557982800,31,46,15,77,20,0.14706369080896792,-1.6957873183109058
571,1557997200,1636,320,0,1956,20,-0.4209367916568064,1.0588272365255689
571,1558011600,1284,436,0,1720,20,-0.4209367916568064,0.7128511668388163
571,1558026000,1018,618,0,1636,20,-0.4209367916568064,0.5897071420350569
571,1558040400,1211,817,0,2028,20,-0.4209367916568064,1.164379257785934
571,1558054800,422,473,51,895,20,1.5102648487268262,-0.49659907676953474
571,1558069200,28,56,28,84,20,0.639330775612639,-1.6855253162439259
571,1558083600,1562,277,0,1839,20,-0.4209367916568064,0.8873052019774754
571,1558086892,406,85,0,491,20,-0.4209367916568064,-1.088863196063806
571,1558098000,1314,463,0,1777,20,-0.4209367916568064,0.7964131836699387
571,1558112400,1130,588,0,1718,20,-0.4209367916568064,0.7099191662482506
571,1558126800,1191,681,0,1872,20,-0.4209367916568064,0.9356832117218095
571,1558141200,460,451,0,911,20,-0.4209367916568064,-0.4731430720450091
571,1558155600,68,88,20,156,20,0.33639718496422605,-1.5799732949835608
571,1558170000,458,197,0,655,20,-0.4209367916568064,-0.8484391476374187
571,1558184400,1015,536,0,1551,20,-0.4209367916568064,0.4650971169360147
571,1558198800,1074,728,0,1802,20,-0.4209367916568064,0.83306319105201
571,1558213200,1085,735,0,1820,20,-0.4209367916568064,0.8594511963671013
571,1558227600,392,513,121,905,20,4.16093376690044,-0.4819390738167062
571,1558242000,48,98,50,146,20,1.4723981498957746,-1.594633297936389
571,1558256400,210,124,0,334,20,-0.4209367916568064,-1.3190252424232134
571,1558270800,899,402,0,1301,20,-0.4209367916568064,0.09859704311530228
571,1558285200,944,594,0,1538,20,-0.4209367916568064,0.4460391130973377
571,1558299600,711,613,0,1324,20,-0.4209367916568064,0.1323150499068078
571,1558314000,299,313,14,612,20,0.1091969919779163,-0.9114771603345811
571,1558328400,23,35,12,58,20,0.033463594315813056,-1.72364132392128
571,1558342800,1660,271,0,1931,20,-0.4209367916568064,1.0221772291434976
571,1558357200,1262,355,0,1617,20,-0.4209367916568064,0.5618531364246828
571,1558371600,1006,578,0,1584,20,-0.4209367916568064,0.5134751266803488
571,1558386000,1012,822,0,1834,20,-0.4209367916568064,0.8799752005010611
571,1558400400,379,357,0,736,21,-0.39489175981245084,-0.5861741711763299
571,1558414800,25,29,4,54,21,-0.04200976168217563,-1.6242188672613247
571,1558429200,1715,330,0,2045,21,-0.39489175981245084,1.4062019390513214
571,1558443600,1264,403,0,1667,21,-0.39489175981245084,0.8308633831567055
571,1558458000,1030,540,0,1570,21,-0.39489175981245084,0.6832235950038543
571,1558472400,1179,775,0,1954,21,-0.39489175981245084,1.2676945089285434
571,1558486800,380,396,16,776,21,1.01663623270865,-0.5252917843091748
571,1558501200,31,33,2,64,21,-0.21845076074731323,-1.6089982705445358
571,1558515600,1703,304,0,2007,21,-0.39489175981245084,1.348363671527524
571,1558530000,1353,425,0,1778,21,-0.39489175981245084,0.9998120067130609
571,1558544400,1109,538,0,1647,21,-0.39489175981245084,0.800422189723128
571,1558558800,1174,779,0,1953,21,-0.39489175981245084,1.2661724492568645
571,1558573200,403,396,0,799,21,-0.39489175981245084,-0.4902844118605606
571,1558587600,26,39,13,65,21,0.7519747341109436,-1.607476210872857
571,1558602000,1625,324,0,1949,21,-0.39489175981245084,1.260084210570149
571,1558616400,1339,393,0,1732,21,-0.39489175981245084,0.9297972618158326
571,1558630800,1166,554,0,1720,21,-0.39489175981245084,0.911532545755686
571,1558645200,1114,744,0,1858,21,-0.39489175981245084,1.121576780447371
571,1558659600,401,380,0,781,21,-0.39489175981245084,-0.5176814859507805
571,1558674000,23,36,13,59,21,0.7519747341109436,-1.6166085689029304
571,1558688400,1354,286,0,1640,21,-0.39489175981245084,0.7897677720213757
571,1558702800,1142,396,0,1538,21,-0.39489175981245084,0.6345176855101302
571,1558717200,1262,570,0,1832,21,-0.39489175981245084,1.0820032289837203
571,1558731600,1127,531,0,1658,21,-0.39489175981245084,0.8171648461115956
571,1558746000,497,350,0,847,21,-0.39489175981245084,-0.41722554761997444
571,1558760400,41,77,36,118,21,2.7810462233600264,-1.5268070482738765
571,1558774800,254,213,0,467,21,-0.39489175981245084,-0.995608222857948
571,1558789200,850,474,0,1324,21,-0.39489175981245084,0.30879691577085033
571,1558803600,898,679,0,1577,21,-0.39489175981245084,0.6938780127056065
571,1558818000,879,553,0,1432,21,-0.39489175981245084,0.4731793603121691
571,1558832400,414,399,0,813,21,-0.39489175981245084,-0.4689755764570563
571,1558846800,41,75,34,116,21,2.6046052242948887,-1.5298511676172342
571,1558861200,206,128,0,334,21,-0.39489175981245084,-1.198042159191239
571,1558875600,811,353,0,1164,21,-0.39489175981245084,0.06526736830222984
571,1558890000,787,507,0,1294,21,-0.39489175981245084,0.26313512562048397
571,1558904400,584,582,0,1166,21,-0.39489175981245084,0.0683114876455876
571,1558918800,281,335,54,616,21,4.369015214946264,-0.7688213317777953
571,1558933200,21,37,16,58,21,1.01663623270865,-1.618130628574609
571,1558947600,165,140,0,305,21,-0.39489175981245084,-1.2421818896699264
571,1558962000,695,372,0,1067,21,-0.39489175981245084,-0.08237241985062131
571,1558976400,777,553,0,1330,21,-0.39489175981245084,0.31792927380092356
571,1558990800,641,536,0,1177,21,-0.39489175981245084,0.08505414403405526
571,1559005200,301,260,0,561,22,-0.33425784848097323,-0.9705644476280866
571,1559019600,28,22,0,50,22,-0.33425784848097323,-1.7006308353679576
571,1559034000,1620,317,0,1937,22,-0.33425784848097323,0.9953286042898437
571,1559048400,1183,467,0,1650,22,-0.33425784848097323,0.5852913180249847
571,1559062800,1069,514,0,1583,22,-0.33425784848097323,0.4895683278516552
571,1559077200,1087,796,0,1883,22,-0.33425784848097323,0.9181787316128319
571,1559091600,368,314,0,682,22,-0.33425784848097323,-0.7976915847777454
571,1559106000,28,32,4,60,22,-0.1571117331976814,-1.6863438219092517
571,1559120400,1756,311,0,2067,22,-0.33425784848097323,1.1810597792530202
571,1559134800,1321,417,0,1738,22,-0.33425784848097323,0.7110170364615965
571,1559149200,1112,533,0,1645,22,-0.33425784848097323,0.5781478112956318
571,1559163600,1020,843,0,1863,22,-0.33425784848097323,0.8896047046954201
571,1559178000,363,329,0,692,22,-0.33425784848097323,-0.7834045713190394
571,1559192400,25,57,32,82,22,1.0829110737853611,-1.6549123923000986
571,1559206800,1626,296,0,1922,22,-0.33425784848097323,0.9738980841017848
571,1559221200,1340,435,0,1775,22,-0.33425784848097323,0.7638789862588082
571,1559235600,1086,557,0,1643,22,-0.33425784848097323,0.5752904086038906
571,1559250000,1039,749,0,1788,22,-0.33425784848097323,0.782452103755126
571,1559264400,358,424,66,782,22,2.588653053693341,-0.6548214501906865
571,1559278800,31,39,8,70,22,0.02003438208561039,-1.6720568084505458
571,1559293200,1531,286,0,1817,22,-0.33425784848097323,0.823884442785373
571,1559307600,1330,438,0,1768,22,-0.33425784848097323,0.7538780768377141
571,1559322000,1183,548,0,1731,22,-0.33425784848097323,0.7010161270405024
571,1559336400,1188,621,0,1809,22,-0.33425784848097323,0.8124548320184083
571,1559350800,473,372,0,845,22,-0.33425784848097323,-0.5648132654008393
571,1559365200,55,100,45,155,22,1.6586359484560593,-1.5506171940515456
571,1559379600,295,198,0,493,22,-0.33425784848097323,-1.0677161391472867
571,1559394000,970,505,0,1475,22,-0.33425784848097323,0.33526858249763164
571,1559408400,1083,607,0,1690,22,-0.33425784848097323,0.6424393718598083
571,1559422800,994,629,0,1623,22,-0.33425784848097323,0.5467163816864787
571,1559437200,434,555,121,989,22,5.024412138838604,-0.35908027159547456
571,1559451600,49,90,41,139,22,1.4814898331727675,-1.573476415585475
571,1559466000,207,125,0,332,22,-0.33425784848097323,-1.2977370558324515
571,1559480400,895,416,0,1311,22,-0.33425784848097323,0.10096156177485506
571,1559494800,918,738,0,1656,22,-0.33425784848097323,0.5938635261002082
571,1559509200,689,646,0,1335,22,-0.33425784848097323,0.13525039407574918
571,1559523600,328,252,0,580,22,-0.33425784848097323,-0.9434191220565454
571,1559538000,45,36,0,81,22,-0.33425784848097323,-1.6563410936459693
571,1559552400,1706,291,0,1997,22,-0.33425784848097323,1.081050685042079
571,1559566800,1867,480,0,2347,22,-0.33425784848097323,1.581096156096785
571,1559581200,984,531,0,1515,22,-0.33425784848097323,0.39241663633245516
571,1559595600,1077,856,0,1933,22,-0.33425784848097323,0.9896137989063614
571,1559610000,338,401,63,739,23,3.390276905612561,-0.7341685994935856
571,1559624400,22,24,2,46,23,-0.26386252736151616,-1.6650643196791792
571,1559638800,1740,280,0,2020,23,-0.3836703776229613,0.9865780347888754
571,1559653200,1284,409,0,1693,23,-0.3836703776229613,0.5473242101125563
571,1559667600,1042,525,0,1567,23,-0.3836703776229613,0.37807044280608476
571,1559682000,1103,792,0,1895,23,-0.3836703776229613,0.8186675513499155
571,1559696400,422,410,0,832,23,-0.3836703776229613,-0.6092431998149994
571,1559710800,27,36,9,63,23,0.15546494855354193,-1.6422284939314806
571,1559725200,1729,320,0,2049,23,-0.3836703776229613,1.025533266946714
571,1559739600,1363,364,0,1727,23,-0.3836703776229613,0.5929958616079534
571,1559754000,1033,544,0,1577,23,-0.3836703776229613,0.39150328148120156
571,1559768400,1115,828,0,1943,23,-0.3836703776229613,0.8831451769904761
571,1559782800,376,398,22,774,23,0.9342159752529354,-0.6871536641306768
571,1559797200,24,29,5,53,23,-0.0841507519693484,-1.6556613326065974
571,1559811600,1696,313,0,2009,23,-0.3836703776229613,0.9718019122462469
571,1559826000,1643,264,0,1907,23,-0.3836703776229613,0.8347869577600556
571,1559840400,2300,922,0,3222,23,-0.3836703776229613,2.6012052435379136
571,1559854800,1225,751,0,1976,23,-0.3836703776229613,0.9274735446183615
571,1559869200,408,381,0,789,23,-0.3836703776229613,-0.6670044061180016
571,1559883600,44,51,7,95,23,0.035657098292096755,-1.5992434101711068
571,1559898000,1496,300,0,1796,23,-0.3836703776229613,0.6856824484662593
571,1559912400,1325,390,0,1715,23,-0.3836703776229613,0.5768764551978133
571,1559926800,1134,547,0,1681,23,-0.3836703776229613,0.5312048037024162
571,1559941200,1311,679,0,1990,23,-0.3836703776229613,0.946279518763525
571,1559955600,496,473,0,969,23,-0.3836703776229613,-0.42521330996589934
571,1559970000,46,75,29,121,23,1.3535434511679936,-1.5643180296158032
571,1559984400,339,215,0,554,23,-0.3836703776229613,-0.9826761149832463
571,1559998800,1039,537,0,1576,23,-0.3836703776229613,0.39015999761368986
571,1560013200,1102,638,0,1740,23,-0.3836703776229613,0.6104585518856053
571,1560027600,997,685,0,1682,23,-0.3836703776229613,0.5325480875699279
571,1560042000,449,504,55,953,23,2.9110455045667805,-0.44670585184608624
571,1560056400,43,113,70,156,23,3.8096043815276195,-1.5173030942528944
571,1560070800,189,146,0,335,23,-0.3836703776229613,-1.276855281968304
571,1560085200,943,381,0,1324,23,-0.3836703776229613,0.051652463000746725
571,1560099600,901,667,0,1568,23,-0.3836703776229613,0.3794137266735964
571,1560114000,703,686,0,1389,23,-0.3836703776229613,0.13896591438900588
571,1560128400,313,293,0,606,23,-0.3836703776229613,-0.9128253538726389
571,1560142800,27,34,7,61,23,0.035657098292096755,-1.644915061666504
571,1560157200,1610,279,0,1889,23,-0.3836703776229613,0.8106078481448454
571,1560171600,1268,386,0,1654,23,-0.3836703776229613,0.49493613927960084
571,1560186000,948,466,0,1414,23,-0.3836703776229613,0.17254801107679785
571,1560200400,1008,836,0,1844,23,-0.3836703776229613,0.7501600741068198
571,1560214800,328,307,0,635,24,-0.28485434610932375,-1.0383924007309977
571,1560229200,23,23,0,46,24,-0.28485434610932375,-1.8705662754820258
571,1560243600,1702,293,0,1995,24,-0.28485434610932375,0.8830956632102557
571,1560258000,1326,423,0,1749,24,-0.28485434610932375,0.5355323810561761
571,1560272400,1037,604,0,1641,24,-0.28485434610932375,0.3829436230373118
571,1560286800,1195,766,0,1961,24,-0.28485434610932375,0.8350584616117244
571,1560301200,469,408,0,877,24,-0.28485434610932375,-0.6964805540590983
571,1560315600,29,43,14,72,24,0.37980579481243165,-1.8338319448478548
571,1560330000,1736,318,0,2054,24,-0.28485434610932375,0.966454336572413
571,1560344400,1425,409,0,1834,24,-0.28485434610932375,0.6556253850525043
571,1560358800,1131,506,0,1637,24,-0.28485434610932375,0.3772921875551316
571,1560373200,1183,806,0,1989,24,-0.28485434610932375,0.8746185099869854
571,1560387600,415,386,0,801,24,-0.28485434610932375,-0.8038578282205212
571,1560402000,33,37,4,70,24,-0.09495144870310791,-1.8366576625889448
571,1560416400,1692,296,0,1988,24,-0.28485434610932375,0.8732056511164404
571,1560430800,1348,472,0,1820,24,-0.28485434610932375,0.6358453608648739
571,1560445200,1110,534,0,1644,24,-0.28485434610932375,0.3871821996489469
571,1560459600,1171,760,0,1931,24,-0.28485434610932375,0.7926726954953732
571,1560474000,370,474,104,844,24,4.652620986452288,-0.7431048967870845
571,1560488400,28,50,22,78,24,0.7596115896248633,-1.8253547916245845
571,1560502800,1485,273,0,1758,24,-0.28485434610932375,0.5482481108910814
571,1560517200,1299,424,0,1723,24,-0.28485434610932375,0.49879805042200503
571,1560531600,1119,691,0,1810,24,-0.28485434610932375,0.6217167721594234
571,1560546000,1322,600,0,1922,24,-0.28485434610932375,0.7799569656604678
571,1561165200,8336,9735,1399,18071,25,4.109582581895508,4.0703419636769675
571,1561179600,42,94,52,136,25,-0.1182237351716376,-0.4904516670866726
571,1561194000,297,214,0,511,25,-0.2814352633731904,-0.39509077433304196
571,1561208400,1086,559,0,1645,25,-0.2814352633731904,-0.10671943464606301
571,1561222800,1063,759,0,1822,25,-0.2814352633731904,-0.061709093266349366
571,1561237200,1011,729,0,1740,25,-0.2814352633731904,-0.08256134181514325
571,1561251600,474,578,104,1052,25,0.04498779302991517,-0.2575167930538042
571,1561266000,71,91,20,162,25,-0.21866159868028548,-0.48383997852242083
571,1561280400,213,152,0,365,25,-0.2814352633731904,-0.43221794857845547
571,1561294800,920,464,0,1384,25,-0.2814352633731904,-0.17309061600258993
571,1561309200,917,692,0,1609,25,-0.2814352633731904,-0.11587408035041155
571,1561323600,662,629,0,1291,25,-0.2814352633731904,-0.1967401174054903
571,1561338000,271,292,21,563,25,-0.21552291544564023,-0.38186739720453855
571,1561352400,24,42,18,66,25,-0.22493896514957595,-0.5082523670673503
571,1561366800,1580,235,0,1815,25,-0.2814352633731904,-0.06348916326441714
571,1561381200,1235,432,0,1667,25,-0.2814352633731904,-0.10112492893785002
571,1561395600,1013,502,0,1515,25,-0.2814352633731904,-0.13977787746732162
571,1561410000,943,807,0,1750,25,-0.2814352633731904,-0.08001838467504645
571,1561424400,363,345,0,708,26,-0.4376818328393327,-0.7579620318491324
571,1561438800,27,31,4,58,26,-0.21003307767831758,-1.747601109255097
571,1561453200,1629,265,0,1894,26,-0.4376818328393327,1.0477486540023664
571,1561467600,1329,476,0,1805,26,-0.4376818328393327,0.9122442264806265
571,1561482000,929,581,0,1510,26,-0.4376818328393327,0.4631003375040733
571,1561496400,962,961,0,1923,26,-0.4376818328393327,1.0919017820712478
571,1561510800,380,327,0,707,26,-0.4376818328393327,-0.75948455350668
571,1561525200,27,36,9,63,26,0.07452786627295138,-1.7399885009673588
571,1561539600,1638,272,0,1910,26,-0.4376818328393327,1.0721090005231286
571,1561554000,1182,415,0,1597,26,-0.4376818328393327,0.5955597217107178
571,1561568400,978,675,0,1653,26,-0.4376818328393327,0.6808209345333855
571,1561582800,1035,1047,12,2082,26,0.24526443264371275,1.3339827256213224
571,1561597200,438,428,0,866,26,-0.4376818328393327,-0.5174036099566055
571,1561611600,21,40,19,61,26,0.6436497541754893,-1.743033544282454
571,1561626000,1594,269,0,1863,26,-0.4376818328393327,1.0005504826183895
571,1561640400,1362,415,0,1777,26,-0.4376818328393327,0.8696136200692927
571,1561654800,948,614,0,1562,26,-0.4376818328393327,0.5422714636965505
571,1561669200,949,877,0,1826,26,-0.4376818328393327,0.9442171812891269
571,1561683600,374,451,77,825,26,3.944556704010209,-0.5798269979160586
571,1561698000,30,64,34,94,26,1.497332586029296,-1.692790329583382
571,1561712400,1262,264,0,1526,26,-0.4376818328393327,0.48746068402483556
571,1561726800,1163,473,0,1636,26,-0.4376818328393327,0.6549380663550757
571,1561741200,1089,685,0,1774,26,-0.4376818328393327,0.8650460550966498
571,1561755600,1192,714,0,1906,26,-0.4376818328393327,1.066018913892938
571,1561770000,474,442,0,916,26,-0.4376818328393327,-0.44127752707922363
571,1561784400,43,98,55,141,26,2.692488550624626,-1.621231811678643
571,1561798800,265,178,0,443,26,-0.4376818328393327,-1.1614302710992563
571,1561813200,952,514,0,1466,26,-0.4376818328393327,0.39610938457197725
571,1561827600,1103,560,0,1663,26,-0.4376818328393327,0.6960461511088619
571,1561842000,891,620,0,1511,26,-0.4376818328393327,0.464622859161621
571,1561856400,469,398,0,867,26,-0.4376818328393327,-0.5158810882990579
571,1561870800,55,110,55,165,26,2.692488550624626,-1.5846912918974998
571,1561885200,204,126,0,330,26,-0.4376818328393327,-1.3334752184021395
571,1561899600,1045,384,0,1429,26,-0.4376818328393327,0.33977608324271463
571,1561914000,986,592,0,1578,26,-0.4376818328393327,0.5666318102173127
571,1561928400,605,630,25,1235,26,0.9851228869170121,0.04440688167847289
571,1561942800,292,283,0,575,26,-0.4376818328393327,-0.9604574123029682
571,1561957200,35,68,33,103,26,1.4404203972390424,-1.6790876346654533
571,1561971600,1464,240,0,1704,26,-0.4376818328393327,0.7584695390683152
571,1561986000,1189,423,0,1612,26,-0.4376818328393327,0.6183975465739324
571,1562000400,977,530,0,1507,26,-0.4376818328393327,0.45853277253143043
571,1562014800,952,822,0,1774,26,-0.4376818328393327,0.8650460550966498
571,1562029200,336,338,2,674,27,-0.21674310119845416,-0.567335048828545
571,1562043600,25,27,2,52,27,-0.21674310119845416,-1.6351348194046913
571,1562058000,1557,221,0,1778,27,-0.27013436366376253,1.3279237079496953
571,1562072400,1226,407,0,1633,27,-0.27013436366376253,1.0789993241337126
571,1562086800,966,538,0,1504,27,-0.27013436366376253,0.8575424585319074
571,1562101200,995,828,0,1823,27,-0.27013436366376253,1.4051761029270693
571,1562115600,374,323,0,697,27,-0.27013436366376253,-0.527850491395665
571,1562130000,36,34,0,70,27,-0.27013436366376253,-1.6042338614137417
571,1562144400,1301,225,0,1526,27,-0.27013436366376253,0.8953102960764013
571,1562158800,1207,392,0,1599,27,-0.27013436366376253,1.0206308479285857
571,1562173200,1177,605,0,1782,27,-0.27013436366376253,1.3347905875032395
571,1562187600,1132,607,0,1739,27,-0.27013436366376253,1.2609716323026379
571,1562202000,358,411,53,769,27,1.144734091666909,-0.4042466594318667
571,1562216400,40,60,20,100,27,0.26377826098932106,-1.552732264762159
571,1562230800,277,119,0,396,27,-0.27013436366376253,-1.0445831777998773
571,1562245200,727,286,0,1013,27,-0.27013436366376253,0.014632993334338543
571,1562259600,751,480,0,1231,27,-0.27013436366376253,0.38887792900250556
571,1562274000,675,424,0,1099,27,-0.27013436366376253,0.16227090373554204
571,1562288400,239,475,236,714,27,6.030034607242624,-0.49866625329310155
571,1562302800,21,68,47,89,27,0.984560304270984,-1.571616183534406
571,1562317200,563,212,0,775,27,-0.27013436366376253,-0.3939463401015502
571,1562331600,791,431,0,1222,27,-0.27013436366376253,0.37342745000703076
571,1562346000,936,460,0,1396,27,-0.27013436366376253,0.6721367105862099
571,1562360400,842,499,0,1341,27,-0.27013436366376253,0.5777171167249752
571,1562374800,390,377,0,767,27,-0.27013436366376253,-0.4076800992086389
571,1562389200,40,72,32,112,27,0.5841258357811712,-1.532131626101526
571,1562403600,211,156,0,367,27,-0.27013436366376253,-1.0943680545630738
571,1562418000,765,556,0,1321,27,-0.27013436366376253,0.5433827189572534
571,1562432400,854,630,0,1484,27,-0.27013436366376253,0.8232080607641856
571,1562446800,910,508,0,1418,27,-0.27013436366376253,0.7099045481307039
571,1562461200,383,371,0,754,27,-0.27013436366376253,-0.4299974577576581
571,1562475600,45,78,33,123,27,0.6108214670138253,-1.5132477073292792
571,1562490000,166,103,0,269,27,-0.27013436366376253,-1.2626066036249104
571,1562504400,674,394,0,1068,27,-0.27013436366376253,0.10905258719557334
571,1562518800,811,486,0,1297,27,-0.27013436366376253,0.5021814416359873
571,1562533200,579,543,0,1122,27,-0.27013436366376253,0.20175546116842205
571,1562547600,264,246,0,510,27,-0.27013436366376253,-0.8488771105238634
571,1562562000,26,26,0,52,27,-0.27013436366376253,-1.6351348194046913
571,1562576400,1530,203,0,1733,27,-0.27013436366376253,1.2506713129723213
571,1562590800,1176,388,0,1564,27,-0.27013436366376253,0.9605456518350726
571,1562605200,947,521,0,1468,27,-0.27013436366376253,0.7957405425500083
571,1562619600,880,857,0,1737,27,-0.27013436366376253,1.2575381925258657
571,1562634000,323,320,0,643,28,-0.4251712885978725,-0.7713429067837606
571,1562648400,24,28,4,52,28,-0.26465718413845096,-1.631733579150925
571,1562662800,1690,282,0,1972,28,-0.4251712885978725,1.1634442397068678
571,1562677200,1252,439,0,1691,28,-0.4251712885978725,0.7543583193427846
571,1562691600,997,533,0,1530,28,-0.4251712885978725,0.5199710126573135
571,1562706000,1029,869,0,1898,28,-0.4251712885978725,1.0557134279383904
571,1562720400,337,418,81,755,28,2.8252393267054137,-0.6082908673503894
571,1562734800,28,32,4,60,28,-0.26465718413845096,-1.6200870049056841
571,1562749200,1642,290,0,1932,28,-0.4251712885978725,1.105211368480664
571,1562763600,1290,450,0,1740,28,-0.4251712885978725,0.8256935865948846
571,1562778000,994,606,0,1600,28,-0.4251712885978725,0.6218785373031706
571,1562792400,1003,844,0,1847,28,-0.4251712885978725,0.9814665171249803
571,1562806800,357,368,11,725,28,0.016242498665536717,-0.6519655207700423
571,1562821200,26,36,10,62,28,-0.02388602744931867,-1.617175361344374
571,1562835600,1659,294,0,1953,28,-0.4251712885978725,1.135783625874421
571,1562850000,1303,429,0,1732,28,-0.4251712885978725,0.8140470123496438
571,1562864400,982,677,0,1659,28,-0.4251712885978725,0.7077720223618215
571,1562878800,1010,802,0,1812,28,-0.4251712885978725,0.9305127548020519
571,1562893200,321,435,114,756,28,4.1494806884956414,-0.6068350455697342
571,1562907600,28,43,15,71,28,0.17675660312495825,-1.604072965318478
571,1562922000,1437,260,0,1697,28,-0.4251712885978725,0.7630932500267152
571,1562936400,1236,452,0,1688,28,-0.4251712885978725,0.7499908540008193
571,1562950800,1031,682,0,1713,28,-0.4251712885978725,0.7863863985171968
571,1562965200,1156,723,0,1879,28,-0.4251712885978725,1.0280528141059435
571,1562979600,472,461,0,933,28,-0.4251712885978725,-0.3491545903937815
571,1562994000,42,83,41,125,28,1.2200982821111983,-1.5254585891631027
571,1563008400,328,197,0,525,28,-0.4251712885978725,-0.9431298769010624
571,1563022800,1063,483,0,1546,28,-0.4251712885978725,0.5432641611477951
571,1563037200,1075,663,0,1738,28,-0.4251712885978725,0.8227819430335744
571,1563051600,621,384,0,1005,28,-0.4251712885978725,-0.24433542218661425
571,1563066000,50,24,0,74,28,-0.4251712885978725,-1.5997054999765128
571,1563080400,39,73,34,112,28,0.9391985993072106,-1.544384272311619
571,1563094800,197,114,0,311,28,-0.4251712885978725,-1.2546757379612539
571,1563109200,848,431,0,1279,28,-0.4251712885978725,0.15455974571288328
571,1563123600,825,645,0,1470,28,-0.4251712885978725,0.43262170581800746
571,1563138000,599,623,24,1222,28,0.5379133381586567,0.07157790421554255
571,1563152400,251,333,82,584,28,2.8653678528202686,-0.8572363918424115
571,1563166800,20,45,25,65,28,0.5780418642735121,-1.6128078960024086
571,1563181200,1596,248,0,1844,28,-0.4251712885978725,0.977099051783015
571,1563195600,1167,427,0,1594,28,-0.4251712885978725,0.61314360661924
571,1563210000,925,544,0,1469,28,-0.4251712885978725,0.43116588403735234
571,1563224400,958,938,0,1896,28,-0.4251712885978725,1.0528017843770803
571,1563238800,377,399,22,776,29,0.3734965654219113,-0.6343011744635382
571,1563253200,37,46,9,83,29,-0.13632624637899762,-1.6883674024929836
571,1563267600,1699,268,0,1967,29,-0.48928050070270385,1.177232559422565
571,1563282000,1247,397,0,1644,29,-0.48928050070270385,0.6859433939773834
571,1563296400,962,599,0,1561,29,-0.48928050070270385,0.5596988096679404
571,1563310800,966,831,0,1797,29,-0.48928050070270385,0.9186593144514168
571,1563325200,378,391,13,769,29,0.020542311098205118,-0.6449483080799971
571,1563339600,23,34,11,57,29,-0.05789196764039626,-1.7279138987826885
571,1563354000,1658,258,0,1916,29,-0.48928050070270385,1.0996605859312205
571,1563368400,1328,466,0,1794,29,-0.48928050070270385,0.9140962571872201
571,1563382800,911,655,0,1566,29,-0.48928050070270385,0.5673039051082683
571,1563397200,946,799,0,1745,29,-0.48928050070270385,0.8395663218720067
571,1563411600,327,413,86,740,29,2.883393485057155,-0.6890578616338989
571,1563426000,26,35,9,61,29,-0.13632624637899762,-1.7218298224304263
571,1563440400,1591,258,0,1849,29,-0.48928050070270385,0.9977523070308268
571,1563454800,1260,457,0,1717,29,-0.48928050070270385,0.7969777874061705
571,1563469200,924,506,0,1430,29,-0.48928050070270385,0.36044530913134976
571,1563483600,1051,836,0,1887,29,-0.48928050070270385,1.0555510323773187
571,1563498000,381,394,13,775,29,0.020542311098205118,-0.6358221935516037
571,1563512400,34,44,10,78,29,-0.09710910700969694,-1.6959724979333115
571,1563526800,1392,255,0,1647,29,-0.48928050070270385,0.6905064512415802
571,1563541200,1266,418,0,1684,29,-0.48928050070270385,0.7467841575000065
571,1563555600,1034,604,0,1638,29,-0.48928050070270385,0.67681727944899
571,1563570000,1446,818,0,2264,29,-0.48928050070270385,1.6289752285780417
571,1563584400,490,493,3,983,29,-0.37162908259480176,-0.31945022323396355
571,1563598800,55,85,30,140,29,0.6872336803763168,-1.6016693144732457
571,1563613200,298,207,0,505,29,-0.48928050070270385,-1.0464973473293098
571,1563627600,811,581,0,1392,29,-0.48928050070270385,0.30264658378485776
571,1563642000,848,756,0,1604,29,-0.48928050070270385,0.6251026304547602
571,1563656400,852,656,0,1508,29,-0.48928050070270385,0.4790847980004648
571,1563670800,397,512,115,909,29,4.020690526766875,-0.4320056357508163
571,1563685200,35,92,57,127,29,1.7460964433474355,-1.6214425626180982
571,1563699600,173,117,0,290,29,-0.48928050070270385,-1.373516451263409
571,1563714000,703,522,0,1225,29,-0.48928050070270385,0.048636396077906284
571,1563728400,722,696,0,1418,29,-0.48928050070270385,0.3421930800745628
571,1563742800,596,617,21,1213,29,0.33427942605261063,0.030384167021119353
571,1563757200,243,310,67,553,29,2.138267837040442,-0.973488431102162
571,1563771600,30,34,4,64,29,-0.33241194322550105,-1.7172667651662294
571,1563786000,1551,284,0,1835,29,-0.48928050070270385,0.9764580397979087
571,1563800400,1207,422,0,1629,29,-0.48928050070270385,0.6631281076563997
571,1563814800,980,567,0,1547,29,-0.48928050070270385,0.5384045424350223
571,1563829200,833,887,54,1720,29,1.6284450252395335,0.8015408446703673
571,1563843600,326,289,0,615,30,-0.44080823388189516,-0.8827064703839177
571,1563858000,30,32,2,62,30,-0.3631248156158235,-1.7262154383657204
571,1563872400,1646,249,0,1895,30,-0.44080823388189516,1.0697193506227864
571,1563879327,815,175,0,990,30,-0.44080823388189516,-0.31070671813585987
571,1563886800,812,307,0,1119,30,-0.44080823388189516,-0.11393880336252797
571,1563901200,807,523,0,1330,30,-0.44080823388189516,0.20790639056904592
571,1563915600,973,997,24,1970,30,0.49139278531096503,1.184119301072398
571,1563930000,348,326,0,674,30,-0.44080823388189516,-0.79271184269689
571,1563944400,29,30,1,59,30,-0.4019665247488593,-1.7307914363837047
571,1563958800,1716,264,0,1980,30,-0.44080823388189516,1.1993726277990129
571,1563973200,1320,438,0,1758,30,-0.44080823388189516,0.8607487744681626
571,1563987600,1014,548,0,1562,30,-0.44080823388189516,0.5617835706265111
571,1564002000,1011,818,0,1829,30,-0.44080823388189516,0.9690473942271282
571,1564016400,407,448,41,855,30,1.1517018405725743,-0.5166266289451606
571,1564030800,44,42,0,86,30,-0.44080823388189516,-1.6896074542218447
571,1564045200,1743,271,0,2014,30,-0.44080823388189516,1.2512339386695035
571,1564059600,1417,423,0,1840,30,-0.44080823388189516,0.9858260536264045
571,1564074000,970,571,0,1541,30,-0.44080823388189516,0.5297515845006198
571,1564088400,1133,885,0,2018,30,-0.44080823388189516,1.2573352693601494
571,1564102800,369,477,108,846,30,3.7540963524859756,-0.5303546229991141
571,1564117200,37,55,18,92,30,0.25834253051274997,-1.6804554581858757
571,1564131600,1379,246,0,1625,30,-0.44080823388189516,0.6578795290041848
571,1564146000,1237,535,0,1772,30,-0.44080823388189516,0.8821034318854234
571,1564160400,1125,597,0,1722,30,-0.44080823388189516,0.805836798252349
571,1564174800,1168,590,0,1758,30,-0.44080823388189516,0.8607487744681626
571,1564189200,480,469,0,949,30,-0.44080823388189516,-0.37324535771498085
571,1564203600,46,97,51,143,30,1.5401189319029327,-1.60266349188014
571,1564218000,275,202,0,477,30,-0.44080823388189516,-1.093202379211203
571,1564232400,930,584,0,1514,30,-0.44080823388189516,0.4885676023387596
571,1564246800,956,745,0,1701,30,-0.44080823388189516,0.7738048121264578
571,1564261200,891,713,0,1604,30,-0.44080823388189516,0.6258475428782935
571,1564275600,428,505,77,933,30,2.5500033693618644,-0.39765068047756463
571,1564290000,35,89,54,124,30,1.6566440593020404,-1.6316448126607082
571,1564304400,182,158,0,340,30,-0.44080823388189516,-1.3021729553658268
571,1564318800,776,520,0,1296,30,-0.44080823388189516,0.15604507969855533
571,1564333200,852,585,0,1437,30,-0.44080823388189516,0.3711169865438251
571,1564347600,656,633,0,1289,30,-0.44080823388189516,0.1453677509899249
571,1564362000,265,355,90,620,30,3.0549455880913303,-0.8750798070206103
571,1564376400,25,35,10,60,30,-0.05239114255153674,-1.7292661037110433
571,1564390800,1506,260,0,1766,30,-0.44080823388189516,0.8729514358494544
571,1564405200,1193,464,0,1657,30,-0.44080823388189516,0.7066901745293523
571,1564419600,902,595,0,1497,30,-0.44080823388189516,0.4626369469035143
571,1564434000,949,961,12,1910,30,0.02529227571453494,1.0925993407127088
571,1564448400,340,347,7,687,31,-0.10911229991117963,-0.916377296878766
571,1564462800,24,36,12,60,31,0.20086582483648982,-1.8813251759983856
571,1564477200,1653,264,0,1917,31,-0.5430816745579169,0.976582657375033
571,1564491600,1276,367,0,1643,31,-0.5430816745579169,0.5548988952079266
571,1564506000,983,590,0,1573,31,-0.5430816745579169,0.44716946691706
571,1564520400,1060,841,0,1901,31,-0.5430816745579169,0.9519587880514064
571,1564534800,356,409,53,765,31,2.7426864477673796,-0.7963359339260861
571,1564549200,27,37,10,64,31,0.07687457493742203,-1.875169208667479
571,1564563600,1660,253,0,1913,31,-0.5430816745579169,0.9704266900441264
571,1564578000,1338,497,0,1835,31,-0.5430816745579169,0.8503853270914464
571,1564592400,975,566,0,1541,31,-0.5430816745579169,0.39792172826980665
571,1564606800,1011,859,0,1870,31,-0.5430816745579169,0.9042500412368798
571,1564621200,384,420,36,804,31,1.6887608236253033,-0.7363152524497462
571,1564635600,18,40,22,58,31,0.8208220743318287,-1.8844031596638389
571,1564647980,950,175,0,1125,31,-0.5430816745579169,-0.24229887414448636
571,1564650000,1151,304,0,1455,31,-0.5430816745579169,0.2655684306553134
571,1564664400,1258,507,0,1765,31,-0.5430816745579169,0.7426558988005798
571,1564678800,993,585,0,1578,31,-0.5430816745579169,0.45486442608069333
571,1564693200,1038,880,0,1918,31,-0.5430816745579169,0.9781216492077598
571,1564707600,375,429,54,804,31,2.804682072716913,-0.7363152524497462
571,1564722000,26,51,25,77,31,1.0068089491804304,-1.8551623148420322
571,1564736400,1410,268,0,1678,31,-0.5430816745579169,0.6087636093533599
571,1564750800,1200,419,0,1619,31,-0.5430816745579169,0.5179630912224866
571,1564765200,929,670,0,1599,31,-0.5430816745579169,0.4871832545679533
571,1564779600,1161,651,0,1812,31,-0.5430816745579169,0.8149885149387331
571,1565398800,7502,8566,1064,16068,32,4.063339741407781,4.063236687168295
571,1565413200,45,106,61,151,32,-0.09442129301616356,-0.496892462744703
571,1565427600,299,193,0,492,32,-0.34728612163018213,-0.39919791979563396
571,1565442000,900,505,0,1405,32,-0.34728612163018213,-0.13762865964167484
571,1565456400,950,685,0,1635,32,-0.34728612163018213,-0.07173497964670159
571,1565470800,938,612,0,1550,32,-0.34728612163018213,-0.09608699181875692
571,1565485200,394,515,121,909,32,0.15429821053860882,-0.27972981302213895
571,1565499600,23,88,65,111,32,-0.07783999277917873,-0.5083522331786113
571,1565514000,176,110,0,286,32,-0.34728612163018213,-0.4582157375302622
571,1565528400,815,476,0,1291,32,-0.34728612163018213,-0.17028900537831376
571,1565542800,675,653,0,1328,32,-0.34728612163018213,-0.1596887177269485
571,1565557200,675,651,0,1326,32,-0.34728612163018213,-0.16026170624864391
571,1565571600,273,345,72,618,32,-0.048822717364455294,-0.3630996429288225
571,1565586000,26,33,7,59,32,-0.3182688462154587,-0.5232499347426923
571,1565600400,1498,250,0,1748,32,-0.34728612163018213,-0.039361128170910364
571,1565614800,1203,443,0,1646,32,-0.34728612163018213,-0.06858354277737677
571,1565629200,884,632,0,1516,32,-0.34728612163018213,-0.10582779668757905
571,1565643600,840,958,118,1798,32,0.1418622353608702,-0.025036415128524874
571,1565658000,325,337,12,662,33,0.7482337321992458,-0.746610001199645
571,1565672400,23,38,15,61,33,1.0322019558652247,-1.637712637271395
571,1565686800,1576,285,0,1861,33,-0.38763916246466945,1.0311471712629643
571,1565701200,1221,457,0,1678,33,-0.38763916246466945,0.7598130907286378
571,1565715600,945,588,0,1533,33,-0.38763916246466945,0.5448216061522588
571,1565730000,979,838,0,1817,33,-0.38763916246466945,0.9659083759432355
571,1565744400,352,327,0,679,33,-0.38763916246466945,-0.7214041030079317
571,1565758800,28,40,12,68,33,0.7482337321992458,-1.6273337380159836
571,1565773200,1581,269,0,1850,33,-0.38763916246466945,1.0148374724330322
571,1565787600,1268,479,0,1747,33,-0.38763916246466945,0.8621193833891216
571,1565802000,974,576,0,1550,33,-0.38763916246466945,0.5700275043439722
571,1565816400,839,751,0,1590,33,-0.38763916246466945,0.6293355000891803
571,1565830800,1398,1263,0,2661,33,-0.38763916246466945,2.217307086167124
571,1565845200,27,25,0,52,33,-0.38763916246466945,-1.6510569363140668
571,1565859600,1528,217,0,1745,33,-0.38763916246466945,0.8591539836018612
571,1565874000,1222,579,0,1801,33,-0.38763916246466945,0.9421851776451524
571,1565888400,1031,595,0,1626,33,-0.38763916246466945,0.6827126962598674
571,1565902800,1043,806,0,1849,33,-0.38763916246466945,1.0133547725394019
571,1565917200,373,407,34,780,33,2.830667372416424,-0.5716514137512815
571,1565931600,24,43,19,67,33,1.4108262540865297,-1.628816437909614
571,1565946000,1278,222,0,1500,33,-0.38763916246466945,0.4958925096624623
571,1565960400,1129,478,0,1607,33,-0.38763916246466945,0.6545413982808936
571,1565974800,1092,515,0,1607,33,-0.38763916246466945,0.6545413982808936
571,1565989200,948,759,0,1707,33,-0.38763916246466945,0.8028113876439136
571,1566003600,402,359,0,761,33,-0.38763916246466945,-0.5998227117302553
571,1566018000,57,73,16,130,33,1.1268580304205509,-1.5354063446109112
571,1566032400,265,129,0,394,33,-0.38763916246466945,-1.1439735726925386
571,1566046800,907,385,0,1292,33,-0.38763916246466945,0.18749093178738074
571,1566061200,923,551,0,1474,33,-0.38763916246466945,0.4573423124280771
571,1566075600,833,525,0,1358,33,-0.38763916246466945,0.28534912476697394
571,1566090000,430,346,0,776,33,-0.38763916246466945,-0.5775822133258023
571,1566104400,24,79,55,103,33,4.818444938078276,-1.5754392417389267
571,1566118800,166,77,0,243,33,-0.38763916246466945,-1.3678612566306987
571,1566133200,747,329,0,1076,33,-0.38763916246466945,-0.1327722452367424
571,1566147600,770,512,0,1282,33,-0.38763916246466945,0.17266393285107876
571,1566162000,555,564,9,1119,33,0.464265508533267,-0.0690161498106438
571,1566176400,230,197,0,427,33,-0.38763916246466945,-1.095044476202742
571,1566190800,23,23,0,46,33,-0.38763916246466945,-1.6599531356758481
571,1566205200,1455,244,0,1699,33,-0.38763916246466945,0.790949788494872
571,1566219600,1135,434,0,1569,33,-0.38763916246466945,0.5981988023229461
571,1566234000,939,507,0,1446,33,-0.38763916246466945,0.4158267154064315
571,1566248400,924,736,0,1660,33,-0.38763916246466945,0.7331244926432943
571,1566262800,327,321,0,648,34,-0.39910716491746673,-0.7312973536539173
571,1566277200,20,28,8,48,34,0.29933037368810006,-1.6860529910012756
571,1566291600,1583,257,0,1840,34,-0.39910716491746673,1.165483845876168
571,1566306000,1251,355,0,1606,34,-0.39910716491746673,0.7931291473106983
571,1566320400,957,582,0,1539,34,-0.39910716491746673,0.6865147678069099
571,1566334800,987,951,0,1938,34,-0.39910716491746673,1.3214272666429032
571,1566349200,340,395,55,735,34,4.402650912995805,-0.5928577862385503
571,1566363600,26,31,5,57,34,0.03741629671101253,-1.6717316564410654
571,1566378000,1562,238,0,1800,34,-0.39910716491746673,1.1018334700530108
571,1566392400,1301,448,0,1749,34,-0.39910716491746673,1.0206792408784853
571,1566406800,984,468,0,1452,34,-0.39910716491746673,0.548075200391543
571,1566421200,951,779,0,1730,34,-0.39910716491746673,0.9904453123624857
571,1566435600,335,349,14,684,34,0.8231585276422752,-0.6740120154130758
571,1566450000,29,27,0,56,34,-0.39910716491746673,-1.6733229158366443
571,1566464400,1542,215,0,1757,34,-0.39910716491746673,1.0334093160431168
571,1566478800,1195,380,0,1575,34,-0.39910716491746673,0.7438001060477515
571,1566493200,966,478,0,1444,34,-0.39910716491746673,0.5353451252269116
571,1566507600,989,836,0,1825,34,-0.39910716491746673,1.141614954942484
571,1566522000,342,325,0,667,34,-0.39910716491746673,-0.7010634251379176
571,1566536400,27,33,6,60,34,0.12472098903670838,-1.6669578782543286
571,1566550800,1251,251,0,1502,34,-0.39910716491746673,0.6276381701704895
571,1566565200,1207,386,0,1593,34,-0.39910716491746673,0.7724427751681722
571,1566579600,1036,603,0,1639,34,-0.39910716491746673,0.845640707364803
571,1566594000,1079,695,0,1774,34,-0.39910716491746673,1.0604607257679586
571,1566608400,408,366,0,774,34,-0.39910716491746673,-0.530798669810972
571,1566622800,41,79,38,120,34,2.9184711434589756,-1.5714823145195926
571,1566637200,278,136,0,414,34,-0.39910716491746673,-1.1036520522193871
571,1566651600,884,371,0,1255,34,-0.39910716491746673,0.23459709946249363
571,1566666000,909,529,0,1438,34,-0.39910716491746673,0.525797568853438
571,1566680400,835,564,0,1399,34,-0.39910716491746673,0.46373845242585965
571,1566694800,405,392,0,797,34,-0.39910716491746673,-0.49419970371265665
571,1566709200,45,75,30,120,34,2.220033604853409,-1.5714823145195926
571,1566723600,178,100,0,278,34,-0.39910716491746673,-1.3200633300181217
571,1566738000,766,357,0,1123,34,-0.39910716491746673,0.024550859246074776
571,1566752400,751,520,0,1271,34,-0.39910716491746673,0.26005724979175654
571,1566766800,562,504,0,1066,34,-0.39910716491746673,-0.06615092630192428
571,1566781200,239,201,0,440,34,-0.39910716491746673,-1.062279307934335
571,1566795600,22,35,13,57,34,0.7358538353165793,-1.6717316564410654
571,1566810000,1370,211,0,1581,34,-0.39910716491746673,0.753347662421225
571,1566824400,1090,419,0,1509,34,-0.39910716491746673,0.638776985939542
571,1566838800,908,531,0,1439,34,-0.39910716491746673,0.5273888282490169
571,1566853200,848,871,23,1719,34,1.608900758573538,0.9729414590111175
571,1566867600,290,302,12,592,35,0.14863316966017684,-0.71459920841456
571,1566882000,22,27,5,49,35,-0.24152890069778743,-1.6068603388335285
571,1566896400,1562,253,0,1815,35,-0.5202160938106191,1.2950423431552347
571,1566910800,1162,392,0,1554,35,-0.5202160938106191,0.8661654462135204
571,1566925200,1013,444,0,1457,35,-0.5202160938106191,0.7067744155493585
571,1566939600,968,988,20,1956,35,0.5945326786407074,1.5267344598938617
571,1566954000,329,336,7,665,35,-0.1300540234526548,-0.5946451337910155
571,1566968400,23,35,12,58,35,0.14863316966017684,-1.5920714803182971
571,1566982800,1529,218,0,1747,35,-0.5202160938106191,1.183304301040152
571,1566997200,1243,392,0,1635,35,-0.5202160938106191,0.9992651728506041
571,1567011600,982,607,0,1589,35,-0.5202160938106191,0.9236776737727541
571,1567026000,916,925,9,1841,35,-0.01857914620752214,1.3377657121992368
571,1567040400,330,401,71,731,35,3.43714204839159,-0.48619350467931766
571,1567054800,21,34,13,55,35,0.20437060828274314,-1.5970010998233743
571,1567069200,1451,253,0,1704,35,-0.5202160938106191,1.1126464214673792
571,1567083600,1335,372,0,1707,35,-0.5202160938106191,1.1175760409724564
571,1567098000,999,497,0,1496,35,-0.5202160938106191,0.7708594691153617
571,1567112400,971,786,0,1757,35,-0.5202160938106191,1.199736366057076
571,1567126800,333,386,53,719,35,2.433868153185396,-0.5059119826996263
571,1567141200,22,49,27,71,35,0.9846947489986716,-1.5707097957962959
571,1567155600,1061,253,0,1314,35,-0.5202160938106191,0.4717958858073465
571,1567170000,1161,374,0,1535,35,-0.5202160938106191,0.834944522681365
571,1567184400,1080,583,0,1663,35,-0.5202160938106191,1.0452749548979912
571,1567198800,1045,504,0,1549,35,-0.5202160938106191,0.8579494137050585
571,1567213200,381,366,0,747,35,-0.5202160938106191,-0.4599022006522394
571,1567227600,51,79,28,130,35,1.040432187621238,-1.4737606121964448
571,1567242000,272,141,0,413,35,-0.5202160938106191,-1.0087331722174981
571,1567256400,846,362,0,1208,35,-0.5202160938106191,0.297615996627953
571,1567270800,809,613,0,1422,35,-0.5202160938106191,0.6492621879901248
571,1567285200,729,514,0,1243,35,-0.5202160938106191,0.3551282241871867
571,1567299600,363,343,0,706,35,-0.5202160938106191,-0.5272736672216275
571,1567314000,28,83,55,111,35,2.5453430304305287,-1.5049815357286003
571,1567328400,158,88,0,246,35,-0.5202160938106191,-1.2831486580001275
571,1567342800,748,359,0,1107,35,-0.5202160938106191,0.1316521399570215
571,1567357200,748,494,0,1242,35,-0.5202160938106191,0.35348501768549434
571,1567371600,631,507,0,1138,35,-0.5202160938106191,0.18259154150948564
571,1567386000,284,341,57,625,35,2.656817907675661,-0.6603733938587112
571,1567400400,20,43,23,63,35,0.7617449945084064,-1.583855447809835
571,1567414800,167,104,0,271,35,-0.5202160938106191,-1.2420684954578176
571,1567429200,569,433,0,1002,35,-0.5202160938106191,-0.040884542720679595
571,1567443600,670,492,0,1162,35,-0.5202160938106191,0.22202849755010304
571,1567458000,581,453,0,1034,35,-0.5202160938106191,0.011698065333476929
571,1567472400,245,228,0,473,36,-0.3618640518178363,-1.0663307711927585
571,1567486800,22,23,1,45,36,-0.3073898934796674,-1.6869673890642505
571,1567501200,1584,272,0,1856,36,-0.3618640518178363,0.9391375524433939
571,1567515600,1188,377,0,1565,36,-0.3618640518178363,0.5171626557130105
571,1567530000,961,554,0,1515,36,-0.3618640518178363,0.44465837792428475
571,1567544400,858,750,0,1608,36,-0.3618640518178363,0.5795163346113146
571,1567558800,310,295,0,605,36,-0.3618640518178363,-0.8749194778305227
571,1567573200,26,36,10,62,36,0.18287753156385272,-1.6623159346160836
571,1567587600,1657,269,0,1926,36,-0.3618640518178363,1.0406435413476098
571,1567602000,1313,377,0,1690,36,-0.3618640518178363,0.6984233501848247
571,1567616400,1045,546,0,1591,36,-0.3618640518178363,0.5548648801631478
571,1567630800,1013,852,0,1865,36,-0.3618640518178363,0.9521883224453646
571,1567645200,308,368,60,676,36,2.9065854484722977,-0.7719634033705323
571,1567659600,16,28,12,44,36,0.29182584824019053,-1.688417474620025
571,1567674000,1744,284,0,2028,36,-0.3618640518178363,1.1885522680366103
571,1567688400,1328,369,0,1697,36,-0.3618640518178363,0.7085739490752463
571,1567702800,1027,580,0,1607,36,-0.3618640518178363,0.57806624905554
571,1567717200,1091,818,0,1909,36,-0.3618640518178363,1.0159920868994432
571,1567731600,354,445,91,799,36,4.595284356955534,-0.5936028800102671
571,1567746000,36,34,0,70,36,-0.3618640518178363,-1.6507152501698876
571,1567760400,1492,326,0,1818,36,-0.3618640518178363,0.8840343013239624
571,1567774800,1333,414,0,1747,36,-0.3618640518178363,0.781078226863972
571,1567789200,1000,675,0,1675,36,-0.3618640518178363,0.6766720668482069
571,1567803600,1199,713,0,1912,36,-0.3618640518178363,1.0203423435667667
571,1567818000,453,376,0,829,36,-0.3618640518178363,-0.5501003133370317
571,1567832400,50,87,37,137,36,1.6536798066944132,-1.553559517932995
571,1567846800,341,130,0,471,36,-0.3618640518178363,-1.0692309423043076
571,1567861200,1104,375,0,1479,36,-0.3618640518178363,0.39245529791640227
571,1567875600,1257,653,0,1910,36,-0.3618640518178363,1.0174421724552176
571,1567890000,1082,626,0,1708,36,-0.3618640518178363,0.7245248901887659
571,1567904400,506,444,0,950,36,-0.3618640518178363,-0.3746399610883155
571,1567918800,64,88,24,152,36,0.9455157482982175,-1.5318082345963775
571,1567933200,202,133,0,335,36,-0.3618640518178363,-1.2664425778896413
571,1567947600,914,454,0,1368,36,-0.3618640518178363,0.23149580122543126
571,1567962000,795,680,0,1475,36,-0.3618640518178363,0.3866549556933042
571,1567976400,661,705,44,1366,36,2.0349989150615952,0.22859563011388223
571,1567990800,261,231,0,492,36,-0.3618640518178363,-1.0387791456330429
571,1568005200,19,15,0,34,36,-0.3618640518178363,-1.70291833017777
571,1568019600,1843,269,0,2112,36,-0.3618640518178363,1.3103594547216695
571,1568034000,1324,374,0,1698,36,-0.3618640518178363,0.7100240346310208
571,1568048400,1070,520,0,1590,36,-0.3618640518178363,0.5534147946073733
571,1568062800,1026,836,0,1862,36,-0.3618640518178363,0.947838065778041
571,1568077200,303,348,45,651,37,0.6706250112106295,-0.889255471535007
571,1568091600,24,21,0,45,37,-0.3935910015417548,-1.7492824602308688
571,1568106000,1874,289,0,2163,37,-0.3935910015417548,1.2565544408546683
571,1568120400,1441,375,0,1816,37,-0.3935910015417548,0.7640967427070378
571,1568134800,1037,537,0,1574,37,-0.3935910015417548,0.4206536218086903
571,1568149200,1115,864,0,1979,37,-0.3935910015417548,0.9954241340559248
571,1568163600,355,362,7,717,37,-0.22804628844693947,-0.7955891658354576
571,1568178000,23,34,11,57,37,-0.13344930953561643,-1.7322522228309507
571,1568192400,1773,288,0,2061,37,-0.3935910015417548,1.1117974229553649
571,1568206800,1375,374,0,1749,37,-0.3935910015417548,0.6690112505574953
571,1568221200,1049,547,0,1596,37,-0.3935910015417548,0.45187572370854007
571,1568235600,1075,856,0,1931,37,-0.3935910015417548,0.9273031844562525
571,1568250000,441,692,251,1133,37,5.542369425143766,-0.20520760263829832
571,1568264400,24,36,12,60,37,-0.10980006480778566,-1.7279946634809713
571,1568278800,1794,303,0,2097,37,-0.3935910015417548,1.162888135155119
571,1568293200,1372,357,0,1729,37,-0.3935910015417548,0.6406275215576319
571,1568307600,1068,512,0,1580,37,-0.3935910015417548,0.42916874050864934
571,1568322000,1133,811,0,1944,37,-0.3935910015417548,0.9457526083061637
571,1568336400,355,435,80,790,37,1.4983485766847062,-0.6919885549859561
571,1568350800,29,31,2,60,37,-0.3462925120860933,-1.7279946634809713
571,1568365200,1694,278,0,1972,37,-0.3935910015417548,0.9854898289059726
571,1568379600,1287,370,0,1657,37,-0.3935910015417548,0.5384460971581235
571,1568394000,1052,640,0,1692,37,-0.3935910015417548,0.5881176229078845
571,1568408400,1317,650,0,1967,37,-0.3935910015417548,0.9783938966560067
571,1568422800,477,508,31,985,37,0.3395355850209988,-0.4152471972372877
571,1568437200,48,86,38,134,37,0.5050802981158141,-1.6229748661814767
571,1568451600,334,194,0,528,37,-0.3935910015417548,-1.063815404884167
571,1568466000,971,617,0,1588,37,-0.3935910015417548,0.4405222321085947
571,1568480400,1124,751,0,1875,37,-0.3935910015417548,0.8478287432566349
571,1568494800,1047,767,0,1814,37,-0.3935910015417548,0.7612583698070514
571,1568509200,475,512,37,987,37,0.48143105338798337,-0.41240882433730136
571,1568523600,38,105,67,143,37,1.1909083952229063,-1.610202188131538
571,1568538000,211,161,0,372,37,-0.3935910015417548,-1.2852084910831019
571,1568552400,876,562,0,1438,37,-0.3935910015417548,0.22764426460961898
571,1568566800,939,769,0,1708,37,-0.3935910015417548,0.6108246061077752
571,1568581200,643,687,44,1330,37,0.6469757664827988,0.07437212801035646
571,1568595600,255,324,69,579,37,1.2382068846785679,-0.9914368959345153
571,1568610000,27,32,5,59,37,-0.275344777902601,-1.7294138499309644
571,1568624400,1735,288,0,2023,37,-0.3935910015417548,1.0578683378556242
571,1568638800,1273,398,0,1671,37,-0.3935910015417548,0.5583147074580279
571,1568653200,1015,507,0,1522,37,-0.3935910015417548,0.3468559264090454
571,1568667600,1036,847,0,1883,37,-0.3935910015417548,0.8591822348565803
571,1568682000,337,345,8,682,38,-0.15107089516356956,-0.8334095890039656
571,1568696400,24,33,9,57,38,-0.12114175555569257,-1.7206627711167162
571,1568710800,1825,291,0,2116,38,-0.39050401202658547,1.2023041120355296
571,1568725200,1252,545,0,1797,38,-0.39050401202658547,0.7494500878851815
571,1568739600,1094,486,0,1580,38,-0.39050401202658547,0.44139578305563454
571,1568754000,1086,871,0,1957,38,-0.39050401202658547,0.9765869025060457
571,1568768400,349,436,87,785,38,2.2133311338587127,-0.6871902645917842
571,1568782800,17,36,19,53,38,0.17814964052307733,-1.7263411914822377
571,1568797200,1772,285,0,2057,38,-0.39050401202658547,1.1185474116440859
571,1568811600,1271,391,0,1662,38,-0.39050401202658547,0.5578034005488275
571,1568826000,1032,525,0,1557,38,-0.39050401202658547,0.4087448659538853
571,1568840400,1099,858,0,1957,38,-0.39050401202658547,0.9765869025060457
571,1568854800,323,509,186,832,38,5.176315955038535,-0.6204688252969054
571,1568869200,32,32,0,64,38,-0.39050401202658547,-1.7107255354770534
571,1568883600,1694,281,0,1975,38,-0.39050401202658547,1.002139794150893
571,1568898000,1294,357,0,1651,38,-0.39050401202658547,0.542187744543643
571,1568912400,1033,523,0,1556,38,-0.39050401202658547,0.4073252608625049
571,1568926800,1161,747,0,1908,38,-0.39050401202658547,0.9070262530284061
571,1568941200,378,428,50,806,38,1.105952968367264,-0.6573785576727958
571,1568955600,30,43,13,73,38,-0.0014251971241846136,-1.6979490896546299
571,1568970000,1672,281,0,1953,38,-0.39050401202658547,0.9709084821405242
571,1568984400,1368,368,0,1736,38,-0.39050401202658547,0.6628541773109771
571,1568998800,1162,622,0,1784,38,-0.39050401202658547,0.7309952216972364
571,1569013200,1327,715,0,2042,38,-0.39050401202658547,1.0972533352733798
571,1569027600,519,489,0,1008,38,-0.39050401202658547,-0.3706183292139548
571,1569042000,44,72,28,116,38,0.4475118969939702,-1.6369060707252725
571,1569056400,313,190,0,503,38,-0.39050401202658547,-1.0875189003610573
571,1569070800,1014,594,0,1608,38,-0.39050401202658547,0.4811447256142858
571,1569085200,1151,747,0,1898,38,-0.39050401202658547,0.8928302021146021
571,1569099600,1098,671,0,1769,38,-0.39050401202658547,0.7097011453265304
571,1569114000,460,459,0,919,38,-0.39050401202658547,-0.49696318234681053
571,1569128400,35,102,67,137,38,1.6147483417011728,-1.6070943638062842
571,1569142800,201,125,0,326,38,-0.39050401202658547,-1.3387890015353883
571,1569157200,847,565,0,1412,38,-0.39050401202658547,0.20290212770372718
571,1569171600,896,770,0,1666,38,-0.39050401202658547,0.5634818209143491
571,1569186000,705,737,32,1442,38,0.5672284554254782,0.2454902804451392
571,1569200400,275,324,49,599,38,1.0760238287593868,-0.9512368115885389
571,1569214800,26,15,0,41,38,-0.39050401202658547,-1.7433764525788027
571,1569229200,1693,275,0,1968,38,-0.39050401202658547,0.9922025585112302
571,1569243600,1241,415,0,1656,38,-0.39050401202658547,0.549285770000545
571,1569258000,1064,579,0,1643,38,-0.39050401202658547,0.5308309038125998
571,1569272400,1040,910,0,1950,38,-0.39050401202658547,0.9666496668663829
571,1569286800,351,338,0,689,39,-0.4235663806475795,-0.8573452422161705
571,1569301200,30,30,0,60,39,-0.4235663806475795,-1.7754751465036076
571,1569315600,1791,277,0,2068,39,-0.4235663806475795,1.1555341504903096
571,1569330000,1298,368,0,1666,39,-0.4235663806475795,0.5687484246977027
571,1569344400,997,642,0,1639,39,-0.4235663806475795,0.5293374431146172
571,1569358800,1098,901,0,1999,39,-0.4235663806475795,1.0548171975557576
571,1569373200,337,385,48,722,39,1.3741385106903579,-0.8091762647257326
571,1569387600,13,40,27,53,39,0.5876426207300103,-1.7856928083955188
571,1569402000,1830,282,0,2112,39,-0.4235663806475795,1.2197594538108936
571,1569416400,1328,409,0,1737,39,-0.4235663806475795,0.6723847096013721
571,1569430800,1117,603,0,1720,39,-0.4235663806475795,0.6475703878638738
571,1569445200,1247,879,0,2126,39,-0.4235663806475795,1.2401947775947155
571,1569459600,346,437,91,783,39,2.98458247584726,-0.7201366396676504
571,1569474000,22,33,11,55,39,-0.011592343049302201,-1.7827734764264014
571,1569488400,1781,298,0,2079,39,-0.4235663806475795,1.1715904763204557
571,1569502800,1391,413,0,1804,39,-0.4235663806475795,0.7701823305668065
571,1569517200,1084,585,0,1669,39,-0.4235663806475795,0.5731274226513788
571,1569531600,1202,802,0,2004,39,-0.4235663806475795,1.0621155274785514
571,1569546000,250,276,26,526,39,0.5501904354938032,-1.0952707976992424
571,1569560400,407,540,133,947,39,4.557574255767955,-0.4807514182000197
571,1569574800,1583,272,0,1855,39,-0.4235663806475795,0.8446252957793015
571,1569589200,1401,378,0,1779,39,-0.4235663806475795,0.7336906809528385
571,1569603600,1110,581,0,1691,39,-0.4235663806475795,0.6052400743116708
571,1569618000,1381,754,0,2135,39,-0.4235663806475795,1.2533317714557441
571,1569632400,448,463,15,911,39,0.13821639789552592,-0.5332993936441338
571,1569646800,40,80,40,120,39,1.0745210288007017,-1.6878951874300843
571,1569661200,288,213,0,501,39,-0.4235663806475795,-1.1317624473132104
571,1569675600,1022,541,0,1563,39,-0.4235663806475795,0.4184028282881541
571,1569690000,1129,752,0,1881,39,-0.4235663806475795,0.8825766113778283
571,1569704400,1135,610,0,1745,39,-0.4235663806475795,0.6840620374778419
571,1569718800,588,527,0,1115,39,-0.4235663806475795,-0.23552753279415412
571,1569733200,46,97,51,143,39,1.4864950663989789,-1.6543228697852337
571,1569747600,221,147,0,368,39,-0.4235663806475795,-1.3258980232595208
571,1569762000,891,569,0,1460,39,-0.4235663806475795,0.2680572318786056
571,1569776400,945,686,0,1631,39,-0.4235663806475795,0.5176601152381474
571,1569790800,710,694,0,1404,39,-0.4235663806475795,0.18631593674331706
571,1569805200,288,321,33,609,39,0.8123557321472524,-0.9741185209808684
571,1569819600,25,25,0,50,39,-0.4235663806475795,-1.790071806349195
571,1569834000,1360,214,0,1574,39,-0.4235663806475795,0.4344591541183001
571,1569848400,1103,392,0,1495,39,-0.4235663806475795,0.3191455413381609
571,1569862800,929,540,0,1469,39,-0.4235663806475795,0.2811942257396341
571,1569877200,896,754,0,1650,39,-0.4235663806475795,0.5453937689447631
571,1569891600,353,291,0,644,40,-0.4004628931745945,-0.8788461740777026
571,1569906000,27,25,0,52,40,-0.4004628931745945,-1.7153042690198248
571,1569920400,1524,268,0,1792,40,-0.4004628931745945,0.743204320843845
571,1569934800,1287,404,0,1691,40,-0.4004628931745945,0.6004977877540573
571,1569949200,1094,524,0,1618,40,-0.4004628931745945,0.49735346185747803
571,1569963600,1041,805,0,1846,40,-0.4004628931745945,0.8195028632878899
571,1569978000,328,360,32,688,40,1.1732860203536366,-0.8166769913455179
571,1569992400,25,27,2,52,40,-0.30210358607908006,-1.7153042690198248
571,1570006800,1771,302,0,2073,40,-0.4004628931745945,1.1402393287471158
571,1570021200,1346,380,0,1726,40,-0.4004628931745945,0.6499505467455678
571,1570035600,1095,566,0,1661,40,-0.4004628931745945,0.5581097086184768
571,1570050000,1126,847,0,1973,40,-0.4004628931745945,0.9989457316285141
571,1570064400,334,422,88,756,40,3.927346619028041,-0.7205973453048687
571,1570078800,26,26,0,52,40,-0.4004628931745945,-1.7153042690198248
571,1570093200,1725,250,0,1975,40,-0.4004628931745945,1.0017716035708861
571,1570107600,1356,493,0,1849,40,-0.4004628931745945,0.8237416712014479
571,1570122000,1053,504,0,1557,40,-0.4004628931745945,0.411164367615131
571,1570136400,1120,948,0,2068,40,-0.4004628931745945,1.1331746488911858
571,1570150800,366,444,78,810,40,3.435550083550469,-0.6442988028608237
571,1570165200,27,40,13,67,40,0.23887260294624937,-1.6941102294520345
571,1570179600,1582,261,0,1843,40,-0.4004628931745945,0.8152640553743319
571,1570194000,1334,422,0,1756,40,-0.4004628931745945,0.6923386258811484
571,1570208400,1162,589,0,1751,40,-0.4004628931745945,0.6852739460252183
571,1570222800,1288,673,0,1961,40,-0.4004628931745945,0.9819904999742819
571,1570237200,464,499,35,963,40,1.3208249809969081,-0.42811959926936316
571,1570251600,46,88,42,134,40,1.665082555831209,-1.5994435193825713
571,1570266000,317,194,0,511,40,-0.4004628931745945,-1.066766658245443
571,1570280400,1078,550,0,1628,40,-0.4004628931745945,0.5114828215693382
571,1570294800,1179,828,0,2007,40,-0.4004628931745945,1.0469855546488387
571,1570309200,1095,777,0,1872,40,-0.4004628931745945,0.8562391985387263
571,1570323600,526,530,4,1056,40,-0.2037442789835656,-0.2967165539490636
571,1570338000,49,95,46,144,40,1.8618011700222379,-1.5853141596707112
571,1570352400,199,110,0,309,40,-0.4004628931745945,-1.3521797244250184
571,1570366800,923,483,0,1406,40,-0.4004628931745945,0.19781103596604238
571,1570381200,963,732,0,1695,40,-0.4004628931745945,0.6061495316388014
571,1570395600,704,696,0,1400,40,-0.4004628931745945,0.1893334201389263
571,1570410000,290,272,0,562,40,-0.4004628931745945,-0.9947069237149561
571,1570424400,20,22,2,42,40,-0.30210358607908006,-1.729433628731685
571,1570438800,1723,301,0,2024,40,-0.4004628931745945,1.071005466159001
571,1570453200,1220,399,0,1619,40,-0.4004628931745945,0.49876639782866405
571,1570467600,1060,535,0,1595,40,-0.4004628931745945,0.46485593452019963
571,1570482000,1113,831,0,1944,40,-0.4004628931745945,0.9579705884641195
571,1570496400,365,268,0,633,41,-0.3160110723862216,-0.8738008431703315
571,1570510800,25,28,3,53,41,-0.13502291274684017,-1.7240420470700426
571,1570525200,1772,296,0,2068,41,-0.3160110723862216,1.229813169926368
571,1570539600,1319,471,0,1790,41,-0.3160110723862216,0.8222837652985753
571,1570554000,1053,670,0,1723,41,-0.3160110723862216,0.7240662469170569
571,1570568400,1068,860,0,1928,41,-0.3160110723862216,1.0245825345022996
571,1570582800,359,316,0,675,41,-0.3160110723862216,-0.8122316525431109
571,1570597200,24,24,0,48,41,-0.3160110723862216,-1.7313717126209023
571,1570611600,1445,236,0,1681,41,-0.3160110723862216,0.6624970562898365
571,1570626000,1165,448,0,1613,41,-0.3160110723862216,0.5628136047981461
571,1570640400,957,600,0,1557,41,-0.3160110723862216,0.48072135062851884
571,1570654800,941,805,0,1746,41,-0.3160110723862216,0.7577827084510109
571,1570669200,352,279,0,631,41,-0.3160110723862216,-0.8767327093906753
571,1570683600,36,20,0,56,41,-0.3160110723862216,-1.7196442477395268
571,1570698000,1753,283,0,2036,41,-0.3160110723862216,1.1829033104008666
571,1570712400,1379,345,0,1724,41,-0.3160110723862216,0.7255321800272287
571,1570726800,1056,640,0,1696,41,-0.3160110723862216,0.6844860529424152
571,1570741200,1216,815,0,2031,41,-0.3160110723862216,1.175573644850007
571,1570755600,433,361,0,794,41,-0.3160110723862216,-0.637785612432653
571,1570770000,24,40,16,64,41,0.6492591123571463,-1.7079167828581516
571,1570784400,1552,278,0,1830,41,-0.3160110723862216,0.8809210897054519
571,1570798800,1331,441,0,1772,41,-0.3160110723862216,0.7958969693154807
571,1570813200,1108,549,0,1657,41,-0.3160110723862216,0.6273146616457105
571,1570827600,1290,760,0,2050,41,-0.3160110723862216,1.2034263739432733
571,1570842000,475,495,20,970,41,0.8905766585429883,-0.3797813850423958
571,1570856400,52,69,17,121,41,0.7095884989036068,-1.6243585955783524
571,1570870800,320,188,0,508,41,-0.3160110723862216,-1.057042481941821
571,1570885200,1092,501,0,1593,41,-0.3160110723862216,0.5334949425947079
571,1570899600,1079,686,0,1765,41,-0.3160110723862216,0.7856354375442773
571,1570914000,1100,653,0,1753,41,-0.3160110723862216,0.7680442402222144
571,1570928400,494,521,27,1015,41,1.3128823643682117,-0.3138143950846596
571,1570942800,48,88,40,136,41,2.097164389472198,-1.6023695989257736
571,1570957200,212,142,0,354,41,-0.3160110723862216,-1.282796180908296
571,1570971600,908,450,0,1358,41,-0.3160110723862216,0.18900066170430757
571,1570986000,1219,661,0,1880,41,-0.3160110723862216,0.9542177452140477
571,1571000400,919,596,0,1515,41,-0.3160110723862216,0.4191521600012984
571,1571014800,279,376,97,655,41,5.535939422620446,-0.8415503147465493
571,1571029200,37,33,0,70,41,-0.3160110723862216,-1.69912118419712
571,1571043600,1176,205,0,1381,41,-0.3160110723862216,0.22271712323826165
571,1571058000,1219,411,0,1630,41,-0.3160110723862216,0.5877344676710687
571,1571072400,971,558,0,1529,41,-0.3160110723862216,0.4396752235437052
571,1571086800,793,739,0,1532,41,-0.3160110723862216,0.44407302287422096
571,1571101200,353,285,0,638,42,-0.37193475975872253,-0.8578043157747846
571,1571115600,29,32,3,61,42,-0.2294916602766586,-1.6653259639310263
571,1571130000,1614,289,0,1903,42,-0.37193475975872253,0.9125854327826606
571,1571144400,1125,378,0,1503,42,-0.37193475975872253,0.35277839766568186
571,1571158800,1041,535,0,1576,42,-0.37193475975872253,0.4549431815745305
571,1571173200,1147,844,0,1991,42,-0.37193475975872253,1.035742980508396
571,1571187600,351,383,32,734,42,1.147458301383293,-0.7234506273467096
571,1571202000,19,25,6,44,42,-0.08704856079459464,-1.689117762923498
571,1571216400,1747,280,0,2027,42,-0.37193475975872253,1.086125613668924
571,1571230800,1394,433,0,1827,42,-0.37193475975872253,0.8062220961104346
571,1571245200,1052,576,0,1628,42,-0.37193475975872253,0.5277180961397377
571,1571259600,1079,886,0,1965,42,-0.37193475975872253,0.9993555232257922
571,1571274000,315,278,0,593,42,-0.37193475975872253,-0.9207826072254446
571,1571288400,14,24,10,38,42,0.10287557184815732,-1.6975148684502526
571,1571302800,1726,255,0,1981,42,-0.37193475975872253,1.0217478046304713
571,1571317200,1426,436,0,1862,42,-0.37193475975872253,0.8552052116831702
571,1571331600,1070,608,0,1678,42,-0.37193475975872253,0.5976939755293601
571,1571346000,1127,894,0,2021,42,-0.37193475975872253,1.0777285081421693
571,1571360400,389,385,0,774,42,-0.37193475975872253,-0.6674699238350118
571,1571374800,24,32,8,56,42,0.007913505526781345,-1.6723235518699886
571,1571389200,1578,271,0,1849,42,-0.37193475975872253,0.8370114830418685
571,1571403600,1372,425,0,1797,42,-0.37193475975872253,0.7642365684766612
571,1571418000,1127,550,0,1677,42,-0.37193475975872253,0.5962944579415677
571,1571432400,1317,776,0,2093,42,-0.37193475975872253,1.1784937744632253
571,1571446800,300,392,92,692,42,3.9963202910245728,-0.7822303660339924
571,1571461200,52,88,36,140,42,1.337382434026045,-1.554764074495423
571,1571475600,341,191,0,532,42,-0.37193475975872253,-1.006153180080784
571,1571490000,1035,607,0,1642,42,-0.37193475975872253,0.5473113423688319
571,1571504400,1139,787,0,1926,42,-0.37193475975872253,0.9447743373018869
571,1571518800,1108,764,0,1872,42,-0.37193475975872253,0.8692003875610947
571,1571533200,450,536,86,986,42,3.7114340920604447,-0.3707721952230131
571,1571547600,54,107,53,161,42,2.1445599977577405,-1.5253742051517816
571,1571562000,191,154,0,345,42,-0.37193475975872253,-1.2678629689979715
571,1571576400,945,434,0,1379,42,-0.37193475975872253,0.17923821677941848
571,1571590800,881,786,0,1667,42,-0.37193475975872253,0.5822992820636431
571,1571605200,626,598,0,1224,42,-0.37193475975872253,-0.03768700932841075
571,1571619600,273,268,0,541,42,-0.37193475975872253,-0.9935575217906518
571,1571634000,25,28,3,53,42,-0.2294916602766586,-1.6765221046333658
571,1571648400,1661,274,0,1935,42,-0.37193475975872253,0.9573699955920189
571,1571662800,1263,430,0,1693,42,-0.37193475975872253,0.6186867393462467
571,1571677200,1011,553,0,1564,42,-0.37193475975872253,0.43814897052102114
571,1571691600,1062,809,0,1871,42,-0.37193475975872253,0.8678008699733023
571,1571706000,368,259,0,627,43,-0.2612340850636811,-0.8108715409019542
571,1571720400,19,25,6,44,43,0.09080329159967525,-1.6250682336980358
571,1571734800,1714,284,0,1998,43,-0.2612340850636811,1.1038174227745947
571,1571749200,1364,416,0,1780,43,-0.2612340850636811,0.7993665153482725
571,1571763600,1032,557,0,1589,43,-0.2612340850636811,0.5326228304013573
571,1571778000,1102,871,0,1973,43,-0.2612340850636811,1.068903327886255
571,1571792400,349,341,0,690,43,-0.2612340850636811,-0.7228880217833382
571,1571806800,18,21,3,39,43,-0.08521539673200294,-1.6320510526757037
571,1571821200,1746,287,0,2033,43,-0.2612340850636811,1.1526971556182701
571,1571835600,1394,378,0,1772,43,-0.2612340850636811,0.7881940049840038
571,1571850000,1057,586,0,1643,43,-0.2612340850636811,0.6080372753601709
571,1571864400,1163,849,0,2012,43,-0.2612340850636811,1.1233693159120648
571,1571878800,370,362,0,732,43,-0.2612340850636811,-0.6642323423709274
571,1571893200,30,21,0,51,43,-0.2612340850636811,-1.6152922871293007
571,1571907600,1751,286,0,2037,43,-0.2612340850636811,1.1582834108004045
571,1571922000,1477,318,0,1795,43,-0.2612340850636811,0.8203149722812764
571,1571936400,1066,636,0,1702,43,-0.2612340850636811,0.6904345392966527
571,1571950800,1208,806,0,2014,43,-0.2612340850636811,1.126162443503132
571,1571965200,336,439,103,775,43,5.782074214323937,-0.6041800991629832
571,1571979600,33,33,0,66,43,-0.2612340850636811,-1.5943438301962969
571,1571994000,1580,288,0,1868,43,-0.2612340850636811,0.9222641293552282
571,1572008400,1348,352,0,1700,43,-0.2612340850636811,0.6876414117055855
571,1572022800,1117,603,0,1720,43,-0.2612340850636811,0.7155726876162573
571,1572037200,1269,817,0,2086,43,-0.2612340850636811,1.2267150367815502
571,1572051600,379,361,0,740,43,-0.2612340850636811,-0.6530598320066587
571,1572066000,31,62,31,93,43,1.5576256943636602,-1.55663660771689
571,1572080400,276,161,0,437,43,-0.2612340850636811,-1.0762186620533358
571,1572094800,984,420,0,1404,43,-0.2612340850636811,0.2742585282276435
571,1572109200,1041,596,0,1637,43,-0.2612340850636811,0.5996578925869694
571,1572123600,1022,499,0,1521,43,-0.2612340850636811,0.43765649230507325
571,1572138000,429,342,0,771,43,-0.2612340850636811,-0.6097663543451176
571,1572152400,58,95,37,153,43,1.9096630710270168,-1.472842779984875
571,1572166800,153,111,0,264,43,-0.2612340850636811,-1.3178241986806465
571,1572181200,697,345,0,1042,43,-0.2612340850636811,-0.23129756575551527
571,1572195600,782,508,0,1290,43,-0.2612340850636811,0.11505025553681449
571,1572210000,647,426,0,1073,43,-0.2612340850636811,-0.18800408809397406
571,1572224400,225,205,0,430,43,-0.2612340850636811,-1.085994608622071
571,1572238800,17,24,7,41,43,0.14947618771023463,-1.6292579250846366
571,1572253200,1728,295,0,2023,43,-0.2612340850636811,1.1387315176629342
571,1572267600,1294,334,0,1628,43,-0.2612340850636811,0.5870888184271672
571,1572282000,1021,528,0,1549,43,-0.2612340850636811,0.47676027858001374
571,1572296400,1006,872,0,1878,43,-0.2612340850636811,0.9362297673105641
571,1572310800,313,377,64,690,44,1.6861892522579254,-0.8492850753462182
571,1572325200,18,27,9,45,44,-0.21015795938560314,-1.7068961645894825
571,1572339600,1799,308,0,2107,44,-0.5204693212909078,1.0348000617975115
571,1572354000,1375,373,0,1748,44,-0.5204693212909078,0.5574630369318806
571,1572368400,1046,572,0,1618,44,-0.5204693212909078,0.38461118948750167
571,1572382800,1212,878,0,2090,44,-0.5204693212909078,1.0121963586701697
571,1572397200,377,379,2,756,44,-0.45151124086750677,-0.7615295220283028
571,1572411600,20,29,9,49,44,-0.21015795938560314,-1.7015776462065786
571,1572426000,1771,295,0,2066,44,-0.5204693212909078,0.9802852483727458
571,1572440400,1411,363,0,1774,44,-0.5204693212909078,0.5920334064207563
571,1572454800,1098,536,0,1634,44,-0.5204693212909078,0.40588526301911754
571,1572469200,1189,844,0,2033,44,-0.5204693212909078,0.936407471713788
571,1572483600,364,451,87,815,44,2.479207177127037,-0.6830813758804692
571,1572498000,30,36,6,66,44,-0.3135950800207047,-1.6789739430792368
571,1572512400,1695,290,0,1985,44,-0.5204693212909078,0.8725852511189405
571,1572526800,1419,401,0,1820,44,-0.5204693212909078,0.6531963678241519
571,1572541200,1105,617,0,1722,44,-0.5204693212909078,0.5228926674430048
571,1572555600,1150,842,0,1992,44,-0.5204693212909078,0.8818926582890224
571,1572570000,390,427,37,817,44,0.7552551665420114,-0.6804221166890173
571,1572584400,37,76,39,113,44,0.8242132469654124,-1.6164813520801151
571,1572598800,1511,290,0,1801,44,-0.5204693212909078,0.627933405505358
571,1572613200,1339,408,0,1747,44,-0.5204693212909078,0.5561334073361546
571,1572627600,1168,553,0,1721,44,-0.5204693212909078,0.5215630378472788
571,1572642000,1200,754,0,1954,44,-0.5204693212909078,0.8313667336514348
571,1572656400,505,473,0,978,44,-0.5204693212909078,-0.46635175177713273
571,1572670800,63,107,44,170,44,0.996608448023915,-1.5406924651237337
571,1572685200,312,198,0,510,44,-0.5204693212909078,-1.0886184025768966
571,1572699600,1109,559,0,1668,44,-0.5204693212909078,0.45109266927380126
571,1572714000,1268,790,0,2058,44,-0.5204693212909078,0.9696482116069378
571,1572728400,1233,924,0,2157,44,-0.5204693212909078,1.1012815415838109
571,1572742800,497,592,95,1089,44,2.7550394988206413,-0.3187628666515477
571,1572753600,60,116,56,176,44,1.4103569305643213,-1.5327146875493778
571,1572768000,145,108,0,253,44,-0.5204693212909078,-1.4303332086784764
571,1572782400,771,841,70,1612,44,1.8930634935281285,0.37663341191314575
571,1572796800,1364,1039,0,2403,44,-0.5204693212909078,1.4283704221324047
571,1572811200,1178,765,0,1943,44,-0.5204693212909078,0.8167408080984488
571,1572825600,346,451,105,797,44,3.0998299009376464,-0.7070147086035371
571,1572840000,35,46,11,81,44,-0.14119987896220212,-1.659029499143347
571,1572854400,747,205,0,952,44,-0.5204693212909078,-0.5009221212660084
571,1572868800,2024,293,0,2317,44,-0.5204693212909078,1.3140222768999696
571,1572883200,875,525,0,1400,44,-0.5204693212909078,0.09475193761923559
571,1572897600,1226,854,0,2080,44,-0.5204693212909078,0.9989000627129097
571,1572912000,451,473,22,924,45,0.6000779925201377,-0.39018472526660536
571,1572926400,41,67,26,108,45,0.7827104250262665,-1.4175672471118035
571,1572940800,756,179,0,935,45,-0.4044003862635711,-0.37633520597702547
571,1572955200,2120,354,0,2474,45,-0.4044003862635711,1.5613384473560135
571,1572969600,988,565,0,1553,45,-0.4044003862635711,0.4017559686557348
571,1572984000,1253,797,0,2050,45,-0.4044003862635711,1.0275024311031165
571,1572998400,440,566,126,1006,45,5.348521237679488,-0.2869428541988281
571,1573012800,43,70,27,113,45,0.8283685331527988,-1.4112720110710852
571,1573027200,1254,201,0,1455,45,-0.4044003862635711,0.2783693422576596
571,1573041600,3151,314,0,3465,45,-0.4044003862635711,2.809054230626346
571,1573056000,1095,494,0,1589,45,-0.4044003862635711,0.4470816681489053
571,1573070400,1137,801,0,1938,45,-0.4044003862635711,0.8864891437910305
571,1573084800,487,526,39,1013,45,1.3762658306711855,-0.27812952374182276
571,1573099200,46,72,26,118,45,0.7827104250262665,-1.4049767750303672
571,1573113600,783,212,0,995,45,-0.4044003862635711,-0.300792373488408
571,1573128000,2103,341,0,2444,45,-0.4044003862635711,1.5235670311117049
571,1573142400,988,500,0,1488,45,-0.4044003862635711,0.3199179001263992
571,1573156800,1246,814,0,2060,45,-0.4044003862635711,1.0400929031845527
571,1573171200,514,491,0,1005,45,-0.4044003862635711,-0.2882019014069717
571,1573185600,61,76,15,137,45,0.2804712356344122,-1.3810548780756384
571,1573200000,692,191,0,883,45,-0.4044003862635711,-0.441805660800494
571,1573214400,2057,342,0,2399,45,-0.4044003862635711,1.4669099067452416
571,1573228800,1007,579,0,1586,45,-0.4044003862635711,0.44330452652447444
571,1573243200,1360,841,0,2201,45,-0.4044003862635711,1.217618559532804
571,1573257600,559,410,0,969,45,-0.4044003862635711,-0.3335276009001422
571,1573272000,80,85,5,165,45,-0.17610984563091,-1.3458015562476169
571,1573286400,116,74,0,190,45,-0.4044003862635711,-1.314325376044026
571,1573300800,853,368,0,1221,45,-0.4044003862635711,-0.016247704447948715
571,1573315200,1080,548,0,1628,45,-0.4044003862635711,0.4961845092665067
571,1573329600,1047,591,0,1638,45,-0.4044003862635711,0.508774981347943
571,1573344000,531,381,0,912,45,-0.4044003862635711,-0.4052932917643289
571,1573358400,85,134,49,219,45,1.8328469119365074,-1.277813007007861
571,1573372800,81,64,0,145,45,-0.4044003862635711,-1.3709825004104894
571,1573387200,751,270,0,1021,45,-0.4044003862635711,-0.26805714607667375
571,1573401600,958,502,0,1460,45,-0.4044003862635711,0.2846645782983777
571,1573416000,782,556,0,1338,45,-0.4044003862635711,0.13106081890485544
571,1573430400,287,314,27,601,45,0.8283685331527988,-0.7968569734969962
571,1573444800,31,41,10,72,45,0.052180695001751085,-1.462892946604974
571,1573459200,578,176,0,754,45,-0.4044003862635711,-0.6042227506510216
571,1573473600,1902,324,0,2226,45,-0.4044003862635711,1.2490947397363945
571,1573488000,915,606,0,1521,45,-0.4044003862635711,0.3614664579951388
571,1573502400,1089,716,0,1805,45,-0.4044003862635711,0.7190358651079284
571,1573516800,428,466,38,894,46,0.8373990631586044,-0.40322116142436076
571,1573531200,41,68,27,109,46,0.4751534010057249,-1.4543954867316409
571,1573545600,776,180,0,956,46,-0.41399504246043356,-0.32019847585869027
571,1573560000,2112,332,0,2444,46,-0.41399504246043356,1.6723459777174023
571,1573574400,919,548,0,1467,46,-0.41399504246043356,0.3640691422712717
571,1573588800,1282,882,0,2164,46,-0.41399504246043356,1.297404817098245
571,1573603200,477,524,47,1001,46,1.1337818776473239,-0.25994007504489713
571,1573617600,41,74,33,115,46,0.6727419439982046,-1.4463610332898018
571,1573632000,805,209,0,1014,46,-0.41399504246043356,-0.2425320925875791
571,1573646400,2061,295,0,2356,46,-0.41399504246043356,1.5545073272370957
571,1573660800,888,464,0,1352,46,-0.41399504246043356,0.21007545130268926
571,1573675200,1246,801,0,2047,46,-0.41399504246043356,1.1407329749823831
571,1573689600,412,572,160,984,46,4.855032770672357,-0.2827043597967745
571,1573704000,38,48,10,86,46,-0.08468080413963414,-1.4851942249253574
571,1573718400,813,132,0,945,46,-0.41399504246043356,-0.33492830716872857
571,1573732800,2120,378,0,2498,46,-0.41399504246043356,1.7446560586939541
571,1573747200,944,504,0,1448,46,-0.41399504246043356,0.33862670637211456
571,1573761600,1300,770,0,2070,46,-0.41399504246043356,1.1715317131760996
571,1573776000,520,617,97,1137,46,2.780353069251321,-0.07782579702987791
571,1573790400,44,102,58,146,46,1.4960275398002032,-1.4048496905069665
571,1573804800,653,172,0,825,46,-0.41399504246043356,-0.4956173760055102
571,1573819200,2019,330,0,2349,46,-0.41399504246043356,1.545133798221617
571,1573833600,1019,482,0,1501,46,-0.41399504246043356,0.40959771177502646
571,1573848000,1363,794,0,2157,46,-0.41399504246043356,1.2880312880827662
571,1573862400,527,531,4,1058,46,-0.28226934713211377,-0.18361276734742582
571,1573876800,79,106,27,185,46,0.4751534010057249,-1.3526257431350124
571,1573891200,121,89,0,210,46,-0.41399504246043356,-1.3191488537940164
571,1573905600,929,297,0,1226,46,-0.41399504246043356,0.0413519290240685
571,1573920000,1136,546,0,1682,46,-0.41399504246043356,0.6519703906038388
571,1573934400,1130,508,0,1638,46,-0.41399504246043356,0.5930510653636856
571,1573948800,530,372,0,902,46,-0.41399504246043356,-0.392508556835242
571,1573963200,84,110,26,194,46,0.442221977173645,-1.3405740629722538
571,1573977600,86,58,0,144,46,-0.41399504246043356,-1.4075278416542463
571,1573992000,619,310,0,929,46,-0.41399504246043356,-0.3563535163469661
571,1574006400,944,481,0,1425,46,-0.41399504246043356,0.3078279681783981
571,1574020800,710,509,0,1219,46,-0.41399504246043356,0.03197840000858957
571,1574035200,298,259,0,557,46,-0.41399504246043356,-0.8544896297409893
571,1574049600,33,34,1,67,46,-0.38106361862835364,-1.5106366608245143
571,1574064000,685,176,0,861,46,-0.41399504246043356,-0.4474106553544757
571,1574078400,2110,313,0,2423,46,-0.41399504246043356,1.6442253906709656
571,1574092800,860,569,0,1429,46,-0.41399504246043356,0.3131842704729575
571,1574107200,1161,820,0,1981,46,-0.41399504246043356,1.0523539871221532
571,1574121600,443,556,113,999,47,3.2580277389285577,-0.2792702162201448
571,1574136000,32,41,9,73,47,-0.11506189454855537,-1.5033632230085894
571,1574150400,756,186,0,942,47,-0.4069638820609979,-0.35461935378703613
571,1574164800,2204,315,0,2519,47,-0.4069638820609979,1.7300401188969565
571,1574179200,952,495,0,1447,47,-0.4069638820609979,0.3129475667617377
571,1574193600,1210,813,0,2023,47,-0.4069638820609979,1.0743704305955866
571,1574208000,475,589,114,1064,47,3.290461293096607,-0.1933457611000056
571,1574222400,49,55,6,104,47,-0.21236255705270288,-1.4623838674897538
571,1574236800,772,217,0,989,47,-0.4069638820609979,-0.2924893631617047
571,1574251200,2128,345,0,2473,47,-0.4069638820609979,1.669232042965781
571,1574265600,935,485,0,1420,47,-0.4069638820609979,0.277255870019526
571,1574280000,1295,841,0,2136,47,-0.4069638820609979,1.223746791035213
571,1574294400,479,588,109,1067,47,3.128293522256361,-0.18938001701753765
571,1574308800,48,64,16,112,47,0.11197298462778879,-1.4518085499365059
571,1574323200,758,193,0,951,47,-0.4069638820609979,-0.3427221215396322
571,1574337600,2203,300,0,2503,47,-0.4069638820609979,1.7088894837904607
571,1574352000,936,580,0,1516,47,-0.4069638820609979,0.40415968065850083
571,1574366400,1322,812,0,2134,47,-0.4069638820609979,1.2211029616469011
571,1574380800,532,608,76,1140,47,2.0579862347107385,-0.09288024434415054
571,1574395200,53,87,34,140,47,0.6957769596526737,-1.4147949385001382
571,1574409600,651,160,0,811,47,-0.4069638820609979,-0.5277901787214705
571,1574424000,2085,330,0,2415,47,-0.4069638820609979,1.5925609907047338
571,1574438400,1001,584,0,1585,47,-0.4069638820609979,0.495371794555264
571,1574452800,1367,758,0,2125,47,-0.4069638820609979,1.2092057293994973
571,1574467200,546,437,0,983,47,-0.4069638820609979,-0.3004208513266406
571,1574481600,89,74,0,163,47,-0.4069638820609979,-1.3843909005345505
571,1574496000,140,100,0,240,47,-0.4069638820609979,-1.2826034690845394
571,1574510400,849,399,0,1248,47,-0.4069638820609979,0.04988654262469613
571,1574524800,1125,578,0,1703,47,-0.4069638820609979,0.6513577284656705
571,1574539200,1086,574,0,1660,47,-0.4069638820609979,0.5945153966169631
571,1574553600,516,408,0,924,47,-0.4069638820609979,-0.3784138182818439
571,1574568000,82,120,38,202,47,0.8255111763248705,-1.332836227462467
571,1574582400,91,60,0,151,47,-0.4069638820609979,-1.4002538768644224
571,1574596800,609,332,0,941,47,-0.4069638820609979,-0.35594126848119206
571,1574611200,881,531,0,1412,47,-0.4069638820609979,0.2666805524662781
571,1574625600,764,487,0,1251,47,-0.4069638820609979,0.05385228670716409
571,1574640000,301,233,0,534,47,-0.4069638820609979,-0.8939605490026791
571,1574654400,27,39,12,66,47,-0.01776123204440787,-1.5126166258676814
571,1574668800,675,170,0,845,47,-0.4069638820609979,-0.4828450791201669
571,1574683200,2037,297,0,2334,47,-0.4069638820609979,1.4854859004780987
571,1574697600,936,530,0,1466,47,-0.4069638820609979,0.33806394595070144
571,1574712000,1192,828,0,2020,47,-0.4069638820609979,1.0704046865131187
571,1574726400,461,519,58,980,48,2.560164748908653,0.04491364957329012
571,1574740800,41,67,26,108,48,0.9454949119620413,-1.3247095827099558
571,1574755200,697,202,0,899,48,-0.3664243305570808,-0.08231052681999305
571,1574769600,2041,347,0,2388,48,-0.3664243305570808,2.256415382434311
571,1574784000,983,531,0,1514,48,-0.3664243305570808,0.8836508124623421
571,1574798400,1249,749,0,1998,48,-0.3664243305570808,1.643854533133318
571,1574812800,506,517,11,1023,48,0.188618425893317,0.1124524098808355
571,1574827200,47,66,19,113,48,0.5922858851299699,-1.3168562384881481
571,1574841600,548,180,0,728,48,-0.3664243305570808,-0.35089489920581307
571,1574856000,1575,303,0,1878,48,-0.3664243305570808,1.4553742718099356
571,1574870400,1194,592,0,1786,48,-0.3664243305570808,1.3108727381286758
571,1574884800,1234,560,0,1794,48,-0.3664243305570808,1.323438088883568
571,1574899200,509,486,0,995,48,-0.3664243305570808,0.06847368223871292
571,1574913600,68,81,13,149,48,0.28953529070248024,-1.2603121600911336
571,1574928000,168,65,0,233,48,-0.3664243305570808,-1.1283759771647657
571,1574942400,655,299,0,954,48,-0.3664243305570808,0.004076259619890579
571,1574956800,635,431,0,1066,48,-0.3664243305570808,0.17999117018838087
571,1574971200,401,373,0,774,48,-0.3664243305570808,-0.27864413236518315
571,1574985600,250,363,113,613,48,5.335378531160642,-0.5315218163073879
571,1575000000,42,54,12,96,48,0.23907685829789863,-1.343557608842294
571,1575014400,174,138,0,312,48,-0.3664243305570808,-1.0042931384602056
571,1575028800,749,326,0,1075,48,-0.3664243305570808,0.19412718978763457
571,1575043200,847,553,0,1400,48,-0.3664243305570808,0.7045945642051288
571,1575057600,913,600,0,1513,48,-0.3664243305570808,0.8820801436179806
571,1575072000,428,456,28,884,48,1.0464117767712044,-0.10587055948541586
571,1575086400,51,56,5,107,48,-0.11413216853417271,-1.3262802515543173
571,1575100800,83,86,3,169,48,-0.21504903334333594,-1.2288987832039031
571,1575115200,598,250,0,848,48,-0.3664243305570808,-0.1624146378824306
571,1575129600,925,416,0,1341,48,-0.3664243305570808,0.6119251023877991
571,1575144000,937,471,0,1408,48,-0.3664243305570808,0.717159914960021
571,1575158400,470,380,0,850,48,-0.3664243305570808,-0.15927330019370756
571,1575172800,66,83,17,149,48,0.49136902032080665,-1.2603121600911336
571,1575187200,59,54,0,113,48,-0.3664243305570808,-1.3168562384881481
571,1575201600,519,260,0,779,48,-0.3664243305570808,-0.27079078814337554
571,1575216000,783,417,0,1200,48,-0.3664243305570808,0.39046079533282463
571,1575230400,530,404,0,934,48,-0.3664243305570808,-0.027337117267339832
571,1575244800,267,196,0,463,48,-0.3664243305570808,-0.7671221429616161
571,1575259200,33,21,0,54,48,-0.3664243305570808,-1.409525700305478
571,1575273600,650,164,0,814,48,-0.3664243305570808,-0.2158173785907223
571,1575288000,1920,286,0,2206,48,-0.3664243305570808,1.9705536527605143
571,1575302400,845,533,0,1378,48,-0.3664243305570808,0.6700398496291753
571,1575316800,1030,843,0,1873,48,-0.3664243305570808,1.447520927588128
571,1575331200,399,411,12,810,49,-0.09383912967045879,-0.5999925578541527
571,1575345600,47,52,5,99,49,-0.3077050531054579,-1.446650612983191
571,1575360000,764,189,0,953,49,-0.46046642698760015,-0.4297083076664559
571,1575374400,1996,354,0,2350,49,-0.46046642698760015,1.2338378287825829
571,1575388800,921,499,0,1420,49,-0.46046642698760015,0.12639480308637235
571,1575403200,1190,864,0,2054,49,-0.46046642698760015,0.8813613388835739
571,1575417600,468,541,73,1009,49,1.7698496316916763,-0.36302356633421096
571,1575432000,41,57,16,98,49,0.028369969435254994,-1.4478414119355525
571,1575446400,721,204,0,925,49,-0.46046642698760015,-0.46305067833257835
571,1575460800,1574,297,0,1871,49,-0.46046642698760015,0.6634451306014164
571,1575475200,3091,790,0,3881,49,-0.46046642698760015,3.0569510248480647
571,1575489600,1289,817,0,2106,49,-0.46046642698760015,0.9432828844063728
571,1575504000,492,632,140,1124,49,3.8168520417123823,-0.22608168681263655
571,1575518400,42,79,37,121,49,0.6699677397402524,-1.4204530360312377
571,1575532800,716,185,0,901,49,-0.46046642698760015,-0.49162985318925473
571,1575547200,2188,287,0,2475,49,-0.46046642698760015,1.3826876978277725
571,1575561600,984,503,0,1487,49,-0.46046642698760015,0.20617833289459397
571,1575576000,1299,788,0,2087,49,-0.46046642698760015,0.920657704311504
571,1575590400,527,582,55,1109,49,1.2199086857159644,-0.2439436710980593
571,1575604800,58,102,44,160,49,0.8838336631752515,-1.3740118768891385
571,1575619200,659,198,0,857,49,-0.46046642698760015,-0.5440250070931615
571,1575633600,2088,350,0,2438,49,-0.46046642698760015,1.3386281365903963
571,1575648000,974,600,0,1574,49,-0.46046642698760015,0.3097778417500459
571,1575662400,1382,732,0,2114,49,-0.46046642698760015,0.9528092760252649
571,1575676800,662,503,0,1165,49,-0.46046642698760015,-0.17725892976581437
571,1575691200,77,182,105,259,49,2.7475224245373866,-1.2561227806053483
571,1575705600,135,110,0,245,49,-0.46046642698760015,-1.2727939659384095
571,1575720000,854,490,0,1344,49,-0.46046642698760015,0.035894082706897104
571,1575734400,1278,770,0,2048,49,-0.46046642698760015,0.8742165451694048
571,1575748800,1298,920,0,2218,49,-0.46046642698760015,1.0766523670708625
571,1575763200,697,717,20,1414,49,0.15057906854096878,0.11925000937220327
571,1575777600,108,213,105,321,49,2.7475224245373866,-1.1822932455589343
571,1575792000,86,87,1,173,49,-0.4299141522111717,-1.358531490508439
571,1575806400,772,375,0,1147,49,-0.46046642698760015,-0.19869331090832168
571,1575820800,1085,779,0,1864,49,-0.46046642698760015,0.6551095379348857
571,1575835200,854,786,0,1640,49,-0.46046642698760015,0.388370572605906
571,1575849600,397,354,0,751,49,-0.46046642698760015,-0.6702496960434823
571,1575864000,39,59,20,98,49,0.15057906854096878,-1.4478414119355525
571,1575878400,715,156,0,871,49,-0.46046642698760015,-0.5273538217601003
571,1575892800,1967,311,0,2278,49,-0.46046642698760015,1.1481003042125537
571,1575907200,838,519,0,1357,49,-0.46046642698760015,0.05137446908759682
571,1575921600,1120,846,0,1966,49,-0.46046642698760015,0.7765710310757604
571,1575936000,422,551,129,973,50,3.023165243601146,-0.4125551817280591
571,1575950400,41,55,14,96,50,-0.13331727403688584,-1.564120623056593
571,1575964800,746,195,0,941,50,-0.5175847109667332,-0.4545735330650182
571,1575979200,2015,330,0,2345,50,-0.5175847109667332,1.38898163184406
571,1575993600,937,503,0,1440,50,-0.5175847109667332,0.2006501330956869
571,1576008000,1217,859,0,2076,50,-0.5175847109667332,1.0357648659177479
571,1576022400,510,586,76,1096,50,1.5684385180810094,-0.2510471437766228
571,1576036800,44,86,42,130,50,0.6352175998228089,-1.519476124761074
571,1576051200,733,195,0,928,50,-0.5175847109667332,-0.4716434882956578
571,1576065600,2200,319,0,2519,50,-0.5175847109667332,1.6174564172387746
571,1576080000,943,481,0,1424,50,-0.5175847109667332,0.1796409574272074
571,1576094400,1262,797,0,2059,50,-0.5175847109667332,1.0134426167699884
571,1576108800,490,623,133,1113,50,3.1329559398668168,-0.2287248946288633
571,1576123200,45,83,38,128,50,0.5254269035571382,-1.522102271719634
571,1576137600,713,173,0,886,50,-0.5175847109667332,-0.5267925744254165
571,1576152000,2192,338,0,2530,50,-0.5175847109667332,1.6319002255108543
571,1576166400,946,515,0,1461,50,-0.5175847109667332,0.2282246761605663
571,1576180800,1315,786,0,2101,50,-0.5175847109667332,1.0685917028997471
571,1576195200,535,561,26,1096,50,0.19605481476012618,-0.2510471437766228
571,1576209600,47,107,60,154,50,1.1292757330183267,-1.4879623612583546
571,1576224000,618,193,0,811,50,-0.5175847109667332,-0.6252730853714142
571,1576238400,2035,324,0,2359,50,-0.5175847109667332,1.4073646605539794
571,1576252800,1022,452,0,1474,50,-0.5175847109667332,0.24529463139120591
571,1576267200,1443,794,0,2237,50,-0.5175847109667332,1.247169696081823
571,1576281600,624,634,10,1258,50,-0.2431079703025565,-0.03832924013326764
571,1576296000,98,154,56,252,50,1.0194850367526562,-1.3592811602889177
571,1576310400,134,107,0,241,50,-0.5175847109667332,-1.3737249685609974
571,1576324800,860,467,0,1327,50,-0.5175847109667332,0.0522728299370503
571,1576339200,1301,781,0,2082,50,-0.5175847109667332,1.0436433067934276
571,1576353600,1324,733,0,2057,50,-0.5175847109667332,1.0108164698114286
571,1576368000,690,673,0,1363,50,-0.5175847109667332,0.09954347519112922
571,1576382400,131,213,82,344,50,1.7331245624795155,-1.2384784001951603
571,1576396800,89,82,0,171,50,-0.5175847109667332,-1.465640112110595
571,1576411200,798,394,0,1192,50,-0.5175847109667332,-0.12499208976574568
571,1576425600,1240,690,0,1930,50,-0.5175847109667332,0.8440561379428723
571,1576440000,882,783,0,1665,50,-0.5175847109667332,0.4960916659336802
571,1576454400,364,477,113,841,50,2.584002458538463,-0.5858808809930152
571,1576468800,39,52,13,91,50,-0.1607649481033035,-1.5706859904529928
571,1576483200,702,171,0,873,50,-0.5175847109667332,-0.5438625296560561
571,1576497600,2074,322,0,2396,50,-0.5175847109667332,1.4559483792873384
571,1576512000,980,462,0,1442,50,-0.5175847109667332,0.20327628005424686
571,1576526400,1202,958,0,2160,50,-0.5175847109667332,1.1460630381772654
571,1576540800,479,508,29,987,51,0.7651209692596349,-0.31502332253975207
571,1576555200,43,70,27,113,51,0.675483366166456,-1.525013499769973
571,1576569600,705,179,0,884,51,-0.5346242755914605,-0.45761941894102526
571,1576584000,2091,321,0,2412,51,-0.5346242755914605,1.65778674903126
571,1576598400,931,560,0,1491,51,-0.5346242755914605,0.3827284501422059
571,1576612800,1227,862,0,2089,51,-0.5346242755914605,1.2106164661418306
571,1576627200,534,531,0,1065,51,-0.5346242755914605,-0.2070379291484967
571,1576641600,42,70,28,112,51,0.7203021677130454,-1.5263979278903737
571,1576656000,683,196,0,879,51,-0.5346242755914605,-0.4645415595430288
571,1576670400,2058,339,0,2397,51,-0.5346242755914605,1.6370203272252495
571,1576684800,976,587,0,1563,51,-0.5346242755914605,0.48240727481105705
571,1576699200,1271,895,0,2166,51,-0.5346242755914605,1.3172174314126854
571,1576713600,524,571,47,1095,51,1.571859397098246,-0.1655050855364754
571,1576728000,40,94,54,134,51,1.8855910079243725,-1.495940509241558
571,1576742400,658,193,0,851,51,-0.5346242755914605,-0.5033055469142487
571,1576756800,2013,306,0,2319,51,-0.5346242755914605,1.5290349338339941
571,1576771200,981,492,0,1473,51,-0.5346242755914605,0.3578087439749931
571,1576785600,1264,816,0,2080,51,-0.5346242755914605,1.1981566130582242
571,1576800000,544,538,0,1082,51,-0.5346242755914605,-0.18350265110168462
571,1576814400,68,118,50,186,51,1.7063158017380144,-1.423950246980721
571,1576828800,553,181,0,734,51,-0.5346242755914605,-0.6652836370011318
571,1576843200,1896,346,0,2242,51,-0.5346242755914605,1.4224339685631393
571,1576857600,1121,630,0,1751,51,-0.5346242755914605,0.7426797614463906
571,1576872000,1286,834,0,2120,51,-0.5346242755914605,1.2535337378742526
571,1576886400,642,488,0,1130,51,-0.5346242755914605,-0.11705010132245051
571,1576900800,105,147,42,252,51,1.3477653893652985,-1.332577991034274
571,1576915200,123,111,0,234,51,-0.5346242755914605,-1.357497697201487
571,1576929600,772,462,0,1234,51,-0.5346242755914605,0.026930423199223355
571,1576944000,1187,543,0,1730,51,-0.5346242755914605,0.7136067709179756
571,1576958400,1132,735,0,1867,51,-0.5346242755914605,0.903273423412873
571,1576972800,554,628,74,1182,51,2.7819670388561626,-0.04505983906161358
571,1576987200,87,126,39,213,51,1.21330898472553,-1.3865706877299018
571,1577001600,95,72,0,167,51,-0.5346242755914605,-1.4502543812683346
571,1577016000,702,346,0,1048,51,-0.5346242755914605,-0.23057320719530877
571,1577030400,967,668,0,1635,51,-0.5346242755914605,0.5820860994799082
571,1577044800,818,720,0,1538,51,-0.5346242755914605,0.44779657180103927
571,1577059200,354,441,87,795,51,3.364611458961826,-0.5808335216566884
571,1577073600,37,61,24,98,51,0.5410269615266875,-1.5457799215759835
571,1577088000,378,142,0,520,51,-0.5346242755914605,-0.9615512547668839
571,1577102400,1378,334,0,1712,51,-0.5346242755914605,0.6886870647507629
571,1577116800,1056,567,0,1623,51,-0.5346242755914605,0.5654729620350997
571,1577131200,1116,692,0,1808,51,-0.5346242755914605,0.8215921643092311
571,1577145600,423,462,39,885,52,2.7526704424081725,0.2253486700836913
571,1577160000,63,87,24,150,52,1.4970663809588307,-1.1755664520045777
571,1577174400,260,142,0,402,52,-0.5119001173601162,-0.6952526958600282
571,1577180025,469,105,0,574,52,-0.5119001173601162,-0.3674194972216851
571,1577183846,240,117,0,357,52,-0.5119001173601162,-0.7810230094572692
571,1577188800,604,216,0,820,52,-0.5119001173601162,0.1014582171098988
571,1577203200,994,482,0,1476,52,-0.5119001173601162,1.3517987886607892
571,1577217600,767,607,0,1374,52,-0.5119001173601162,1.1573860778403764
571,1577232000,297,278,0,575,52,-0.5119001173601162,-0.3655134902528575
571,1577246400,33,63,30,96,52,1.9993080055385672,-1.2784908283212668
571,1577260800,56,47,0,103,52,-0.5119001173601162,-1.2651487795394738
571,1577275200,290,174,0,464,52,-0.5119001173601162,-0.5770802637927185
571,1577289600,476,281,0,757,52,-0.5119001173601162,-0.018620221926238533
571,1577304000,407,370,0,777,52,-0.5119001173601162,0.019499917450313
571,1577318400,242,235,0,477,52,-0.5119001173601162,-0.55230217319796
571,1577332800,32,42,10,74,52,0.32516925693944493,-1.3204229816354736
571,1577347200,206,157,0,363,52,-0.5119001173601162,-0.7695869676443038
571,1577361600,901,419,0,1320,52,-0.5119001173601162,1.0544617015236872
571,1577376000,863,506,0,1369,52,-0.5119001173601162,1.1478560429962386
571,1577390400,932,663,0,1595,52,-0.5119001173601162,1.5786136179512709
571,1577404800,366,391,25,757,52,1.5807733183887869,-0.018620221926238533
571,1577419200,43,74,31,117,52,2.0830149429685236,-1.2384646819758878
571,1577433600,246,166,0,412,52,-0.5119001173601162,-0.6761926261717526
571,1577448000,1023,380,0,1403,52,-0.5119001173601162,1.2126602799363762
571,1577462400,961,514,0,1475,52,-0.5119001173601162,1.3498927816919617
571,1577476800,1071,693,0,1764,52,-0.5119001173601162,1.9007287956831314
