remote_unit_id,time_stamp,entries,exits,num_people_exited,sum_exit_entry,week_num,z_score_num_people_exited,z_score_sum_exit_entry
87,1546311600,36,36,0,72,1,-0.6506286446877236,-0.6411300524575376
87,1546326000,4,14,10,18,1,-0.390839035007621,-0.8182700214708197
87,1546340400,17,71,54,88,1,0.7522352475848304,-0.5886441357128614
87,1546354800,77,211,134,288,1,2.830552125025651,0.0674298235955909
87,1546369200,157,151,0,308,1,-0.6506286446877236,0.13303721952643613
87,1546383600,39,68,29,107,1,0.10276122338457391,-0.5263171095785585
87,1546398000,17,15,0,32,1,-0.6506286446877236,-0.772344844319228
87,1546412400,9,31,22,40,1,-0.0790915033914979,-0.74610188594689
87,1546426800,208,285,77,493,1,1.3497513498490663,0.7399056318867545
87,1546441200,204,262,58,466,1,0.8561510914568714,0.6513356473801134
87,1546455600,829,250,0,1079,1,-0.6506286446877236,2.6622023326605198
87,1546470000,168,80,0,248,1,-0.6506286446877236,-0.06378496826609957
87,1546484400,23,9,0,32,1,-0.6506286446877236,-0.772344844319228
87,1546498800,6,40,34,46,1,0.23265602822462522,-0.7264196671676364
87,1546513200,221,352,131,573,1,2.75261524212162,1.0023352156101355
87,1546527600,232,339,107,571,1,2.129120178889374,0.9957744760170509
87,1546542000,841,256,0,1097,1,-0.6506286446877236,2.7212489889982803
87,1546556400,187,111,0,298,1,-0.6506286446877236,0.1002335215610135
87,1546570800,22,9,0,31,1,-0.6506286446877236,-0.7756252141157703
87,1546585200,7,28,21,35,1,-0.10507046435950815,-0.7625037349296012
87,1546598644,206,286,80,492,1,1.427688232753097,0.7366252620902123
87,1546599589,6,11,5,17,1,-0.5207338398476723,-0.821550391267362
87,1546599600,10,29,19,39,1,-0.15702838629552868,-0.7493822557434322
87,1546600079,3,2,0,5,1,-0.6506286446877236,-0.8609148288258691
87,1546614000,218,227,9,445,1,-0.41681799597563124,0.582447881652726
87,1546628400,798,261,0,1059,1,-0.6506286446877236,2.5965949367296743
87,1546642800,170,84,0,254,1,-0.6506286446877236,-0.044102749486846005
87,1546657200,27,15,0,42,1,-0.6506286446877236,-0.7395411463538054
87,1546671600,5,8,3,13,1,-0.5726917617836929,-0.834671870453531
87,1546686000,45,60,15,105,1,-0.2609442301675697,-0.5328778491716429
87,1546700400,110,89,0,199,1,-0.6506286446877236,-0.2245230882966704
87,1546714800,128,97,0,225,1,-0.6506286446877236,-0.1392334735865716
87,1546729200,44,31,0,75,1,-0.6506286446877236,-0.6312889430679108
87,1546743600,22,12,0,34,1,-0.6506286446877236,-0.7657841047261436
87,1546758000,3,7,4,10,1,-0.5467128008156825,-0.8445129798431578
87,1546772400,17,116,99,133,1,1.9212884911452919,-0.44102749486845966
87,1546786800,107,172,65,279,1,1.0380038182329432,0.03790649542671053
87,1546801200,125,120,0,245,1,-0.6506286446877236,-0.07362607765572636
87,1546815600,35,18,0,53,1,-0.6506286446877236,-0.7034570785918406
87,1546830000,14,11,0,25,1,-0.6506286446877236,-0.7953074328950239
87,1546844400,9,37,28,46,1,0.07678226241656366,-0.7264196671676364
87,1546858800,241,345,104,586,1,2.0511832959853433,1.0449800229651849
87,1546873200,212,231,19,443,1,-0.15702838629552868,0.5758871420596414
87,1546887600,839,185,0,1024,1,-0.6506286446877236,2.4817819938506953
87,1546902000,199,66,0,265,1,-0.6506286446877236,-0.008018681724881125
87,1546916400,20,5,0,25,2,-0.6273984678302855,-0.8629372108548903
87,1546930800,9,45,36,54,2,0.699436209129891,-0.7761811534131285
87,1546933719,32,68,36,100,2,0.699436209129891,-0.6385680967813685
87,1546945200,219,290,71,509,2,1.9894143672856184,0.5849914719662368
87,1546945613,8,4,0,12,2,-0.6273984678302855,-0.9018278572943007
87,1546959600,228,206,0,434,2,-0.6273984678302855,0.360622357892715
87,1546974000,915,230,0,1145,2,-0.6273984678302855,2.487641559309701
87,1546988400,208,86,0,294,2,-0.6273984678302855,-0.05819998837785893
87,1547002800,20,11,0,31,2,-0.6273984678302855,-0.8449876817290085
87,1547017200,8,34,26,42,2,0.33087102108539757,-0.812080211664892
87,1547031600,272,345,73,617,2,2.063127404894517,0.9080829962321081
87,1547046000,223,234,11,457,2,-0.2219767609813427,0.42942888620859504
87,1547060400,924,186,0,1110,2,-0.6273984678302855,2.3829359727420574
87,1547074800,215,79,0,294,2,-0.6273984678302855,-0.05819998837785893
87,1547089200,17,5,0,22,2,-0.6273984678302855,-0.8719119754178312
87,1547103600,10,35,25,45,2,0.2940145022809482,-0.8031054471019512
87,1547118000,244,355,111,599,2,3.463675119463592,0.8542344088544629
87,1547132400,229,206,0,435,2,-0.6273984678302855,0.36361394608036196
87,1547146800,879,215,0,1094,2,-0.6273984678302855,2.3350705617397063
87,1547161200,190,62,0,252,2,-0.6273984678302855,-0.1838466922590311
87,1547175600,24,7,0,31,2,-0.6273984678302855,-0.8449876817290085
87,1547190000,9,37,28,46,2,0.40458405869429626,-0.8001138589143042
87,1547204400,248,318,70,566,2,1.952557848481169,0.7555119986621133
87,1547218800,256,220,0,476,2,-0.6273984678302855,0.4862690617738872
87,1547233200,831,202,0,1033,2,-0.6273984678302855,2.152583682293242
87,1547247600,164,66,0,230,2,-0.6273984678302855,-0.24966163238726416
87,1547262000,24,21,0,45,2,-0.6273984678302855,-0.8031054471019512
87,1547276400,7,10,3,17,2,-0.5168289114169375,-0.8868699163560659
87,1547290800,43,99,56,142,2,1.436566585218878,-0.5129213929001963
87,1547305200,102,165,63,267,2,1.6945622168500234,-0.13897286944432677
87,1547319600,163,108,0,271,2,-0.6273984678302855,-0.12700651669373894
87,1547334000,55,54,0,109,2,-0.6273984678302855,-0.611643803092546
87,1547348400,17,17,0,34,2,-0.6273984678302855,-0.8360129171660676
87,1547362800,5,7,2,12,2,-0.5536854302213868,-0.9018278572943007
87,1547377200,33,48,15,81,2,-0.0745506857635453,-0.6954082723466607
87,1547391600,95,137,42,232,2,0.9205753219565872,-0.24367845601197025
87,1547406000,114,89,0,203,2,-0.6273984678302855,-0.330434513453732
87,1547420400,39,20,0,59,2,-0.6273984678302855,-0.7612232124748938
87,1547434800,10,6,0,16,2,-0.6273984678302855,-0.8898615045437129
87,1547449200,8,35,27,43,2,0.3677275398898469,-0.8090886234772451
87,1547463600,238,292,54,530,2,1.3628535476099795,0.6478148239068229
87,1547478000,232,201,0,433,2,-0.6273984678302855,0.3576307697050681
87,1547492400,841,237,0,1078,2,-0.6273984678302855,2.287205150737355
87,1547506800,189,78,0,267,2,-0.6273984678302855,-0.13897286944432677
87,1547521200,21,8,0,29,3,-0.536947780184666,-0.8231468586968631
87,1547535600,8,37,29,45,3,0.3168412488818134,-0.7726304487384803
87,1547550000,258,324,66,582,3,1.406158285966632,0.9228265604897434
87,1547564400,250,259,9,509,3,-0.2719787711640345,0.6923454400546218
87,1547578800,883,221,0,1104,3,-0.536947780184666,2.570924435381983
87,1547593200,218,66,0,284,3,-0.536947780184666,-0.01804157498513675
87,1547607600,25,12,0,37,3,-0.536947780184666,-0.7978886537176717
87,1547622000,11,41,30,52,3,0.34628224988410583,-0.7505295193816878
87,1547636400,274,268,0,542,3,-0.536947780184666,0.7965355355937864
87,1547650800,262,236,0,498,3,-0.536947780184666,0.6576154082082336
87,1547665200,911,221,0,1132,3,-0.536947780184666,2.6593281528091532
87,1547679600,192,92,0,284,3,-0.536947780184666,-0.01804157498513675
87,1547694000,19,4,0,23,3,-0.536947780184666,-0.8420905124312567
87,1547708400,12,36,24,48,3,0.16963624387035145,-0.7631586218712835
87,1547722800,246,335,89,581,3,2.0833013090193573,0.9196692848673446
87,1547737200,277,207,0,484,3,-0.536947780184666,0.6134135494946487
87,1547751600,899,226,0,1125,3,-0.536947780184666,2.6372272234523604
87,1547766000,200,74,0,274,3,-0.536947780184666,-0.04961433120912602
87,1547780400,21,15,0,36,3,-0.536947780184666,-0.8010459293400706
87,1547794800,7,35,28,42,3,0.28740024787952106,-0.782102275605677
87,1547809200,213,319,106,532,3,2.583798326058328,0.7649627793697972
87,1547823600,268,195,0,463,3,-0.536947780184666,0.5471107614242712
87,1547838000,777,218,0,995,3,-0.536947780184666,2.2267813925405
87,1547852400,143,80,0,223,3,-0.536947780184666,-0.2106353879514713
87,1547866800,26,10,0,36,3,-0.536947780184666,-0.8010459293400706
87,1547881200,11,13,2,24,3,-0.4780657781800813,-0.8389332368088578
87,1547895600,38,170,132,208,3,3.34926435211793,-0.2579945222874552
87,1547910000,125,249,124,374,3,3.113736344099591,0.2661132310307667
87,1547924400,129,116,0,245,3,-0.536947780184666,-0.1411753242586949
87,1547938800,47,36,0,83,3,-0.536947780184666,-0.652653975087321
87,1547953200,18,9,0,27,3,-0.536947780184666,-0.829461409941661
87,1547967600,3,8,5,11,3,-0.3897427751732041,-0.8799778199000438
87,1547982000,18,34,16,52,3,-0.06589176414798772,-0.7505295193816878
87,1547996400,74,105,31,179,3,0.37572325088639824,-0.34955551533702406
87,1548010800,79,78,0,157,3,-0.536947780184666,-0.41901557902980047
87,1548025200,30,39,9,69,3,-0.2719787711640345,-0.696855833800906
87,1548039600,14,5,0,19,3,-0.536947780184666,-0.8547196149208524
87,1548054000,3,15,12,18,3,-0.1836557681571573,-0.8578768905432513
87,1548068400,61,89,28,150,3,0.28740024787952106,-0.44111650838659294
87,1548082800,103,129,26,232,3,0.22851824587493624,-0.18221990734988094
87,1548097200,198,72,0,270,3,-0.536947780184666,-0.06224343369872173
87,1548111600,54,36,0,90,3,-0.536947780184666,-0.6305530457305286
87,1548126000,10,3,0,13,4,-0.5849964581576184,-0.9326994680547003
87,1548140400,6,37,31,43,4,0.5922297992167542,-0.8432625327617839
87,1548154800,252,314,62,566,4,1.7694560565911268,0.7159213725113934
87,1548169200,285,239,0,524,4,-0.5849964581576184,0.5907096631013103
87,1548183600,800,218,0,1018,4,-0.5849964581576184,2.0634378642580016
87,1548198000,216,89,0,305,4,-0.5849964581576184,-0.06217996453697995
87,1548212400,20,5,0,25,4,-0.5849964581576184,-0.8969246939375337
87,1548226800,7,33,26,40,4,0.4023545964144361,-0.8522062262910755
87,1548241200,275,324,49,599,4,1.2757805293050997,0.8143020013336015
87,1548255600,255,215,0,470,4,-0.5849964581576184,0.42972317957406064
87,1548270000,865,209,0,1074,4,-0.5849964581576184,2.2303868101381124
87,1548284400,217,79,0,296,4,-0.5849964581576184,-0.0890110451248549
87,1548298800,16,11,0,27,4,-0.5849964581576184,-0.8909622315846726
87,1548313200,9,35,26,44,4,0.4023545964144361,-0.8402813015853533
87,1548327600,256,303,47,559,4,1.1998304481841724,0.6950527542763796
87,1548342000,207,173,0,380,4,-0.5849964581576184,0.16141237369531125
87,1548356400,792,192,0,984,4,-0.5849964581576184,1.9620760042593628
87,1548370800,191,88,0,279,4,-0.5849964581576184,-0.13969197512417422
87,1548385200,25,4,0,29,4,-0.5849964581576184,-0.8849997692318116
87,1548399600,8,32,24,40,4,0.32640451529350883,-0.8522062262910755
87,1548414000,234,318,84,552,4,2.604906948921327,0.6741841360413657
87,1548428400,332,310,0,642,4,-0.5849964581576184,0.9424949419201152
87,1548442800,833,237,0,1070,4,-0.5849964581576184,2.21846188543239
87,1548457200,170,112,0,282,4,-0.5849964581576184,-0.13074828159488258
87,1548471600,28,13,0,41,4,-0.5849964581576184,-0.849224995114645
87,1548486000,6,10,4,16,4,-0.4330962959157638,-0.9237557745254087
87,1548500400,35,114,79,149,4,2.4150317461190087,-0.5272520280601456
87,1548514800,107,117,10,224,4,-0.20524605255298203,-0.30365968982785446
87,1548529200,115,94,0,209,4,-0.5849964581576184,-0.34837815747431267
87,1548543600,52,33,0,85,4,-0.5849964581576184,-0.7180508233517008
87,1548558000,24,17,0,41,4,-0.5849964581576184,-0.849224995114645
87,1548572400,4,8,4,12,4,-0.4330962959157638,-0.9356806992311308
87,1548586800,23,56,33,79,4,0.6681798803376815,-0.7359382104102841
87,1548601200,70,131,61,201,4,1.7314810160306633,-0.3722280068857571
87,1548615600,89,71,0,160,4,-0.5849964581576184,-0.4944584851194096
87,1548630000,32,26,0,58,4,-0.5849964581576184,-0.7985440651153256
87,1548644400,11,4,0,15,4,-0.5849964581576184,-0.9267370057018393
87,1548658800,15,25,10,40,4,-0.20524605255298203,-0.8522062262910755
87,1548673200,250,347,97,597,4,3.0985824762073544,0.8083395389807404
87,1548687600,246,214,0,460,4,-0.5849964581576184,0.39991086780975516
87,1548702000,925,230,0,1155,4,-0.5849964581576184,2.471866535428987
87,1548716400,223,60,0,283,4,-0.5849964581576184,-0.12776705041845204
87,1548730800,22,9,0,31,5,-0.6342930427407486,-0.8961561928576671
87,1548745200,11,42,31,53,5,0.47768827770544653,-0.8309470216768333
87,1548759600,265,337,72,602,5,1.9483732499084787,0.7963182046085193
87,1548774000,281,207,0,488,5,-0.6342930427407486,0.4584161357623805
87,1548788400,888,235,0,1123,5,-0.6342930427407486,2.3405899403000836
87,1548802800,290,75,0,365,5,-0.6342930427407486,0.0938375877968097
87,1548817200,19,12,0,31,5,-0.6342930427407486,-0.8961561928576671
87,1548831600,6,39,33,45,5,0.5494290080568139,-0.854659447560773
87,1548846000,257,362,105,619,5,3.1320953007060415,0.8467071096118909
87,1548860400,292,229,0,521,5,-0.6342930427407486,0.5562298925336312
87,1548874800,871,211,0,1082,5,-0.6342930427407486,2.2190637576448933
87,1548889200,223,60,0,283,5,-0.6342930427407486,-0.14921477751357085
87,1548903600,18,7,0,25,5,-0.6342930427407486,-0.9139405122706218
87,1548918000,11,40,29,51,5,0.4059475473540791,-0.8368751281478183
87,1548932400,239,324,85,563,5,2.414687997192367,0.680720128424314
87,1548946800,212,191,0,403,5,-0.6342930427407486,0.20647161074552264
87,1548961200,805,208,0,1013,5,-0.6342930427407486,2.0145440843959146
87,1548975600,256,69,0,325,5,-0.6342930427407486,-0.024724541622888126
87,1549004400,33,37,4,70,5,-0.4908115820380138,-0.7805581166734618
87,1549018800,227,314,87,541,5,2.4864287275437342,0.6155109572434802
87,1549033200,200,229,29,429,5,0.4059475473540791,0.28353699486832623
87,1549047600,790,180,0,970,5,-0.6342930427407486,1.8870897952697394
87,1549062000,164,81,0,245,5,-0.6342930427407486,-0.26184880046228376
87,1549076400,25,7,0,32,5,-0.6342930427407486,-0.8931921396221747
87,1549090800,8,6,0,14,5,-0.6342930427407486,-0.9465450978610387
87,1549105200,32,66,34,98,5,0.5852993732324977,-0.6975646260796733
87,1549119600,95,118,23,213,5,0.1907253562999768,-0.35669850399804204
87,1549134000,120,73,0,193,5,-0.6342930427407486,-0.41597956870789093
87,1549148400,52,36,0,88,5,-0.6342930427407486,-0.7272051584345978
87,1549162800,17,15,0,32,5,-0.6342930427407486,-0.8931921396221747
87,1549177200,6,10,4,16,5,-0.4908115820380138,-0.9406169913900538
87,1549191600,25,69,44,94,5,0.9440030249893349,-0.7094208390216431
87,1549206000,56,102,46,158,5,1.0157437553407023,-0.5197214319501265
87,1549220400,77,93,16,170,5,-0.0603671999298092,-0.4841527931242172
87,1549234800,47,16,0,63,5,-0.6342930427407486,-0.8013064893219088
87,1549249200,10,9,0,19,5,-0.6342930427407486,-0.9317248316835766
87,1549263600,5,31,26,36,5,0.29833645182702795,-0.8813359266802049
87,1549278000,269,326,57,595,5,1.410317772273223,0.7755698319600722
87,1549292400,267,241,0,508,5,-0.6342930427407486,0.5176972004722294
87,1549306800,889,271,0,1160,5,-0.6342930427407486,2.4502599100133042
87,1549321200,210,90,0,300,5,-0.6342930427407486,-0.09882587251019927
87,1549335600,20,5,0,25,6,-0.5038075243709366,-0.7515574155383112
87,1549350000,11,36,25,47,6,0.4260385776559598,-0.6826019656746961
87,1549364400,271,380,109,651,6,3.550321480466332,1.210538566944556
87,1549378800,265,248,0,513,6,-0.5038075243709366,0.7779998359818792
87,1549393200,887,260,0,1147,6,-0.5038075243709366,2.7651705275060614
87,1549407600,284,87,0,371,6,-0.5038075243709366,0.3329237504985451
87,1549422000,19,6,0,25,6,-0.5038075243709366,-0.7515574155383112
87,1549436400,6,42,36,48,6,0.8351708625477942,-0.6794676270445318
87,1549450800,280,349,69,629,6,2.0625677172232972,1.141583117080941
87,1549465200,332,218,0,550,6,-0.5038075243709366,0.8939703652979593
87,1549479600,901,189,0,1090,6,-0.5038075243709366,2.5865132255866947
87,1549494000,240,84,0,324,6,-0.5038075243709366,0.18560983488082183
87,1549508400,19,11,0,30,6,-0.5038075243709366,-0.7358857223874896
87,1549522800,6,34,28,40,6,0.5376201098991874,-0.7045423360858464
87,1549537200,263,339,76,602,6,2.3229246257908285,1.0569559740665042
87,1549551600,265,220,0,485,6,-0.5038075243709366,0.6902383543372781
87,1549552939,33,16,0,49,6,-0.5038075243709366,-0.6763332884143675
87,1549553242,10,4,0,14,6,-0.5038075243709366,-0.7860351404701188
87,1549566000,910,214,0,1124,6,-0.5038075243709366,2.6930807390122817
87,1549575266,267,69,0,336,6,-0.5038075243709366,0.22322189844279372
87,1549575400,2,0,0,2,6,-0.5038075243709366,-0.8236472040320907
87,1549575577,2,2,0,4,6,-0.5038075243709366,-0.817378526771762
87,1549576952,9,5,0,14,6,-0.5038075243709366,-0.7860351404701188
87,1549577121,3,2,0,5,6,-0.5038075243709366,-0.8142441881415977
87,1549577439,3,1,0,4,6,-0.5038075243709366,-0.817378526771762
87,1549577796,3,2,0,5,6,-0.5038075243709366,-0.8142441881415977
87,1549578108,3,1,0,4,6,-0.5038075243709366,-0.817378526771762
87,1549580400,10,12,2,22,6,-0.4294198362087849,-0.7609604314288042
87,1549594800,22,7,0,29,6,-0.5038075243709366,-0.7390200610176539
87,1549609200,8,33,25,41,6,0.4260385776559598,-0.701407997455682
87,1549623600,258,355,97,613,6,3.1039953514934213,1.0914336989983118
87,1549638000,283,232,0,515,6,-0.5038075243709366,0.7842685132422078
87,1549652400,852,219,0,1071,6,-0.5038075243709366,2.526960791613573
87,1549666800,183,64,0,247,6,-0.5038075243709366,-0.05573423964183117
87,1549681200,24,8,0,32,6,-0.5038075243709366,-0.729617045127161
87,1549695600,7,7,0,14,6,-0.5038075243709366,-0.7860351404701188
87,1549710000,28,72,44,100,6,1.132721615196401,-0.5164820182759869
87,1549724400,110,137,27,247,6,0.5004262658181116,-0.05573423964183117
87,1549738800,132,85,0,217,6,-0.5038075243709366,-0.1497643985467609
87,1549753200,38,37,0,75,6,-0.5038075243709366,-0.594840484030095
87,1549767600,19,16,0,35,6,-0.5038075243709366,-0.720214029236668
87,1549782000,8,6,0,14,6,-0.5038075243709366,-0.7860351404701188
87,1549796400,27,74,47,101,6,1.2443031474396287,-0.5133476796458226
87,1549810800,62,105,43,167,6,1.095527771115325,-0.30648133005497713
87,1549825200,119,72,0,191,6,-0.5038075243709366,-0.23125720293103336
87,1549839600,31,34,3,65,6,-0.39222599212770903,-0.6261838703317383
87,1549854000,9,5,0,14,6,-0.5038075243709366,-0.7860351404701188
87,1549868400,5,35,30,40,6,0.6120077980613391,-0.7045423360858464
87,1549882800,259,343,84,602,6,2.6204753784394352,1.0569559740665042
87,1549897200,252,224,0,476,6,-0.5038075243709366,0.6620293066657992
87,1549905359,416,96,0,512,6,-0.5038075243709366,0.7748654973517148
87,1549905692,32,8,0,40,6,-0.5038075243709366,-0.7045423360858464
87,1549906199,40,9,0,49,6,-0.5038075243709366,-0.6763332884143675
87,1549911600,477,77,0,554,6,-0.5038075243709366,0.9065077198186166
87,1549926000,278,64,0,342,6,-0.5038075243709366,0.24202793022377966
87,1549940400,14,8,0,22,7,-0.4837657423295055,-0.8429768560562146
87,1549954800,7,41,34,48,7,0.4717217819395592,-0.7621008477260981
87,1549969200,257,300,43,557,7,0.7246449501284293,0.8212025461211833
87,1549983600,206,165,0,371,7,-0.4837657423295055,0.24262802499034958
87,1549998000,756,176,0,932,7,-0.4837657423295055,1.9876834354978639
87,1550012400,191,64,0,255,7,-0.4837657423295055,-0.1182033967901703
87,1550026800,18,5,0,23,7,-0.4837657423295055,-0.8398662403512102
87,1550041200,11,35,24,46,7,0.19069603950748137,-0.7683220791361071
87,1550055600,261,406,145,667,7,3.5911075229356233,1.1633702736716762
87,1550070000,336,272,0,608,7,-0.4837657423295055,0.9798439470764118
87,1550084400,944,183,0,1127,7,-0.4837657423295055,2.594253497973738
87,1550098800,254,62,0,316,7,-0.4837657423295055,0.07154416121510308
87,1550113200,16,6,0,22,7,-0.4837657423295055,-0.8429768560562146
87,1550127600,11,34,23,45,7,0.1625934652642736,-0.7714326948411115
87,1550142000,254,358,104,612,7,2.438901978964104,0.9922864098964297
87,1550156400,292,250,0,542,7,-0.4837657423295055,0.774543310546116
87,1550170800,951,238,0,1189,7,-0.4837657423295055,2.787111671684016
87,1550185200,229,63,0,292,7,-0.4837657423295055,-0.003110615705004482
87,1550199600,29,11,0,40,7,-0.4837657423295055,-0.786985773366134
87,1550214000,6,37,31,43,7,0.3874140592099359,-0.7776539262511205
87,1550228400,210,363,153,573,7,3.8159281168812855,0.8709723974012549
87,1550242800,296,263,0,559,7,-0.4837657423295055,0.8274237775311922
87,1550257200,835,204,0,1039,7,-0.4837657423295055,2.3205193159333435
87,1550271600,185,77,0,262,7,-0.4837657423295055,-0.09642908685513894
87,1550286000,26,14,0,40,7,-0.4837657423295055,-0.786985773366134
87,1550300400,6,6,0,12,7,-0.4837657423295055,-0.8740830131062594
87,1550314800,37,50,13,87,7,-0.11843227716780426,-0.6407868352309233
87,1550329200,130,166,36,296,7,0.5279269304259748,0.009331847115013446
87,1550343600,150,107,0,257,7,-0.4837657423295055,-0.11198216538016134
87,1550358000,53,44,0,97,7,-0.4837657423295055,-0.6096806781808785
87,1550372400,14,13,0,27,7,-0.4837657423295055,-0.8274237775311922
87,1550386800,5,4,0,9,7,-0.4837657423295055,-0.8834148602212728
87,1550401200,21,58,37,79,7,0.5560295046691826,-0.6656717608709591
87,1550415600,83,123,40,206,7,0.6403372273988059,-0.2706235663353899
87,1550430000,112,57,0,169,7,-0.4837657423295055,-0.38571634742055577
87,1550444400,48,27,0,75,7,-0.4837657423295055,-0.6781142236909771
87,1550458800,9,3,0,12,7,-0.4837657423295055,-0.8740830131062594
87,1550473200,3,17,14,20,7,-0.09032970292459648,-0.8491980874662235
87,1550487600,77,103,26,180,7,0.24690118799389693,-0.35149957466550646
87,1550502000,92,64,0,156,7,-0.4837657423295055,-0.426154351585614
87,1550516400,195,106,0,301,7,-0.4837657423295055,0.024884925640035856
87,1550530800,65,28,0,93,7,-0.4837657423295055,-0.6221231410008964
87,1550559600,17,42,25,59,8,0.12857571271486284,-1.082503745795857
87,1550574000,252,298,46,550,8,0.7622702968095442,0.3014784574502217
87,1550588400,254,214,0,468,8,-0.6258226016835673,0.07034497340505175
87,1550602800,868,247,0,1115,8,-0.6258226016835673,1.8940445365419418
87,1550617200,281,86,0,367,8,-0.6258226016835673,-0.2143438301139991
87,1550631600,23,3,0,26,8,-0.6258226016835673,-1.1755208796189134
87,1550646000,9,41,32,50,8,0.33980724074642327,-1.107872055020327
87,1550660400,249,367,118,616,8,2.9349374422770227,0.48751272509633414
87,1550674800,281,179,0,460,8,-0.6258226016835673,0.047795365205522966
87,1550689200,764,169,0,933,8,-0.6258226016835673,1.3810409500026621
87,1550703600,232,68,0,300,8,-0.6258226016835673,-0.4031967987850526
87,1550718000,22,5,0,27,8,-0.6258226016835673,-1.1727021785939722
87,1550732400,7,46,39,53,8,0.5510387687779837,-1.0994159519455038
87,1550746800,244,328,84,572,8,1.9089557346951578,0.3634898799989259
87,1550761200,268,253,0,521,8,-0.6258226016835673,0.2197361277269299
87,1550775600,880,276,0,1156,8,-0.6258226016835673,2.009611278564527
87,1550790000,265,86,0,351,8,-0.6258226016835673,-0.25944304651305666
87,1550804400,24,18,0,42,8,-0.6258226016835673,-1.1304216632198558
87,1550818800,6,68,62,74,8,1.2450852180245393,-1.0402232304217407
87,1550833200,236,307,71,543,8,1.5166686112079741,0.28174755027563403
87,1550847600,272,219,0,491,8,-0.6258226016835673,0.13517509697869698
87,1550862000,886,237,0,1123,8,-0.6258226016835673,1.9165941447414707
87,1550876400,209,84,0,293,8,-0.6258226016835673,-0.4229277059596403
87,1551495600,8859,5329,0,14188,9,-0.751124338644849,4.230871777098544
87,1551510000,4,7,3,11,9,-0.642734244207491,-0.2846117678609231
87,1551524400,14,57,43,71,9,0.8024670149572817,-0.26550130636007185
87,1551538800,47,87,40,134,9,0.6940769205199236,-0.24543532178417807
87,1551553200,61,90,29,151,9,0.2966465742496112,-0.24002069102560356
87,1551567600,29,35,6,64,9,-0.5343441497701331,-0.26773086020183784
87,1551582000,13,14,1,27,9,-0.7149943071657296,-0.27951564479402946
87,1551596400,5,6,1,11,9,-0.7149943071657296,-0.2846117678609231
87,1551610800,6,63,57,69,9,1.308287455664952,-0.2661383217434336
87,1551625200,29,91,62,120,9,1.4889376130605487,-0.24989442946771004
87,1551639600,71,44,0,115,9,-0.751124338644849,-0.2514869679261143
87,1551654000,30,12,0,42,9,-0.751124338644849,-0.27473802941881664
87,1551668400,16,4,0,20,9,-0.751124338644849,-0.28174519863579545
87,1551682800,9,26,17,35,9,-0.1369138034998206,-0.27696758326058263
87,1551697200,206,304,98,510,9,2.7896187463088444,-0.12567642971217696
87,1551702510,49,30,0,79,9,-0.751124338644849,-0.262953244826625
87,1551711600,168,206,38,374,9,0.621816857561685,-0.16899347578077312
87,1551726000,780,230,0,1010,9,-0.751124338644849,0.033577416128250034
87,1551740400,104,52,0,156,9,-0.751124338644849,-0.2384281525671993
87,1551754800,10,10,0,20,10,-0.48530400148602193,-0.6758626250825439
87,1551769200,15,57,42,72,10,0.7639624281457379,-0.5256821902115145
87,1551783600,257,348,91,605,10,2.2214399293827913,1.013667267216536
87,1551798000,261,232,0,493,10,-0.48530400148602193,0.6902017151866267
87,1551812400,911,241,0,1152,10,-0.48530400148602193,2.593449918648325
87,1551819155,200,51,0,251,10,-0.48530400148602193,-0.008714924020855953
87,1551819233,3,0,0,3,10,-0.48530400148602193,-0.7249600749442265
87,1551819316,2,1,0,3,10,-0.48530400148602193,-0.7249600749442265
87,1551819397,1,2,1,3,10,-0.45555956268526576,-0.7249600749442265
87,1551819476,3,0,0,3,10,-0.48530400148602193,-0.7249600749442265
87,1551819556,1,0,0,1,10,-0.48530400148602193,-0.7307362455161892
87,1551819637,3,0,0,3,10,-0.48530400148602193,-0.7249600749442265
87,1551819717,2,0,0,2,10,-0.48530400148602193,-0.7278481602302078
87,1551819798,3,0,0,3,10,-0.48530400148602193,-0.7249600749442265
87,1551819881,1,2,1,3,10,-0.45555956268526576,-0.7249600749442265
87,1551819959,3,1,0,4,10,-0.48530400148602193,-0.7220719896582452
87,1551820040,2,1,0,3,10,-0.48530400148602193,-0.7249600749442265
87,1551820120,3,1,0,4,10,-0.48530400148602193,-0.7220719896582452
87,1551820201,1,0,0,1,10,-0.48530400148602193,-0.7307362455161892
87,1551820282,6,0,0,6,10,-0.48530400148602193,-0.7162958190862826
87,1551820362,3,0,0,3,10,-0.48530400148602193,-0.7249600749442265
87,1551826800,47,17,0,64,10,-0.48530400148602193,-0.5487868724993652
87,1551841200,25,6,0,31,10,-0.48530400148602193,-0.6440936869367492
87,1551855600,12,46,34,58,10,0.5260069177396884,-0.5661153842152532
87,1551870000,273,330,57,603,10,1.2101290101570807,1.0078910966445733
87,1551884400,266,239,0,505,10,-0.48530400148602193,0.7248587386184027
87,1551898800,899,219,0,1118,10,-0.48530400148602193,2.49525501892496
87,1551913200,240,85,0,325,10,-0.48530400148602193,0.2050033871417627
87,1551927600,18,8,0,26,10,-0.48530400148602193,-0.6585341133666559
87,1551942000,6,35,29,41,10,0.3772847237359075,-0.6152128340769358
87,1551956400,257,397,140,654,10,3.6789174306198444,1.1551834462296213
87,1551970800,275,255,0,530,10,-0.48530400148602193,0.7970608707679361
87,1551985200,895,228,0,1123,10,-0.48530400148602193,2.5096954453548665
87,1551999600,281,80,0,361,10,-0.48530400148602193,0.3089744574370907
87,1552014000,21,11,0,32,10,-0.48530400148602193,-0.6412056016507679
87,1552028400,11,36,25,47,10,0.2583069685328827,-0.5978843223610479
87,1552042800,235,362,127,597,10,3.292239726210014,0.9905625849286853
87,1552057200,288,270,0,558,10,-0.48530400148602193,0.8779272587754133
87,1552071600,918,210,0,1128,10,-0.48530400148602193,2.524135871784773
87,1552086000,181,68,0,249,10,-0.48530400148602193,-0.01449109459281862
87,1552100400,18,14,0,32,10,-0.48530400148602193,-0.6412056016507679
87,1552114800,4,9,5,13,10,-0.33658180748224104,-0.6960792220844132
87,1552129200,25,92,67,117,10,1.5075733981646426,-0.3957183523423546
87,1552143600,108,133,25,241,10,0.2583069685328827,-0.037595776880669285
87,1552158000,124,133,9,257,10,-0.21760405227921628,0.008613587695032045
87,1552172400,48,57,9,105,10,-0.21760405227921628,-0.4303753757741306
87,1552190400,22,6,0,28,10,-0.48530400148602193,-0.6527579427946932
87,1552204800,3,9,6,12,10,-0.3068373686814848,-0.6989673073703946
87,1552219200,24,54,30,78,10,0.40702916253666366,-0.5083536784956265
87,1552233600,61,70,9,131,10,-0.21760405227921628,-0.3552851583386159
87,1552248000,56,91,35,147,10,0.5557513565404446,-0.3090757937629146
87,1552262400,30,14,0,44,10,-0.48530400148602193,-0.6065485782189919
87,1552276800,5,4,0,9,10,-0.48530400148602193,-0.7076315632283385
87,1552291200,44,101,57,145,10,1.2101290101570807,-0.3148519643348773
87,1552305600,259,390,131,649,10,3.4112174814130385,1.1407430197997146
87,1552320000,325,261,0,586,10,-0.48530400148602193,0.9587936467828907
87,1552334400,917,280,0,1197,10,-0.48530400148602193,2.723413756517485
87,1552348800,159,31,0,190,11,-0.7220263411341015,-0.45817893001733795
87,1552363200,8,3,0,11,11,-0.7220263411341015,-0.9674322114884123
87,1552377600,45,104,59,149,11,1.208050544874856,-0.5748235363878075
87,1552392000,312,339,27,651,11,0.1612291829716925,0.8533616440506245
87,1552406400,358,213,0,571,11,-0.7220263411341015,0.6257624121082449
87,1552420800,961,225,0,1186,11,-0.7220263411341015,2.375431507665288
87,1552435200,162,66,0,228,11,-0.7220263411341015,-0.3500692948447076
87,1552449600,10,8,0,18,11,-0.7220263411341015,-0.947517278693454
87,1552464000,55,122,67,177,11,1.4697558853506467,-0.49516380520797465
87,1552478400,300,396,96,696,11,2.4184377445753884,0.981386212018213
87,1552492800,377,216,0,593,11,-0.7220263411341015,0.6883522008923992
87,1552507200,927,205,0,1132,11,-0.7220263411341015,2.2218020261041818
87,1552521600,142,47,0,189,11,-0.7220263411341015,-0.4610239204166177
87,1552536000,8,5,0,13,11,-0.7220263411341015,-0.9617422306898528
87,1552550400,48,125,77,173,11,1.7968875609453852,-0.5065437668050936
87,1552564800,295,361,66,656,11,1.4370427177911729,0.8675865960470233
87,1552579200,324,268,0,592,11,-0.7220263411341015,0.6855072104931196
87,1552593600,888,288,0,1176,11,-0.7220263411341015,2.3469816036724906
87,1552608000,143,65,0,208,11,-0.7220263411341015,-0.4069691028303025
87,1552622400,10,6,0,16,11,-0.7220263411341015,-0.9532072594920136
87,1552636800,46,114,68,160,11,1.5024690529101206,-0.5435286419957303
87,1552651200,252,328,76,580,11,1.7641743933859113,0.6513673257017626
87,1552665600,355,240,0,595,11,-0.7220263411341015,0.6940421816909588
87,1552680000,775,236,0,1011,11,-0.7220263411341015,1.8775581877913328
87,1552694400,102,36,0,138,11,-0.7220263411341015,-0.6061184307798847
87,1552708800,9,9,0,18,11,-0.7220263411341015,-0.947517278693454
87,1552723200,7,18,11,25,11,-0.36218149797988913,-0.9276023458984959
87,1552737600,37,110,73,147,11,1.6660348907074898,-0.580513517186367
87,1552752000,128,179,51,307,11,0.9463452043990649,-0.12531505330160778
87,1552766400,108,105,0,213,11,-0.7220263411341015,-0.3927441508339038
87,1552780800,35,32,0,67,11,-0.7220263411341015,-0.8081127491287465
87,1552795200,9,5,0,14,11,-0.7220263411341015,-0.9588972402905731
87,1552809600,6,13,7,19,11,-0.4930341682177845,-0.9446722882941744
87,1552824000,28,78,50,106,11,0.913632036839591,-0.6971581235568365
87,1552838400,75,140,65,215,11,1.404329550231699,-0.3870541700353443
87,1552852800,80,102,22,182,11,-0.0023366548256767536,-0.4809388532115759
87,1552867200,36,50,14,86,11,-0.26404199530146755,-0.7540579315424314
87,1552881600,4,3,0,7,11,-0.7220263411341015,-0.9788121730855313
87,1552896000,36,105,69,141,11,1.5351822204695944,-0.5975834595820454
87,1552910400,256,285,29,541,11,0.22665551809064022,0.5404127001298525
87,1552924800,279,226,0,505,11,-0.7220263411341015,0.43799304575578174
87,1552939200,850,192,0,1042,11,-0.7220263411341015,1.9657528901690047
87,1552953600,128,53,0,181,12,-0.617306730843915,-0.4806614754982924
87,1552968000,12,6,0,18,12,-0.617306730843915,-0.9575612524926851
87,1552982400,43,112,69,155,12,1.0437470351594886,-0.5567313785771526
87,1552996800,264,393,129,657,12,2.488141614292883,0.9120029039454557
87,1553011200,331,247,0,578,12,-0.617306730843915,0.6808674292058421
87,1553025600,932,217,0,1149,12,-0.617306730843915,2.3514795314377333
87,1553040000,139,44,0,183,12,-0.617306730843915,-0.47480994449222624
87,1553054400,14,7,0,21,12,-0.617306730843915,-0.9487839559835859
87,1553068800,45,112,67,157,12,0.9956005491883755,-0.5508798475710864
87,1553083200,257,367,110,624,12,2.030749997567308,0.815452642345364
87,1553097600,308,241,0,549,12,-0.617306730843915,0.5960202296178826
87,1553112000,919,249,0,1168,12,-0.617306730843915,2.407069075995362
87,1553126400,120,53,0,173,12,-0.617306730843915,-0.5040675995225571
87,1553140800,16,8,0,24,12,-0.617306730843915,-0.9400066594744866
87,1553155200,36,103,67,139,12,0.9956005491883755,-0.603543626625682
87,1553169600,290,293,3,583,12,-0.5450870018872452,0.6954962567210075
87,1553184000,303,199,0,502,12,-0.617306730843915,0.45850925097532763
87,1553198400,820,195,0,1015,12,-0.617306730843915,1.9594269540313
87,1553212800,115,42,0,157,12,-0.617306730843915,-0.5508798475710864
87,1553227200,15,17,2,32,12,-0.5691602448728018,-0.9166005354502219
87,1553241600,37,88,51,125,12,0.6104286614194703,-0.6445043436681451
87,1553256000,243,346,103,589,12,1.8622372966684122,0.713050849739206
87,1553270400,306,299,0,605,12,-0.617306730843915,0.7598630977877353
87,1553284800,737,212,0,949,12,-0.617306730843915,1.7663264308311164
87,1553299200,88,39,0,127,12,-0.617306730843915,-0.638652812662079
87,1553313600,24,8,0,32,12,-0.617306730843915,-0.9166005354502219
87,1553328000,9,17,8,26,12,-0.42472078695946236,-0.9341551284684204
87,1553342400,54,98,44,152,12,0.44191596052057425,-0.5655086750862518
87,1553356800,117,160,43,277,12,0.41784271753501767,-0.1997879872071163
87,1553371200,140,122,0,262,12,-0.617306730843915,-0.24367446975261256
87,1553385600,43,33,0,76,12,-0.617306730843915,-0.7878668533167662
87,1553400000,9,3,0,12,12,-0.617306730843915,-0.9751158455108836
87,1553414400,4,13,9,17,12,-0.4006475439739058,-0.9604870179957182
87,1553428800,32,176,144,208,12,2.8492402590762316,-0.40166580691639914
87,1553443200,86,123,37,209,12,0.2734032596216782,-0.39874004141336605
87,1553457600,108,98,0,206,12,-0.617306730843915,-0.4075173379224653
87,1553472000,41,32,0,73,12,-0.617306730843915,-0.7966441498258655
87,1553486400,5,5,0,10,12,-0.617306730843915,-0.9809673765169498
87,1553500800,37,125,88,162,12,1.5011386518850636,-0.536251020055921
87,1553515200,287,390,103,677,12,1.8622372966684122,0.9705182140061174
87,1553529600,303,228,0,531,12,-0.617306730843915,0.5433564505632871
87,1553544000,895,217,0,1112,12,-0.617306730843915,2.243226207825509
87,1553558400,138,39,0,177,13,-0.6196946477394581,-0.49525019875755694
87,1553572800,14,4,0,18,13,-0.6196946477394581,-0.9375182954816764
87,1553587200,49,115,66,164,13,0.7436335772873497,-0.531410483395378
87,1553601600,282,382,100,664,13,1.4459541780587355,0.8593696949823562
87,1553616000,327,235,0,562,13,-0.6196946477394581,0.5756505385932984
87,1553630400,943,247,0,1190,13,-0.6196946477394581,2.3224704426357325
87,1553644800,174,57,0,231,13,-0.6196946477394581,-0.34504593949276163
87,1553659200,10,9,0,19,13,-0.6196946477394581,-0.934736735124921
87,1553673600,42,96,54,138,13,0.4957557181915665,-0.6037310526710202
87,1553688000,267,321,54,588,13,0.4957557181915665,0.6479711078689406
87,1553702400,366,255,0,621,13,-0.6196946477394581,0.7397625996418711
87,1553716800,984,270,0,1254,13,-0.6196946477394581,2.5004903054680825
87,1553731200,159,52,0,211,13,-0.6196946477394581,-0.400677146627871
87,1553745600,9,9,0,18,13,-0.6196946477394581,-0.9375182954816764
87,1553760000,46,99,53,145,13,0.47509922993358455,-0.5842601301737319
87,1553774400,216,363,147,579,13,2.4168091261838867,0.6229370646581414
87,1553788800,363,251,0,614,13,-0.6196946477394581,0.7202916771445828
87,1553803200,978,226,0,1204,13,-0.6196946477394581,2.361412287630309
87,1553817600,136,59,0,195,13,-0.6196946477394581,-0.4451821123359585
87,1553832000,11,3,0,14,13,-0.6196946477394581,-0.9486445369086983
87,1553846400,35,119,84,154,13,1.1154503659310246,-0.5592260869629327
87,1553860800,227,353,126,580,13,1.983022872766266,0.6257186250148968
87,1553875200,326,243,0,569,13,-0.6196946477394581,0.5951214610905867
87,1553889600,785,218,0,1003,13,-0.6196946477394581,1.80231865592246
87,1553904000,93,60,0,153,13,-0.6196946477394581,-0.5620076473196882
87,1553918400,14,16,2,30,13,-0.5783816712234943,-0.9041395712006108
87,1553932800,9,16,7,25,13,-0.47509922993358455,-0.9180473729843882
87,1553947200,53,208,155,261,13,2.582061032247742,-0.2615991287900976
87,1553961600,120,195,75,315,13,0.9295419716091872,-0.11139486952530231
87,1553976000,101,96,0,197,13,-0.6196946477394581,-0.4396189916224476
87,1553990400,67,43,0,110,13,-0.6196946477394581,-0.6816147426601733
87,1554004800,9,12,3,21,13,-0.5577251829655123,-0.92917361441141
87,1554019200,5,9,4,14,13,-0.5370686947075304,-0.9486445369086983
87,1554033600,39,76,37,115,13,0.14459541780587357,-0.667706940876396
87,1554048000,68,114,46,182,13,0.33050381212771096,-0.4813423969737796
87,1554062400,68,72,4,140,13,-0.5370686947075304,-0.5981679319575093
87,1554076800,32,28,0,60,13,-0.6196946477394581,-0.8206927604979468
87,1554091200,5,2,0,7,13,-0.6196946477394581,-0.9681154594059866
87,1554105600,58,125,67,183,13,0.7642900655453316,-0.47856083661702414
87,1554120000,180,356,176,536,13,3.015847285665363,0.5033299693176563
87,1554134400,337,204,0,541,13,-0.6196946477394581,0.5172377711014335
87,1554148800,906,204,0,1110,13,-0.6196946477394581,2.099945614095295
87,1554163200,131,27,0,158,14,-0.7054834446475208,-0.567192103608021
87,1554177600,10,7,0,17,14,-0.7054834446475208,-0.9874910188091248
87,1554192000,57,119,62,176,14,0.9020540454638387,-0.5135369229440503
87,1554206400,266,353,87,619,14,1.5502546463151932,0.806976690063673
87,1554220800,386,220,0,606,14,-0.7054834446475208,0.7682257262508053
87,1554235200,935,205,0,1140,14,-0.7054834446475208,2.3599960859486027
87,1554249600,151,47,0,198,14,-0.7054834446475208,-0.4479583687991972
87,1554264000,11,5,0,16,14,-0.7054834446475208,-0.9904718621793454
87,1554278400,52,135,83,187,14,1.4465425501789766,-0.4807476458716237
87,1554292800,291,374,83,665,14,1.4465425501789766,0.9440954850938204
87,1554307200,368,232,0,600,14,-0.7054834446475208,0.7503406660294817
87,1554321600,907,214,0,1121,14,-0.7054834446475208,2.3033600619144114
87,1554336000,160,122,0,282,14,-0.7054834446475208,-0.19756752570066727
87,1554350400,10,8,0,18,14,-0.7054834446475208,-0.9845101754389042
87,1554364800,46,108,62,154,14,0.9020540454638387,-0.5791154770889033
87,1554379200,274,389,115,663,14,2.2762393192687105,0.9381337983533792
87,1554393600,370,246,0,616,14,-0.7054834446475208,0.7980341599530112
87,1554408000,894,201,0,1095,14,-0.7054834446475208,2.2258581342886763
87,1554422400,161,86,0,247,14,-0.7054834446475208,-0.3018970436583881
87,1554436800,7,9,2,16,14,-0.6536273965794124,-0.9904718621793454
87,1554451200,56,128,72,184,14,1.1613342858043805,-0.48969017598228554
87,1554465600,255,322,67,577,14,1.0316941656341097,0.681781268514408
87,1554480000,309,215,0,524,14,-0.7054834446475208,0.5237965698927165
87,1554494400,714,189,0,903,14,-0.7054834446475208,1.653536207206322
87,1554508800,72,28,0,100,14,-0.7054834446475208,-0.7400810190808155
87,1554523200,14,5,0,19,14,-0.7054834446475208,-0.9815293320686836
87,1554537600,11,15,4,26,14,-0.601771348511304,-0.9606634284771395
87,1554552000,59,146,87,205,14,1.5502546463151932,-0.42709246520765304
87,1554566400,119,186,67,305,14,1.0316941656341097,-0.12900812818559362
87,1554580800,147,163,16,310,14,-0.29063506010265383,-0.11410391133449065
87,1554595200,52,44,0,96,14,-0.7054834446475208,-0.7520043925616978
87,1554609600,7,4,0,11,14,-0.7054834446475208,-1.0053760790304485
87,1554624000,8,18,10,26,14,-0.4462032043069789,-0.9606634284771395
87,1554638400,40,147,107,187,14,2.068815126996277,-0.4807476458716237
87,1554652800,97,149,52,246,14,0.6427738051232967,-0.3048778870286087
87,1554667200,74,68,0,142,14,-0.7054834446475208,-0.6148855975315505
87,1554681600,38,27,0,65,14,-0.7054834446475208,-0.8444105370385363
87,1554696000,5,3,0,8,14,-0.7054834446475208,-1.01431860914111
87,1554710400,50,119,69,169,14,1.083550213702218,-0.5344028265355945
87,1554713684,74,88,14,162,14,-0.34249110817076217,-0.5552687301271386
87,1554724800,173,284,111,457,14,2.1725272231324935,0.3240800640879367
87,1554739200,329,216,0,545,14,-0.7054834446475208,0.586394280667349
87,1554753600,880,235,0,1115,14,-0.7054834446475208,2.285475001693088
87,1554768000,134,52,0,186,15,-0.6364338779678289,-0.48158808934383246
87,1554782400,14,3,0,17,15,-0.6364338779678289,-0.9753830764625929
87,1554796046,60,115,55,175,15,0.5855784168113616,-0.5137285914639885
87,1554796800,8,29,21,37,15,-0.1698473654157744,-0.9169457998804911
87,1554803956,171,265,94,436,15,1.4520962258366057,0.24887786793244043
87,1554804022,1,0,0,1,15,-0.6364338779678289,-1.0221328977282744
87,1554811200,124,129,5,253,15,-0.5253418511697208,-0.2858232127937913
87,1554825600,372,257,0,629,15,-0.6364338779678289,0.8127975869497231
87,1554840000,944,222,0,1166,15,-0.6364338779678289,2.3818384631791574
87,1554854400,164,46,0,210,15,-0.6364338779678289,-0.41146335744531026
87,1554868800,18,3,0,21,15,-0.6364338779678289,-0.9636956211461726
87,1554883200,51,128,77,179,15,1.0743833347230378,-0.5020411361475681
87,1554897600,285,367,82,652,15,1.185475361521146,0.8800004550191403
87,1554912000,343,112,0,455,15,-0.6364338779678289,0.3043932806854372
87,1554926400,953,104,0,1057,15,-0.6364338779678289,2.0633553058067022
87,1554940800,154,23,0,177,15,-0.6364338779678289,-0.5078848638057782
87,1554955200,14,3,0,17,15,-0.6364338779678289,-0.9753830764625929
87,1554969600,58,99,41,157,15,0.27452074177665853,-0.5663221403878801
87,1554984000,266,273,7,539,15,-0.48090504045047744,0.5498298423302649
87,1554998400,388,90,0,478,15,-0.6364338779678289,0.3715961487548543
87,1555012800,972,242,0,1214,15,-0.6364338779678289,2.5220879269762015
87,1555027200,141,60,0,201,15,-0.6364338779678289,-0.4377601319072561
87,1555041600,9,7,0,16,15,-0.6364338779678289,-0.978304940291698
87,1555056000,47,99,52,146,15,0.5189232007324966,-0.5984626425080362
87,1555070400,279,339,60,618,15,0.6966704436094698,0.7806570848295671
87,1555084800,409,289,0,698,15,-0.6364338779678289,1.0144061911579745
87,1555099200,783,233,0,1016,15,-0.6364338779678289,1.9435588888133937
87,1555113600,93,56,0,149,15,-0.6364338779678289,-0.5896970510207209
87,1555128000,11,9,0,20,15,-0.6364338779678289,-0.9666174849752777
87,1555142400,12,25,13,37,15,-0.3475946082927476,-0.9169457998804911
87,1555156800,46,224,178,270,15,3.318442276044824,-0.23615152769900477
87,1555171200,155,299,144,454,15,2.5630164938176883,0.3014714168563321
87,1555185600,176,204,28,380,15,-0.014318527898422867,0.08525349350255532
87,1555200000,77,60,0,137,15,-0.6364338779678289,-0.6247594169699819
87,1555214400,16,7,0,23,15,-0.6364338779678289,-0.9578518934879624
87,1555228800,10,30,20,40,15,-0.19206577077539602,-0.9081802083931758
87,1555243200,54,159,105,213,15,1.696498684792444,-0.402697765957995
87,1555257600,136,175,39,311,15,0.23008393105741523,-0.11635511070569601
87,1555272000,120,164,44,284,15,0.34117595785552346,-0.1952454340915335
87,1555286400,59,50,0,109,15,-0.6364338779678289,-0.7065716041849245
87,1555300800,5,8,3,13,15,-0.569778661888964,-0.9870705317790133
87,1555315200,47,123,76,170,15,1.052164929363416,-0.528337910609514
87,1555329600,277,422,145,699,15,2.5852348991773098,1.0173280549870796
87,1555344000,298,263,0,561,15,-0.6364338779678289,0.6141108465705769
87,1555358400,896,270,0,1166,15,-0.6364338779678289,2.3818384631791574
87,1555372800,124,69,0,193,16,-0.6507023086395956,-0.5070766367067064
87,1555387200,12,5,0,17,16,-0.6507023086395956,-1.0030817311272402
87,1555401600,64,133,69,197,16,0.64001315367221,-0.4958037936516943
87,1555416000,286,470,184,756,16,2.791205590858553,1.079576023286251
87,1555430400,414,287,0,701,16,-0.6507023086395956,0.9245744312798342
87,1555444800,899,292,0,1191,16,-0.6507023086395956,2.30549770551882
87,1555459200,162,65,0,227,16,-0.6507023086395956,-0.4112574707391033
87,1555473600,12,8,0,20,16,-0.6507023086395956,-0.9946270988359811
87,1555488000,58,115,57,173,16,0.4155408993571134,-0.5634408519817671
87,1555502400,285,413,128,698,16,1.7436684040547685,0.9161197989885751
87,1555516800,374,283,0,657,16,-0.6507023086395956,0.8005731576747007
87,1555531200,915,287,0,1202,16,-0.6507023086395956,2.3364980239201034
87,1555545600,159,56,0,215,16,-0.6507023086395956,-0.4450759999041397
87,1555560000,13,8,0,21,16,-0.6507023086395956,-0.991808888072228
87,1555574400,48,123,75,171,16,0.7522492808297584,-0.5690772735092732
87,1555588800,304,396,92,700,16,1.0702516411094785,0.9217562205160811
87,1555603200,380,267,0,647,16,-0.6507023086395956,0.7723910500371703
87,1555617600,911,285,0,1196,16,-0.6507023086395956,2.3195887593375852
87,1555632000,146,66,0,212,16,-0.6507023086395956,-0.4535306321953988
87,1555646400,12,7,0,19,16,-0.6507023086395956,-0.9974453095997341
87,1555660800,31,83,52,114,16,0.32201079339248984,-0.729715287043196
87,1555675200,186,372,186,558,16,2.828617633244402,0.5215702920631505
87,1555689600,432,311,0,743,16,-0.6507023086395956,1.0429392833574616
87,1555704000,551,253,0,804,16,-0.6507023086395956,1.2148501399463965
87,1555718400,64,114,50,178,16,0.2845987510066404,-0.5493497981630019
87,1555732800,23,6,0,29,16,-0.6507023086395956,-0.9692632019622037
87,1555747200,10,20,10,30,16,-0.46364209671034834,-0.9664449911984507
87,1555761600,60,87,27,147,16,-0.14563973643062814,-0.6367143318393459
87,1555776000,106,154,48,260,16,0.24718670862079095,-0.31825651553525325
87,1555790400,108,144,36,252,16,0.02271445430569432,-0.34080220164527747
87,1555804800,51,66,15,117,16,-0.37011199074572476,-0.7212606547519369
87,1555819200,16,9,0,25,16,-0.6507023086395956,-0.9805360450172159
87,1555833600,4,13,9,17,16,-0.4823481179032731,-1.0030817311272402
87,1555848000,55,170,115,225,16,1.5004901285467471,-0.4168938922666094
87,1555862400,126,191,65,317,16,0.5651890689005111,-0.15761850200133037
87,1555876800,134,152,18,286,16,-0.3139939271669506,-0.24498303567767438
87,1555891200,35,38,3,73,16,-0.5945842450608214,-0.8452619283570704
87,1555905600,5,5,0,10,16,-0.6507023086395956,-1.0228092064735115
87,1555920000,47,82,35,129,16,0.004008433112769601,-0.6874421255869005
87,1555934400,235,422,187,657,16,2.847323654437327,0.8005731576747007
87,1555948800,235,220,0,455,16,-0.6507023086395956,0.23129458339658812
87,1555963200,783,241,0,1024,16,-0.6507023086395956,1.8348565079720638
87,1555977600,109,45,0,154,17,-0.5239030755547119,-0.5397161550238235
87,1555992000,8,13,5,21,17,-0.4522693424148508,-0.8994859396461512
87,1556006400,48,87,39,135,17,0.03484004293620518,-0.5911118385412989
87,1556020800,238,556,318,794,17,4.032002352140458,1.1915068687227162
87,1556035200,350,334,0,684,17,-0.5239030755547119,0.8939529115162796
87,1556049600,900,325,0,1225,17,-0.5239030755547119,2.3573773737770263
87,1556064000,138,57,0,195,17,-0.5239030755547119,-0.4288096800650608
87,1556078400,11,6,0,17,17,-0.5239030755547119,-0.9103060835445671
87,1556092800,48,79,31,127,17,-0.07977393008757269,-0.6127521263381306
87,1556107200,263,494,231,757,17,2.7855753955068745,1.0914205376623693
87,1556121600,320,318,0,638,17,-0.5239030755547119,0.7695212566844971
87,1556136000,890,305,0,1195,17,-0.5239030755547119,2.2762262945389073
87,1556150400,153,74,0,227,17,-0.5239030755547119,-0.3422485288777338
87,1556164800,12,10,0,22,17,-0.5239030755547119,-0.8967809036715473
87,1556179200,48,105,57,153,17,0.2927214822397054,-0.5424211909984274
87,1556193600,249,423,174,672,17,1.968950837712457,0.8614924798210319
87,1556208000,332,345,13,677,17,-0.33765536939107293,0.8750176596940519
87,1556222400,907,287,0,1194,17,-0.5239030755547119,2.2735212585643034
87,1556236800,112,74,0,186,17,-0.5239030755547119,-0.45315500383649654
87,1556251200,11,6,0,17,17,-0.5239030755547119,-0.9103060835445671
87,1556263225,15,39,24,54,17,-0.18006115648337834,-0.8102197524842203
87,1556263313,0,0,0,0,17,-0.5239030755547119,-0.9562916951128346
87,1556265600,31,34,3,65,17,-0.48092283567079525,-0.7804643567635766
87,1556280000,234,303,69,537,17,0.46464244177537223,0.4963126232494963
87,1556294400,292,244,0,536,17,-0.5239030755547119,0.49360758727489235
87,1556308800,747,197,0,944,17,-0.5239030755547119,1.5972622649133112
87,1556323200,83,53,0,136,17,-0.5239030755547119,-0.5884068025666949
87,1556337600,9,7,0,16,17,-0.5239030755547119,-0.9130111195191711
87,1556352000,8,30,22,38,17,-0.2087146497393228,-0.8535003280778838
87,1556366400,56,245,189,301,17,2.1838520371320405,-0.14207586675704018
87,1556380800,114,161,47,275,17,0.14945401595998306,-0.21240680209674334
87,1556395200,145,128,0,273,17,-0.5239030755547119,-0.2178168740459513
87,1556409600,44,39,0,83,17,-0.5239030755547119,-0.7317737092207053
87,1556424000,7,6,0,13,17,-0.5239030755547119,-0.921126227442983
87,1556438400,5,14,9,19,17,-0.39496235590296186,-0.9048960115953592
87,1556452800,38,96,58,134,17,0.30704822886767763,-0.5938168745159028
87,1556467200,76,99,23,175,17,-0.19438790311135057,-0.48291039955714016
87,1556481600,77,129,52,206,17,0.22108774909984422,-0.39905428434441714
87,1556496000,34,32,0,66,17,-0.5239030755547119,-0.7777593207889727
87,1556510400,5,6,1,11,17,-0.5095763289267398,-0.926536299392191
87,1556524800,45,133,88,178,17,0.7368506277068446,-0.47479529163332823
87,1556539200,267,423,156,690,17,1.7110693984089567,0.9101831273639034
87,1556553600,315,272,0,587,17,-0.5239030755547119,0.6315644219796948
87,1556568000,878,250,0,1128,17,-0.5239030755547119,2.0949888842404416
87,1556582400,123,57,0,180,18,-0.6224679901011471,-0.5038498375167348
87,1556596800,10,7,0,17,18,-0.6224679901011471,-0.9324477485057466
87,1556611200,54,123,69,177,18,0.8287888363776335,-0.511738142626962
87,1556625600,292,386,94,678,18,1.3546065271308145,0.8056088107809823
87,1556640000,341,264,0,605,18,-0.6224679901011471,0.6136600530987868
87,1556654400,959,313,0,1272,18,-0.6224679901011471,2.36749322260597
87,1556668800,161,62,0,223,18,-0.6224679901011471,-0.39078413093681147
87,1556683200,13,3,0,16,18,-0.6224679901011471,-0.935077183542489
87,1556697600,49,117,68,166,18,0.8077561287475062,-0.5406619280311284
87,1556712000,263,377,114,640,18,1.7752606797333597,0.7056902793847709
87,1556726400,299,328,29,627,18,-0.01251946882745669,0.6715076239071197
87,1556740800,949,249,0,1198,18,-0.6224679901011471,2.172915029887032
87,1556755200,134,62,0,196,18,-0.6224679901011471,-0.4617788769288564
87,1556769600,12,3,0,15,18,-0.6224679901011471,-0.9377066185792315
87,1556784000,52,111,59,163,18,0.6184617600763609,-0.5485502331413558
87,1556798400,268,436,168,704,18,2.9110268917602315,0.8739741217362847
87,1556812800,288,318,30,606,18,0.008513238802670561,0.6162894881355292
87,1556827200,968,307,0,1275,18,-0.6224679901011471,2.3753815277161974
87,1556841600,136,73,0,209,18,-0.6224679901011471,-0.4275962214512051
87,1556856000,11,5,0,16,18,-0.6224679901011471,-0.935077183542489
87,1556870400,49,121,72,170,18,0.8918869592680152,-0.5301441878841588
87,1556884800,258,392,134,650,18,2.195914832335905,0.731984629752195
87,1556899200,390,307,0,697,18,-0.6224679901011471,0.855568076479088
87,1556913600,802,269,0,1071,18,-0.6224679901011471,1.838976780220747
87,1556928000,93,49,0,142,18,-0.6224679901011471,-0.6037683689129462
87,1556942400,16,6,0,22,18,-0.6224679901011471,-0.9193005733220346
87,1556956800,8,21,13,29,18,-0.34904279090949275,-0.9008945280648378
87,1556971200,67,182,115,249,18,1.796293387363487,-0.32241881998150895
87,1556985600,115,130,15,245,18,-0.3069773756492382,-0.3329365601284786
87,1557000000,153,100,0,253,18,-0.6224679901011471,-0.31190107983453935
87,1557014400,62,63,1,125,18,-0.6014352824710197,-0.6484687645375671
87,1557028800,7,6,0,13,18,-0.6224679901011471,-0.9429654886527163
87,1557043200,7,11,4,18,18,-0.538337159580638,-0.9298183134690042
87,1557057600,39,57,18,96,18,-0.24387925275885647,-0.7247223806030968
87,1557072000,62,58,0,120,18,-0.6224679901011471,-0.6616159397212791
87,1557086400,67,51,0,118,18,-0.6224679901011471,-0.6668748097947639
87,1557100800,25,23,0,48,18,-0.6224679901011471,-0.8509352623667321
87,1557115200,5,6,1,11,18,-0.6014352824710197,-0.9482243587262011
87,1557129600,40,133,93,173,18,1.3335738195006874,-0.5222558827739316
87,1557144000,263,409,146,672,18,2.4483073238974318,0.7898322005605278
87,1557158400,303,253,0,556,18,-0.6224679901011471,0.484817736298409
87,1557172800,916,231,0,1147,18,-0.6224679901011471,2.0388138430131697
87,1557187200,121,45,0,166,19,-0.6289996702365019,-0.5017997904510663
87,1557201600,7,4,0,11,19,-0.6289996702365019,-0.9347798727987726
87,1557216000,66,133,67,199,19,0.7098386170250199,-0.40961693420929646
87,1557230400,259,439,180,698,19,2.967879310466094,0.9842995889617069
87,1557244800,370,249,0,619,19,-0.6289996702365019,0.7636194179586823
87,1557259200,946,271,0,1217,19,-0.6289996702365019,2.434084509854995
87,1557273600,133,68,0,201,19,-0.6289996702365019,-0.404030094437068
87,1557288000,15,8,0,23,19,-0.6289996702365019,-0.9012588341654019
87,1557302400,47,135,88,182,19,1.1294744981069895,-0.45710507227323843
87,1557316800,284,423,139,707,19,2.1485902093060583,1.009440367936735
87,1557331200,386,317,0,703,19,-0.6289996702365019,0.9982666883922781
87,1557345600,916,265,0,1181,19,-0.6289996702365019,2.3335213939548827
87,1557360000,135,78,0,213,19,-0.6289996702365019,-0.37050905580369714
87,1557374400,17,5,0,22,19,-0.6289996702365019,-0.9040522540515161
87,1557388800,55,134,79,189,19,0.9496305490718596,-0.4375511330704388
87,1557403200,250,399,149,649,19,2.3484168193450916,0.8474220145421094
87,1557417600,355,237,0,592,19,-0.6289996702365019,0.688197081033598
87,1557432000,917,282,0,1199,19,-0.6289996702365019,2.3838029519049386
87,1557446400,132,72,0,204,19,-0.6289996702365019,-0.3956498347787253
87,1557460800,12,6,0,18,19,-0.6289996702365019,-0.915225933595973
87,1557475200,44,120,76,164,19,0.8896825660601497,-0.5073866302232947
87,1557489600,240,369,129,609,19,1.9487635992670254,0.7356852190975399
87,1557504000,349,258,0,607,19,-0.6289996702365019,0.7300983793253115
87,1557518400,780,262,0,1042,19,-0.6289996702365019,1.9452360297850038
87,1557532800,93,57,0,150,19,-0.6289996702365019,-0.5464945086288939
87,1557547200,10,12,2,22,19,-0.5890343482286953,-0.9040522540515161
87,1557561600,11,24,13,35,19,-0.36922507718575887,-0.867737795532031
87,1557576000,42,142,100,184,19,1.3692664301538293,-0.45151823250101
87,1557590400,131,204,73,335,19,0.8297345830484397,-0.029711829697760473
87,1557604800,140,149,9,289,19,-0.44915572120137215,-0.1582091444590153
87,1557619200,44,39,0,83,19,-0.6289996702365019,-0.7336536409985477
87,1557633600,11,6,0,17,19,-0.6289996702365019,-0.9180193534820873
87,1557648000,3,10,7,13,19,-0.48912104320917876,-0.9291930330265442
87,1557662400,25,61,36,86,19,0.09037612590401727,-0.725273381340205
87,1557676800,67,48,0,115,19,-0.6289996702365019,-0.6442642046428922
87,1557691200,69,58,0,127,19,-0.6289996702365019,-0.6107431660095214
87,1557705600,26,36,10,62,19,-0.4291730601974688,-0.7923154586069466
87,1557720000,4,3,0,7,19,-0.6289996702365019,-0.9459535523432296
87,1557734400,49,132,83,181,19,1.0295611930874728,-0.4598984921593527
87,1557736238,32,52,20,84,19,-0.22934645015843572,-0.7308602211124335
87,1557736321,3,7,4,10,19,-0.5490690262208887,-0.9375732926848869
87,1557748800,191,312,121,503,19,1.788902311235799,0.43958271116943104
87,1557763200,275,221,0,496,19,-0.6289996702365019,0.4200287719666314
87,1557777600,808,186,0,994,19,-0.6289996702365019,1.8111518752515205
87,1557792000,119,53,0,172,20,-0.6369299569252919,-0.5175633431877922
87,1557806400,11,6,0,17,20,-0.6369299569252919,-0.9543634917511806
87,1557820800,57,126,69,183,20,0.8655714799241145,-0.48656462296716463
87,1557835200,264,368,104,632,20,1.6277098899201903,0.7787467751293606
87,1557849600,339,314,0,653,20,-0.6369299569252919,0.8379261500960133
87,1557864000,868,270,0,1138,20,-0.6369299569252919,2.2046879052782287
87,1557878400,119,33,0,152,20,-0.6369299569252919,-0.5739246526798423
87,1557892800,10,4,0,14,20,-0.6369299569252919,-0.9628176881749881
87,1557906908,51,108,57,159,20,0.6042668822111743,-0.5541981943576247
87,1557907200,5,3,0,8,20,-0.6369299569252919,-0.9797260810226032
87,1557911048,106,144,38,250,20,0.1905346024990189,-0.2977542361687967
87,1557921600,180,316,136,496,20,2.324522150488031,0.39548987058341983
87,1557936000,381,298,0,679,20,-0.6369299569252919,0.9111958524356785
87,1557950400,941,265,0,1206,20,-0.6369299569252919,2.396316357551199
87,1557964800,157,69,0,226,20,-0.6369299569252919,-0.3653878075592568
87,1557979200,11,5,0,16,20,-0.6369299569252919,-0.9571815572257831
87,1557993600,47,136,89,183,20,1.301079142779015,-0.48656462296716463
87,1558008000,286,417,131,703,20,2.2156452347743056,0.9788294238261386
87,1558022400,364,326,0,690,20,-0.6369299569252919,0.942194572656306
87,1558036800,946,296,0,1242,20,-0.6369299569252919,2.497766714636889
87,1558051200,135,71,0,206,20,-0.6369299569252919,-0.42174911705130697
87,1558065600,12,14,2,26,20,-0.5933791906398018,-0.9290009024797581
87,1558080000,52,110,58,162,20,0.6260422653539193,-0.5457439979338172
87,1558094400,266,359,93,625,20,1.388180675349995,0.7590203168071431
87,1558108800,350,303,0,653,20,-0.6369299569252919,0.8379261500960133
87,1558123200,763,221,0,984,20,-0.6369299569252919,1.7707058221894427
87,1558137600,94,80,0,174,20,-0.6369299569252919,-0.5119272122385872
87,1558152000,15,13,0,28,20,-0.6369299569252919,-0.9233647715305531
87,1558166400,11,19,8,30,20,-0.46272689178333165,-0.9177286405813481
87,1558180800,47,134,87,181,20,1.2575283764935248,-0.49220075391636964
87,1558195200,131,132,1,263,20,-0.6151545737825468,-0.2611193849989641
87,1558209600,127,168,41,295,20,0.255860751927254,-0.1709412898116839
87,1558224000,56,56,0,112,20,-0.6369299569252919,-0.6866472716639426
87,1558238400,10,18,8,28,20,-0.46272689178333165,-0.9233647715305531
87,1558252800,4,10,6,14,20,-0.5062776580688217,-0.9628176881749881
87,1558267200,26,148,122,174,20,2.0196667864896005,-0.5119272122385872
87,1558281600,101,100,0,201,20,-0.6369299569252919,-0.4358394444243195
87,1558296000,100,92,0,192,20,-0.6369299569252919,-0.46120203369574203
87,1558310400,40,18,0,58,20,-0.6369299569252919,-0.8388228072924778
87,1558324800,4,4,0,8,20,-0.6369299569252919,-0.9797260810226032
87,1558339200,43,122,79,165,20,1.0833253113515646,-0.5372898015100097
87,1558353600,244,399,155,643,20,2.738254430200186,0.8097454953499882
87,1558368000,279,282,3,561,20,-0.5716038074970567,0.5786641264325827
87,1558382400,824,223,0,1047,20,-0.6369299569252919,1.9482439470894006
87,1558396800,101,67,0,168,21,-0.6865067674012435,-0.43876513090225516
87,1558411200,8,5,0,13,21,-0.6865067674012435,-0.9261155834144
87,1558425600,54,102,48,156,21,0.3098918237297191,-0.47649548851609863
87,1558440000,256,389,133,645,21,2.0743476621907986,1.061016584248023
87,1558454400,334,343,9,677,21,-0.49968203156418806,1.1616308712182724
87,1558468800,914,275,0,1189,21,-0.6865067674012435,2.7714594627422606
87,1558483200,91,63,0,154,21,-0.6865067674012435,-0.4827838814517392
87,1558497600,10,7,0,17,21,-0.6865067674012435,-0.913538797543119
87,1558512000,58,125,67,183,21,0.7042995993857251,-0.3916021838849508
87,1558526400,252,385,133,637,21,2.0743476621907986,1.0358630125054606
87,1558540800,334,264,0,598,21,-0.6865067674012435,0.9132393502604694
87,1558555200,894,289,0,1183,21,-0.6865067674012435,2.752594283935339
87,1558569600,117,67,0,184,21,-0.6865067674012435,-0.38845798741713056
87,1558584000,11,2,0,13,21,-0.6865067674012435,-0.9261155834144
87,1558598400,50,120,70,170,21,0.7665745113314102,-0.43247673796661457
87,1558612800,240,327,87,567,21,1.1194656790236261,0.8157692597580405
87,1558627200,321,289,0,610,21,-0.6865067674012435,0.9509697078743129
87,1558641600,781,256,0,1037,21,-0.6865067674012435,2.293541599633577
87,1558656000,84,76,0,160,21,-0.6865067674012435,-0.4639187026448175
87,1558670400,12,12,0,24,21,-0.6865067674012435,-0.891529422268377
87,1558684800,39,115,76,154,21,0.8911243352227806,-0.4827838814517392
87,1558699200,185,363,178,548,21,3.0084713413760764,0.7560295268694549
87,1558713600,477,249,0,726,21,-0.6865067674012435,1.3156964981414665
87,1558728000,492,195,0,687,21,-0.6865067674012435,1.1930728358964753
87,1558742400,78,62,0,140,21,-0.6865067674012435,-0.5268026320012232
87,1558756800,10,12,2,22,21,-0.6449901594374534,-0.8978178152040175
87,1558771200,8,14,6,22,21,-0.5619569435098732,-0.8978178152040175
87,1558785600,43,168,125,211,21,1.9082812303356382,-0.3035646827859827
87,1558800000,99,139,40,238,21,0.14382539187455862,-0.2186713781548349
87,1558814400,122,162,40,284,21,0.14382539187455862,-0.07403834063510155
87,1558828800,61,53,0,114,21,-0.6865067674012435,-0.6085517401645508
87,1558843200,9,6,0,15,21,-0.6865067674012435,-0.9198271904787595
87,1558857600,5,7,2,12,21,-0.6449901594374534,-0.9292597798822204
87,1558872000,42,170,128,212,21,1.9705561422813234,-0.3004204863181624
87,1558886400,89,146,57,235,21,0.4967165595667745,-0.22810396755829576
87,1558900800,81,117,36,198,21,0.060792175946978416,-0.3444392368676465
87,1558915200,49,54,5,103,21,-0.5827152474917683,-0.643137901310574
87,1558929600,4,11,7,15,21,-0.5411986395279781,-0.9198271904787595
87,1558944000,5,11,6,16,21,-0.5619569435098732,-0.9166829940109392
87,1558958400,37,141,104,178,21,1.472356846715842,-0.4073231662240523
87,1558972800,93,113,20,206,21,-0.2713406877633424,-0.31928566512508416
87,1558987200,93,103,10,196,21,-0.47892372758229296,-0.35072762980328703
87,1559001600,68,70,2,138,22,-0.5986223593021794,-0.6043594415748982
87,1559016000,3,6,3,9,22,-0.5799985525683339,-0.9794790949662142
87,1559030400,52,118,66,170,22,0.5933012716639378,-0.5113065042995328
87,1559044800,235,343,108,578,22,1.3755011544854523,0.6751184459613739
87,1559059200,260,223,0,483,22,-0.6358699727698707,0.39886753842513334
87,1559073600,860,249,0,1109,22,-0.6358699727698707,2.219215623874466
87,1559088000,99,64,0,163,22,-0.6358699727698707,-0.531661834328519
87,1559102400,8,2,0,10,22,-0.6358699727698707,-0.9765711906763591
87,1559116800,51,104,53,155,22,0.3511917841239452,-0.5549250686473604
87,1559131200,249,371,122,620,22,1.6362344487592906,0.7972504261352907
87,1559145600,318,275,0,593,22,-0.6358699727698707,0.7187370103092013
87,1559160000,846,207,0,1053,22,-0.6358699727698707,2.056372983642577
87,1559174400,97,48,0,145,22,-0.6358699727698707,-0.584004111545912
87,1559188800,13,4,0,17,22,-0.6358699727698707,-0.956215860647373
87,1559203200,44,112,68,156,22,0.630548885131629,-0.5520171643575051
87,1559217600,250,383,133,633,22,1.841096322831592,0.8350531819034079
87,1559232000,381,305,0,686,22,-0.6358699727698707,0.9891721092657315
87,1559246400,827,225,0,1052,22,-0.6358699727698707,2.053465079352722
87,1559260800,102,53,0,155,22,-0.6358699727698707,-0.5549250686473604
87,1559275200,17,8,0,25,22,-0.6358699727698707,-0.9329526263285316
87,1559289600,42,104,62,146,22,0.5188060447285554,-0.5810962072560568
87,1559304000,249,402,153,651,22,2.2135724575085036,0.8873954591208009
87,1559318400,384,323,0,707,22,-0.6358699727698707,1.05023809935269
87,1559332800,702,273,0,975,22,-0.6358699727698707,1.829556449033874
87,1559347200,111,62,0,173,22,-0.6358699727698707,-0.5025827914299674
87,1559361600,12,14,2,26,22,-0.5986223593021794,-0.9300447220386765
87,1559376000,6,17,11,23,22,-0.43100809869756923,-0.9387684349082419
87,1559390400,50,151,101,201,22,1.2451345073485334,-0.4211614713140228
87,1559404800,98,171,73,269,22,0.7236679188008569,-0.2234239796038717
87,1559419200,97,58,0,155,22,-0.6358699727698707,-0.5549250686473604
87,1559433600,42,63,21,105,22,-0.24477003135911343,-0.7003202831401185
87,1559448000,8,6,0,14,22,-0.6358699727698707,-0.9649395735169384
87,1559462400,4,19,15,23,22,-0.35651287176218693,-0.9387684349082419
87,1559476800,52,157,105,209,22,1.3196297342839156,-0.3978982369951815
87,1559491200,76,118,42,194,22,0.1463299100516438,-0.44151680134300897
87,1559505600,90,90,0,180,22,-0.6358699727698707,-0.48222746140098127
87,1559520000,31,21,0,52,22,-0.6358699727698707,-0.8544392105024422
87,1559534400,7,6,0,13,22,-0.6358699727698707,-0.9678474778067936
87,1559548800,43,91,48,134,22,0.2580727504547173,-0.6159910587343188
87,1559563200,209,444,235,653,22,3.7407246096838414,0.8932112677005112
87,1559577600,268,279,11,547,22,-0.43100809869756923,0.5849734129758638
87,1559592000,884,241,0,1125,22,-0.6358699727698707,2.2657420925121485
87,1559606400,92,66,0,158,23,-0.6530250795228395,-0.5890277502811815
87,1559620800,10,6,0,16,23,-0.6530250795228395,-1.003697588508151
87,1559635200,52,87,35,139,23,-0.08023107639614353,-0.6445117427200013
87,1559649600,244,407,163,651,23,2.0145584207529157,0.8506358429997765
87,1559664000,320,282,0,602,23,-0.6530250795228395,0.7075455467101883
87,1559678400,891,278,0,1169,23,-0.6530250795228395,2.363304689489708
87,1559692800,108,81,0,189,23,-0.6530250795228395,-0.4985012363020543
87,1559721600,55,133,78,188,23,0.6234872703023686,-0.5014214464304132
87,1559736000,239,442,203,681,23,2.669180138611997,0.9382421468505446
87,1559750400,300,255,0,555,23,-0.6530250795228395,0.5702956706773181
87,1559764800,888,287,0,1175,23,-0.6530250795228395,2.380825950259861
87,1559779200,112,54,0,166,23,-0.6530250795228395,-0.56566606925431
87,1559793600,6,5,0,11,23,-0.6530250795228395,-1.0182986391499458
87,1559808000,37,91,54,128,23,0.23071423958691997,-0.6766340541319497
87,1559822400,219,416,197,635,23,2.570986880933135,0.8039124809460334
87,1559836800,281,292,11,573,23,-0.4730041071115922,0.622859452987779
87,1559851200,887,236,0,1123,23,-0.6530250795228395,2.228975023585196
87,1559865600,108,48,0,156,23,-0.6530250795228395,-0.5948681705378993
87,1559880000,8,6,0,14,23,-0.6530250795228395,-1.0095380087648689
87,1559894400,42,118,76,160,23,0.5907561844094146,-0.5831873300244635
87,1559908800,224,360,136,584,23,1.5726887611980362,0.6549817643997273
87,1559923200,346,282,0,628,23,-0.6530250795228395,0.7834710100475207
87,1559937600,760,253,0,1013,23,-0.6530250795228395,1.907751909465713
87,1559952000,84,82,0,166,23,-0.6530250795228395,-0.56566606925431
87,1559966400,14,17,3,31,23,-0.6039284506834084,-0.959894436582767
87,1559980800,8,14,6,22,23,-0.5548318218439773,-0.9861763277379973
87,1559995200,47,153,106,200,23,1.0817224728037254,-0.4663789248901059
87,1560009600,116,147,31,263,23,-0.14569324818205162,-0.28240568680349265
87,1560024000,122,146,24,268,23,-0.26025204880739083,-0.2678046361616979
87,1560038400,58,56,0,114,23,-0.6530250795228395,-0.7175169959289749
87,1560052800,9,11,2,20,23,-0.6202939936298854,-0.9920167479947153
87,1560067200,9,12,3,21,23,-0.6039284506834084,-0.9890965378663563
87,1560081600,34,193,159,227,23,1.9490962489670078,-0.3875332514244145
87,1560096000,75,190,115,265,23,1.2290123593220186,-0.27656526654677477
87,1560110400,92,119,27,211,23,-0.21115541996795975,-0.4342566134781576
87,1560124800,54,46,0,100,23,-0.6530250795228395,-0.758399937726
87,1560139200,6,7,1,13,23,-0.6366595365763624,-1.0124582188932278
87,1560153600,44,103,59,147,23,0.3125419543193051,-0.6211500616931298
87,1560168000,208,355,147,563,23,1.7527097336092834,0.5936573517041897
87,1560182400,288,168,0,456,23,-0.6530250795228395,0.28119486796978294
87,1560196800,791,156,0,947,23,-0.6530250795228395,1.7150180409940228
87,1560211200,95,32,0,127,24,-0.6333004963811235,-0.8493181605822638
87,1560225600,9,2,0,11,24,-0.6333004963811235,-1.162912558335715
87,1560240000,39,110,71,149,24,0.5657484434338037,-0.7898433610083334
87,1560254400,214,367,153,581,24,1.9505655288538606,0.3780254306252091
87,1560268800,326,288,0,614,24,-0.6333004963811235,0.46723762998610474
87,1560283200,880,232,0,1112,24,-0.6333004963811235,1.8135308203414384
87,1560297600,124,64,0,188,24,-0.6333004963811235,-0.6844107617636386
87,1560312000,10,3,0,13,24,-0.6333004963811235,-1.1575057583744486
87,1560326400,48,122,74,170,24,0.6164124831442936,-0.7330719614150362
87,1560340800,272,436,164,708,24,2.13633367445899,0.7213572281656255
87,1560355200,318,253,0,571,24,-0.6333004963811235,0.3509914308188771
87,1560369600,915,270,0,1185,24,-0.6333004963811235,2.0108790189276617
87,1560384000,132,47,0,179,24,-0.6333004963811235,-0.7087413615893374
87,1560398400,7,3,0,10,24,-0.6333004963811235,-1.1656159583163483
87,1560412800,54,117,63,171,24,0.43064433753916403,-0.730368561434403
87,1560427200,227,359,132,586,24,1.5959172508804313,0.3915424305283751
87,1560441600,297,252,0,549,24,-0.6333004963811235,0.2915166312449467
87,1560456000,848,262,0,1110,24,-0.6333004963811235,1.8081240203801718
87,1560470400,119,63,0,182,24,-0.6333004963811235,-0.7006311616474378
87,1560484800,8,5,0,13,24,-0.6333004963811235,-1.1575057583744486
87,1560499200,42,108,66,150,24,0.4813083772496539,-0.7871399610277002
87,1560513600,224,401,177,625,24,2.3558778465377794,0.49697502977306995
87,1560528000,376,293,0,669,24,-0.6333004963811235,0.6159246289209307
87,1560542400,697,218,0,915,24,-0.6333004963811235,1.280961024156698
87,1561161600,8105,6166,0,14271,25,-0.5959937708653434,4.108783663411756
87,1561176000,15,7,0,22,25,-0.5959937708653434,-0.306251053268697
87,1561190400,10,28,18,38,25,-0.29845604858433994,-0.3012934734057671
87,1561204800,33,171,138,204,25,1.6851287666223498,-0.2498585823278701
87,1561219200,112,123,11,235,25,-0.41416516280473015,-0.24025327134344351
87,1561233600,102,143,41,245,25,0.08173104099694228,-0.23715478392911238
87,1561248000,57,49,0,106,25,-0.5959937708653434,-0.2802237589883153
87,1561262400,7,8,1,15,25,-0.5794638974052877,-0.3084199944587288
87,1561276800,6,16,10,22,25,-0.4306950362647859,-0.306251053268697
87,1561291200,44,136,92,180,25,0.9247545874597854,-0.25729495212226483
87,1561305600,77,73,0,150,25,-0.5959937708653434,-0.26659041436525827
87,1561320000,73,104,31,177,25,-0.0835676936036152,-0.2582244983465642
87,1561334400,44,66,22,110,25,-0.23233655474411694,-0.27898436402258286
87,1561348800,5,4,0,9,25,-0.5959937708653434,-0.3102790869073275
87,1561363200,35,84,49,119,25,0.21397002867738826,-0.27619572534968484
87,1561377600,192,428,236,620,25,3.3050563657078134,-0.12096150589169433
87,1561392000,298,260,0,558,25,-0.5959937708653434,-0.14017212786054745
87,1561406400,820,286,0,1106,25,-0.5959937708653434,0.02962498244479947
87,1561420800,93,51,0,144,26,-0.6579143030552717,-0.5860485564204443
87,1561435200,5,6,1,11,26,-0.6393316529353513,-0.9701014935584783
87,1561449600,36,77,41,113,26,0.10397435186145852,-0.675564654550362
87,1561464000,217,328,111,545,26,1.404759860255876,0.5718854871310717
87,1561478400,292,266,0,558,26,-0.6579143030552717,0.609424496024263
87,1561492800,824,257,0,1081,26,-0.6579143030552717,2.1196476999580356
87,1561507200,82,53,0,135,26,-0.6579143030552717,-0.6120371010388075
87,1561521600,6,11,5,17,26,-0.5650010524556703,-0.9527757971462362
87,1561536000,51,85,34,136,26,-0.02610419897798321,-0.6091494849701005
87,1561550400,245,366,121,611,26,1.5905863614550784,0.7624681476657351
87,1561564800,288,272,0,560,26,-0.6579143030552717,0.615199728161677
87,1561579200,901,299,0,1200,26,-0.6579143030552717,2.463274012134171
87,1561593600,121,63,0,184,26,-0.6579143030552717,-0.4705439136721634
87,1561608000,10,9,0,19,26,-0.6579143030552717,-0.9470005650088221
87,1561622400,30,103,73,133,26,0.6986191556989064,-0.6178123331762215
87,1561636800,228,425,197,653,26,3.002867770569017,0.8837480225514301
87,1561651200,390,271,0,661,26,-0.6579143030552717,0.9068489511010863
87,1561665600,860,298,0,1158,26,-0.6579143030552717,2.3419941372484763
87,1561680000,108,90,0,198,26,-0.6579143030552717,-0.43011728871026506
87,1561694400,12,5,0,17,26,-0.6579143030552717,-0.9527757971462362
87,1561708800,28,97,69,125,26,0.6242885552192254,-0.6409132617258777
87,1561723200,213,401,188,614,26,2.835623919489735,0.7711309958718562
87,1561737600,341,310,0,651,26,-0.6579143030552717,0.8779727904140161
87,1561752000,702,204,0,906,26,-0.6579143030552717,1.6143148879343068
87,1561766400,81,65,0,146,26,-0.6579143030552717,-0.5802733242830302
87,1561780800,15,18,3,33,26,-0.6021663526955109,-0.9065739400469238
87,1561795200,7,17,10,24,26,-0.47208780185606913,-0.932562484665287
87,1561809600,45,141,96,186,26,1.1260201084570722,-0.4647686815347494
87,1561824000,80,128,48,208,26,0.23405290270090026,-0.40124112802319484
87,1561838400,102,73,0,175,26,-0.6579143030552717,-0.4965324582905266
87,1561852800,53,74,21,127,26,-0.26767865053694645,-0.6351380295884637
87,1561867200,7,4,0,11,26,-0.6579143030552717,-0.9701014935584783
87,1561881600,5,14,9,19,26,-0.4906704519759894,-0.9470005650088221
87,1561896000,64,161,97,225,26,1.1446027585769925,-0.35215165485517547
87,1561910400,107,135,28,242,26,-0.1376000996975047,-0.3030621816871561
87,1561924800,90,152,62,242,26,0.49421000437978374,-0.3030621816871561
87,1561939200,40,87,47,127,26,0.21547025258098002,-0.6351380295884637
87,1561953600,11,5,0,16,26,-0.6579143030552717,-0.9556634132149432
87,1561968000,33,90,57,123,26,0.4012967537801825,-0.6466884938632917
87,1561982400,208,377,169,585,26,2.48255356721125,0.6873901298793526
87,1561996800,304,268,0,572,26,-0.6579143030552717,0.6498511209861613
87,1562011200,838,243,0,1081,26,-0.6579143030552717,2.1196476999580356
87,1562025600,100,76,0,176,27,-0.5594244973949672,-0.39779402218690585
87,1562040000,8,6,0,14,27,-0.5594244973949672,-0.9545617856094468
87,1562054400,51,113,62,164,27,0.1713083345770968,-0.4390360787367237
87,1562068800,212,362,150,574,27,1.2084775154406715,0.9700675200487193
87,1562083200,319,273,0,592,27,-0.5594244973949672,1.0319306048734462
87,1562097600,817,287,0,1104,27,-0.5594244973949672,2.7915916843323405
87,1562112000,83,80,0,163,27,-0.5594244973949672,-0.44247291678254186
87,1562126400,10,2,0,12,27,-0.5594244973949672,-0.9614354617010831
87,1562136677,8,37,29,45,27,-0.21763010824674378,-0.848019806189084
87,1562140800,26,73,47,99,27,-0.005481866706467107,-0.6624305517149037
87,1562155200,190,331,141,521,27,1.1024033946705332,0.7879151036203572
87,1562169600,461,300,0,761,27,-0.5594244973949672,1.6127562346167141
87,1562184000,576,241,0,817,27,-0.5594244973949672,1.8052191651825304
87,1562198400,76,95,19,171,27,-0.33549024243578635,-0.41497821241599664
87,1562212800,8,7,0,15,27,-0.5594244973949672,-0.9511249475636286
87,1562227200,7,11,4,18,27,-0.5122804437193502,-0.9408144334261741
87,1562241600,37,122,85,159,27,0.44238664321189475,-0.45622026896581447
87,1562256000,84,120,36,204,27,-0.13512801431441396,-0.3015625569039975
87,1562270400,51,511,460,562,27,4.862141675300992,0.9288254634989015
87,1562284800,455,355,0,810,27,-0.5594244973949672,1.7811612988618035
87,1562299200,6,10,4,16,27,-0.5122804437193502,-0.9476881095178105
87,1562313600,12,46,34,58,27,-0.15870004115222247,-0.803340911593448
87,1562328000,81,323,242,404,27,2.292790749979863,0.38580505225963324
87,1562342400,197,238,41,435,27,-0.07619794721989266,0.492347031679996
87,1562356800,316,178,0,494,27,-0.5594244973949672,0.695120476383267
87,1562371200,65,60,0,125,27,-0.5594244973949672,-0.5730727625236317
87,1562385600,8,7,0,15,27,-0.5594244973949672,-0.9511249475636286
87,1562400000,5,16,11,21,27,-0.42977834978702045,-0.9305039192887197
87,1562414400,61,227,166,288,27,1.3970537301431396,-0.012868161055272626
87,1562428800,100,213,113,313,27,0.7723950189412139,0.07305279009018122
87,1562443200,115,150,35,265,27,-0.14691402773331821,-0.09191543610909017
87,1562457600,46,54,8,100,27,-0.46513639004373325,-0.6589937136690855
87,1562472000,7,15,8,22,27,-0.46513639004373325,-0.9270670812429015
87,1562486400,4,11,7,15,27,-0.4769224034626375,-0.9511249475636286
87,1562500800,36,148,112,184,27,0.7606090055223097,-0.37029931782036063
87,1562515200,90,125,35,215,27,-0.14691402773331821,-0.2637573383999979
87,1562529600,105,107,2,212,27,-0.5358524705571588,-0.2740678525374523
87,1562544000,64,42,0,106,27,-0.5594244973949672,-0.6383726853941766
87,1562558400,10,5,0,15,27,-0.5594244973949672,-0.9511249475636286
87,1562572800,30,97,67,127,27,0.23023840167161808,-0.5661990864319953
87,1562587200,224,347,123,571,27,0.8902551531302565,0.9597570059112649
87,1562601600,271,246,0,517,27,-0.5594244973949672,0.7741677514370846
87,1562616000,794,252,0,1046,27,-0.5594244973949672,2.5922550776748876
87,1562630400,90,76,0,166,28,-0.6558346501661644,-0.4800801509101898
87,1562644800,8,5,0,13,28,-0.6558346501661644,-0.9342233939175326
87,1562659200,43,110,67,153,28,0.40786489194771836,-0.5186674852833627
87,1562673600,244,362,118,606,28,1.2175466329597784,0.8259527047972013
87,1562688000,301,269,0,570,28,-0.6558346501661644,0.7190954711484148
87,1562702400,821,244,0,1065,28,-0.6558346501661644,2.1883824338192297
87,1562716800,104,53,0,157,28,-0.6558346501661644,-0.5067944593223864
87,1562731200,9,12,3,21,28,-0.6082063124595727,-0.9104773419955801
87,1562745600,23,144,121,167,28,1.2651749706663702,-0.4771118944199457
87,1562760000,28,105,77,133,28,0.5666260176363576,-0.5780326150882441
87,1562774400,290,199,0,489,28,-0.6558346501661644,0.478666695438645
87,1562788800,831,269,0,1100,28,-0.6558346501661644,2.292271410977772
87,1562803200,104,65,0,169,28,-0.6558346501661644,-0.4711753814394576
87,1562817600,8,6,0,14,28,-0.6558346501661644,-0.9312551374272885
87,1562832000,42,75,33,117,28,-0.131922935393655,-0.6255247189321492
87,1562846400,250,461,211,711,28,2.6940251018641233,1.1376196362728286
87,1562860800,320,265,0,585,28,-0.6558346501661644,0.7636193185020758
87,1562875200,822,193,0,1015,28,-0.6558346501661644,2.0399696093070263
87,1562889600,72,50,0,122,28,-0.6558346501661644,-0.6106834364809289
87,1562904000,11,8,0,19,28,-0.6558346501661644,-0.9164138549760682
87,1562918400,29,91,62,120,28,0.32848432910339875,-0.6166199494614171
87,1562932800,240,402,162,642,28,1.916095585989791,0.9328099384459878
87,1562947200,311,304,0,615,28,-0.6558346501661644,0.8526670132093979
87,1562961600,622,293,0,915,28,-0.6558346501661644,1.7431439602826193
87,1562976000,148,97,0,245,28,-0.6558346501661644,-0.24558788818090824
87,1562990400,9,9,0,18,28,-0.6558346501661644,-0.9193821114663122
87,1563004800,5,17,12,22,28,-0.4653212993397973,-0.9075090855053359
87,1563019200,17,184,167,201,28,1.9954761488341106,-0.37619117375164735
87,1563033600,48,143,95,191,28,0.8523960438759082,-0.40587373865408805
87,1563048000,82,140,58,222,28,0.26497987882794305,-0.3138577874565219
87,1563062400,62,64,2,126,28,-0.6240824250284366,-0.5988104105199527
87,1563076800,9,10,1,19,28,-0.6399585375973005,-0.9164138549760682
87,1563091200,2,9,7,11,28,-0.544701862184117,-0.9401599068980208
87,1563105600,18,218,200,236,28,2.51938786360662,-0.27230219659310484
87,1563120000,40,98,58,138,28,0.26497987882794305,-0.5631913326370238
87,1563134400,60,95,35,155,28,-0.10017071025592714,-0.5127309723028746
87,1563148800,34,41,7,75,28,-0.544701862184117,-0.7501914915224003
87,1563163200,11,7,0,18,28,-0.6558346501661644,-0.9193821114663122
87,1563177600,24,73,49,97,28,0.12209486570816777,-0.6848898487370306
87,1563192000,228,418,190,646,28,2.360626737917981,0.9446829644069641
87,1563206400,278,245,0,523,28,-0.6558346501661644,0.5795874161069434
87,1563220800,860,278,0,1138,28,-0.6558346501661644,2.405065157607047
87,1563235200,95,70,0,165,29,-0.6001575697890806,-0.48504136634799655
87,1563249600,13,8,0,21,29,-0.6001575697890806,-0.8913474859702517
87,1563264000,50,107,57,157,29,0.6082337019309018,-0.5076139285492329
87,1563278400,259,373,114,632,29,1.8166249736508842,0.8326319521491784
87,1563292800,276,310,34,586,29,0.1206372238684527,0.702839719492069
87,1563307200,875,312,0,1187,29,-0.6001575697890806,2.3986034548599537
87,1563321600,110,87,0,197,29,-0.6001575697890806,-0.3947511175430509
87,1563336000,10,5,0,15,29,-0.6001575697890806,-0.9082769076211791
87,1563350400,36,99,63,135,29,0.7354327831645842,-0.569688474602633
87,1563364800,256,379,123,635,29,2.007423595501408,0.841096662974642
87,1563379200,271,238,0,509,29,-0.6001575697890806,0.4855788083051687
87,1563393600,889,250,0,1139,29,-0.6001575697890806,2.2631680816525352
87,1563408000,76,40,0,116,29,-0.6001575697890806,-0.6232983098305694
87,1563422400,11,8,0,19,29,-0.6001575697890806,-0.8969906265205608
87,1563436800,42,105,63,147,29,0.7354327831645842,-0.5358296313007784
87,1563451200,222,313,91,535,29,1.329028495588435,0.558939635459187
87,1563465600,347,257,0,604,29,-0.6001575697890806,0.7536279844448509
87,1563480000,793,257,0,1050,29,-0.6001575697890806,2.01204832716378
87,1563494400,127,101,0,228,29,-0.6001575697890806,-0.30728243901325986
87,1563508800,13,6,0,19,29,-0.6001575697890806,-0.8969906265205608
87,1563523200,36,95,59,131,29,0.6506333956754625,-0.5809747557032512
87,1563537600,201,411,210,612,29,3.8518102733898023,0.7762005466460874
87,1563552000,348,211,0,559,29,-0.6001575697890806,0.6266573220628963
87,1563566400,760,391,0,1151,29,-0.6001575697890806,2.2970269249543898
87,1563580800,107,77,0,184,29,-0.6001575697890806,-0.43143153112006005
87,1563595200,14,16,2,30,29,-0.5577578760445199,-0.8659533534938608
87,1563609600,4,15,11,19,29,-0.36695925419399633,-0.8969906265205608
87,1563624000,42,142,100,184,29,1.5198271174389586,-0.43143153112006005
87,1563638400,89,108,19,197,29,-0.1973604792157532,-0.3947511175430509
87,1563652800,84,74,0,158,29,-0.6001575697890806,-0.5047923582740784
87,1563667200,71,52,0,123,29,-0.6001575697890806,-0.6035473179044877
87,1563681600,6,3,0,9,29,-0.6001575697890806,-0.9252063292721063
87,1563696000,4,11,7,15,29,-0.4517586416831179,-0.9082769076211791
87,1563710400,18,76,58,94,29,0.6294335488031821,-0.6853728558839696
87,1563724800,57,60,3,117,29,-0.5365580291722395,-0.6204767395554149
87,1563739200,66,78,12,144,29,-0.34575940732171595,-0.5442943421262421
87,1563753600,34,33,0,67,29,-0.6001575697890806,-0.7615552533131424
87,1563768000,5,5,0,10,29,-0.6001575697890806,-0.9223847589969518
87,1563782400,26,66,40,92,29,0.24783630510213506,-0.6910159964342787
87,1563796800,223,346,123,569,29,2.007423595501408,0.6548730248144417
87,1563811200,256,255,0,511,29,-0.6001575697890806,0.4912219488554778
87,1563825600,833,245,0,1078,29,-0.6001575697890806,2.0910522948681076
87,1563840000,79,49,0,128,30,-0.6962477382953745,-0.6764360428074603
87,1563854400,9,6,0,15,30,-0.6962477382953745,-1.0161213098865214
87,1563868800,32,79,47,111,30,-0.0014079832928116725,-0.7275391360848411
87,1563883200,249,337,88,586,30,0.6047288242626154,0.7003414113713892
87,1563897600,274,255,0,529,30,-0.6962477382953745,0.5289957456766415
87,1563912000,865,228,0,1093,30,-0.6962477382953745,2.224416016761513
87,1563926400,79,80,1,159,30,-0.6814639137208519,-0.583248049184001
87,1563940800,8,14,6,22,30,-0.6075447908482389,-0.9950788597134821
87,1563955200,37,106,69,143,30,0.3238361573466858,-0.6313450781509476
87,1563969600,224,380,156,604,30,1.6100288953301531,0.7544505689592041
87,1563984000,316,267,0,583,30,-0.6962477382953745,0.6913232184400866
87,1563998400,842,299,0,1141,30,-0.6962477382953745,2.368707103662353
87,1564012800,114,96,0,210,30,-0.6962477382953745,-0.4299387693518584
87,1564027200,15,12,0,27,30,-0.6962477382953745,-0.9800485381613113
87,1564041600,38,92,54,130,30,0.10207878872884663,-0.6704239141865919
87,1564056000,213,418,205,631,30,2.3344362994817613,0.8356143053409267
87,1564070400,341,235,0,576,30,-0.6962477382953745,0.6702807682670474
87,1564084800,796,309,0,1105,30,-0.6962477382953745,2.2604887884867226
87,1564099200,114,102,0,216,30,-0.6962477382953745,-0.41190238348925334
87,1564113600,17,9,0,26,30,-0.6962477382953745,-0.9830546024717455
87,1564128000,34,106,72,140,30,0.36818763107025365,-0.6403632710822502
87,1564142400,222,381,159,603,30,1.6543803690537209,0.75144450464877
87,1564156800,314,290,0,604,30,-0.6962477382953745,0.7544505689592041
87,1564171200,685,228,0,913,30,-0.6962477382953745,1.6833244408833623
87,1564185600,93,76,0,169,30,-0.6962477382953745,-0.5531874060796593
87,1564200000,15,13,0,28,30,-0.6962477382953745,-0.9770424738508772
87,1564214400,6,12,6,18,30,-0.6075447908482389,-1.007103116955219
87,1564228800,37,248,211,285,30,2.423139246928897,-0.2044839460692957
87,1564243200,105,254,149,359,30,1.5065421233084948,0.017964812902832788
87,1564257600,106,233,127,339,30,1.1812979826689973,-0.04215647330585059
87,1564272000,64,92,28,156,30,-0.28230065020874134,-0.5922662421153035
87,1564286400,12,9,0,21,30,-0.6962477382953745,-0.9980849240239164
87,1564300800,10,10,0,20,30,-0.6962477382953745,-1.0010909883343504
87,1564315200,22,163,141,185,30,1.3882715267123138,-0.5050903771127127
87,1564329600,86,191,105,277,30,0.8560538420294999,-0.22853246055276907
87,1564344000,89,172,83,261,30,0.5308097013900024,-0.2766294895197158
87,1564358400,76,70,0,146,30,-0.6962477382953745,-0.6223268852196452
87,1564372800,7,4,0,11,30,-0.6962477382953745,-1.028145567128258
87,1564387200,26,82,56,108,30,0.13164643787789185,-0.7365573290161436
87,1564401600,199,414,215,613,30,2.4822745452269874,0.7815051477531116
87,1564416000,259,198,0,457,30,-0.6962477382953745,0.31255911532538133
87,1564430400,799,280,0,1079,30,-0.6962477382953745,2.182331116415434
87,1564444800,85,79,0,164,31,-0.5532891052318437,-0.706364319883952
87,1564459200,11,7,0,18,31,-0.5532891052318437,-1.1121850408010479
87,1564473600,38,88,50,126,31,0.140490337065139,-0.8119888910815524
87,1564488000,234,420,186,654,31,2.027570420112932,0.6556367297693151
87,1564502400,258,211,0,469,31,-0.5532891052318437,0.14141184367573462
87,1564516800,858,281,0,1139,31,-0.5532891052318437,2.003739809528161
87,1564531200,102,83,0,185,31,-0.5532891052318437,-0.6479928463273834
87,1564545600,6,3,0,9,31,-0.5532891052318437,-1.1372013866110058
87,1564560000,33,86,53,119,31,0.18211710360295796,-0.8314460489337419
87,1564574400,232,403,171,635,31,1.8194365874238372,0.6028244441705148
87,1564588800,319,223,0,542,31,-0.5532891052318437,0.34432220413428255
87,1564603200,779,238,0,1017,31,-0.5532891052318437,1.6646293441042863
87,1564617600,98,52,0,150,31,-0.5532891052318437,-0.7452786355883311
87,1564632000,7,6,0,13,31,-0.5532891052318437,-1.1260830106954691
87,1564646400,40,85,45,125,31,0.07111239283544073,-0.8147684850604365
87,1564660800,231,374,143,605,31,1.4309200997375269,0.5194366248039883
87,1564675200,280,275,0,555,31,-0.5532891052318437,0.3804569258597774
87,1564689600,840,299,0,1139,31,-0.5532891052318437,2.003739809528161
87,1564704000,123,45,0,168,31,-0.5532891052318437,-0.6952459439684151
87,1564718400,9,10,1,19,31,-0.5394135163859041,-1.1094054468221637
87,1564732800,33,78,45,111,31,0.07111239283544073,-0.8536828007648156
87,1564747200,183,446,263,629,31,3.0959907612502855,0.5861468802972096
87,1564761600,322,249,0,571,31,-0.5532891052318437,0.4249304295219249
87,1564776000,657,216,0,873,31,-0.5532891052318437,1.2643678111449588
87,1565395200,7677,6316,0,13993,32,-0.7605189175499728,4.1093470129709475
87,1565409600,10,10,0,20,32,-0.7605189175499728,-0.3096461232057804
87,1565424000,6,20,14,26,32,-0.4894428677301805,-0.30774860951387023
87,1565438400,40,186,146,226,32,2.0664170305707183,-0.24449815311686562
87,1565452800,141,152,11,293,32,-0.5475305926915646,-0.22330925022386908
87,1565467200,122,159,37,281,32,-0.04410364302623606,-0.22710427760768934
87,1565481600,51,100,49,151,32,0.18824725681930018,-0.2682170742657424
87,1565496000,8,12,4,20,32,-0.6830686176014606,-0.3096461232057804
87,1565510400,6,12,6,18,32,-0.6443434676272046,-0.3102786277697504
87,1565524800,23,169,146,192,32,2.0664170305707183,-0.2552507307043564
87,1565539200,66,127,61,193,32,0.4205981566648364,-0.2549344784223714
87,1565553600,82,112,30,194,32,-0.1796416679361322,-0.2546182261403864
87,1565568000,47,23,0,70,32,-0.7605189175499728,-0.2938335091065292
87,1565582400,4,3,0,7,32,-0.7605189175499728,-0.31375740287158566
87,1565596800,38,96,58,134,32,0.3625104317034523,-0.2735933630594877
87,1565611200,229,374,145,603,32,2.04705445558359,-0.12527104280851192
87,1565625600,256,229,0,485,32,-0.7605189175499728,-0.16258881208274464
87,1565640000,784,294,0,1078,32,-0.7605189175499728,0.02494879113437405
87,1565654400,89,57,0,146,33,-0.6356529424441721,-0.6118024891543554
87,1565668800,10,4,0,14,33,-0.6356529424441721,-0.9894701208069272
87,1565683200,38,93,55,131,33,0.21606300711849463,-0.6547192654785113
87,1565697600,228,359,131,587,33,1.3929795919687251,0.6499507347758274
87,1565712000,311,254,0,565,33,-0.6356529424441721,0.5870061295003988
87,1565726400,827,238,0,1065,33,-0.6356529424441721,2.017565340305595
87,1565740800,80,42,0,122,33,-0.6356529424441721,-0.6804693312730048
87,1565755200,9,2,0,11,33,-0.6356529424441721,-0.9980534760717583
87,1565769600,45,103,58,148,33,0.2625202407310037,-0.6060802523111346
87,1565784000,234,399,165,633,33,1.9194949062438282,0.7815621821699055
87,1565798400,334,266,0,600,33,-0.6356529424441721,0.6871452742567625
87,1565812800,759,275,0,1034,33,-0.6356529424441721,1.9288706692356727
87,1565827200,104,68,0,172,33,-0.6356529424441721,-0.5374134101924852
87,1565841600,12,3,0,15,33,-0.6356529424441721,-0.9866090023853168
87,1565856000,37,92,55,129,33,0.21606300711849463,-0.6604415023217322
87,1565870400,255,409,154,664,33,1.7491517163312948,0.8702568532398276
87,1565884800,326,300,0,626,33,-0.6356529424441721,0.7615343532186327
87,1565899200,822,264,0,1086,33,-0.6356529424441721,2.0776488271594133
87,1565913600,108,39,0,147,33,-0.6356529424441721,-0.608941370732745
87,1565928000,12,6,0,18,33,-0.6356529424441721,-0.9780256471204856
87,1565942400,51,89,38,140,33,-0.047194650019056913,-0.6289691996840178
87,1565956800,441,700,259,1141,33,3.3751548927691135,2.235010340347985
87,1565971200,335,240,0,575,33,-0.6356529424441721,0.6156173137165027
87,1565985600,672,344,0,1016,33,-0.6356529424441721,1.8773705376466858
87,1566000000,68,59,0,127,33,-0.6356529424441721,-0.6661637391649529
87,1566014400,14,12,0,26,33,-0.6356529424441721,-0.9551366997476025
87,1566028800,11,23,12,34,33,-0.44982400799413574,-0.9322477523747194
87,1566043200,46,225,179,271,33,2.136295329768871,-0.25416268645305645
87,1566057600,125,233,108,358,33,1.0368074676061554,-0.005245383772952331
87,1566072000,127,193,66,320,33,0.38640619703102796,-0.11396788379414723
87,1566086400,83,71,0,154,33,-0.6356529424441721,-0.5889135417814723
87,1566100800,11,13,2,24,33,-0.604681453369166,-0.9608589365908232
87,1566115200,6,15,9,21,33,-0.49628124160664483,-0.9694422918556544
87,1566129600,34,189,155,223,33,1.7646374608687978,-0.39149637069035526
87,1566144000,89,176,87,265,33,0.7116068323185917,-0.2713293969827188
87,1566158400,106,87,0,193,33,-0.6356529424441721,-0.47732992333866703
87,1566172800,54,49,0,103,33,-0.6356529424441721,-0.7348305812836023
87,1566187200,10,6,0,16,33,-0.6356529424441721,-0.9837478839637064
87,1566201600,25,91,66,116,33,0.38640619703102796,-0.6976360418026673
87,1566216000,201,326,125,527,33,1.300065124743707,0.47828362947920394
87,1566230400,284,275,0,559,33,-0.6356529424441721,0.5698394189707364
87,1566244800,768,223,0,991,33,-0.6356529424441721,1.805842577106426
87,1566259200,72,63,0,135,34,-0.6900905486679821,-0.6443099768464764
87,1566273600,9,7,0,16,34,-0.6900905486679821,-1.0236551605287345
87,1566288000,33,77,44,110,34,0.05831751115504079,-0.7240043431662785
87,1566302400,233,354,121,587,34,1.368031615845331,0.7965641662155462
87,1566316800,273,311,38,584,34,-0.043738133366280525,0.7870008422571699
87,1566331200,833,266,0,1099,34,-0.6900905486679821,2.428704788445094
87,1566345600,103,58,0,161,34,-0.6900905486679821,-0.5614278358738822
87,1566360000,17,6,0,23,34,-0.6900905486679821,-1.0013407379591899
87,1566374400,36,92,56,128,34,0.2624288001976834,-0.666624399416021
87,1566388800,232,376,144,608,34,1.7592449198437294,0.86350743392418
87,1566403200,269,305,36,574,34,-0.0777566815400543,0.7551230957292491
87,1566417600,808,206,0,1014,34,-0.6900905486679821,2.1577439429577665
87,1566432000,77,66,0,143,34,-0.6900905486679821,-0.6188077796241397
87,1566446400,10,8,0,18,34,-0.6900905486679821,-1.0172796112231504
87,1566460800,37,85,48,122,34,0.12635460750258834,-0.6857510473327735
87,1566475200,191,358,167,549,34,2.150458223842128,0.675428729409447
87,1566489600,254,272,18,526,34,-0.38392361510401823,0.6021099123952289
87,1566504000,777,230,0,1007,34,-0.6900905486679821,2.135429520388222
87,1566518400,93,70,0,163,34,-0.6900905486679821,-0.555052286568298
87,1566532800,8,7,0,15,34,-0.6900905486679821,-1.0268429351815267
87,1566547200,33,82,49,115,34,0.14336388158947522,-0.7080654699023181
87,1566561600,174,305,131,479,34,1.5381243567141998,0.452284503714001
87,1566576000,290,266,0,556,34,-0.6900905486679821,0.6977431519789915
87,1566590400,586,202,0,788,34,-0.6900905486679821,1.4373068714267554
87,1566604800,70,68,0,138,34,-0.6900905486679821,-0.6347466528881002
87,1566619200,12,12,0,24,34,-0.6900905486679821,-0.9981529633063979
87,1566633600,12,26,14,38,34,-0.4519607114515658,-0.9535241181673086
87,1566648000,48,173,125,221,34,1.4360687121928786,-0.3701613567063571
87,1566662400,120,252,132,372,34,1.5551336308010868,0.11119261586524783
87,1566676800,163,161,0,324,34,-0.6900905486679821,-0.041820567468772274
87,1566691200,92,63,0,155,34,-0.6900905486679821,-0.5805544837906347
87,1566705600,10,9,0,19,34,-0.6900905486679821,-1.0140918365703584
87,1566720000,9,20,11,29,34,-0.5029885337122264,-0.9822140900424374
87,1566734400,34,182,148,216,34,1.8272820161912768,-0.3861002299703175
87,1566748800,97,177,80,274,34,0.6706513782829686,-0.20120930010837654
87,1566763200,146,201,55,347,34,0.24541952611079654,0.031498249545445695
87,1566777600,83,75,0,158,34,-0.6900905486679821,-0.5709911598322585
87,1566792000,5,9,4,14,34,-0.6220534523204346,-1.0300307098343187
87,1566806400,24,74,50,98,34,0.1603731556763621,-0.7622576389997836
87,1566820800,213,445,232,658,34,3.2560610394897753,1.0228961665637841
87,1566835200,261,262,1,523,34,-0.6730812745810953,0.5925465884368527
87,1566849600,781,250,0,1031,34,-0.6900905486679821,2.211936112055232
87,1566864000,63,34,0,97,35,-0.45384338434087895,-0.4480228333211739
87,1566878400,0,1,1,1,35,-0.4349519847944796,-0.7500505985696229
87,1566892800,36,80,44,116,35,0.37737819570069114,-0.38824650478241834
87,1566907200,233,391,158,624,35,2.530997743990214,1.2099837529906239
87,1566921600,334,240,0,574,35,-0.45384338434087895,1.0526776252570567
87,1566936000,802,241,0,1043,35,-0.45384338434087895,2.528209103397917
87,1566950400,95,54,0,149,35,-0.45384338434087895,-0.28442446047826403
87,1566964800,0,3,3,3,35,-0.39716918570168097,-0.7437583534602801
87,1566979200,31,101,70,132,35,0.8685545839070735,-0.3379085439076769
87,1566993600,234,355,121,589,35,1.832015960773439,1.099869463577127
87,1567008000,297,273,0,570,35,-0.45384338434087895,1.0400931350383713
87,1567022400,787,205,0,992,35,-0.45384338434087895,2.367756853109678
87,1567036800,86,63,0,149,35,-0.45384338434087895,-0.28442446047826403
87,1567051200,1,6,5,7,35,-0.35938638660888234,-0.7311738632415947
87,1567065600,31,84,53,115,35,0.547400791618285,-0.3913926273370897
87,1567080000,219,456,237,675,35,4.02341830815576,1.3704360032788623
87,1567094400,301,293,0,594,35,-0.45384338434087895,1.1156000763504836
87,1567108800,737,239,0,976,35,-0.45384338434087895,2.3174188922349366
87,1567123200,79,55,0,134,35,-0.45384338434087895,-0.33161629879833415
87,1567137600,0,1,1,1,35,-0.4349519847944796,-0.7500505985696229
87,1567152000,20,82,62,102,35,0.717423387535879,-0.43229222054781713
87,1567166400,161,330,169,491,35,2.7388031390006065,0.7915494532193353
87,1567180800,429,292,0,721,35,-0.45384338434087895,1.5151576407937442
87,1567195200,486,208,0,694,35,-0.45384338434087895,1.4302123318176179
87,1567209600,71,47,0,118,35,-0.45384338434087895,-0.38195425967307567
87,1567224000,0,1,1,1,35,-0.4349519847944796,-0.7500505985696229
87,1567238400,0,2,2,2,35,-0.4160605852480803,-0.7469044760149515
87,1567252800,0,1,1,1,35,-0.4349519847944796,-0.7500505985696229
87,1567267200,0,1,1,1,35,-0.4349519847944796,-0.7500505985696229
87,1567281600,0,0,0,0,35,-0.45384338434087895,-0.7531967211242941
87,1567296000,0,1,1,1,35,-0.4349519847944796,-0.7500505985696229
87,1567310400,0,6,6,6,35,-0.34049498706248305,-0.7343199857962661
87,1567324800,0,0,0,0,35,-0.45384338434087895,-0.7531967211242941
87,1567339200,0,1,1,1,35,-0.4349519847944796,-0.7500505985696229
87,1567353600,0,0,0,0,35,-0.45384338434087895,-0.7531967211242941
87,1567368000,0,1,1,1,35,-0.4349519847944796,-0.7500505985696229
87,1567382400,0,1,1,1,35,-0.4349519847944796,-0.7500505985696229
87,1567396800,0,0,0,0,35,-0.45384338434087895,-0.7531967211242941
87,1567411200,3,10,7,13,35,-0.3216035875160837,-0.7122971279135667
87,1567425600,23,86,63,109,35,0.7363147870822783,-0.41026936266511776
87,1567440000,81,59,0,140,35,-0.45384338434087895,-0.3127395634703061
87,1567454400,60,51,0,111,35,-0.45384338434087895,-0.4039771175557751
87,1567468800,54,28,0,82,36,-0.5036048455321201,-0.6149234225706026
87,1567483200,3,5,2,8,36,-0.46465198455173523,-0.8094457632677459
87,1567497600,39,94,55,133,36,0.5675988314284669,-0.4808607283063552
87,1567512000,226,422,196,648,36,3.3137755305456085,0.8729096157345744
87,1567526400,305,299,0,604,36,-0.5036048455321201,0.7572476834281648
87,1567540800,845,247,0,1092,36,-0.5036048455321201,2.040043659917434
87,1567555200,100,45,0,145,36,-0.5036048455321201,-0.44931656495006167
87,1567569600,0,1,1,1,36,-0.4841284150419277,-0.8278465252255838
87,1567584000,41,101,60,142,36,0.6649809838794294,-0.4572026057891351
87,1567598400,268,363,95,631,36,1.3466560510361667,0.8282220509798253
87,1567612800,344,268,0,612,36,-0.5036048455321201,0.7782771256656938
87,1567627200,874,247,0,1121,36,-0.5036048455321201,2.116275388028477
87,1567641600,93,40,0,133,36,-0.5036048455321201,-0.4808607283063552
87,1567656000,1,2,1,3,36,-0.4841284150419277,-0.8225891646662015
87,1567670400,44,128,84,172,36,1.132415315644049,-0.3783421973984013
87,1567684800,258,438,180,696,36,3.0021526427025287,0.9990862691597484
87,1567699200,339,307,0,646,36,-0.5036048455321201,0.8676522551751921
87,1567713600,870,268,0,1138,36,-0.5036048455321201,2.1609629527832257
87,1567728000,127,66,0,193,36,-0.5036048455321201,-0.3231399115248877
87,1567742400,1,3,2,4,36,-0.46465198455173523,-0.8199604843865104
87,1567756800,44,96,52,140,36,0.5091695399578895,-0.4624599663485173
87,1567771200,261,390,129,651,36,2.0088546877027116,0.8807956565736478
87,1567785600,332,273,0,605,36,-0.5036048455321201,0.7598763637078559
87,1567800000,696,198,0,894,36,-0.5036048455321201,1.5195649645385911
87,1567814400,62,33,0,95,36,-0.5036048455321201,-0.5807505789346179
87,1567828800,0,3,3,3,36,-0.4451755540615427,-0.8225891646662015
87,1567843200,0,2,2,2,36,-0.46465198455173523,-0.8252178449458926
87,1567857600,2,1,0,3,36,-0.5036048455321201,-0.8225891646662015
87,1567872000,1,1,0,2,36,-0.5036048455321201,-0.8252178449458926
87,1567886400,1,2,1,3,36,-0.4841284150419277,-0.8225891646662015
87,1567900800,1,1,0,2,36,-0.5036048455321201,-0.8252178449458926
87,1567915200,0,1,1,1,36,-0.4841284150419277,-0.8278465252255838
87,1567929600,1,3,2,4,36,-0.46465198455173523,-0.8199604843865104
87,1567944000,0,0,0,0,36,-0.5036048455321201,-0.8304752055052749
87,1567958400,3,1,0,4,36,-0.5036048455321201,-0.8199604843865104
87,1567972800,0,4,4,4,36,-0.4256991235713502,-0.8199604843865104
87,1567987200,0,4,4,4,36,-0.4256991235713502,-0.8199604843865104
87,1568001600,1,2,1,3,36,-0.4841284150419277,-0.8225891646662015
87,1568016000,44,107,63,151,36,0.7234102753500068,-0.4335444832719149
87,1568030400,249,397,148,646,36,2.3789068670163687,0.8676522551751921
87,1568044800,362,287,0,649,36,-0.5036048455321201,0.8755382960142655
87,1568059200,890,309,0,1199,36,-0.5036048455321201,2.3213124498443842
87,1568073600,108,35,0,143,37,-0.5367756094315977,-0.5673449873025908
87,1568088000,4,11,7,15,37,-0.3795923134426637,-0.9114775216294246
87,1568102400,43,102,59,145,37,0.7880550281894173,-0.561967916453734
87,1568116800,268,399,131,667,37,2.404797501218453,0.8414475750978851
87,1568131200,341,274,0,615,37,-0.5367756094315977,0.701643733027609
87,1568145600,919,281,0,1200,37,-0.5367756094315977,2.2744369563182167
87,1568160000,134,50,0,184,37,-0.5367756094315977,-0.45711503490102684
87,1568174400,8,20,12,28,37,-0.26731853059342514,-0.8765265611118556
87,1568188800,48,129,81,177,37,1.282059672726067,-0.47593478287202556
87,1568203200,244,429,185,673,37,3.6173543559902295,0.8575787876444555
87,1568217600,329,304,0,633,37,-0.5367756094315977,0.7500373706673199
87,1568232000,917,278,0,1195,37,-0.5367756094315977,2.2609942791960744
87,1568246400,139,63,0,202,37,-0.5367756094315977,-0.4087213972613158
87,1568260800,7,15,8,22,37,-0.357137556872816,-0.8926577736584259
87,1568275200,47,124,77,171,37,1.1922406464466762,-0.49206599541859586
87,1568289600,298,349,51,647,37,0.6084169756306357,0.7876768666093173
87,1568304000,361,296,0,657,37,-0.5367756094315977,0.8145622208536013
87,1568318400,840,262,0,1102,37,-0.5367756094315977,2.0109604847242344
87,1568332800,127,36,0,163,37,-0.5367756094315977,-0.513574278814023
87,1568347200,9,5,0,14,37,-0.5367756094315977,-0.914166057053853
87,1568361600,31,118,87,149,37,1.4167882121451534,-0.5512137747560204
87,1568376000,271,402,131,673,37,2.404797501218453,0.8575787876444555
87,1568390400,346,300,0,646,37,-0.5367756094315977,0.784988331184889
87,1568404800,777,291,0,1068,37,-0.5367756094315977,1.9195502802936693
87,1568419200,92,49,0,141,37,-0.5367756094315977,-0.5727220581514475
87,1568433600,10,5,0,15,37,-0.5367756094315977,-0.9114775216294246
87,1568448000,7,15,8,22,37,-0.357137556872816,-0.8926577736584259
87,1568462400,40,42,2,82,37,-0.49186609629190226,-0.7313456481927225
87,1568476800,136,51,0,187,37,-0.5367756094315977,-0.44904942862774166
87,1568491200,132,44,0,176,37,-0.5367756094315977,-0.47862331829645394
87,1568505600,58,23,0,81,37,-0.5367756094315977,-0.7340341836171509
87,1568520000,9,9,0,18,37,-0.5367756094315977,-0.9034119153561394
87,1568534400,4,7,3,11,37,-0.46941133972205457,-0.9222316633271381
87,1568548800,37,43,6,80,37,-0.40204707001251144,-0.7367227190415793
87,1568563200,106,34,0,140,37,-0.5367756094315977,-0.575410593575876
87,1568577600,116,41,0,157,37,-0.5367756094315977,-0.5297054913605933
87,1568592000,43,9,0,52,37,-0.5367756094315977,-0.8120017109255742
87,1568606400,6,4,0,10,37,-0.5367756094315977,-0.9249201987515665
87,1568620800,37,121,84,158,37,1.34942394243561,-0.5270169559361649
87,1568635200,242,314,72,556,37,1.0799668635974375,0.5430201429863339
87,1568649600,358,284,0,642,37,-0.5367756094315977,0.7742341894871754
87,1568664000,902,250,0,1152,37,-0.5367756094315977,2.145387255945654
87,1568678400,119,59,0,178,38,-0.6629286386578099,-0.5488338714878751
87,1568692800,9,11,2,20,38,-0.6255052477658368,-0.9762557200025493
87,1568707200,45,111,66,156,38,0.5720432607773036,-0.6083483060911842
87,1568721600,271,385,114,656,38,1.470204642184659,0.7442524803476582
87,1568736000,346,260,0,606,38,-0.6629286386578099,0.608992401703774
87,1568750400,970,266,0,1236,38,-0.6629286386578099,2.313269392616715
87,1568764800,135,71,0,206,38,-0.6629286386578099,-0.47308822744729995
87,1568779200,17,9,0,26,38,-0.6629286386578099,-0.9600245105652832
87,1568793600,48,148,100,196,38,1.208240905940847,-0.5001402431760767
87,1568808000,289,360,71,649,38,0.6656017380072365,0.7253160693375144
87,1568822400,356,294,0,650,38,-0.6629286386578099,0.728021270910392
87,1568836800,921,253,0,1174,38,-0.6629286386578099,2.145546895098299
87,1568851200,135,52,0,187,38,-0.6629286386578099,-0.524487057331976
87,1568865600,20,7,0,27,38,-0.6629286386578099,-0.9573193089924055
87,1568880000,51,110,59,161,38,0.4410613926553977,-0.5948222982267958
87,1568894400,268,439,171,707,38,2.5367712826058932,0.8822177605644201
87,1568908800,370,336,0,706,38,-0.6629286386578099,0.8795125589915425
87,1568923200,879,284,0,1163,38,-0.6629286386578099,2.1157896777966445
87,1568937600,152,70,0,222,38,-0.6629286386578099,-0.429805002281257
87,1568952000,13,12,0,25,38,-0.6629286386578099,-0.9627297121381608
87,1568966400,40,121,81,161,38,0.8527186924671022,-0.5948222982267958
87,1568980800,233,446,213,679,38,3.3226624913373293,0.806472116523845
87,1568995200,424,359,0,783,38,-0.6629286386578099,1.087813080103124
87,1569009600,781,255,0,1036,38,-0.6629286386578099,1.7722290780411785
87,1569024000,87,42,0,129,38,-0.6629286386578099,-0.6813887485588817
87,1569038400,15,21,6,36,38,-0.5506584659818905,-0.9329724948365063
87,1569052800,8,17,9,25,38,-0.4945233796439308,-0.9627297121381608
87,1569067200,44,147,103,191,38,1.2643759922788067,-0.5136662510404653
87,1569081600,125,155,30,280,38,-0.10157777527821285,-0.2729033110543513
87,1569096000,126,162,36,288,38,0.010692397397706574,-0.2512616984713298
87,1569110400,50,44,0,94,38,-0.6629286386578099,-0.7760708036096007
87,1569124800,10,9,0,19,38,-0.6629286386578099,-0.978960921575427
87,1569139200,5,7,2,12,38,-0.6255052477658368,-0.9978973325855708
87,1569153600,36,176,140,212,38,1.9567087237803098,-0.4568570180100338
87,1569168000,92,145,53,237,38,0.32879121997947824,-0.3892269786880917
87,1569182400,93,121,28,214,38,-0.13900116617018599,-0.45144661486427845
87,1569196800,36,47,11,83,38,-0.4570999887519577,-0.8058280209112552
87,1569211200,6,4,0,10,38,-0.6629286386578099,-1.0033077357313263
87,1569225600,46,123,77,169,38,0.777871910683156,-0.5731806856437742
87,1569240000,244,360,116,604,38,1.507628033076632,0.6035819985580186
87,1569254400,339,282,0,621,38,-0.6629286386578099,0.6495704252969392
87,1569268800,885,278,0,1163,38,-0.6629286386578099,2.1157896777966445
87,1569283200,111,44,0,155,39,-0.6523004071638809,-0.5690219658102138
87,1569297600,6,4,0,10,39,-0.6523004071638809,-0.9909834259465938
87,1569312000,46,108,62,154,39,0.4667683737234465,-0.5719320448456371
87,1569321807,194,328,134,522,39,1.7663321192700203,0.49897704019014116
87,1569326400,82,96,14,178,39,-0.39960745664093605,-0.5020901479954777
87,1569340800,366,298,0,664,39,-0.6523004071638809,0.9122082632202513
87,1569355200,896,256,0,1152,39,-0.6523004071638809,2.3323268325068267
87,1569369600,114,66,0,180,39,-0.6523004071638809,-0.49626998992463106
87,1569384000,7,5,0,12,39,-0.6523004071638809,-0.9851632678757473
87,1569398400,54,110,56,164,39,0.35847139492789865,-0.542831254491404
87,1569412800,269,431,162,700,39,2.27171802031591,1.0169711084954904
87,1569427200,370,278,0,648,39,-0.6523004071638809,0.8656469986534783
87,1569441600,911,336,0,1247,39,-0.6523004071638809,2.6087843408720413
87,1569456000,142,66,0,208,39,-0.6523004071638809,-0.41478777693277835
87,1569470400,10,11,1,21,39,-0.6342509106979564,-0.9589725565569375
87,1569484800,41,119,78,160,39,0.7555603171782407,-0.5544715706330973
87,1569499200,249,409,160,658,39,2.2356190273840606,0.8947477890077113
87,1569513600,352,258,0,610,39,-0.6523004071638809,0.7550639953073924
87,1569528000,832,267,0,1099,39,-0.6523004071638809,2.1780926436293915
87,1569542400,155,58,0,213,39,-0.6523004071638809,-0.4002373817556618
87,1569556800,8,2,0,10,39,-0.6523004071638809,-0.9909834259465938
87,1569571200,47,103,56,150,39,0.35847139492789865,-0.5835723609873303
87,1569585600,225,404,179,629,39,2.578559460236629,0.8103554969804354
87,1569600000,333,264,0,597,39,-0.6523004071638809,0.7172329678468895
87,1569614400,764,267,0,1031,39,-0.6523004071638809,1.9802072692206063
87,1569628800,81,70,0,151,39,-0.6523004071638809,-0.5806622819519071
87,1569643200,15,8,0,23,39,-0.6523004071638809,-0.9531523984860908
87,1569657600,6,14,8,20,39,-0.5079044354364839,-0.9618826355923608
87,1569672000,40,176,136,216,39,1.8024311122018695,-0.39150714464939185
87,1569686400,97,223,126,320,39,1.6219361475426233,-0.08885892496536757
87,1569700800,138,121,0,259,39,-0.6523004071638809,-0.2663737461261895
87,1569715200,43,34,0,77,39,-0.6523004071638809,-0.796008130573232
87,1569729600,14,18,4,32,39,-0.5801024213001824,-0.926961687167281
87,1569744000,6,19,13,25,39,-0.4176569531068607,-0.9473322404152442
87,1569758400,39,163,124,202,39,1.585837154610774,-0.43224825114531823
87,1569772800,96,141,45,237,39,0.15992693380272766,-0.33039548490550236
87,1569787200,111,126,15,237,39,-0.3815579601750114,-0.33039548490550236
87,1569801600,35,39,4,74,39,-0.5801024213001824,-0.804738367679502
87,1569816000,3,3,0,6,39,-0.6523004071638809,-1.002623742088287
87,1569830400,31,88,57,119,39,0.3765208913938233,-0.673784811085453
87,1569844800,190,310,120,500,39,1.5136391687470754,0.43495530141082833
87,1569859200,276,205,0,481,39,-0.6523004071638809,0.3796637997377854
87,1569873600,707,215,0,922,39,-0.6523004071638809,1.6630086543594653
87,1569888000,91,36,0,127,40,-0.5816520226087941,-0.5937444326209886
87,1569902400,6,4,0,10,40,-0.5816520226087941,-0.9184701022814826
87,1569916800,49,104,55,153,40,0.5856947821056406,-0.5215831726964344
87,1569931200,193,373,180,566,40,3.238755701911174,0.6246706868743689
87,1569945600,324,297,0,621,40,-0.5816520226087941,0.7773195059455413
87,1569960000,821,255,0,1076,40,-0.5816520226087941,2.0401415546252397
87,1569974400,110,66,0,176,40,-0.5816520226087941,-0.45774821199394417
87,1569988800,10,6,0,16,40,-0.5816520226087941,-0.9018175038373547
87,1570003200,41,126,85,167,40,1.2224294028589686,-0.48272710966013604
87,1570017600,278,422,144,700,40,2.4746741570071804,0.9965787187932252
87,1570032000,343,297,0,640,40,-0.5816520226087941,0.8300527343519463
87,1570046400,879,263,0,1142,40,-0.5816520226087941,2.2233201375106466
87,1570060800,131,54,0,185,40,-0.5816520226087941,-0.43276931432775234
87,1570075200,8,3,0,11,40,-0.5816520226087941,-0.9156946692074612
87,1570089600,46,95,49,141,40,0.45834785795497496,-0.5548883695846902
87,1570104000,246,329,83,575,40,1.17998042814208,0.6496495845405608
87,1570118400,304,254,0,558,40,-0.5816520226087941,0.6024672222821984
87,1570132800,875,279,0,1154,40,-0.5816520226087941,2.2566253343989024
87,1570147200,117,45,0,162,40,-0.5816520226087941,-0.49660427503024257
87,1570161600,7,4,0,11,40,-0.5816520226087941,-0.9156946692074612
87,1570176000,50,94,44,144,40,0.3522254211627536,-0.5465620703626263
87,1570190400,260,384,124,644,40,2.050184409838295,0.8411544666480315
87,1570204800,309,370,61,679,40,0.7130417062563061,0.9382946242387776
87,1570219200,775,252,0,1027,40,-0.5816520226087941,1.9041453339981955
87,1570233600,90,50,0,140,40,-0.5816520226087941,-0.5576638026587115
87,1570248000,15,8,0,23,40,-0.5816520226087941,-0.8823894723192055
87,1570262400,11,9,0,20,40,-0.5816520226087941,-0.8907157715412695
87,1570276800,35,72,37,107,40,0.20365400965364377,-0.649253094101415
87,1570291200,93,111,18,204,40,-0.19961125015679726,-0.38003608592134736
87,1570305600,100,67,0,167,40,-0.5816520226087941,-0.48272710966013604
87,1570320000,41,31,0,72,40,-0.5816520226087941,-0.746393251692161
87,1570334400,5,4,0,9,40,-0.5816520226087941,-0.9212455353555039
87,1570348800,2,6,4,8,40,-0.496754073175017,-0.9240209684295252
87,1570363200,34,68,34,102,40,0.139980547578311,-0.6631302594715215
87,1570377600,81,42,0,123,40,-0.5816520226087941,-0.6048461649170739
87,1570392000,81,66,0,147,40,-0.5816520226087941,-0.5382357711405623
87,1570406400,24,22,0,46,40,-0.5816520226087941,-0.8185545116167152
87,1570420800,5,10,5,15,40,-0.47552958581657273,-0.904592936911376
87,1570435200,46,107,61,153,40,0.7130417062563061,-0.5215831726964344
87,1570449600,210,366,156,576,40,2.7293680053085114,0.652425017614582
87,1570464000,280,291,11,571,40,-0.3481826616659071,0.6385478522444755
87,1570478400,898,253,0,1151,40,-0.5816520226087941,2.2482990351768386
87,1570492800,66,21,0,87,41,-0.6446332167799309,-0.7154906643503591
87,1570507200,0,3,3,3,41,-0.5854322070756516,-0.9768544108639299
87,1570521600,49,103,54,152,41,0.42098495789709783,-0.5132449081196198
87,1570536000,257,438,181,695,41,2.927161035378258,1.1762850247002485
87,1570550400,309,270,0,579,41,-0.6446332167799309,0.8153541366576984
87,1570564800,842,256,0,1098,41,-0.6446332167799309,2.430208713330832
87,1570579200,73,37,0,110,41,-0.6446332167799309,-0.6439267813764052
87,1570593600,1,2,1,3,41,-0.6248995468785045,-0.9768544108639299
87,1570608000,28,78,50,106,41,0.342050278291392,-0.6563726740675276
87,1570622400,216,288,72,504,41,0.7761910161227741,0.581993648699153
87,1570636800,245,192,0,437,41,-0.6446332167799309,0.3735249461228526
87,1570651200,692,191,0,883,41,-0.6446332167799309,1.7612419811830022
87,1570665600,48,27,0,75,41,-0.6446332167799309,-0.7528283424237263
87,1570680000,1,7,6,8,41,-0.5262311973713721,-0.9612970450000269
87,1570694400,42,104,62,146,41,0.5788543171085095,-0.5319137471563035
87,1570708800,272,439,167,711,41,2.6508896567582876,1.2260685954647383
87,1570723200,378,314,0,692,41,-0.6446332167799309,1.1669506051819067
87,1570737600,903,301,0,1204,41,-0.6446332167799309,2.7600248696455765
87,1570752000,102,40,0,142,41,-0.6446332167799309,-0.5443596398474259
87,1570766400,0,2,2,2,41,-0.605165876977078,-0.9799658840367105
87,1570780800,33,93,60,126,41,0.5393869773056565,-0.5941432106119156
87,1570795200,251,415,164,666,41,2.5916886470540086,1.086052302689611
87,1570809600,346,268,0,614,41,-0.6446332167799309,0.9242556977050196
87,1570824000,685,225,0,910,41,-0.6446332167799309,1.8452517568480786
87,1570838400,66,45,0,111,41,-0.6446332167799309,-0.6408153082036245
87,1570852800,10,15,5,25,41,-0.5459648672727986,-0.9084020010627566
87,1570867200,7,24,17,31,41,-0.30916082845568116,-0.889733162026073
87,1570881600,45,167,122,212,41,1.762874511194097,-0.3265565177527835
87,1570896000,127,150,23,277,41,-0.1907588090471224,-0.12431076152204419
87,1570910400,151,145,0,296,41,-0.6446332167799309,-0.0651927712392127
87,1570924800,61,64,3,125,41,-0.5854322070756516,-0.5972546837846961
87,1570939200,15,20,5,35,41,-0.5459648672727986,-0.8772872693349505
87,1570953600,5,16,11,21,41,-0.42756284786423987,-0.920847893753879
87,1570968000,26,157,131,183,41,1.9404775403069352,-0.416789239763421
87,1570982400,102,173,71,275,41,0.7564573462213476,-0.1305337078676054
87,1570996800,114,80,0,194,41,-0.6446332167799309,-0.3825630348628344
87,1571011200,39,51,12,90,41,-0.4078291779628134,-0.7061562448320173
87,1571025600,5,5,0,10,41,-0.6446332167799309,-0.9550740986544657
87,1571040000,12,34,22,46,41,-0.21049247894854883,-0.8430610644343639
87,1571054400,164,236,72,400,41,0.7761910161227741,0.2584004387299702
87,1571068800,175,231,56,406,41,0.4604522976999507,0.2770692777666538
87,1571083200,418,204,0,622,41,-0.6446332167799309,0.9491474830872645
87,1571097600,79,31,0,110,42,-0.575118922422053,-0.6485051198222692
87,1571112000,5,3,0,8,42,-0.575118922422053,-0.9310745074181835
87,1571126400,48,107,59,155,42,0.32499008817927244,-0.5238421547064247
87,1571140800,277,456,179,733,42,2.1557202792328156,1.0773843750037562
87,1571155200,334,270,0,604,42,-0.575118922422053,0.7200172083383352
87,1571169600,852,296,0,1148,42,-0.575118922422053,2.227053942183211
87,1571184000,79,44,0,123,42,-0.575118922422053,-0.6124913743443586
87,1571198400,1,2,1,3,42,-0.5598628374966068,-0.9449259479866107
87,1571212800,47,109,62,156,42,0.37075834295561105,-0.5210718665927393
87,1571227200,256,349,93,605,42,0.843696975644443,0.7227874964520207
87,1571241600,347,266,0,613,42,-0.575118922422053,0.7449498013615041
87,1571256000,721,217,0,938,42,-0.575118922422053,1.64529343830927
87,1571270400,83,38,0,121,42,-0.575118922422053,-0.6180319505717294
87,1571284800,0,3,3,3,42,-0.5293506676457144,-0.9449259479866107
87,1571299200,43,95,52,138,42,0.2181974937011491,-0.570937052639077
87,1571313600,252,410,158,662,42,1.8353424957984457,0.8806939189320904
87,1571328000,325,361,36,686,42,-0.025899865105990016,0.9471808336605407
87,1571342400,886,249,0,1135,42,-0.575118922422053,2.1910401967053006
87,1571356800,88,29,0,117,42,-0.575118922422053,-0.6291131030264712
87,1571371200,1,5,4,6,42,-0.5140945827202682,-0.9366150836455543
87,1571385505,40,88,48,128,42,0.15717315399936432,-0.5986399337759314
87,1571385600,4,6,2,10,42,-0.5446067525711606,-0.9255339311908126
87,1571400000,231,483,252,714,42,3.2694144787903876,1.024748900843733
87,1571414400,364,308,0,672,42,-0.575118922422053,0.9083968000689447
87,1571428800,760,247,0,1007,42,-0.575118922422053,1.836443318153565
87,1571443200,73,45,0,118,42,-0.575118922422053,-0.6263428149127858
87,1571457600,11,3,0,14,42,-0.575118922422053,-0.9144527787360709
87,1571472000,5,18,13,23,42,-0.3767898183912525,-0.889520185712902
87,1571486400,44,225,181,269,42,2.186232449083708,-0.2080293097462852
87,1571500800,127,165,38,292,42,0.004612304744902373,-0.14431268313152024
87,1571515200,135,157,22,292,42,-0.23948505406223672,-0.14431268313152024
87,1571529600,41,41,0,82,42,-0.575118922422053,-0.7260731870054614
87,1571544000,8,8,0,16,42,-0.575118922422053,-0.9089122025087
87,1571558400,8,18,10,26,42,-0.4225580731675911,-0.8812093213718457
87,1571572800,33,139,106,172,42,1.0420260796752436,-0.47674725677377233
87,1571587200,76,83,7,159,42,-0.46832632794392964,-0.512761002251683
87,1571601600,57,46,0,103,42,-0.575118922422053,-0.6678971366180673
87,1571616000,18,11,0,29,42,-0.575118922422053,-0.8728984570307894
87,1571630400,4,3,0,7,42,-0.575118922422053,-0.9338447955318689
87,1571644800,41,107,66,148,42,0.43178268265739583,-0.5432341715022228
87,1571659200,240,469,229,709,42,2.9185245255051253,1.0108974602753058
87,1571673600,297,285,0,582,42,-0.575118922422053,0.6590708698372556
87,1571688000,892,268,0,1160,42,-0.575118922422053,2.2602973995474365
87,1571702400,62,33,0,95,43,-0.5459224811584494,-0.7134340844295843
87,1571716800,0,3,3,3,43,-0.4992561089563024,-0.9632038862086832
87,1571731200,52,96,44,148,43,0.1385176444730394,-0.5695449594916252
87,1571745600,257,400,143,657,43,1.678507927143889,0.8123336177427369
87,1571760000,333,205,0,538,43,-0.5459224811584494,0.48926180891977206
87,1571774400,855,246,0,1101,43,-0.5459224811584494,2.0177444002418663
87,1571788800,63,23,0,86,43,-0.5459224811584494,-0.7378680867775397
87,1571803200,0,1,1,1,43,-0.5303670237577337,-0.9686336645082289
87,1571817600,52,102,50,154,43,0.23185038887733334,-0.5532556245929884
87,1571832000,265,416,151,681,43,1.8029515863496144,0.8774909573372844
87,1571846400,373,305,0,678,43,-0.5459224811584494,0.8693462898879659
87,1571860800,931,269,0,1200,43,-0.5459224811584494,2.286518426069375
87,1571875200,91,32,0,123,43,-0.5459224811584494,-0.6374171882359456
87,1571889600,0,2,2,2,43,-0.5148115663570181,-0.965918775358456
87,1571904000,51,105,54,156,43,0.29407221848019593,-0.5478258462934427
87,1571918400,265,420,155,685,43,1.8651734159524769,0.8883505139363757
87,1571932800,337,308,0,645,43,-0.5459224811584494,0.7797549479454631
87,1571947200,849,301,0,1150,43,-0.5459224811584494,2.1507739685807343
87,1571961600,98,51,0,149,43,-0.5459224811584494,-0.5668300703418524
87,1571976000,0,3,3,3,43,-0.4992561089563024,-0.9632038862086832
87,1571990400,46,84,38,130,43,0.045184900068745475,-0.6184129641875359
87,1572004800,220,417,197,637,43,2.5185026267825346,0.7580358347472806
87,1572019200,353,278,0,631,43,-0.5459224811584494,0.7417464998486437
87,1572033600,781,218,0,999,43,-0.5459224811584494,1.7408257069650392
87,1572048000,88,82,0,170,43,-0.5459224811584494,-0.5098173981966233
87,1572062400,13,11,0,24,43,-0.5459224811584494,-0.9061912140634542
87,1572076800,7,20,13,27,43,-0.3437015349491459,-0.8980465466141356
87,1572091200,44,212,168,256,43,2.0673943621617803,-0.2763369313161614
87,1572105600,152,173,21,325,43,-0.21925787574342065,-0.08900957998183723
87,1572120000,156,154,0,310,43,-0.5459224811584494,-0.12973291722842942
87,1572134400,51,61,10,112,43,-0.3903679071512928,-0.6672809688834466
87,1572148800,8,16,8,24,43,-0.4214788219527241,-0.9061912140634542
87,1572163200,5,12,7,17,43,-0.4370342793534398,-0.9251954381118638
87,1572177600,25,77,52,102,43,0.26296130367876464,-0.6944298603811746
87,1572192000,57,77,20,134,43,-0.2348133331441363,-0.6075534075884447
87,1572206400,69,54,0,123,43,-0.5459224811584494,-0.6374171882359456
87,1572220800,32,23,0,55,43,-0.5459224811584494,-0.8220296504204969
87,1572235200,7,2,0,9,43,-0.5459224811584494,-0.9469145513100463
87,1572249600,48,109,61,157,43,0.4029604202852055,-0.5451109571436699
87,1572264000,252,525,273,777,43,3.700717389236924,1.1381203157154745
87,1572278400,351,296,0,647,43,-0.5459224811584494,0.7851847262450088
87,1572292800,900,206,0,1106,43,-0.5459224811584494,2.0313188459907305
87,1572307200,123,48,0,171,44,-0.5984113151119776,-0.5331169430133387
87,1572321600,8,5,0,13,44,-0.5984113151119776,-0.9657491110535468
87,1572336000,42,108,66,150,44,0.7252763795784296,-0.590618686866784
87,1572350400,288,435,147,723,44,2.349802186698475,0.9783574668486543
87,1572364800,333,251,0,584,44,-0.5984113151119776,0.5977506861044206
87,1572379200,888,242,0,1130,44,-0.5984113151119776,2.0927960262940006
87,1572393600,115,55,0,170,44,-0.5984113151119776,-0.5358551212920741
87,1572408000,7,2,0,9,44,-0.5984113151119776,-0.9767018241684887
87,1572422400,51,110,59,161,44,0.5848852604445985,-0.5604987258006936
87,1572436800,282,452,170,734,44,2.8110872924239194,1.0084774279147448
87,1572451200,337,302,0,639,44,-0.5984113151119776,0.7483504914348728
87,1572465600,915,268,0,1183,44,-0.5984113151119776,2.2379194750669815
87,1572480000,145,47,0,192,44,-0.5984113151119776,-0.47561519915989325
87,1572494400,6,4,0,10,44,-0.5984113151119776,-0.9739636458897533
87,1572508800,35,99,64,134,44,0.6851646312544778,-0.634429539326552
87,1572523200,249,301,52,550,44,0.4444941413107674,0.5046526246274138
87,1572537600,354,255,0,609,44,-0.5984113151119776,0.666205143072808
87,1572552000,826,198,0,1024,44,-0.5984113151119776,1.802549128748038
87,1572566400,139,79,0,218,44,-0.5984113151119776,-0.4044225639127704
87,1572580800,10,12,2,22,44,-0.558299566788026,-0.9411055065449273
87,1572595200,33,105,72,138,44,0.8456116245502848,-0.6234768262116099
87,1572609600,225,392,167,617,44,2.750919669937992,0.6881105693026919
87,1572624000,403,299,0,702,44,-0.5984113151119776,0.920855722995209
87,1572638400,875,259,0,1134,44,-0.5984113151119776,2.1037487394089425
87,1572652800,87,66,0,153,44,-0.5984113151119776,-0.5824041520305776
87,1572667200,13,16,3,29,44,-0.53824369262605,-0.9219382585937789
87,1572681600,8,10,2,18,44,-0.558299566788026,-0.9520582196598694
87,1572696000,59,205,146,264,44,2.329746312536499,-0.27846636309093764
87,1572710400,158,210,52,368,44,0.4444941413107674,0.006304177897553781
87,1572724800,178,159,0,337,44,-0.5984113151119776,-0.07857934874324655
87,1572739200,43,63,20,106,44,-0.1972938318724603,-0.7110985311311457
87,1572750000,12,10,0,22,44,-0.5984113151119776,-0.9411055065449273
87,1572764400,6,5,0,11,44,-0.5984113151119776,-0.9712254676110178
87,1572778800,39,63,24,102,44,-0.11707033522455683,-0.7220512442460878
87,1572793200,98,123,25,221,44,-0.09701446106258096,-0.39620802907656394
87,1572807600,95,126,31,221,44,0.023320783909274233,-0.39620802907656394
87,1572822000,33,45,12,78,44,-0.3577408251682672,-0.7877675229357396
87,1572836400,12,4,0,16,44,-0.5984113151119776,-0.9575345762173403
87,1572850800,7,37,30,44,44,0.003264909747298367,-0.8808655844127464
87,1572865200,239,378,139,617,44,2.1893551934026676,0.6881105693026919
87,1572879600,308,258,0,566,44,-0.5984113151119776,0.5484634770871817
87,1572894000,972,314,0,1286,44,-0.5984113151119776,2.5199518377767376
87,1572908400,206,43,0,249,44,-0.5984113151119776,-0.3195390372719701
87,1572922800,15,6,0,21,45,-0.5489066503036383,-0.9538952181916386
87,1572937200,10,33,23,43,45,0.13351783385764174,-0.8894984050398103
87,1572951600,278,294,16,572,45,-0.07417657436535652,0.6589522384746066
87,1572966000,272,240,0,512,45,-0.5489066503036383,0.48332456624234765
87,1572980400,729,278,0,1007,45,-0.5489066503036383,1.9322528621584845
87,1572994800,229,74,0,303,45,-0.5489066503036383,-0.12844515870002124
87,1573009200,12,9,0,21,45,-0.5489066503036383,-0.9538952181916386
87,1573023600,11,34,23,45,45,0.13351783385764174,-0.883644149298735
87,1573038000,310,405,95,715,45,2.2698031755799097,1.0775315239614907
87,1573052400,297,343,46,640,45,0.8159423180189218,0.8579969336711668
87,1573066800,914,275,0,1189,45,-0.5489066503036383,2.464990134596337
87,1573081200,236,95,0,331,45,-0.5489066503036383,-0.046485578324967046
87,1573095600,24,7,0,31,45,-0.5489066503036383,-0.9246239394862621
87,1573110000,8,28,20,36,45,0.044505944619213915,-0.9099883001335739
87,1573124400,236,413,177,649,45,4.702794814763603,0.8843410845060057
87,1573138800,330,218,0,548,45,-0.5489066503036383,0.588701169581703
87,1573153200,910,310,0,1220,45,-0.5489066503036383,2.555731098583004
87,1573167600,251,88,0,339,45,-0.5489066503036383,-0.023068555360665845
87,1573182000,26,11,0,37,45,-0.5489066503036383,-0.9070611722630362
87,1573196400,9,30,21,39,45,0.07417657436535652,-0.9012069165219609
87,1573210800,225,305,80,530,45,1.8247437293877704,0.5360128679120253
87,1573225200,274,296,22,570,45,0.10384720411149913,0.6530979827335314
87,1573239600,827,275,0,1102,45,-0.5489066503036383,2.210330009859561
87,1573254000,152,79,0,231,45,-0.5489066503036383,-0.33919836537873205
87,1573268400,26,7,0,33,45,-0.5489066503036383,-0.9187696837451867
87,1573282800,4,6,2,10,45,-0.48956539081135303,-0.9860936247675528
87,1573297200,37,96,59,133,45,1.2016605047187756,-0.6260568966914217
87,1573311600,140,203,63,343,45,1.3203430237033462,-0.011360043878515245
87,1573326000,180,194,14,374,45,-0.13351783385764174,0.07938092010815191
87,1573340400,57,50,0,107,45,-0.5489066503036383,-0.7021622213254007
87,1573354800,24,25,1,49,45,-0.5192360205574956,-0.8719356378165845
87,1573369200,4,10,6,14,45,-0.3708828718267826,-0.9743851132854021
87,1573383600,29,71,42,100,45,0.6972597990343513,-0.7226521164191643
87,1573398000,128,131,3,259,45,-0.45989476106521043,-0.25723878500367786
87,1573412400,129,142,13,271,45,-0.16318846360378436,-0.22211325055722606
87,1573426800,53,75,22,128,45,0.10384720411149913,-0.64069253604411
87,1573441200,11,30,19,41,45,0.014835314873071305,-0.8953526607808856
87,1573455600,8,18,10,26,45,-0.2522003528422122,-0.9392595788389504
87,1573470000,218,216,0,434,45,-0.5489066503036383,0.2550085923404109
87,1573484400,210,169,0,379,45,-0.5489066503036383,0.09401655946084016
87,1573498800,570,290,0,860,45,-0.5489066503036383,1.5019650651894498
87,1573513200,169,108,0,277,45,-0.5489066503036383,-0.20455048333400017
87,1573527600,23,15,0,38,46,-0.5505357092347882,-0.8687379238560679
87,1573542000,7,38,31,45,46,0.4168023385704672,-0.8497257942138403
87,1573556400,261,341,80,602,46,1.945820543165871,0.6630965216034034
87,1573570800,286,229,0,515,46,-0.5505357092347882,0.426802910335719
87,1573585200,911,252,0,1163,46,-0.5505357092347882,2.1867829115019197
87,1573599600,211,69,0,280,46,-0.5505357092347882,-0.21146144193906066
87,1573614000,17,9,0,26,46,-0.5505357092347882,-0.9013301460998864
87,1573628400,8,33,25,41,46,0.22957561964041778,-0.8605898682951132
87,1573642800,300,386,86,686,46,2.1330472620959204,0.8912420773101332
87,1573657200,303,248,0,551,46,-0.5505357092347882,0.5245795770671746
87,1573671600,974,258,0,1232,46,-0.5505357092347882,2.3741881894038763
87,1573686000,282,82,0,364,46,-0.5505357092347882,0.016684113767669078
87,1573700400,27,7,0,34,46,-0.5505357092347882,-0.8796019979373406
87,1573714800,10,36,26,46,46,0.26078007279542603,-0.8470097756935221
87,1573729200,257,362,105,619,46,2.7259318720410772,0.709268836448813
87,1573743600,320,275,0,595,46,-0.5505357092347882,0.644084391961176
87,1573758000,984,270,0,1254,46,-0.5505357092347882,2.433940596850877
87,1573772400,241,97,0,338,46,-0.5505357092347882,-0.053932367760604415
87,1573786800,31,27,0,58,46,-0.5505357092347882,-0.8144175534497036
87,1573801200,16,29,13,45,46,-0.1448778182196811,-0.8497257942138403
87,1573815600,251,370,119,621,46,3.1627942162111924,0.7147008734894494
87,1573830000,362,290,0,652,46,-0.5505357092347882,0.7988974476193139
87,1573844400,856,245,0,1101,46,-0.5505357092347882,2.0183897632421908
87,1573858800,169,87,0,256,46,-0.5505357092347882,-0.27664588642669774
87,1573873200,31,22,0,53,46,-0.5505357092347882,-0.8279976460512947
87,1573887600,5,5,0,10,46,-0.5505357092347882,-0.9447864424249778
87,1573902000,38,73,35,111,46,0.5416201511905002,-0.6704685718728384
87,1573916400,126,143,17,269,46,-0.02006000559964814,-0.241337645662561
87,1573930800,171,102,0,273,46,-0.5505357092347882,-0.23047357158128814
87,1573945200,48,42,0,90,46,-0.5505357092347882,-0.7275049607995209
87,1573959600,18,12,0,30,46,-0.5505357092347882,-0.8904660720186135
87,1573974000,3,6,3,9,46,-0.4569223497697635,-0.947502460945296
87,1573988400,22,81,59,103,46,1.290527026910698,-0.6921967200353841
87,1574002800,86,98,12,184,46,-0.17608227137468935,-0.47219921988960895
87,1574017200,100,82,0,182,46,-0.5505357092347882,-0.4776312569302454
87,1574031600,31,37,6,68,46,-0.3633089903047388,-0.7872573682465215
87,1574046000,11,6,0,17,46,-0.5505357092347882,-0.9257743127827502
87,1574060400,7,38,31,45,46,0.4168023385704672,-0.8497257942138403
87,1574074800,251,344,93,595,46,2.351478434180978,0.644084391961176
87,1574089200,282,200,0,482,46,-0.5505357092347882,0.337174299165218
87,1574103600,854,215,0,1069,46,-0.5505357092347882,1.931477170592008
87,1574118000,207,71,0,278,46,-0.5505357092347882,-0.2168934789796971
87,1574132400,17,10,0,27,47,-0.5678436361143245,-0.9277435755323261
87,1574146800,9,28,19,37,47,-0.13213284609583323,-0.9013193044266989
87,1574161200,250,415,165,665,47,3.2159605929936266,0.7581249210066818
87,1574175600,334,296,0,630,47,-0.5678436361143245,0.6656399721369871
87,1574190000,937,287,0,1224,47,-0.5678436361143245,2.2352416758112357
87,1574204400,263,93,0,356,47,-0.5678436361143245,-0.058385056157195026
87,1574218800,14,15,1,29,47,-0.5449114892712461,-0.9224587213112007
87,1574233200,7,37,30,44,47,0.12012076917803018,-0.8828223146527601
87,1574247600,294,402,108,696,47,1.9088282229381526,0.8400401614341259
87,1574262000,313,253,0,566,47,-0.5678436361143245,0.4965246370609737
87,1574276400,940,283,0,1223,47,-0.5678436361143245,2.232599248700673
87,1574290800,239,107,0,346,47,-0.5678436361143245,-0.0848093272628221
87,1574305200,21,13,0,34,47,-0.5678436361143245,-0.9092465857583871
87,1574319600,7,40,33,47,47,0.18891720970726567,-0.8748950333210719
87,1574334000,279,374,95,653,47,1.6107103139781322,0.7264157956799293
87,1574348400,320,312,0,632,47,-0.5678436361143245,0.6709248263581125
87,1574362800,967,264,0,1231,47,-0.5678436361143245,2.2537386655851748
87,1574377200,299,97,0,396,47,-0.5678436361143245,0.04731202826531331
87,1574391600,23,16,0,39,47,-0.5678436361143245,-0.8960344502055736
87,1574406000,11,33,22,44,47,-0.06333640556659775,-0.8828223146527601
87,1574420400,252,390,138,642,47,2.5967926282305074,0.6973490974637395
87,1574434800,294,229,0,523,47,-0.5678436361143245,0.3829002713067773
87,1574449200,882,239,0,1121,47,-0.5678436361143245,1.9630716834232769
87,1574463600,166,93,0,259,47,-0.5678436361143245,-0.31470048588177774
87,1574478000,37,61,24,98,47,-0.017472111880440774,-0.7401312506823737
87,1574492400,7,7,0,14,47,-0.5678436361143245,-0.9620951279696413
87,1574506800,43,130,87,173,47,1.4272531392335044,-0.5419492173901707
87,1574521200,127,222,95,349,47,1.6107103139781322,-0.07688204593113399
87,1574535600,163,146,0,309,47,-0.5678436361143245,-0.18257913035364232
87,1574550000,57,56,0,113,47,-0.5678436361143245,-0.7004948440239331
87,1574564400,17,16,0,33,47,-0.5678436361143245,-0.9118890128689499
87,1574578800,6,11,5,17,47,-0.4531829018989321,-0.9541678466379532
87,1574593200,24,60,36,84,47,0.2577136502365011,-0.7771252302302517
87,1574607600,62,65,3,127,47,-0.4990471955850891,-0.6635008644760553
87,1574622000,98,115,17,213,47,-0.17799713978199022,-0.4362521329676623
87,1574636400,31,33,2,64,47,-0.5219793424281676,-0.8299737724415058
87,1574650800,11,9,0,20,47,-0.5678436361143245,-0.946240565306265
87,1574665200,6,40,34,46,47,0.21184935655034415,-0.8775374604316346
87,1574679600,266,392,126,658,47,2.3216068661135654,0.7396279312327428
87,1574694000,296,281,0,577,47,-0.5678436361143245,0.5255913352771635
87,1574708400,925,252,0,1177,47,-0.5678436361143245,2.1110476016147883
87,1574722800,245,99,0,344,47,-0.5678436361143245,-0.09009418148394752
87,1574737200,17,10,0,27,48,-0.566778931399342,-0.7874665875595295
87,1574751600,7,37,30,44,48,0.11595668386181567,-0.7282635609703431
87,1574766000,252,412,160,664,48,3.0744776833268324,1.4309056440470467
87,1574780400,342,300,0,642,48,-0.566778931399342,1.3542899625786877
87,1574794800,937,247,0,1184,48,-0.566778931399342,3.241821751480986
87,1574809200,209,84,0,293,48,-0.566778931399342,0.1388866520124473
87,1574823600,20,12,0,32,48,-0.566778931399342,-0.770053932680357
87,1574838000,11,38,27,49,48,0.04768312233569989,-0.7108509060911705
87,1574852400,182,346,164,528,48,3.165509098694987,0.9572814313335547
87,1574866800,378,300,0,678,48,-0.566778931399342,1.4796610777087296
87,1574881200,633,181,0,814,48,-0.566778931399342,1.9532852904222215
87,1574895600,92,60,0,152,48,-0.566778931399342,-0.3521502155802171
87,1574910000,14,10,0,24,48,-0.566778931399342,-0.797914180487033
87,1574924400,5,6,1,11,48,-0.5440210775573034,-0.8431870831728815
87,1574938800,41,57,16,98,48,-0.20265326992672458,-0.5402068882752801
87,1574953200,47,134,87,181,48,1.4131543528580153,-0.25115681728101663
87,1574967600,94,89,0,183,48,-0.566778931399342,-0.24419175532934764
87,1574982000,26,28,2,54,48,-0.5212632237152648,-0.693438251211998
87,1574996400,9,5,0,14,48,-0.566778931399342,-0.832739490245378
87,1575010800,5,17,12,22,48,-0.29368468529487896,-0.804879242438702
87,1575025200,48,154,106,202,48,1.8455535758567485,-0.17802366678849216
87,1575039600,188,189,1,377,48,-0.5440210775573034,0.4314192539825452
87,1575054000,282,160,0,442,48,-0.566778931399342,0.6577837674117877
87,1575068400,59,49,0,108,48,-0.566778931399342,-0.5053815785169351
87,1575082800,29,24,0,53,48,-0.566778931399342,-0.6969207821878325
87,1575097200,3,6,3,9,48,-0.49850536987322625,-0.8501521451245505
87,1575111600,34,160,126,194,48,2.3007106526975205,-0.20588391459516814
87,1575126000,130,228,98,358,48,1.66349074512044,0.36525116544168973
87,1575140400,137,138,1,275,48,-0.5440210775573034,0.0762010944474263
87,1575154800,46,63,17,109,48,-0.179895416084686,-0.5018990475411006
87,1575169200,25,22,0,47,48,-0.566778931399342,-0.7178159680428395
87,1575183600,3,11,8,14,48,-0.3847161006630333,-0.832739490245378
87,1575198000,32,81,49,113,48,0.5483559068605489,-0.48796892363776256
87,1575212400,61,100,39,161,48,0.32077736844016297,-0.3208074367977066
87,1575226800,49,76,27,125,48,0.04768312233569989,-0.4461785519277486
87,1575241200,29,17,0,46,48,-0.566778931399342,-0.721298499018674
87,1575255600,10,4,0,14,48,-0.566778931399342,-0.832739490245378
87,1575270000,12,29,17,41,48,-0.179895416084686,-0.7387111538978465
87,1575284400,246,301,55,547,48,0.6849030299127804,1.0234495198744102
87,1575298800,267,200,0,467,48,-0.566778931399342,0.7448470418076502
87,1575313200,814,201,0,1015,48,-0.566778931399342,2.6532740165649558
87,1575327600,168,52,0,220,48,-0.566778931399342,-0.11533810922347115
87,1575342000,21,12,0,33,49,-0.6472520148416859,-0.98212800751546
87,1575356400,7,31,24,38,49,-0.002558308359058038,-0.9685840830619371
87,1575370800,268,356,88,624,49,1.7166249089279497,0.6187638628909459
87,1575385200,315,289,0,604,49,-0.6472520148416859,0.5645881650768544
87,1575399600,1005,242,0,1247,49,-0.6472520148416859,2.3063368497998984
87,1575414000,214,84,0,298,49,-0.6472520148416859,-0.2643000114787467
87,1575428400,20,18,0,38,49,-0.6472520148416859,-0.9685840830619371
87,1575442800,8,37,29,45,49,0.13175288049148945,-0.9496225888270051
87,1575457200,275,374,99,649,49,2.012109524399154,0.6864834851585604
87,1575471600,344,221,0,565,49,-0.6472520148416859,0.4589455543393758
87,1575486000,994,258,0,1252,49,-0.6472520148416859,2.3198807742534213
87,1575500400,269,94,0,363,49,-0.6472520148416859,-0.08822899358294908
87,1575514800,20,19,0,39,49,-0.6472520148416859,-0.9658752981712325
87,1575529200,7,32,25,39,49,0.02430392941105146,-0.9658752981712325
87,1575543600,255,392,137,647,49,3.032874559663315,0.6810659153771512
87,1575558000,326,307,0,633,49,-0.6472520148416859,0.6431429269072871
87,1575572400,1004,259,0,1263,49,-0.6472520148416859,2.3496774080511718
87,1575586800,240,116,0,356,49,-0.6472520148416859,-0.10719048781788114
87,1575601200,31,18,0,49,49,-0.6472520148416859,-0.9387874492641868
87,1575615600,8,32,24,40,49,-0.002558308359058038,-0.9631665132805279
87,1575630000,262,357,95,619,49,1.9046605733187159,0.605219938437423
87,1575644400,352,322,0,674,49,-0.6472520148416859,0.7542031074261748
87,1575658800,902,281,0,1183,49,-0.6472520148416859,2.1329746167948054
87,1575673200,186,100,0,286,49,-0.6472520148416859,-0.2968054301672016
87,1575687600,38,45,7,83,49,-0.45921635045091946,-0.8466887629802311
87,1575702000,7,16,9,23,49,-0.4054918749107005,-1.0092158564225058
87,1575716400,56,156,100,212,49,2.0389717621692633,-0.49725551207934043
87,1575730800,206,278,72,484,49,1.2868291046061977,0.23953397819230493
87,1575745200,245,198,0,443,49,-0.6472520148416859,0.1284737976734172
87,1575759600,86,116,30,202,49,0.15861511826159894,-0.5243433609863862
87,1575774000,29,29,0,58,49,-0.6472520148416859,-0.9144083852478455
87,1575788400,5,15,10,20,49,-0.37862963714059095,-1.0173422110946195
87,1575802800,36,124,88,160,49,1.7166249089279497,-0.6381123263959786
87,1575817200,159,212,53,371,49,0.7764465869741173,-0.06655871445731246
87,1575831600,240,193,0,433,49,-0.6472520148416859,0.10138594876637141
87,1575846000,49,58,9,107,49,-0.4054918749107005,-0.7816779256033212
87,1575860400,17,7,0,24,49,-0.6472520148416859,-1.0065070715318012
87,1575874800,8,39,31,47,49,0.18547735603170842,-0.944205019045596
87,1575889200,246,328,82,574,49,1.5554514823072927,0.483324618355717
87,1575903600,247,230,0,477,49,-0.6472520148416859,0.22057248395737286
87,1575918000,795,232,0,1027,49,-0.6472520148416859,1.7104041738448912
87,1575932400,215,70,0,285,49,-0.6472520148416859,-0.2995142150579062
87,1575946800,18,7,0,25,50,-0.6648958224594992,-0.9804320392850584
87,1575961200,9,35,26,44,50,-0.0868176073912085,-0.9298413656769449
87,1575975600,290,411,121,701,50,2.0253912553583153,0.8195308743509828
87,1575990000,337,283,0,620,50,-0.6648958224594992,0.6038548447584986
87,1576004400,928,256,0,1184,50,-0.6648958224594992,2.1055990508098703
87,1576018800,233,102,0,335,50,-0.6648958224594992,-0.1550052593632052
87,1576033200,19,10,0,29,50,-0.6648958224594992,-0.9697813711570346
87,1576047600,7,34,27,41,50,-0.06458382988858193,-0.9378293667729628
87,1576062000,258,386,128,644,50,2.181027697876701,0.6677588535266421
87,1576076400,305,290,0,595,50,-0.6648958224594992,0.5372881689583492
87,1576090800,1021,260,0,1281,50,-0.6648958224594992,2.36387775291445
87,1576105200,313,90,0,403,50,-0.6648958224594992,0.026056098813201336
87,1576119600,24,21,0,45,50,-0.6648958224594992,-0.9271786986449388
87,1576134000,7,27,20,34,50,-0.22022027240696787,-0.9564680359970047
87,1576148400,291,428,137,719,50,2.3811316954003403,0.8674588809270904
87,1576162800,344,291,0,635,50,-0.6648958224594992,0.6437948502385883
87,1576177200,976,319,0,1295,50,-0.6648958224594992,2.4011550913625337
87,1576191600,250,130,0,380,50,-0.6648958224594992,-0.035185242922936164
87,1576206000,31,12,0,43,50,-0.6648958224594992,-0.9325040327089509
87,1576220400,5,31,26,36,50,-0.0868176073912085,-0.9511427019329927
87,1576234800,238,359,121,597,50,2.0253912553583153,0.5426135030223611
87,1576249200,317,246,0,563,50,-0.6648958224594992,0.4520828239341579
87,1576263600,840,277,0,1117,50,-0.6648958224594992,1.9272003596654697
87,1576278000,162,84,0,246,50,-0.6648958224594992,-0.39198262521173727
87,1576292400,38,21,0,59,50,-0.6648958224594992,-0.8899013601968552
87,1576306800,7,8,1,15,50,-0.6426620449568726,-1.0070587096051182
87,1576321200,28,121,93,149,50,1.4028454852847714,-0.6502613273163171
87,1576335600,137,253,116,390,50,1.9142223678451824,-0.008558572602876381
87,1576350000,180,206,26,386,50,-0.0868176073912085,-0.019209240730900294
87,1576364400,78,115,37,193,50,0.1577539451376837,-0.5331039779080541
87,1576378800,32,26,0,58,50,-0.6648958224594992,-0.8925640272288612
87,1576393200,6,10,4,16,50,-0.5759607124489929,-1.0043960425731122
87,1576407600,36,124,88,160,50,1.2916765977716385,-0.6209719899642514
87,1576422000,151,275,124,426,50,2.092092587866195,0.08729744054933884
87,1576436400,119,186,67,305,50,0.8247672702164807,-0.23488527032338452
87,1576450800,53,64,11,117,50,-0.42032426993060695,-0.7354666723405084
87,1576465200,11,9,0,20,50,-0.6648958224594992,-0.9937453744450884
87,1576479600,11,41,30,52,50,0.0021175026192977605,-0.9085400294208971
87,1576494000,256,309,53,565,50,0.5134943851797087,0.4574081579981698
87,1576508400,316,231,0,547,50,-0.6648958224594992,0.40948015142206223
87,1576522800,869,286,0,1155,50,-0.6648958224594992,2.0283817068816967
87,1576537200,196,94,0,290,50,-0.6648958224594992,-0.2748252758034742
87,1576551600,20,12,0,32,51,-0.6710088116689155,-0.9294838403681684
87,1576566000,16,37,21,53,51,-0.10950048919075281,-0.8665091324864106
87,1576580400,254,310,56,564,51,0.8263467149395183,0.6658754259696987
87,1576594800,263,200,0,463,51,-0.6710088116689155,0.36299706901457734
87,1576609200,879,216,0,1095,51,-0.6710088116689155,2.2582358966941487
87,1576623600,205,102,0,307,51,-0.6710088116689155,-0.10481504667848146
87,1576638000,23,12,0,35,51,-0.6710088116689155,-0.9204874535279173
87,1576652400,11,36,25,47,51,-0.0025465230044361027,-0.8845019061669128
87,1576666800,255,331,76,586,51,1.3611165458711019,0.7318489294648737
87,1576681200,334,274,0,608,51,-0.6710088116689155,0.7978224329600486
87,1576695600,901,216,0,1117,51,-0.6710088116689155,2.324209400189324
87,1576710000,196,95,0,291,51,-0.6710088116689155,-0.15279577649315415
87,1576724400,24,9,0,33,51,-0.6710088116689155,-0.9264850447547515
87,1576738800,9,43,34,52,51,0.23809990091477648,-0.8695079280998276
87,1576753200,250,313,63,563,51,1.0135161557655725,0.6628766303562817
87,1576767600,320,224,0,544,51,-0.6710088116689155,0.6058995137013579
87,1576782000,869,269,0,1138,51,-0.6710088116689155,2.387184108071082
87,1576796400,188,108,0,296,51,-0.6710088116689155,-0.13780179842606893
87,1576810800,28,11,0,39,51,-0.6710088116689155,-0.9084922710742491
87,1576825200,9,41,32,50,51,0.18462291782161813,-0.8755055193266617
87,1576839600,211,321,110,532,51,2.2702252584547935,0.5699139663403534
87,1576854000,282,253,0,535,51,-0.6710088116689155,0.5789103531806045
87,1576868400,847,250,0,1097,51,-0.6710088116689155,2.264233487920983
87,1576882800,147,89,0,236,51,-0.6710088116689155,-0.31772953523109154
87,1576897200,40,38,0,78,51,-0.6710088116689155,-0.7915392421509845
87,1576911600,5,6,1,11,51,-0.6442703201223363,-0.9924585482499264
87,1576926000,33,74,41,107,51,0.4252693417408307,-0.7045741693618902
87,1576940400,138,175,37,313,51,0.318315375554514,-0.0868222729979792
87,1576954800,137,206,69,343,51,1.1739471050450476,0.0031415954045321084
87,1576969200,48,101,53,149,51,0.7461312402997808,-0.5786247535983744
87,1576983600,25,20,0,45,51,-0.6710088116689155,-0.8904994973937469
87,1576998000,11,12,1,23,51,-0.6442703201223363,-0.9564730008889218
87,1577012400,27,79,52,106,51,0.7193927487532016,-0.7075729649753072
87,1577026800,80,212,132,292,51,2.8584720724795356,-0.1497969808797371
87,1577041200,153,158,5,311,51,-0.5373163539360196,-0.09281986422481328
87,1577055600,42,70,28,112,51,0.07766895163530142,-0.689580191294805
87,1577070000,15,14,0,29,51,-0.6710088116689155,-0.9384802272084196
87,1577084400,8,33,25,41,51,-0.0025465230044361027,-0.902494679847415
87,1577098800,121,273,152,394,51,3.393241903411119,0.15608017168880134
87,1577113200,269,310,41,579,51,0.4252693417408307,0.7108573601709544
87,1577127600,715,225,0,940,51,-0.6710088116689155,1.793422576614507
87,1577142000,100,76,0,176,51,-0.6710088116689155,-0.4976572720361142
87,1577156400,30,20,0,50,52,-0.6857452675146669,-0.8165871243783002
87,1577170800,9,29,20,38,52,-0.29850088115344325,-0.870024318611645
87,1577185200,71,193,122,264,52,1.6764454892887979,0.13637617278301536
87,1577199600,278,200,0,478,52,-0.6857452675146669,1.0893394699443308
87,1577214000,306,191,0,497,52,-0.6857452675146669,1.1739483608137935
87,1577228400,38,43,5,81,52,-0.5889341709243611,-0.6785410392754928
87,1577242800,16,7,0,23,52,-0.6857452675146669,-0.936820811403326
87,1577257200,1,6,5,7,52,-0.5889341709243611,-1.0080704037144523
87,1577271600,16,70,54,86,52,0.35981457566063707,-0.6562755416782657
87,1577286000,58,184,126,242,52,1.7538943665610427,0.03840798335521657
87,1577300400,139,110,0,249,52,-0.6857452675146669,0.06957967999133437
87,1577314800,37,46,9,83,52,-0.5114852936521163,-0.669634840236602
87,1577329200,10,4,0,14,52,-0.6857452675146669,-0.9768987070783346
87,1577343600,9,21,12,30,52,-0.4533986356979327,-0.9056491147672082
87,1577358000,60,210,150,270,52,2.218587630194511,0.16309476989968777
87,1577372400,155,272,117,427,52,1.579634392698492,0.8622313944526155
87,1577386800,512,207,0,719,52,-0.6857452675146669,2.1625364541306724
87,1577401200,74,78,4,152,52,-0.6082963902424222,-0.3623709733948694
87,1577415600,18,14,0,32,52,-0.6857452675146669,-0.8967429157283173
87,1577430000,8,29,21,37,52,-0.27913866183538205,-0.8744774181310904
87,1577444400,92,227,135,319,52,1.9281543404235932,0.38129664635251237
87,1577458800,232,302,70,534,52,0.669610084749616,1.3387130430332732
87,1577473200,530,247,0,777,52,-0.6857452675146669,2.4208162262585056
87,1577487600,96,96,0,192,52,-0.6857452675146669,-0.1842469926170534
