remote_unit_id,time_stamp,entries,exits,num_people_exited,sum_exit_entry,week_num,z_score_num_people_exited,z_score_sum_exit_entry
86,1546311600,102,95,0,197,1,-0.674575785725018,-0.8635952990826228
86,1546326000,26,32,6,58,1,-0.645971865482261,-1.075849303041885
86,1546340400,28,165,137,193,1,-0.02145294018206771,-0.8697033279735369
86,1546354800,331,583,252,914,1,0.5267888644707738,0.23126887961371467
86,1546369200,839,616,0,1455,1,-0.674575785725018,1.0573797871098354
86,1546383600,379,184,0,563,1,-0.674575785725018,-0.3047106555639903
86,1546398000,26,20,0,46,1,-0.674575785725018,-1.0941733897146269
86,1546412400,8,48,40,56,1,-0.4838829841066383,-1.078903317487342
86,1546426800,150,706,556,856,1,1.976054156770459,0.1427024606954614
86,1546441200,440,754,314,1194,1,0.8223627069792622,0.6588309019776958
86,1546455600,991,892,0,1883,1,-0.674575785725018,1.7109388784376351
86,1546470000,461,185,0,646,1,-0.674575785725018,-0.17796905607752445
86,1546484400,54,43,0,97,1,-0.674575785725018,-1.0162960213554733
86,1546498800,11,79,68,90,1,-0.3503980229737726,-1.0269850719145728
86,1546513200,185,763,578,948,1,2.0809351976605677,0.2831871251864838
86,1546527600,427,763,336,1190,1,0.927243747869371,0.6527228730867818
86,1546542000,1063,956,0,2019,1,-0.674575785725018,1.9186118607287117
86,1546556400,516,235,0,751,1,-0.674575785725018,-0.01763329769103152
86,1546570800,57,26,0,83,1,-0.674575785725018,-1.0376741224736723
86,1546585200,14,54,40,68,1,-0.4838829841066383,-1.0605792308145998
86,1546599600,173,776,603,949,1,2.200118198672055,0.2847141324092123
86,1546614000,433,768,335,1201,1,0.9224764278289115,0.6695199525367953
86,1546628400,1414,1047,0,2461,1,-0.674575785725018,2.5935490531747107
86,1546642800,622,263,0,885,1,-0.674575785725018,0.18698567015458803
86,1546657200,90,59,0,149,1,-0.674575785725018,-0.9368916457735911
86,1546671600,13,46,33,59,1,-0.5172542243898548,-1.0743222958191565
86,1546686000,60,379,319,439,1,0.8461993071815597,-0.4940595511823248
86,1546700400,399,958,559,1357,1,1.9903561168918376,0.907733079282442
86,1546714800,1165,916,0,2081,1,-0.674575785725018,2.013286308537879
86,1546729200,572,290,0,862,1,-0.674575785725018,0.15186450403183244
86,1546743600,77,63,0,140,1,-0.674575785725018,-0.9506347107781475
86,1546758000,13,41,28,54,1,-0.5410908245921522,-1.0819573319327989
86,1546772400,51,296,245,347,1,0.4934176241875573,-0.6345442156733472
86,1546786800,368,991,623,1359,1,2.295464599481245,0.910787093727899
86,1546801200,796,793,0,1589,1,-0.674575785725018,1.261998754955455
86,1546815600,282,154,0,436,1,-0.674575785725018,-0.49864057285051033
86,1546830000,42,31,0,73,1,-0.674575785725018,-1.0529441947009575
86,1546844400,14,62,48,76,1,-0.4457444237829624,-1.0483631730327718
86,1546858800,196,785,589,981,1,2.133375718105622,0.3335783635365244
86,1546873200,352,586,234,938,1,0.44097710374250293,0.26791705295919876
86,1546887600,907,731,0,1638,1,-0.674575785725018,1.3368221088691516
86,1546902000,402,244,0,646,1,-0.674575785725018,-0.17796905607752445
86,1546916400,57,40,0,97,2,-0.6934981435508933,-1.1186959564513135
86,1546930800,15,65,50,80,2,-0.4588307085755669,-1.1470979374955208
86,1546945200,208,784,576,992,2,2.009870707364868,0.376584810287828
86,1546959600,332,586,254,918,2,0.4986124261237651,0.25295265750716156
86,1546974000,865,798,0,1663,2,-0.6934981435508933,1.4976277091503576
86,1546988400,460,200,0,660,2,-0.6934981435508933,-0.17808917245786474
86,1547002800,45,35,0,80,2,-0.6934981435508933,-1.1470979374955208
86,1547017200,19,71,52,90,2,-0.44944401117655386,-1.1303908898224577
86,1547031600,190,838,648,1028,2,2.3477918137293377,0.43673018191085494
86,1547046000,380,650,270,1030,2,0.5737060053158696,0.44007159144546754
86,1547060400,916,836,0,1752,2,-0.6934981435508933,1.6463204334406185
86,1547074800,490,254,0,744,2,-0.6934981435508933,-0.03774997200413525
86,1547089200,47,55,8,102,2,-0.6559513539548412,-1.110342432614782
86,1547103600,9,47,38,56,2,-0.5151508929696452,-1.187194851910872
86,1547118000,202,861,659,1063,2,2.3994186494239096,0.49520484876657556
86,1547132400,424,633,209,1057,2,0.2874117346459713,0.4851806201627377
86,1547146800,949,812,0,1761,2,-0.6934981435508933,1.6613567763463752
86,1547161200,714,223,0,937,2,-0.6934981435508933,0.2846960480859813
86,1547175600,67,63,0,130,2,-0.6934981435508933,-1.0635626991302056
86,1547190000,14,66,52,80,2,-0.44944401117655386,-1.1470979374955208
86,1547204400,324,744,420,1068,2,1.277708310241849,0.5035583726031071
86,1547218800,412,657,245,1069,2,0.4563722878282064,0.5052290773704133
86,1547233200,1107,950,0,2057,2,-0.6934981435508933,2.155885387469041
86,1547247600,672,242,0,914,2,-0.6934981435508933,0.24626983843793632
86,1547262000,100,80,0,180,2,-0.6934981435508933,-0.9800274607648903
86,1547276400,16,39,23,55,2,-0.5855511234622433,-1.1888655566781783
86,1547290800,72,445,373,517,2,1.057120921365042,-0.4169999541826661
86,1547305200,435,1092,657,1527,2,2.3900319520248967,1.2704118607967003
86,1547319600,881,1076,195,1957,2,0.22170485285287989,1.9888149107384108
86,1547334000,466,346,0,812,2,-0.6934981435508933,0.07585795217269338
86,1547348400,68,69,1,137,2,-0.6888047948513868,-1.0518677657590614
86,1547362800,12,47,35,59,2,-0.5292309390681649,-1.182182737608953
86,1547377200,61,302,241,363,2,0.43759889303018024,-0.6742884883478368
86,1547391600,345,734,389,1079,2,1.1322145005571467,0.5219361250434764
86,1547406000,718,623,0,1341,2,-0.6934981435508933,0.9596607740777279
86,1547420400,292,142,0,434,2,-0.6934981435508933,-0.5556684498690893
86,1547434800,32,27,0,59,2,-0.6934981435508933,-1.182182737608953
86,1547449200,12,59,47,71,2,-0.4729107546740865,-1.1621342804012775
86,1547463600,201,803,602,1004,2,2.1318977735520375,0.39663326749550365
86,1547478000,369,531,162,900,2,0.0668243457691644,0.22287997169564808
86,1547492400,832,793,0,1625,2,-0.6934981435508933,1.434140927992718
86,1547506800,430,219,0,649,2,-0.6934981435508933,-0.19646692489823406
86,1547521200,34,22,0,56,3,-0.643910166578133,-1.0024956404889669
86,1547535600,10,52,42,62,3,-0.4520781912045691,-0.9923117870805416
86,1547541538,61,110,49,171,3,-0.42010619530897514,-0.8073051168274804
86,1547550000,160,796,636,956,3,2.2609740319358353,0.5250823707748407
86,1547564400,396,641,245,1037,3,0.4751096897676567,0.6625643917885834
86,1547578800,895,857,0,1752,3,-0.643910166578133,1.8761402562926084
86,1547593200,493,213,0,706,3,-0.643910166578133,0.10075514542378303
86,1547607600,47,27,0,74,3,-0.643910166578133,-0.9719440802636907
86,1547622000,12,62,50,74,3,-0.4155387673238903,-0.9719440802636907
86,1547627115,46,91,45,137,3,-0.4383759072493145,-0.8650136194752243
86,1547636400,179,815,636,994,3,2.2609740319358353,0.5895801090282015
86,1547650800,396,629,233,1025,3,0.42030055394663846,0.6421966849717327
86,1547665200,920,803,0,1723,3,-0.643910166578133,1.8269182981518857
86,1547679600,498,277,0,775,3,-0.643910166578133,0.21786945962067494
86,1547694000,45,27,0,72,3,-0.643910166578133,-0.9753386980664992
86,1547708400,15,60,45,75,3,-0.4383759072493145,-0.9702467713622865
86,1547722800,229,793,564,1022,3,1.9321192170097257,0.6371047582675199
86,1547737200,411,646,235,1057,3,0.4294354099168081,0.696510569816668
86,1547751600,948,866,0,1814,3,-0.643910166578133,1.9813734081796706
86,1547766000,524,235,0,759,3,-0.643910166578133,0.19071251719820725
86,1547780400,71,26,0,97,3,-0.643910166578133,-0.9329059755313934
86,1547794800,16,48,32,64,3,-0.4977524710554177,-0.9889171692777331
86,1547797200,13,22,9,35,3,-0.6028033147123694,-1.0381391274184557
86,1547797496,4,7,3,11,3,-0.6302078826228785,-1.0788745410521572
86,1547797890,4,8,4,12,3,-0.6256404546377936,-1.0771772321507531
86,1547809200,180,767,587,947,3,2.0371700606666776,0.5098065906622026
86,1547823600,416,606,190,1022,3,0.22390115058798962,0.6371047582675199
86,1547838000,932,852,0,1784,3,-0.643910166578133,1.9304541411375438
86,1547852400,491,269,0,760,3,-0.643910166578133,0.1924098260996115
86,1547866800,83,52,0,135,3,-0.643910166578133,-0.8684082372780327
86,1547881200,14,39,25,53,3,-0.5297244669510117,-1.0075875671931795
86,1547895600,66,497,431,563,3,1.32465129499344,-0.14196002747702197
86,1547910000,438,1115,677,1553,3,2.4482385793243147,1.5383757849131665
86,1547924400,886,306,0,1192,3,-0.643910166578133,0.9256472715062392
86,1547938800,587,1317,730,1904,3,2.690312262533812,2.134131209306051
86,1547953200,71,46,0,117,3,-0.643910166578133,-0.8989597975033089
86,1547967600,7,30,23,37,3,-0.5388593229211814,-1.0347445096156473
86,1547982000,34,292,258,326,3,0.5344862535737598,-0.5442222371098246
86,1547996400,361,738,377,1099,3,1.0780101837988578,0.7677975436756457
86,1548010800,708,742,34,1450,3,-0.488617615085248,1.3635529680685305
86,1548025200,298,152,0,450,3,-0.643910166578133,-0.33375593333570003
86,1548039600,42,24,0,66,3,-0.643910166578133,-0.9855225514749246
86,1548054000,7,41,34,48,3,-0.488617615085248,-1.0160741117002008
86,1548068400,83,387,304,470,3,0.7445879408876632,-0.29980975530761544
86,1548082800,290,418,128,708,3,-0.05927938448727148,0.10414976322659149
86,1548097200,496,363,0,859,3,-0.643910166578133,0.36044340733863034
86,1548111600,207,82,0,289,3,-0.643910166578133,-0.6070226664617812
86,1548126000,25,10,0,35,4,-0.6643923802146668,-1.1866108472651715
86,1548140400,13,54,41,67,4,-0.4759857908116658,-1.131760789288926
86,1548154800,194,825,631,1019,4,2.2352309835242035,0.5000284355043775
86,1548169200,361,509,148,870,4,0.01570945470348331,0.24463285305248436
86,1548183600,867,751,0,1618,4,-0.6643923802146668,1.5267529582472228
86,1548198000,434,231,0,665,4,-0.6643923802146668,-0.10675033085783835
86,1548212400,47,23,0,70,4,-0.6643923802146668,-1.126618596353653
86,1548226800,20,56,36,76,4,-0.49896220415349524,-1.116334210483107
86,1548241200,217,887,670,1104,4,2.4144470075904727,0.6457239020037796
86,1548255600,382,798,416,1180,4,1.2472452098255393,0.7759927896973626
86,1548270000,890,863,0,1753,4,-0.6643923802146668,1.7581516403345088
86,1548284400,424,250,0,674,4,-0.6643923802146668,-0.0913237520520193
86,1548298800,52,28,0,80,4,-0.6643923802146668,-1.1094779532360763
86,1548313200,17,67,50,84,4,-0.4346282467963729,-1.1026216959890456
86,1548327600,207,805,598,1012,4,2.0835866554681295,0.48802998532207376
86,1548338198,210,166,0,376,4,-0.6643923802146668,-0.6021149169558054
86,1548342000,169,462,293,631,4,0.6820254416165359,-0.1650285174575992
86,1548356400,824,737,0,1561,4,-0.6643923802146668,1.4290512924770356
86,1548370800,390,272,0,662,4,-0.6643923802146668,-0.11189252379311136
86,1548385200,61,38,0,99,4,-0.6643923802146668,-1.0769107313126807
86,1548399600,12,65,53,77,4,-0.4208423987912753,-1.1146201461713494
86,1548414000,199,803,604,1002,4,2.1111583514783248,0.470889342204497
86,1548428400,437,727,290,1164,4,0.6682395936114383,0.7485677607092399
86,1548442800,1043,948,0,1991,4,-0.6643923802146668,2.1660989465328346
86,1548457200,543,259,0,802,4,-0.6643923802146668,0.1280764798529627
86,1548471600,85,50,0,135,4,-0.6643923802146668,-1.0152044160894045
86,1548486000,15,35,20,50,4,-0.5724867268473492,-1.1608998825888064
86,1548500400,105,413,308,518,4,0.7509546816420241,-0.35871778468621607
86,1548514800,447,926,479,1373,4,1.5367480179325896,1.1068072018665933
86,1548529200,945,989,44,1934,4,-0.4621999428065682,2.0683972807626474
86,1548543600,537,271,0,808,4,-0.6643923802146668,0.13836086572350872
86,1548558000,79,70,0,149,4,-0.6643923802146668,-0.9912075157247969
86,1548572400,14,24,10,38,4,-0.6184395535310081,-1.1814686543298984
86,1548586800,60,289,229,349,4,0.38792735084111957,-0.6483946533732626
86,1548601200,369,824,455,1193,4,1.4264612338918086,0.7982756257502124
86,1548615600,837,648,0,1485,4,-0.6643923802146668,1.2987824047834524
86,1548630000,288,142,0,430,4,-0.6643923802146668,-0.5095554441208912
86,1548644400,38,36,0,74,4,-0.6643923802146668,-1.1197623391066223
86,1548658800,12,61,49,73,4,-0.4392235294647388,-1.12147640341838
86,1548673200,193,801,608,994,4,2.129539482151788,0.45717682771043566
86,1548687600,362,547,185,909,4,0.18573491343302087,0.3114813612110336
86,1548702000,861,632,0,1493,4,-0.6643923802146668,1.312494919277514
86,1548716400,397,199,0,596,4,-0.6643923802146668,-0.2250207683691177
86,1548730800,47,24,0,71,5,-0.641333554037375,-1.1177284640141993
86,1548745200,11,66,55,77,5,-0.36027104031581625,-1.1070304666374824
86,1548759600,217,754,537,971,5,2.1028586253894805,0.48697114249332973
86,1548774000,350,510,160,860,5,0.17630284951625053,0.2890581910240678
86,1548788400,879,733,0,1612,5,-0.641333554037375,1.6298738622392477
86,1548802800,422,208,0,630,5,-0.641333554037375,-0.12103170841674517
86,1548817200,53,24,0,77,5,-0.641333554037375,-1.1070304666374824
86,1548831600,15,67,52,82,5,-0.37560172288244675,-1.0981154688235517
86,1548846000,208,797,589,1005,5,2.368590456544409,0.5475931276280587
86,1548860400,391,524,133,915,5,0.0383267064165762,0.3871231669773057
86,1548874800,897,672,0,1569,5,-0.641333554037375,1.5532048810394434
86,1548889200,391,199,0,590,5,-0.641333554037375,-0.1923516909281909
86,1548903600,41,19,0,60,5,-0.641333554037375,-1.137341459204847
86,1548918000,12,54,42,66,5,-0.42670399810454834,-1.12664346182813
86,1548932400,204,772,568,976,5,2.2612756785779955,0.49588614030726047
86,1548946800,321,458,137,779,5,0.058767616505416835,0.14463522643839022
86,1548961200,801,660,0,1461,5,-0.641333554037375,1.36064092825854
86,1548975600,412,245,0,657,5,-0.641333554037375,-0.0728907202215193
86,1548990000,48,19,0,67,5,-0.641333554037375,-1.124860462265344
86,1549004400,12,46,34,58,5,-0.4675858182822296,-1.1409074583304193
86,1549018800,191,776,585,967,5,2.3481495464555686,0.47983914424218516
86,1549033200,436,611,175,1047,5,0.2529562623494029,0.6224791092650767
86,1549047600,962,888,0,1850,5,-0.641333554037375,2.05422775818235
86,1549062000,461,213,0,674,5,-0.641333554037375,-0.04257972765415485
86,1549076400,71,38,0,109,5,-0.641333554037375,-1.049974480628326
86,1549090800,13,30,17,43,5,-0.5544596861598023,-1.1676524517722113
86,1549105200,94,404,310,498,5,0.9428369778477744,-0.3563876507045161
86,1549119600,460,934,474,1394,5,1.7809142914902407,1.2411799575518685
86,1549134000,953,1014,61,1967,5,-0.3296096751825553,2.2628387070283287
86,1549148400,460,344,0,804,5,-0.641333554037375,0.1892102155080438
86,1549162800,81,52,0,133,5,-0.641333554037375,-1.0071824911214584
86,1549177200,13,32,19,45,5,-0.544239231115382,-1.164086452646639
86,1549191600,54,261,207,315,5,0.416483543060128,-0.6826765706943804
86,1549206000,313,684,371,997,5,1.2545608567025943,0.5333291311257695
86,1549220400,669,655,0,1324,5,-0.641333554037375,1.1163699881568383
86,1549234800,271,143,0,414,5,-0.641333554037375,-0.5061596139785521
86,1549249200,31,37,6,68,5,-0.6106721889041141,-1.1230774627025577
86,1549263600,8,55,47,63,5,-0.4011528604934975,-1.1319924605164886
86,1549278000,195,787,592,982,5,2.3839211391110395,0.5065841376839774
86,1549292400,365,465,100,830,5,-0.13031080181635907,0.23556820414048352
86,1549306800,870,685,0,1555,5,-0.641333554037375,1.5282428871604374
86,1549321200,438,211,0,649,5,-0.641333554037375,-0.08715471672380844
86,1549335600,40,30,0,70,6,-0.6842225373196882,-1.1434393522105755
86,1549350000,14,68,54,82,6,-0.4114475830850155,-1.1238235234378422
86,1549364400,277,798,521,1075,6,1.9475506322407645,0.4993863075058339
86,1549378800,437,640,203,1077,6,0.34120923508102563,0.5026556123012894
86,1549393200,959,842,0,1801,6,-0.6842225373196882,1.6861439482561953
86,1549407600,496,209,0,705,6,-0.6842225373196882,-0.10543507965344119
86,1549422000,52,29,0,81,6,-0.6842225373196882,-1.12545817583557
86,1549436400,7,60,53,67,6,-0.41649897112639833,-1.1483433094037587
86,1549450800,247,749,502,996,6,1.8515742594544908,0.37024876808534
86,1549465200,424,581,157,1005,6,0.10884538517741561,0.38496063966488997
86,1549479600,924,713,0,1637,6,-0.6842225373196882,1.418060955028841
86,1549494000,450,230,0,680,6,-0.6842225373196882,-0.14630138959663547
86,1549508400,42,37,0,79,6,-0.6842225373196882,-1.1287274806310255
86,1549522800,10,75,65,85,6,-0.3558823146298044,-1.118919566244659
86,1549537200,210,825,615,1035,6,2.4223811081307502,0.4340002115967231
86,1549551600,405,647,242,1052,6,0.5382133686949558,0.4617893023580952
86,1549566000,1124,855,0,1979,6,-0.6842225373196882,1.9771120750517384
86,1549580400,712,289,0,1001,6,-0.6842225373196882,0.37842203007397884
86,1549594800,87,44,0,131,6,-0.6842225373196882,-1.0437255559491814
86,1549609200,15,65,50,80,6,-0.4316531352505468,-1.1270928282332977
86,1549623600,241,825,584,1066,6,2.2657880788478826,0.48467443592628395
86,1549638000,405,612,207,1017,6,0.36141478724655696,0.4045764684376232
86,1549652400,999,955,0,1954,6,-0.6842225373196882,1.936245765108544
86,1549666800,542,272,0,814,6,-0.6842225373196882,0.07274203169888578
86,1549681200,91,53,0,144,6,-0.6842225373196882,-1.0224750747787203
86,1549695600,14,31,17,45,6,-0.59834894061618,-1.1843056621537698
86,1549710000,82,389,307,471,6,0.8665535913848396,-0.4879437407217395
86,1549724400,498,1013,515,1511,6,1.9172423039924675,1.2120947529151418
86,1549738800,942,1014,72,1956,6,-0.32052259834012464,1.9395150699039998
86,1549753200,459,351,0,810,6,-0.6842225373196882,0.06620342210797471
86,1549767600,111,69,0,180,6,-0.6842225373196882,-0.9636275884605207
86,1549782000,13,26,13,39,6,-0.6185544927817114,-1.1941135765401363
86,1549796400,58,266,208,324,6,0.36646617528793973,-0.7282376431877218
86,1549810800,381,845,464,1226,6,1.6596215138819432,0.7462188195627272
86,1549825200,740,700,0,1440,6,-0.6842225373196882,1.0960344326764702
86,1549839600,270,134,0,404,6,-0.6842225373196882,-0.5974654513695001
86,1549854000,35,17,0,52,6,-0.6842225373196882,-1.1728630953696753
86,1549868400,10,70,60,80,6,-0.38113925483671857,-1.1270928282332977
86,1549882800,191,758,567,949,6,2.1799144821443743,0.2934201053921348
86,1549897200,333,546,213,879,6,0.3917231154948539,0.17899443755119088
86,1549911600,868,752,0,1620,6,-0.6842225373196882,1.3902718642674687
86,1549926000,411,209,0,620,6,-0.6842225373196882,-0.2443805334603017
86,1549940400,41,24,0,65,7,-0.5894410489056414,-1.08667124751375
86,1549954800,12,57,45,69,7,-0.33370821714949434,-1.0801197576412567
86,1549969200,194,783,589,977,7,2.757817571191484,0.40706844341475157
86,1549983600,338,476,138,814,7,0.19480630181320968,0.14009523111064437
86,1549998000,787,686,0,1473,7,-0.5894410489056414,1.2194531876039367
86,1550012400,392,201,0,593,7,-0.5894410489056414,-0.2218745843446176
86,1550026800,41,21,0,62,7,-0.5894410489056414,-1.0915848649181203
86,1550041200,17,49,32,66,7,-0.4075865907679368,-1.085033375045627
86,1550055600,206,812,606,1018,7,2.8544277520771395,0.47422121460780925
86,1550070000,432,575,143,1007,7,0.22322106089722604,0.4562046174584523
86,1550084400,918,931,13,1849,7,-0.5155626752871989,1.8352932356183194
86,1550098800,492,263,0,755,7,-0.5894410489056414,0.04346075549136628
86,1550113200,47,25,0,72,7,-0.5894410489056414,-1.0752061402368867
86,1550127600,11,58,47,69,7,-0.32234231351588777,-1.0801197576412567
86,1550142000,206,829,623,1035,7,2.951037932962795,0.5020650465659063
86,1550144733,33,109,76,142,7,-0.15753671082859297,-0.9605550674682517
86,1550156400,414,505,91,919,7,-0.07229243357654394,0.31207184026359686
86,1550170800,1005,899,0,1904,7,-0.5894410489056414,1.925376221365104
86,1550185200,484,256,0,740,7,-0.5894410489056414,0.01889266846951592
86,1550199600,62,41,0,103,7,-0.5894410489056414,-1.0244320937250626
86,1550214000,12,60,48,72,7,-0.3166593616990845,-1.0752061402368867
86,1550228400,173,768,595,941,7,2.7919152820923037,0.34810503456231073
86,1550242800,468,643,175,1111,7,0.4050755190349306,0.6265433541432814
86,1550257200,952,792,0,1744,7,-0.5894410489056414,1.6633166264653665
86,1550271600,479,251,0,730,7,-0.5894410489056414,0.0025139437882823494
86,1550286000,107,49,0,156,7,-0.5894410489056414,-0.9376248529145247
86,1550300400,18,37,19,55,7,-0.4814649643863793,-1.1030499721949838
86,1550314800,102,281,179,383,7,0.4278073263021437,-0.5658278026505226
86,1550329200,549,792,243,1341,7,0.7915162425775529,1.0032540218116537
86,1550343600,1178,873,0,2051,7,-0.5894410489056414,2.1661434741792376
86,1550358000,548,243,0,791,7,-0.5894410489056414,0.10242416434380713
86,1550372400,102,56,0,158,7,-0.5894410489056414,-0.934349107978278
86,1550386800,15,16,1,31,7,-0.5837580970888381,-1.1423589114299444
86,1550401200,81,210,129,291,7,0.14365973546198027,-0.7165120697178715
86,1550415600,523,701,178,1224,7,0.42212437448534046,0.8116229430412208
86,1550430000,1151,576,0,1727,7,-0.5894410489056414,1.6354727945072696
86,1550444400,415,135,0,550,7,-0.5894410489056414,-0.29230310047392194
86,1550458800,60,30,0,90,7,-0.5894410489056414,-1.0457244358106663
86,1550473200,13,48,35,61,7,-0.390537735317527,-1.0932227373862435
86,1550487600,149,402,253,551,7,0.8483457607455855,-0.2906652280057986
86,1550502000,505,707,202,1212,7,0.5585152180886189,0.7919684734237405
86,1550516400,966,763,0,1729,7,-0.5894410489056414,1.6387485394435162
86,1550530800,399,194,0,593,7,-0.5894410489056414,-0.2218745843446176
86,1550545200,59,36,0,95,8,-0.6550435888710257,-1.0807227247368516
86,1550559600,13,65,52,78,8,-0.3594212170372359,-1.1098799416094909
86,1550574000,199,799,600,998,8,2.755983778441933,0.46804003032158487
86,1550588400,385,569,184,954,8,0.39100480377161506,0.3925742925335769
86,1550602800,938,802,0,1740,8,-0.6550435888710257,1.740666790292083
86,1550617200,452,206,0,658,8,-0.6550435888710257,-0.11510430713120404
86,1550631600,48,23,0,71,8,-0.6550435888710257,-1.1218858544394013
86,1550646000,16,58,42,74,8,-0.4162716731591185,-1.1167404632265827
86,1550660400,216,786,570,1002,8,2.5854324100762853,0.4749005519386765
86,1550674800,424,525,101,949,8,-0.08085398204001092,0.38399864051221233
86,1550689200,766,688,0,1454,8,-0.6550435888710257,1.250139494670031
86,1550703600,407,194,0,601,8,-0.6550435888710257,-0.21286674017475982
86,1550718000,45,29,0,74,8,-0.6550435888710257,-1.1167404632265827
86,1550732400,9,56,47,65,8,-0.38784644509817723,-1.1321766368650388
86,1550739610,53,258,205,311,8,0.5103907616275686,-0.7102545574139033
86,1550746800,197,513,316,710,8,1.141430824580466,-0.025917526109012795
86,1550761200,404,659,255,1063,8,0.7946430422369819,0.579523506599324
86,1550775600,984,873,0,1857,8,-0.6550435888710257,1.9413370475920133
86,1550790000,542,306,0,848,8,-0.6550435888710257,0.21077046968064858
86,1550804400,73,32,0,105,8,-0.6550435888710257,-1.0635714206941225
86,1550818800,17,52,35,69,8,-0.4560669924444364,-1.1253161152479472
86,1550824732,29,182,153,211,8,0.21476838979377885,-0.8817675978411942
86,1550832348,64,533,469,597,8,2.0112428032452705,-0.21972726179185145
86,1550833200,335,417,82,752,8,-0.18886984867158793,0.04611795087044936
86,1550847600,760,682,0,1442,8,-0.6550435888710257,1.2295579298187562
86,1550862000,1066,931,0,1997,8,-0.6550435888710257,2.1814553041902203
86,1550876400,520,283,0,803,8,-0.6550435888710257,0.13358960148836768
86,1551495600,6236,6710,474,12946,9,1.1690988728740477,4.069945534038998
86,1551510000,18,25,7,43,9,-0.8778590786733892,-0.4346871422731484
86,1551524400,60,373,313,433,9,0.46340244846476,-0.29853223692077013
86,1551538800,261,931,670,1192,9,2.0282075634592673,-0.03355384419652626
86,1551553200,434,908,474,1342,9,1.1690988728740477,0.01881342709285
86,1551567600,250,311,61,561,9,-0.6411658680019511,-0.2538454987538357
86,1551582000,70,59,0,129,9,-0.9085415319085756,-0.40466324006723936
86,1551596400,14,31,17,45,9,-0.8340270026231229,-0.43398891198929007
86,1551610800,40,242,202,282,9,-0.023133595693196084,-0.3512486233520756
86,1551625200,210,778,568,988,9,1.581120387746551,-0.10477333315007797
86,1551639600,433,664,231,1097,9,0.10397942485257623,-0.06671978267979789
86,1551654000,189,122,0,311,9,-0.9085415319085756,-0.3411242842361295
86,1551668400,24,16,0,40,9,-0.9085415319085756,-0.43573448769893597
86,1551682800,12,45,33,57,9,-0.7638956809426968,-0.42979953028614
86,1551697200,187,701,514,888,9,1.3444271770751128,-0.1396848473429955
86,1551711600,311,478,167,789,9,-0.17654586186912818,-0.1742472463939838
86,1551726000,810,629,0,1439,9,-0.9085415319085756,0.052677595859979984
86,1551740400,368,236,0,604,9,-0.9085415319085756,-0.23883354765088122
86,1551754800,41,23,0,64,10,-0.7488547135060464,-1.1394289939947142
86,1551769200,10,55,45,65,10,-0.569000906370059,-1.137702458820134
86,1551783600,205,793,588,998,10,1.601235033070856,0.47315485906292426
86,1551798000,347,566,219,913,10,0.12643381455575914,0.3263993692236317
86,1551812400,902,838,0,1740,10,-0.7488547135060464,1.7542439586012195
86,1551826800,406,282,0,688,10,-0.7488547135060464,-0.06207104505684864
86,1551841200,39,37,0,76,10,-0.7488547135060464,-1.1187105718997552
86,1551855600,12,64,52,76,10,-0.5410236474822386,-1.1187105718997552
86,1551870000,217,760,543,977,10,1.4213812259348686,0.4368976203967461
86,1551884400,372,640,268,1012,10,0.322274626770501,0.497326351507043
86,1551898800,828,735,0,1563,10,-0.7488547135060464,1.4486472327005748
86,1551913200,416,217,0,633,10,-0.7488547135060464,-0.15703047965874384
86,1551927600,44,29,0,73,10,-0.7488547135060464,-1.1238901774234948
86,1551942000,10,63,53,73,10,-0.5370268962125501,-1.1238901774234948
86,1551956400,199,817,618,1016,10,1.7211375711615144,0.5042324922053627
86,1551970800,393,631,238,1024,10,0.20237208867984274,0.518044773602002
86,1551985200,1070,838,0,1908,10,-0.7488547135060464,2.0443018679306446
86,1551999600,631,266,0,897,10,-0.7488547135060464,0.2987748064303531
86,1552014000,53,38,0,91,10,-0.7488547135060464,-1.0928125442810566
86,1552028400,11,63,52,74,10,-0.5410236474822386,-1.122163642248915
86,1552042800,172,742,570,914,10,1.529293510216461,0.3281259043982116
86,1552057200,397,641,244,1038,10,0.22635259629797438,0.5422162660461207
86,1552071600,988,974,0,1962,10,-0.7488547135060464,2.13753476735796
86,1552086000,442,271,0,713,10,-0.7488547135060464,-0.018907665692350827
86,1552100400,88,77,0,165,10,-0.7488547135060464,-0.9650489413621429
86,1552114800,14,33,19,47,10,-0.6729164393819628,-1.1687800919625726
86,1552129200,51,382,331,433,10,0.5740699567608835,-0.5023375145747263
86,1552143600,227,1197,970,1424,10,3.127994018091905,1.2086588434339671
86,1552158000,493,1163,670,1656,10,1.928968637185322,1.6092150039365067
86,1552172400,271,412,141,683,10,-0.1853127844799524,-0.0707037209297482
86,1552190400,77,86,9,163,10,-0.7128839520788488,-0.9685020117113028
86,1552204800,12,38,26,50,10,-0.6449391804941424,-1.163600486438833
86,1552219200,44,358,314,402,10,0.5061251851761771,-0.5558601049867037
86,1552233600,232,765,533,997,10,1.3814137132379825,0.4714283238883443
86,1552248000,394,683,289,1077,10,0.4062064034339618,0.6095511378547374
86,1552262400,135,130,0,265,10,-0.7488547135060464,-0.7923954239041516
86,1552276800,21,12,0,33,10,-0.7488547135060464,-1.1929515844066914
86,1552291200,30,156,126,186,10,-0.24526405352528152,-0.9287917026959648
86,1552305600,212,837,625,1049,10,1.7491148300493347,0.5612081529664998
86,1552320000,385,524,139,909,10,-0.19330628701932961,0.31949322852531203
86,1552334400,872,683,0,1555,10,-0.7488547135060464,1.4348349513039356
86,1552348800,308,97,0,405,11,-0.7128995281151824,-0.47076870700934403
86,1552363200,20,10,0,30,11,-0.7128995281151824,-1.1109395115738296
86,1552377600,41,129,88,170,11,-0.27822150452706607,-0.8719424112030884
86,1552392000,247,817,570,1064,11,2.1026285792169346,0.6542247868786454
86,1552406400,452,639,187,1091,11,0.21079127200956482,0.7003170848072884
86,1552420800,977,755,0,1732,11,-0.7128995281151824,1.7945823800761824
86,1552435200,302,94,0,396,11,-0.7128995281151824,-0.48613280631889166
86,1552449600,18,9,0,27,11,-0.7128995281151824,-1.1160608780103456
86,1552464000,35,126,91,161,11,-0.26340293554110755,-0.887306510512636
86,1552478400,234,866,632,1100,11,2.408879004926744,0.715681184116836
86,1552492800,459,610,151,1069,11,0.03296844417806268,0.6627603976061719
86,1552507200,936,863,0,1799,11,-0.7128995281151824,1.9089595638250372
86,1552521600,277,103,0,380,11,-0.7128995281151824,-0.5134467606469764
86,1552536000,24,8,0,32,11,-0.7128995281151824,-1.107525267282819
86,1552550400,34,124,90,158,11,-0.2683424585364271,-0.8924278769491519
86,1552552016,22,46,24,68,11,-0.5943509762275143,-1.0460688700446283
86,1552564800,234,739,505,973,11,1.781559584521167,0.4988766716376636
86,1552579200,507,693,186,1200,11,0.20585174901424533,0.8863933986673656
86,1552593600,1089,876,0,1965,11,-0.7128995281151824,2.192341839978916
86,1552608000,308,108,0,416,11,-0.7128995281151824,-0.4519903634087858
86,1552622400,20,7,0,27,11,-0.7128995281151824,-1.1160608780103456
86,1552636800,35,121,86,156,11,-0.2881005505177051,-0.8958421212401625
86,1552651200,214,813,599,1027,11,2.2458747460812005,0.5910612674949495
86,1552665600,509,668,159,1177,11,0.07248462814061872,0.8471295893207438
86,1552680000,1056,864,0,1920,11,-0.7128995281151824,2.115521343431178
86,1552694400,243,166,0,409,11,-0.7128995281151824,-0.4639402184273228
86,1552708800,58,42,0,100,11,-0.7128995281151824,-0.9914409613884589
86,1552723200,12,61,49,73,11,-0.47086290134452674,-1.037533259317102
86,1552737600,81,511,430,592,11,1.4110953598722042,-0.15153686579985384
86,1552752000,285,898,613,1183,11,2.3150280680156734,0.8573723221937756
86,1552766400,488,822,334,1310,11,0.9369011523215319,1.0741768346729479
86,1552780800,187,221,34,408,11,-0.5449557462743193,-0.46564734057282814
86,1552795200,52,44,0,96,11,-0.7128995281151824,-0.9982694499704802
86,1552809600,12,38,26,50,11,-0.5844719302368754,-1.0767970686637238
86,1552824000,75,324,249,399,11,0.5170416977193741,-0.48101143988237577
86,1552838400,407,780,373,1187,11,1.1295425491389925,0.8642008107757967
86,1552852800,564,536,0,1100,11,-0.7128995281151824,0.715681184116836
86,1552867200,170,97,0,267,11,-0.7128995281151824,-0.7063515630890748
86,1552881600,19,13,0,32,11,-0.7128995281151824,-1.107525267282819
86,1552896000,33,146,113,179,11,-0.15473342964407846,-0.8565783118935407
86,1552910400,218,738,520,956,11,1.8556524294509595,0.46985559516407355
86,1552924800,403,500,97,903,11,-0.23376579756919055,0.37937812145229294
86,1552939200,858,628,0,1486,11,-0.7128995281151824,1.37463033228188
86,1552953600,221,78,0,299,12,-0.670538381873033,-0.6959544315981169
86,1552968000,17,9,0,26,12,-0.670538381873033,-1.1667398895747545
86,1552982400,31,126,95,157,12,-0.1874310969915954,-0.9408318493002507
86,1552996800,241,841,600,1082,12,2.3806655226413103,0.6543203434777339
86,1553011200,422,565,143,987,12,0.05666521536955207,0.4904939020572923
86,1553025600,924,747,0,1671,12,-0.670538381873033,1.6700442802844724
86,1553040000,274,97,0,371,12,-0.670538381873033,-0.5717912338899926
86,1553054400,27,24,0,51,12,-0.670538381873033,-1.1236276681483224
86,1553068800,32,119,87,151,12,-0.2281138157184533,-0.9511787824425944
86,1553083200,233,825,592,1058,12,2.3399828039144523,0.6129326109083593
86,1553097600,467,607,140,1074,12,0.04140919584698035,0.6405244326212757
86,1553112000,919,768,0,1687,12,-0.670538381873033,1.6976361019973887
86,1553126400,298,77,0,375,12,-0.670538381873033,-0.5648932784617635
86,1553140800,22,8,0,30,12,-0.670538381873033,-1.1598419341465254
86,1553155200,31,145,114,176,12,-0.09080964001530786,-0.9080665610161623
86,1553169600,232,742,510,974,12,1.9229849369641585,0.46807554691554765
86,1553184000,455,588,133,1043,12,0.005811816960979681,0.5870652780525
86,1553198400,889,755,0,1644,12,-0.670538381873033,1.6234830811439258
86,1553212800,293,104,0,397,12,-0.670538381873033,-0.5269545236065033
86,1553227200,25,10,0,35,12,-0.670538381873033,-1.151219489861239
86,1553241600,28,128,100,156,12,-0.1620043977873092,-0.942556338157308
86,1553256000,230,808,578,1038,12,2.268788046142451,0.5784428337672136
86,1553270400,485,619,134,1104,12,0.01089715680183692,0.6922590983329941
86,1553284800,974,804,0,1778,12,-0.670538381873033,1.8545645879896016
86,1553299200,316,146,0,462,12,-0.670538381873033,-0.41486274789778005
86,1553313600,60,40,0,100,12,-0.670538381873033,-1.0391277141525157
86,1553328000,12,68,56,80,12,-0.3857593507850277,-1.0736174912936614
86,1553342400,116,542,426,658,12,1.4958163903321504,-0.07686293191455305
86,1553356800,560,1010,450,1570,12,1.6178645465127242,1.495870905721687
86,1553371200,891,896,5,1787,12,-0.6451116826687469,1.8700849877031172
86,1553385600,354,230,0,584,12,-0.670538381873033,-0.20447510733679183
86,1553400000,55,29,0,84,12,-0.670538381873033,-1.0667195358654322
86,1553414400,16,34,18,50,12,-0.5790022647376027,-1.1253521570053797
86,1553428800,86,362,276,448,12,0.7330154142035649,-0.439005591896582
86,1553443200,462,739,277,1201,12,0.7381007540444221,0.8595345174675504
86,1553457600,672,480,0,1152,12,-0.670538381873033,0.7750345634717436
86,1553472000,233,93,0,326,12,-0.670538381873033,-0.6493932324575702
86,1553486400,13,11,0,24,12,-0.670538381873033,-1.170188867288869
86,1553500800,39,133,94,172,12,-0.19251643683245265,-0.9149645164443915
86,1553515200,205,818,613,1023,12,2.446774940572454,0.5525755009113544
86,1553529600,396,493,97,889,12,-0.17726041730988093,0.3214939940656788
86,1553544000,875,659,0,1534,12,-0.670538381873033,1.4337893068676248
86,1553558400,242,86,0,328,13,-0.7089578207631396,-0.6042650752211124
86,1553572800,13,10,0,23,13,-0.7089578207631396,-1.0937464121841913
86,1553587200,36,136,100,172,13,-0.24736942014789634,-0.8546227426514085
86,1553601600,225,911,686,1136,13,2.4575386074574297,0.6924592535204213
86,1553616000,436,624,188,1060,13,0.15882837239351782,0.570490133490277
86,1553630400,954,755,0,1709,13,-0.7089578207631396,1.612042224274009
86,1553644800,275,121,0,396,13,-0.7089578207631396,-0.4951348099309833
86,1553659200,21,8,0,29,13,-0.7089578207631396,-1.0841172711291798
86,1553673600,32,138,106,170,13,-0.21967411611098173,-0.8578324563364123
86,1553688000,242,872,630,1114,13,2.1990491031128934,0.6571524029853795
86,1553702400,442,308,0,750,13,-0.7089578207631396,0.07298451231468862
86,1553716800,949,1421,472,2370,13,1.4697394301408089,2.6728525971677635
86,1553731200,281,96,0,377,13,-0.7089578207631396,-0.5256270899385194
86,1553745600,22,7,0,29,13,-0.7089578207631396,-1.0841172711291798
86,1553760000,34,135,101,169,13,-0.2427535361417439,-0.8594373131789141
86,1553774400,229,843,614,1072,13,2.1251949590144545,0.5897484156002998
86,1553788800,475,639,164,1114,13,0.04804715624585941,0.6571524029853795
86,1553803200,455,766,311,1221,13,0.7265821051502671,0.8288720851330826
86,1553817600,317,105,0,422,13,-0.7089578207631396,-0.45340853202593395
86,1553832000,30,11,0,41,13,-0.7089578207631396,-1.064858989019157
86,1553846400,37,133,96,170,13,-0.2658329561725061,-0.8578324563364123
86,1553850581,65,114,49,179,13,-0.48277950446167045,-0.8433887447538951
86,1553860800,173,844,671,1017,13,2.388300347365143,0.5014812892626954
86,1553875200,517,749,232,1266,13,0.36192726866422487,0.901090643045668
86,1553889600,986,872,0,1858,13,-0.7089578207631396,1.8511658938067916
86,1553904000,358,177,0,535,13,-0.7089578207631396,-0.27205970882321945
86,1553918400,90,48,0,138,13,-0.7089578207631396,-0.9091878752964729
86,1553932800,19,65,46,84,13,-0.49662715648012773,-0.9958501447915755
86,1553947200,123,581,458,704,13,1.4051170540546747,-0.0008389024403986863
86,1553961600,588,1128,540,1716,13,1.7836195425591743,1.6232762221715222
86,1553976000,1021,910,0,1931,13,-0.7089578207631396,1.9683204433094301
86,1553990400,398,207,0,605,13,-0.7089578207631396,-0.1597197298480866
86,1554004800,80,47,0,127,13,-0.7089578207631396,-0.9268413005639938
86,1554019200,12,56,44,68,13,-0.5058589244924326,-1.0215278542716058
86,1554022591,9,22,13,31,13,-0.6489513286831581,-1.080907557444176
86,1554033600,87,359,272,446,13,0.5465626289103223,-0.4148919678058884
86,1554048000,519,701,182,1220,13,0.1311330683566032,0.8272672282905807
86,1554062400,587,456,0,1043,13,-0.7089578207631396,0.5432075671677448
86,1554076800,247,103,0,350,13,-0.7089578207631396,-0.5689582246860706
86,1554091200,16,12,0,28,13,-0.7089578207631396,-1.0857221279716818
86,1554105600,35,164,129,199,13,-0.11350878396947577,-0.8112916079038572
86,1554120000,221,756,535,977,13,1.760540122528412,0.4372870155626195
86,1554134400,396,515,119,911,13,-0.1596676240310001,0.3313664639574942
86,1554148800,1096,598,0,1694,13,-0.7089578207631396,1.5879693716364804
86,1554163200,257,134,0,391,14,-0.6842636745548356,-0.5931279191384304
86,1554177600,26,27,1,53,14,-0.6789612623165878,-1.1809556167151658
86,1554192000,39,167,128,206,14,-0.00555490805911669,-0.9148679311256969
86,1554206400,261,790,529,1051,14,2.120712399478253,0.5547013128161418
86,1554220800,422,623,201,1045,14,0.381521185332973,0.5442665016165548
86,1554235200,930,675,0,1605,14,-0.6842636745548356,1.5181822135780099
86,1554249600,296,181,0,477,14,-0.6842636745548356,-0.4435622919443498
86,1554264000,30,27,0,57,14,-0.6842636745548356,-1.1739990759154413
86,1554278400,30,140,110,170,14,-0.10099832834757716,-0.977476798323219
86,1554292800,248,867,619,1115,14,2.597929500920555,0.6660059656117366
86,1554307200,456,539,83,995,14,-0.24416345878026788,0.4573097416199962
86,1554321600,914,789,0,1703,14,-0.6842636745548356,1.6886174631712645
86,1554336000,338,183,0,521,14,-0.6842636745548356,-0.3670403431473783
86,1554350400,40,30,0,70,14,-0.6842636745548356,-1.1513903183163359
86,1554364800,36,145,109,181,14,-0.10630074058582496,-0.9583463111239761
86,1554379200,226,792,566,1018,14,2.3169016522934216,0.49730985121841315
86,1554393600,427,645,218,1072,14,0.47166219338318566,0.5912231520146963
86,1554408000,979,795,0,1774,14,-0.6842636745548356,1.8120960623663775
86,1554422400,376,241,0,617,14,-0.6842636745548356,-0.20008336395398602
86,1554436800,48,33,0,81,14,-0.6842636745548356,-1.132259831117093
86,1554451200,32,133,101,165,14,-0.1487200384918074,-0.9861724743228748
86,1554465600,254,818,564,1072,14,2.306296827816926,0.5912231520146963
86,1554480000,508,714,206,1222,14,0.408033246524212,0.8520934320043718
86,1554494400,986,834,0,1820,14,-0.6842636745548356,1.8920962815632114
86,1554508800,305,152,0,457,14,-0.6842636745548356,-0.4783449959429732
86,1554523200,56,35,0,91,14,-0.6842636745548356,-1.1148684791177814
86,1554537600,21,67,46,88,14,-0.44035271159543665,-1.120085884717575
86,1554552000,121,480,359,601,14,1.219302318976126,-0.22790952715288473
86,1554566400,584,836,252,1420,14,0.651944209483611,1.1964422015907434
86,1554580800,932,807,0,1739,14,-0.6842636745548356,1.7512263303687867
86,1554595200,407,211,0,618,14,-0.6842636745548356,-0.19834422875405483
86,1554609600,76,56,0,132,14,-0.6842636745548356,-1.0435639359206035
86,1554624000,17,42,25,59,14,-0.5517033685986406,-1.170520805515579
86,1554638400,90,369,279,459,14,0.7951093399163017,-0.4748667255431109
86,1554652800,506,740,234,1246,14,0.5565007891951506,0.8938326768027199
86,1554667200,731,462,0,1193,14,-0.6842636745548356,0.8016585112063679
86,1554681600,225,122,0,347,14,-0.6842636745548356,-0.6696498679354019
86,1554696000,21,18,0,39,14,-0.6842636745548356,-1.2053035095142022
86,1554710400,33,140,107,173,14,-0.11690556506232058,-0.9722593927234254
86,1554724800,218,816,598,1034,14,2.4865788439173513,0.5251360144173118
86,1554739200,412,497,85,909,14,-0.23355863430377227,0.3077441144259156
86,1554753600,935,725,0,1660,14,-0.6842636745548356,1.6138346495742242
86,1554768000,303,158,0,461,15,-0.7463961920893681,-0.550250026875336
86,1554782400,30,23,0,53,15,-0.7463961920893681,-1.1874364345341923
86,1554796800,41,152,111,193,15,-0.23818835690306256,-0.9687940397492906
86,1554811200,254,783,529,1037,15,1.6756033107354575,0.3493072545254024
86,1554825600,565,1016,451,1581,15,1.318484291415351,1.1988891314038774
86,1554840000,953,789,0,1742,15,-0.7463961920893681,1.4503278854065145
86,1554854400,317,170,0,487,15,-0.7463961920893681,-0.5096450107009971
86,1554868800,41,30,0,71,15,-0.7463961920893681,-1.1593252694904193
86,1554883200,37,154,117,191,15,-0.2107176631092082,-0.9719175025319321
86,1554897600,269,888,619,1157,15,2.087663717643273,0.5367150214838895
86,1554912000,489,586,97,1075,15,-0.30228664242205605,0.40865304739559
86,1554926400,934,813,0,1747,15,-0.7463961920893681,1.458136542363118
86,1554940800,324,239,0,563,15,-0.7463961920893681,-0.39095342496062185
86,1554955200,39,33,0,72,15,-0.7463961920893681,-1.1577635380990985
86,1554969600,37,147,110,184,15,-0.24276680586870494,-0.9828496222711771
86,1554984000,252,820,568,1072,15,1.854162820395511,0.4039678532216278
86,1554998400,457,615,158,1072,15,-0.023001255517870092,0.4039678532216278
86,1555012800,1207,799,0,2006,15,-0.7463961920893681,1.862624972715186
86,1555027200,355,186,0,541,15,-0.7463961920893681,-0.42531151556967783
86,1555041600,49,45,0,94,15,-0.7463961920893681,-1.1234054474900426
86,1555056000,42,177,135,219,15,-0.1283055817276451,-0.9281890235749517
86,1555070400,249,901,652,1150,15,2.238752533509472,0.5257829017446445
86,1555084800,504,703,199,1207,15,0.164715152073468,0.6148015910499258
86,1555099200,1047,866,0,1913,15,-0.7463961920893681,1.7173839533223585
86,1555113600,314,189,0,503,15,-0.7463961920893681,-0.48465730843986543
86,1555128000,65,41,0,106,15,-0.7463961920893681,-1.1046646707941938
86,1555142400,14,94,80,108,15,-0.3801202748379767,-1.1015412080115523
86,1555156800,121,689,568,810,15,1.854162820395511,-0.00520577130440248
86,1555171200,567,1115,548,1682,15,1.7625938410826631,1.3566240019272708
86,1555185600,967,1104,137,2071,15,-0.11914868379636034,1.9641375131510332
86,1555200000,409,310,0,719,15,-0.7463961920893681,-0.14732332791458858
86,1555214400,77,63,0,140,15,-0.7463961920893681,-1.0515658034892892
86,1555228800,19,85,66,104,15,-0.4442185603569702,-1.1077881335768351
86,1555243200,110,517,407,627,15,1.1170325369270857,-0.2910026159160954
86,1555257600,523,933,410,1456,15,1.130767883824013,1.0036727074887868
86,1555272000,797,630,0,1427,15,-0.7463961920893681,0.9583824971404856
86,1555286400,248,127,0,375,15,-0.7463961920893681,-0.6845589265289185
86,1555300800,24,19,0,43,15,-0.7463961920893681,-1.2030537484473995
86,1555315200,35,143,108,178,15,-0.25192370379998974,-0.9922200106191015
86,1555329600,249,832,583,1081,15,1.922839554880147,0.41802343574351436
86,1555344000,413,607,194,1020,15,0.14182290724525606,0.32275782087295
86,1555358400,1002,820,0,1822,15,-0.7463961920893681,1.5752663967121725
86,1555372800,319,117,0,436,16,-0.6877799866737645,-0.5248545613965762
86,1555387200,19,10,0,29,16,-0.6877799866737645,-1.1341172492483869
86,1555401600,37,166,129,203,16,-0.07037698108143697,-0.8736462229923302
86,1555416000,291,888,597,1179,16,2.1695036903697975,0.5873866599152062
86,1555430400,469,631,162,1100,16,0.08756332267473983,0.46912682615527246
86,1555444800,1115,844,0,1959,16,-0.6877799866737645,1.7550153983044257
86,1555459200,323,158,0,481,16,-0.6877799866737645,-0.45749136495104425
86,1555473600,22,16,0,38,16,-0.6877799866737645,-1.1206446099592806
86,1555488000,34,142,108,176,16,-0.17088444710809494,-0.9140641408596494
86,1555502400,267,886,619,1153,16,2.274797226207249,0.5484657019688989
86,1555516800,500,671,171,1171,16,0.13063795097187897,0.5754109805471117
86,1555531200,1096,909,0,2005,16,-0.6877799866737645,1.8238755546709695
86,1555545600,403,197,0,600,16,-0.6877799866737645,-0.27935313435063763
86,1555560000,27,16,0,43,16,-0.6877799866737645,-1.1131598103542215
86,1555574400,32,163,131,195,16,-0.060804841459850496,-0.8856219023604248
86,1555588800,247,860,613,1107,16,2.2460808073424894,0.4796055456023552
86,1555603200,652,689,37,1341,16,-0.5106954036744147,0.8298941671191211
86,1555617600,1214,923,0,2137,16,-0.6877799866737645,2.02147426424453
86,1555632000,411,195,0,606,16,-0.6877799866737645,-0.2703713748245667
86,1555646400,41,27,0,68,16,-0.6877799866737645,-1.075735812328926
86,1555660800,25,131,106,156,16,-0.1804565867296814,-0.9440033392798858
86,1555668906,107,204,97,311,16,-0.22353121502682052,-0.7119745515230537
86,1555668988,1,1,0,2,16,-0.6877799866737645,-1.174535167115706
86,1555675200,119,772,653,891,16,2.437523599774219,0.15626220266380203
86,1555689600,660,917,257,1577,16,0.5422399547000973,1.1831767084779106
86,1555704000,1141,860,0,2001,16,-0.6877799866737645,1.8178877149869221
86,1555718400,345,167,0,512,16,-0.6877799866737645,-0.4110856073996778
86,1555732800,57,41,0,98,16,-0.6877799866737645,-1.0308270146985714
86,1555747200,13,76,63,89,16,-0.38625758859379056,-1.0442996539876777
86,1555761600,110,602,492,712,16,1.6669663602365077,-0.11169362319731378
86,1555776000,550,1038,488,1588,16,1.6478220809933348,1.1996432676090407
86,1555790400,1034,1065,31,2099,16,-0.5394118225391742,1.9645897872460807
86,1555804800,402,277,0,679,16,-0.6877799866737645,-0.16109330059070384
86,1555819200,50,53,3,103,16,-0.6734217772413847,-1.0233422150935123
86,1555833600,20,52,32,72,16,-0.5346257527283809,-1.0697479726448786
86,1555848000,111,403,292,514,16,0.7097523980778606,-0.4080916875576542
86,1555862400,470,809,339,1279,16,0.9346976791851427,0.7370826520163882
86,1555876800,652,690,38,1342,16,-0.5059093338636215,0.831391127040133
86,1555891200,262,133,0,395,16,-0.6877799866737645,-0.5862299181580608
86,1555905600,22,20,0,42,16,-0.6877799866737645,-1.1146567702752332
86,1555920000,29,138,109,167,16,-0.1660983772973017,-0.9275367801487557
86,1555934400,253,869,616,1122,16,2.260439016774869,0.5020599444175324
86,1555948800,533,673,140,1206,16,-0.01773021316271137,0.6278045777825254
86,1555963200,950,677,0,1627,16,-0.6877799866737645,1.2580247045285016
86,1555977600,271,124,0,395,17,-0.6869993319821528,-0.6000397701624106
86,1555992000,22,11,0,33,17,-0.6869993319821528,-1.1503808852947803
86,1556006400,29,148,119,177,17,-0.1160610777010089,-0.9314606627006884
86,1556020800,246,861,615,1107,17,2.263647948546448,0.4823991082194877
86,1556035200,505,720,215,1225,17,0.3445277660888214,0.6617920684007574
86,1556049600,1114,971,0,2085,17,-0.6869993319821528,1.969232286671028
86,1556064000,348,129,0,477,17,-0.6869993319821528,-0.47537686562966386
86,1556078400,27,18,0,45,17,-0.6869993319821528,-1.1321375334119392
86,1556092800,30,127,97,157,17,-0.22161268773617834,-0.9618662491720901
86,1556107200,252,917,665,1169,17,2.5035379713536514,0.5766564262808328
86,1556121600,523,743,220,1266,17,0.3685167683695418,0.7241235206671307
86,1556136000,1070,919,0,1989,17,-0.6869993319821528,1.8232854716083
86,1556150400,334,151,0,485,17,-0.6869993319821528,-0.4632146310411032
86,1556164800,30,17,0,47,17,-0.6869993319821528,-1.1290969747647992
86,1556179200,35,146,111,181,17,-0.15444348135016142,-0.9253795454064081
86,1556193600,248,905,657,1153,17,2.4651555677044987,0.5523319571037115
86,1556208000,570,799,229,1369,17,0.41169697247483833,0.8807122909948492
86,1556222400,1099,992,0,2091,17,-0.6869993319821528,1.9783539626124482
86,1556236800,378,195,0,573,17,-0.6869993319821528,-0.32943005056693603
86,1556251200,36,30,0,66,17,-0.6869993319821528,-1.1002116676169675
86,1556265600,31,133,102,164,17,-0.19762368545545803,-0.9512242939070995
86,1556280000,231,841,610,1072,17,2.2396589462657275,0.42918933189453484
86,1556294400,565,754,189,1319,17,0.2197849542290757,0.8046983248163451
86,1556308800,1006,940,0,1946,17,-0.6869993319821528,1.7579134606947864
86,1556323200,314,169,0,483,17,-0.6869993319821528,-0.46625518968824337
86,1556337600,42,32,0,74,17,-0.6869993319821528,-1.088049433028407
86,1556352000,16,60,44,76,17,-0.47589611191181386,-1.0850088743812667
86,1556366400,143,563,420,706,17,1.328076859598355,-0.1272329005321151
86,1556380800,629,967,338,1596,17,0.9346572221945415,1.2258156974452579
86,1556395200,914,930,16,1844,17,-0.6102345246838476,1.6028449696906382
86,1556409600,418,213,0,631,17,-0.6869993319821528,-0.24125384979987127
86,1556424000,62,35,0,97,17,-0.6869993319821528,-1.053083008586295
86,1556438400,17,48,31,65,17,-0.5382675178416867,-1.1017319469405376
86,1556452800,106,404,298,510,17,0.7427452039487789,-0.4252076479518512
86,1556467200,431,628,197,1059,17,0.25816735787822825,0.4094257006881238
86,1556481600,625,486,0,1111,17,-0.6869993319821528,0.4884802255137681
86,1556496000,207,97,0,304,17,-0.6869993319821528,-0.7383851886072881
86,1556510400,18,15,0,33,17,-0.6869993319821528,-1.1503808852947803
86,1556524800,27,146,119,173,17,-0.1160610777010089,-0.9375417799949688
86,1556539200,226,848,622,1074,17,2.297232551739456,0.43222989054167504
86,1556553600,444,544,100,988,17,-0.20721928636774614,0.301485868714648
86,1556568000,957,795,0,1752,17,-0.6869993319821528,1.4629792719221906
86,1556582400,268,116,0,384,18,-0.6569860408168401,-0.5942944212657771
86,1556596800,23,15,0,38,18,-0.6569860408168401,-1.1671064216527423
86,1556611200,43,150,107,193,18,-0.13247098176001304,-0.9104998896874833
86,1556625600,238,931,693,1169,18,2.740106818308217,0.7052934986873085
86,1556640000,481,684,203,1165,18,0.3381219684218131,0.6986713946365921
86,1556654400,953,763,0,1716,18,-0.6569860408168401,1.6108662276227708
86,1556668800,321,174,0,495,18,-0.6569860408168401,-0.4105310338583982
86,1556683200,26,20,0,46,18,-0.6569860408168401,-1.1538622135513097
86,1556697600,35,135,100,170,18,-0.16678505104410452,-0.9485769879791024
86,1556712000,267,880,613,1147,18,2.3479460264900287,0.6688719264083686
86,1556726400,477,634,157,1111,18,0.11262951312635473,0.6092729899519213
86,1556740800,995,841,0,1836,18,-0.6569860408168401,1.8095293491442617
86,1556755200,307,174,0,481,18,-0.6569860408168401,-0.43370839803590544
86,1556769600,25,18,0,43,18,-0.6569860408168401,-1.158828791589347
86,1556784000,35,151,116,186,18,-0.08835289268046682,-0.9220885717762369
86,1556798400,265,883,618,1148,18,2.3724560759786657,0.6705274524210476
86,1556812800,491,644,153,1135,18,0.09302147353544532,0.6490056142562195
86,1556827200,989,878,0,1867,18,-0.6569860408168401,1.8608506555373134
86,1556841600,347,206,0,553,18,-0.6569860408168401,-0.3145105251230109
86,1556856000,32,25,0,57,18,-0.6569860408168401,-1.1356514274118397
86,1556870400,32,153,121,185,18,-0.06384284319183005,-0.9237440977889161
86,1556884800,274,897,623,1171,18,2.3969661254673023,0.7086045507126667
86,1556899200,574,809,235,1383,18,0.49498628514908843,1.0595760654006339
86,1556913600,1067,972,0,2039,18,-0.6569860408168401,2.1456011297181172
86,1556928000,352,170,0,522,18,-0.6569860408168401,-0.36583183151606274
86,1556942400,57,29,0,86,18,-0.6569860408168401,-1.087641173044146
86,1556956800,75,67,0,142,18,-0.6569860408168401,-0.9949317163341169
86,1556971200,122,484,362,606,18,1.1175415421604626,-0.22676764645101918
86,1556985600,563,843,280,1406,18,0.7155767305468195,1.0976531636922529
86,1557000000,853,718,0,1571,18,-0.6569860408168401,1.3708149557843028
86,1557014400,352,211,0,563,18,-0.6569860408168401,-0.29795526499622005
86,1557028800,72,36,0,108,18,-0.6569860408168401,-1.051219600765206
86,1557043200,16,38,22,54,18,-0.5491418230668382,-1.140618005449877
86,1557057600,89,320,231,409,18,0.47537824555817904,-0.5529062709488
86,1557072000,379,496,117,875,18,-0.08345088278273947,0.21856885095965603
86,1557086400,508,417,0,925,18,-0.6569860408168401,0.3013451515936105
86,1557100800,168,65,0,233,18,-0.6569860408168401,-0.8442788491803197
86,1557115200,14,17,3,31,18,-0.642280011123658,-1.1786951037414959
86,1557129600,33,147,114,180,18,-0.09815691247592154,-0.9320217278523115
86,1557144000,251,858,607,1109,18,2.3185339671036647,0.605961937926563
86,1557158400,429,583,154,1012,18,0.09792348343317267,0.44537591469669136
86,1557172800,951,704,0,1655,18,-0.6569860408168401,1.5098791408493462
86,1557187200,292,125,0,417,19,-0.6831403748868551,-0.49124516257032397
86,1557201600,19,14,0,33,19,-0.6831403748868551,-1.1313524956165038
86,1557216000,35,134,99,169,19,-0.18199810780201245,-0.9046478151626485
86,1557230400,249,844,595,1093,19,2.328775270724068,0.6356104549797218
86,1557244800,427,617,190,1044,19,0.27864781446789344,0.5539300921691415
86,1557259200,917,756,0,1673,19,-0.6831403748868551,1.6024392392682225
86,1557273600,310,138,0,448,19,-0.6831403748868551,-0.4395698309962834
86,1557288000,24,19,0,43,19,-0.6831403748868551,-1.1146830338184261
86,1557302400,36,140,104,176,19,-0.15668789229267696,-0.8929791919039941
86,1557316800,266,833,567,1099,19,2.1870380638717895,0.6456121320585683
86,1557331200,441,657,216,1098,19,0.41026093511643796,0.6439451858787606
86,1557345600,964,820,0,1784,19,-0.6831403748868551,1.7874702652268841
86,1557360000,314,174,0,488,19,-0.6831403748868551,-0.37289198380397304
86,1557374400,30,29,0,59,19,-0.6831403748868551,-1.088011894941502
86,1557388800,34,145,111,179,19,-0.12125359057960727,-0.8879783533645709
86,1557403200,271,896,625,1167,19,2.480636563780081,0.758964472285496
86,1557417600,571,727,156,1298,19,0.10653834900441211,0.9773344218403125
86,1557432000,1035,878,0,1913,19,-0.6831403748868551,2.002506322422085
86,1557446400,313,187,0,500,19,-0.6831403748868551,-0.35288862964627987
86,1557460800,35,33,0,68,19,-0.6831403748868551,-1.0730093793232323
86,1557475200,36,147,111,183,19,-0.12125359057960727,-0.8813105686453397
86,1557489600,239,854,615,1093,19,2.43001613276141,0.6356104549797218
86,1557504000,547,756,209,1303,19,0.3748266334033683,0.9856691527393513
86,1557518400,989,1053,64,2042,19,-0.3591696163673609,2.217542379617286
86,1557532800,336,192,0,528,19,-0.6831403748868551,-0.30621413661166264
86,1557547200,54,43,0,97,19,-0.6831403748868551,-1.0246679401088072
86,1557561600,14,62,48,76,19,-0.44016230599723444,-1.05967380988477
86,1557576000,138,503,365,641,19,1.1645053572946356,-0.11784921829338574
86,1557590400,544,965,421,1509,19,1.447979770999193,1.3290600657797498
86,1557604800,871,786,0,1657,19,-0.6831403748868551,1.5757681003912984
86,1557619200,331,241,0,572,19,-0.6831403748868551,-0.2328685047001212
86,1557633600,43,29,0,72,19,-0.6831403748868551,-1.0663415946040011
86,1557648000,11,36,25,47,19,-0.5565892973401777,-1.1080152490991952
86,1557662400,90,355,265,445,19,0.6583010471079258,-0.4445706695357067
86,1557676800,347,510,163,857,19,0.1419726507174818,0.2422111565450904
86,1557691200,407,366,0,773,19,-0.6831403748868551,0.10218767744123856
86,1557705600,150,94,0,244,19,-0.6831403748868551,-0.7796268516770665
86,1557720000,24,15,0,39,19,-0.6831403748868551,-1.1213508185376573
86,1557734400,33,135,102,168,19,-0.16681197849641116,-0.9063147613424561
86,1557736246,27,34,7,61,19,-0.6477060731737855,-1.0846780025818865
86,1557748800,207,823,616,1030,19,2.435078175863277,0.5305928456518328
86,1557763200,407,536,129,943,19,-0.03013681474599952,0.38556852800855773
86,1557777600,820,654,0,1474,19,-0.6831403748868551,1.2707169494864783
86,1557792000,230,91,0,321,20,-0.6767118973113287,-0.6287716827470224
86,1557806400,23,19,0,42,20,-0.6767118973113287,-1.0674374127364015
86,1557820800,32,147,115,179,20,-0.09411597839831491,-0.8520352442469931
86,1557835200,260,849,589,1109,20,2.3071924178170637,0.6101838557176037
86,1557849600,500,654,154,1154,20,0.1034600288852289,0.6809363928126648
86,1557864000,959,797,0,1756,20,-0.6767118973113287,1.6274481112843717
86,1557878400,182,155,0,337,20,-0.6767118973113287,-0.6036152251132229
86,1557892800,20,17,0,37,20,-0.6767118973113287,-1.0752988057469637
86,1557906877,29,75,46,104,20,-0.4436735297461232,-0.9699561394054284
86,1557907200,25,154,129,179,20,-0.023191257834991492,-0.8520352442469931
86,1557921600,259,864,605,1123,20,2.3882492413180048,0.6321957561471783
86,1557936000,481,667,186,1148,20,0.265573675887111,0.67150272119999
86,1557950400,997,894,0,1891,20,-0.6767118973113287,1.8397057225695552
86,1557964800,231,186,0,417,20,-0.6767118973113287,-0.4778329369442253
86,1557979200,30,26,0,56,20,-0.6767118973113287,-1.0454255123068268
86,1557993600,37,150,113,187,20,-0.10424808133593254,-0.8394570154300933
86,1558008000,263,862,599,1125,20,2.357852932505152,0.6353403133514033
86,1558022400,506,707,201,1213,20,0.34156444791924323,0.7737008303373005
86,1558036800,1149,948,0,2097,20,-0.6767118973113287,2.163595114604724
86,1558051200,252,218,0,470,20,-0.6767118973113287,-0.3945021710322644
86,1558065600,45,26,0,71,20,-0.6767118973113287,-1.0218413332751397
86,1558078593,21,59,38,80,20,-0.48420194149659374,-1.0076908258561277
86,1558080000,31,136,105,167,20,-0.14477649308640306,-0.8709025874723427
86,1558082073,30,40,10,70,20,-0.6260513826232406,-1.0234136118772523
86,1558094400,218,861,643,1079,20,2.58075919713274,0.5630154976542296
86,1558108800,580,754,174,1334,20,0.20478105826140522,0.9639465411929093
86,1558123200,1054,922,0,1976,20,-0.6767118973113287,1.973349403749115
86,1558137600,346,196,0,542,20,-0.6767118973113287,-0.2812981116801666
86,1558152000,51,44,0,95,20,-0.6767118973113287,-0.9841066468244405
86,1558166400,21,60,39,81,20,-0.4791358900277849,-1.006118547254015
86,1558180800,115,493,378,608,20,1.2382555578984036,-0.1775277239407436
86,1558195200,517,904,387,1421,20,1.2838500211176829,1.1007347795766942
86,1558209600,837,835,0,1672,20,-0.6767118973113287,1.495376708706924
86,1558224000,384,220,0,604,20,-0.6767118973113287,-0.18381683834919346
86,1558238400,58,43,0,101,20,-0.6767118973113287,-0.9746729752117658
86,1558252800,14,42,28,56,20,-0.5348624561846819,-1.0454255123068268
86,1558267200,84,396,312,480,20,0.9038961609570217,-0.3787793850111397
86,1558281600,491,746,255,1237,20,0.6151312272349193,0.8114355167879999
86,1558296000,675,557,0,1232,20,-0.6767118973113287,0.8035741237774375
86,1558310400,237,111,0,348,20,-0.6767118973113287,-0.5863201604899857
86,1558324800,23,15,0,38,20,-0.6767118973113287,-1.0737265271448513
86,1558339200,32,157,125,189,20,-0.04345546371022675,-0.8363124582258684
86,1558353600,214,836,622,1050,20,2.4743721162877548,0.517419418192968
86,1558368000,493,651,158,1144,20,0.12372423476046417,0.6652136067915402
86,1558382400,999,822,0,1821,20,-0.6767118973113287,1.7296462204216823
86,1558396800,274,144,0,418,21,-0.6798534308898815,-0.49421556521469745
86,1558411200,25,13,0,38,21,-0.6798534308898815,-1.1185664719309607
86,1558425600,31,134,103,165,21,-0.14082338386522386,-0.9099018267915779
86,1558436977,203,346,143,549,21,0.06850867323173054,-0.2789788052677752
86,1558440000,140,879,739,1019,21,3.1875563239763514,0.49324468461812926
86,1558454400,490,736,246,1226,21,0.6075387202563881,0.8333516259083041
86,1558454755,22,8,0,30,21,-0.6798534308898815,-1.13171070154604
86,1558468800,1014,849,0,1863,21,-0.6798534308898815,1.8799609090089875
86,1558483200,349,153,0,502,21,-0.6798534308898815,-0.3562011542563656
86,1558497600,24,12,0,36,21,-0.6798534308898815,-1.1218525293347303
86,1558512000,35,164,129,199,21,-0.004757546752203495,-0.8540388509274912
86,1558526400,266,826,560,1092,21,2.25079536846748,0.6131857798557272
86,1558540800,539,714,175,1253,21,0.23597431890929407,0.8777134008591966
86,1558555200,1016,907,0,1923,21,-0.6798534308898815,1.9785426311220815
86,1558569600,361,177,0,538,21,-0.6798534308898815,-0.2970521209885091
86,1558584000,26,25,0,51,21,-0.6798534308898815,-1.0972070988064568
86,1558598400,27,135,108,162,21,-0.11465687672810455,-0.9148309128972326
86,1558612800,232,864,632,1096,21,2.627593071241998,0.6197578946632668
86,1558627200,664,706,42,1370,21,-0.46005477093807934,1.0699477589797302
86,1558641600,1039,921,0,1960,21,-0.6798534308898815,2.0393346930918232
86,1558656000,444,179,0,623,21,-0.6798534308898815,-0.15739468132829235
86,1558670400,35,17,0,52,21,-0.6798534308898815,-1.095564070104572
86,1558684800,29,131,102,160,21,-0.14605668529264773,-0.9181169703010025
86,1558699200,227,760,533,987,21,2.109496229927036,0.44066776615781234
86,1558713600,668,911,243,1579,21,0.5918388159741166,1.413340757673675
86,1558728000,1050,833,0,1883,21,-0.6798534308898815,1.9128214830466854
86,1558742400,369,167,0,536,21,-0.6798534308898815,-0.3003381783922789
86,1558756800,53,31,0,84,21,-0.6798534308898815,-1.042987151644255
86,1558771200,15,64,49,79,21,-0.4234216609461123,-1.0512022951536797
86,1558785600,121,449,328,570,21,1.0366694373051446,-0.24447520252819221
86,1558800000,518,910,392,1428,21,1.3716007286602718,1.1652434236890545
86,1558814400,787,719,0,1506,21,-0.6798534308898815,1.293399662436077
86,1558828800,365,186,0,551,21,-0.6798534308898815,-0.2756927478640054
86,1558843200,43,38,0,81,21,-0.6798534308898815,-1.0479162377499098
86,1558857600,13,34,21,47,21,-0.5699541009139804,-1.1037792136139966
86,1558872000,81,352,271,433,21,0.7383712559419846,-0.46957013468642395
86,1558886400,421,731,310,1152,21,0.9424700116115152,0.7117675019688213
86,1558900800,675,619,0,1294,21,-0.6798534308898815,0.9450775776364776
86,1558915200,247,128,0,375,21,-0.6798534308898815,-0.5648657993957483
86,1558929600,25,21,0,46,21,-0.6798534308898815,-1.1054222423158815
86,1558944000,10,55,45,65,21,-0.44435486665580776,-1.0742046969800683
86,1558958400,97,367,270,464,21,0.7331379545145608,-0.41863624492799195
86,1558972800,418,693,275,1111,21,0.7593044616516801,0.6444033251915403
86,1558987200,570,461,0,1031,21,-0.6798534308898815,0.5129610290407481
86,1559001600,226,102,0,328,22,-0.6822689393357743,-0.672613136464276
86,1559016000,15,22,7,37,22,-0.6478333911529901,-1.1433344920452644
86,1559030400,31,131,100,162,22,-0.1903325367245723,-0.9411345970362488
86,1559044800,222,847,625,1069,22,2.3923335769842384,0.5260278411491686
86,1559059200,466,641,175,1107,22,0.17861976523382925,0.5874966092319094
86,1559073600,941,799,0,1740,22,-0.6822689393357743,1.6114368775575645
86,1559088000,273,113,0,386,22,-0.6822689393357743,-0.5787923851800928
86,1559102400,22,12,0,34,22,-0.6822689393357743,-1.1481872895254808
86,1559116800,37,153,116,190,22,-0.11162271230677995,-0.8958418205542293
86,1559131200,285,883,598,1168,22,2.259510748279214,0.686170157996309
86,1559145600,534,689,155,1223,22,0.08023248471158884,0.7751381118002758
86,1559160000,980,859,0,1839,22,-0.6822689393357743,1.7715791944047048
86,1559174400,283,133,0,416,22,-0.6822689393357743,-0.530264410377929
86,1559188800,21,19,0,40,22,-0.6822689393357743,-1.138481694565048
86,1559203200,32,132,100,164,22,-0.1903325367245723,-0.9378993987161046
86,1559217600,238,877,639,1115,22,2.4612046733498065,0.6004374025124863
86,1559232000,534,718,184,1252,22,0.22289404146883743,0.8220484874423675
86,1559246400,1027,865,0,1892,22,-0.6822689393357743,1.8573119498885275
86,1559260800,312,158,0,470,22,-0.6822689393357743,-0.4429140557340343
86,1559275200,26,29,3,55,22,-0.6675108472574383,-1.1142177071639663
86,1559289600,39,138,99,177,22,-0.1952519007506843,-0.916870609635167
86,1559304000,240,878,638,1118,22,2.4562853093236945,0.6052901999927027
86,1559318400,638,827,189,1465,22,0.2474908615993975,1.16659710853773
86,1559332800,1030,1017,0,2047,22,-0.6822689393357743,2.108039819699707
86,1559347200,338,179,0,517,22,-0.6822689393357743,-0.36688689521064444
86,1559361600,64,47,0,111,22,-0.6822689393357743,-1.0236321541999271
86,1559376000,16,50,34,66,22,-0.5150105624479656,-1.0964241164031727
86,1559390400,107,515,408,622,22,1.3248315833179298,-0.1970389834030713
86,1559404800,485,774,289,1259,22,0.7394272642105996,0.8333716815628723
86,1559419200,706,699,0,1405,22,-0.6822689393357743,1.0695411589334025
86,1559433600,315,186,0,501,22,-0.6822689393357743,-0.3927684817717984
86,1559448000,48,33,0,81,22,-0.6822689393357743,-1.072160129002091
86,1559462400,11,40,29,51,22,-0.5396073825785257,-1.1206881038042547
86,1559476800,90,386,296,476,22,0.7738628123933837,-0.43320846077360153
86,1559491200,442,794,352,1236,22,1.0493471978556568,0.7961669008812134
86,1559505600,572,475,0,1047,22,-0.6822689393357743,0.4904406596275818
86,1559520000,175,99,0,274,22,-0.6822689393357743,-0.7599634911081709
86,1559534400,21,13,0,34,22,-0.6822689393357743,-1.1481872895254808
86,1559548800,34,124,90,158,22,-0.23952617698569248,-0.9476049936765373
86,1559563200,229,798,569,1027,22,2.116849191521965,0.4580886764261393
86,1559577600,479,609,130,1088,22,-0.04275161594121167,0.556762225190539
86,1559592000,982,811,0,1793,22,-0.6822689393357743,1.697169633041387
86,1559606400,269,140,0,409,23,-0.6972560452632411,-0.577427299023907
86,1559620800,25,23,0,48,23,-0.6972560452632411,-1.1502454557760975
86,1559635200,31,146,115,177,23,-0.1513415212526309,-0.9455542030862565
86,1559649600,265,868,603,1133,23,2.16523489367935,0.5713825222741147
86,1559664000,479,661,182,1140,23,0.16671302751876815,0.582489799551858
86,1559678400,1016,932,0,1948,23,-0.6972560452632411,1.8645869481827995
86,1559692800,313,143,0,456,23,-0.6972560452632411,-0.5028498658733449
86,1559707200,29,16,0,45,23,-0.6972560452632411,-1.155005717466559
86,1559721600,35,140,105,175,23,-0.19881234942746656,-0.9487277108798975
86,1559736000,281,970,689,1251,23,2.573484015982937,0.7586194820989304
86,1559750400,536,696,160,1232,23,0.06227720553412967,0.7284711580593414
86,1559764800,975,817,0,1792,23,-0.6972560452632411,1.6170533402788057
86,1559779200,300,143,0,443,23,-0.6972560452632411,-0.523477666532011
86,1559793600,24,25,1,49,23,-0.6925089624457577,-1.1486587018792769
86,1559808000,31,156,125,187,23,-0.1038706930777952,-0.9296866641180518
86,1559822400,264,845,581,1109,23,2.0607990716947118,0.5333004287504234
86,1559836800,505,725,220,1230,23,0.34710217458314374,0.7252976502657005
86,1559851200,1145,964,0,2109,23,-0.6972560452632411,2.1200543255708952
86,1559865600,351,167,0,518,23,-0.6972560452632411,-0.4044711242704756
86,1559880000,40,39,0,79,23,-0.6972560452632411,-1.101056084974663
86,1559894400,33,121,88,154,23,-0.2795127573246872,-0.9820495427131274
86,1559908800,244,851,607,1095,23,2.1842232249492843,0.5110858741949368
86,1559923200,628,896,268,1524,23,0.574962149822355,1.1918032959309193
86,1559937600,1004,941,0,1945,23,-0.6972560452632411,1.8598266864923378
86,1559952000,349,166,0,515,23,-0.6972560452632411,-0.409231385960937
86,1559966400,51,34,0,85,23,-0.6972560452632411,-1.0915355615937399
86,1559980800,13,53,40,66,23,-0.5073727325638985,-1.1216838856333289
86,1559995200,145,509,364,654,23,1.0306821003007776,-0.1886725943028914
86,1560009600,502,1003,501,1505,23,1.6810324462960262,1.1616549718913303
86,1560024000,780,776,0,1556,23,-0.6972560452632411,1.2425794206291743
86,1560038400,385,245,0,630,23,-0.6972560452632411,-0.22675468782658273
86,1560052800,63,43,0,106,23,-0.6972560452632411,-1.05821372976051
86,1560067200,13,48,35,61,23,-0.5311081466513163,-1.1296176551174313
86,1560081600,100,371,271,471,23,0.5892033982748057,-0.47904855742103775
86,1560096000,446,832,386,1278,23,1.135117922285416,0.8014618373130832
86,1560110400,667,518,0,1185,23,-0.6972560452632411,0.6538937249087793
86,1560124800,248,129,0,377,23,-0.6972560452632411,-0.6282034237221621
86,1560139200,19,20,1,39,23,-0.6925089624457577,-1.1645262408474817
86,1560153600,30,125,95,155,23,-0.24628317760230223,-0.9804627888163069
86,1560168000,227,831,604,1058,23,2.1699819764968336,0.4523759800125793
86,1560182400,387,515,128,902,23,-0.0896294446253445,0.20484237210858566
86,1560196800,910,661,0,1571,23,-0.6972560452632411,1.2663807290814815
86,1560211200,187,113,0,300,24,-0.6432271734852736,-0.6861252213908212
86,1560225600,29,16,0,45,24,-0.6432271734852736,-1.086460539336887
86,1560240000,34,151,117,185,24,-0.13473001606786136,-0.8666686000723803
86,1560254400,243,883,640,1126,24,2.138295738883477,0.6106472202697681
86,1560268800,434,589,155,1023,24,0.030422906854033212,0.4489431506680239
86,1560283200,999,852,0,1851,24,-0.6432271734852736,1.7488554771752494
86,1560297600,223,155,0,378,24,-0.6432271734852736,-0.5636697123720247
86,1560312000,27,22,0,49,24,-0.6432271734852736,-1.0801807696436154
86,1560325753,35,70,35,105,24,-0.49111263921510756,-0.9922639939378127
86,1560326400,23,136,113,159,24,-0.15211453427016605,-0.9074871030786459
86,1560333095,131,231,100,362,24,-0.2086142184276563,-0.5887887911451112
86,1560340800,141,852,711,993,24,2.4468709369743853,0.4018448779684868
86,1560355200,534,645,111,1179,24,-0.1608067933713184,0.6938541687056171
86,1560369600,983,852,0,1835,24,-0.6432271734852736,1.7237363984021628
86,1560384000,235,170,0,405,24,-0.6432271734852736,-0.5212812669424413
86,1560398400,25,18,0,43,24,-0.6432271734852736,-1.0896004241835229
86,1560412800,31,121,90,152,24,-0.25207551393341804,-0.9184767000418712
86,1560427200,215,901,686,1116,24,2.338217698209981,0.5949477960365891
86,1560441600,453,633,180,1086,24,0.13907614561843754,0.547849523337052
86,1560456000,959,930,0,1889,24,-0.6432271734852736,1.8085132892613296
86,1560470400,235,183,0,418,24,-0.6432271734852736,-0.5008720154393085
86,1560484800,32,28,0,60,24,-0.6432271734852736,-1.0629114029871185
86,1560499200,29,123,94,152,24,-0.23469099573111335,-0.9184767000418712
86,1560513600,216,852,636,1068,24,2.1209112206811724,0.5195905597173296
86,1560528000,566,746,180,1312,24,0.13907614561843754,0.9026565110068984
86,1560542400,991,881,0,1872,24,-0.6432271734852736,1.7818242680649252
86,1561161600,6422,6512,90,12934,25,-0.21489879916418445,4.049884599938783
86,1561176000,64,53,0,117,25,-0.7666199634208862,-0.431993648210711
86,1561190400,17,57,40,74,25,-0.5214105570845743,-0.4470299878120552
86,1561204800,114,391,277,505,25,0.9314551754580737,-0.29631690948230316
86,1561219200,510,841,331,1351,25,1.2624878740120948,-0.00048566988376435547
86,1561233600,754,708,0,1462,25,-0.7666199634208862,0.03832906722668222
86,1561248000,342,207,0,549,25,-0.7666199634208862,-0.2809308875646487
86,1561262400,49,61,12,110,25,-0.6930571415199926,-0.4344414244248833
86,1561276800,14,39,25,53,25,-0.6133640844606912,-0.45437331645457213
86,1561291200,77,336,259,413,25,0.8211109426067333,-0.3284876825828535
86,1561305600,432,750,318,1182,25,1.1827948169527933,-0.059581981340210054
86,1561320000,548,560,12,1108,25,-0.6930571415199926,-0.08545847274717444
86,1561334400,225,136,0,361,25,-0.7666199634208862,-0.3466711630309906
86,1561348800,24,17,0,41,25,-0.7666199634208862,-0.4585695042502961
86,1561363200,51,155,104,206,25,-0.1290755069464753,-0.4008719220590917
86,1561377600,223,812,589,1035,25,2.8440885448813065,-0.11098528183782849
86,1561392000,453,647,194,1100,25,0.42264565731022646,-0.08825593127765707
86,1561406400,927,815,0,1742,25,-0.7666199634208862,0.1362401157935745
86,1561420800,283,151,0,434,26,-0.7077950743255148,-0.5561441442992511
86,1561435200,24,27,3,51,26,-0.6933596293004234,-1.1673859251955174
86,1561449600,35,116,81,151,26,-0.3180380586480462,-1.0077927709145078
86,1561464000,221,836,615,1057,26,2.2514711558182285,0.4381212068714379
86,1561478400,449,663,214,1112,26,0.3219333374643406,0.5258974417259931
86,1561492800,939,829,0,1768,26,-0.7077950743255148,1.5728285338094152
86,1561507200,319,187,0,506,26,-0.7077950743255148,-0.4412370732169243
86,1561521600,25,20,0,45,26,-0.7077950743255148,-1.176961514452378
86,1561536000,36,145,109,181,26,-0.18330723841385949,-0.959914824630205
86,1561550400,254,860,606,1114,26,2.2081648207429545,0.5290893048116133
86,1561564800,519,742,223,1261,26,0.3652396725396149,0.7636912416046971
86,1561579200,988,829,0,1817,26,-0.7077950743255148,1.65102917940711
86,1561593600,332,202,0,534,26,-0.7077950743255148,-0.3965509900182416
86,1561608000,26,31,5,57,26,-0.6837359992836958,-1.1578103359386567
86,1561622400,33,150,117,183,26,-0.144812718346949,-0.9567229615445848
86,1561636800,239,878,639,1117,26,2.3669547160189603,0.5338770994400436
86,1561651200,539,746,207,1285,26,0.28825063240579396,0.8019935986321395
86,1561665600,1043,1033,0,2076,26,-0.7077950743255148,2.0643754489949244
86,1561680000,401,225,0,626,26,-0.7077950743255148,-0.24972528807971292
86,1561694400,38,35,0,73,26,-0.7077950743255148,-1.1322754312536953
86,1561708800,30,116,86,146,26,-0.2939789836062271,-1.0157724286285583
86,1561723200,216,849,633,1065,26,2.3380838259687775,0.45088865921391863
86,1561737600,648,938,290,1586,26,0.6876312780999903,1.282368993017978
86,1561752000,1019,918,0,1937,26,-0.7077950743255148,1.8425409645443214
86,1561766400,329,192,0,521,26,-0.7077950743255148,-0.41729810007477286
86,1561780800,62,47,0,109,26,-0.7077950743255148,-1.074821895712532
86,1561795200,22,63,41,85,26,-0.5105106589825986,-1.113124252739974
86,1561809600,120,530,410,650,26,1.2650490791036475,-0.21142293105227064
86,1561824000,565,952,387,1517,26,1.1543773339112797,1.1722497165640815
86,1561838400,808,773,0,1581,26,-0.7077950743255148,1.2743893353039275
86,1561852800,335,249,0,584,26,-0.7077950743255148,-0.31675441287773687
86,1561867200,57,58,1,115,26,-0.702983259317151,-1.0652463064556712
86,1561881600,17,51,34,68,26,-0.5441933640411453,-1.1402550889677456
86,1561896000,106,371,265,477,26,0.567335902890895,-0.48751908795841703
86,1561910400,439,711,272,1150,26,0.6010186079494416,0.5865428403527767
86,1561924800,618,532,0,1150,26,-0.7077950743255148,0.5865428403527767
86,1561939200,247,156,0,403,26,-0.7077950743255148,-0.6056180221263641
86,1561953600,26,29,3,55,26,-0.6933596293004234,-1.161002199024277
86,1561968000,35,148,113,183,26,-0.16405997838040423,-0.9567229615445848
86,1561982400,195,818,623,1013,26,2.2899656758851394,0.36790021898779374
86,1561996800,495,696,201,1191,26,0.25937974235561106,0.6519760336079906
86,1562011200,999,831,0,1830,26,-0.7077950743255148,1.6717762894636412
86,1562025600,214,136,0,350,27,-0.7058775983761212,-0.5390924928449427
86,1562040000,32,16,0,48,27,-0.7058775983761212,-1.0993882302462252
86,1562054400,30,133,103,163,27,-0.12256785805614023,-0.8860305818980547
86,1562068800,216,893,677,1109,27,3.12810972392123,0.8690679862529829
86,1562083200,498,718,220,1216,27,0.5400267013364596,1.0675833634117153
86,1562097600,949,795,0,1744,27,-0.7058775983761212,2.04717326191462
86,1562112000,223,132,0,355,27,-0.7058775983761212,-0.5298160733515439
86,1562126400,23,21,0,44,27,-0.7058775983761212,-1.1068093658409441
86,1562140800,29,119,90,148,27,-0.1961894757664291,-0.9138598403782509
86,1562155200,229,709,480,938,27,2.012459055542237,0.5518144395787467
86,1562169600,613,747,134,1360,27,0.052991384176087064,1.3347442448215985
86,1562184000,944,842,0,1786,27,-0.7058775983761212,2.1250951856591693
86,1562198400,264,123,0,387,27,-0.7058775983761212,-0.47044698859379214
86,1562212800,23,32,9,55,27,-0.654908786115152,-1.086401242955467
86,1562227200,10,55,45,65,27,-0.45103353707127514,-1.0678484039686695
86,1562241600,77,377,300,454,27,0.9930828103228526,-0.3461429673822493
86,1562256000,357,570,213,927,27,0.5003842918001502,0.5314063166932694
86,1562270400,459,455,0,914,27,-0.7058775983761212,0.5072876260104329
86,1562284800,263,108,0,371,27,-0.7058775983761212,-0.500131530972668
86,1562299200,33,19,0,52,27,-0.7058775983761212,-1.0919670946515063
86,1562313600,18,79,61,97,27,-0.36042231527399654,-1.0084793192109178
86,1562328000,119,445,326,564,27,1.1403260457434303,-0.1420617385274775
86,1562342400,483,648,165,1131,27,0.22855062640831436,0.9098842320239372
86,1562356800,719,615,0,1334,27,-0.7058775983761212,1.2865068634559251
86,1562371200,282,142,0,424,27,-0.7058775983761212,-0.4018014843426416
86,1562385600,48,43,0,91,27,-0.7058775983761212,-1.0196110226029962
86,1562400000,14,62,48,76,27,-0.43404393298428545,-1.0474402810831924
86,1562414400,118,498,380,616,27,1.4461389193092455,-0.045586975796130816
86,1562428800,478,832,354,1310,27,1.2988956838886678,1.2419800498876112
86,1562443200,680,703,23,1383,27,-0.5756239670425333,1.3774157744912325
86,1562457600,261,194,0,455,27,-0.7058775983761212,-0.34428768348356953
86,1562472000,40,34,0,74,27,-0.7058775983761212,-1.0511508488805519
86,1562486400,10,41,31,51,27,-0.5303183561438939,-1.093822378550186
86,1562500800,68,376,308,444,27,1.0383884212214918,-0.36469580636904675
86,1562515200,402,752,350,1154,27,1.2762428784393482,0.9525557616935713
86,1562529600,537,555,18,1092,27,-0.6039399738541829,0.8375281599754272
86,1562544000,195,136,0,331,27,-0.7058775983761212,-0.5743428869198578
86,1562558400,17,16,0,33,27,-0.7058775983761212,-1.1272174887264215
86,1562572800,36,142,106,178,27,-0.10557825396915049,-0.8582013234178586
86,1562587200,195,811,616,1006,27,2.782654440819105,0.6779737446889692
86,1562601600,369,547,178,916,27,0.3021722441186032,0.5109981938077923
86,1562616000,927,731,0,1658,27,-0.7058775983761212,1.887618846628162
86,1562630400,234,106,0,340,28,-0.6888636908608293,-0.6375375453323131
86,1562644800,19,14,0,33,28,-0.6888636908608293,-1.1576520097116136
86,1562659200,36,135,99,171,28,-0.22221409382607396,-0.9238546283293873
86,1562673600,232,870,638,1102,28,2.3184337122520384,0.6534306040391102
86,1562688000,429,586,157,1015,28,0.05117657918418675,0.5060366027329242
86,1562702400,909,844,0,1753,28,-0.6888636908608293,1.7563443379509167
86,1562716800,257,119,0,376,28,-0.6888636908608293,-0.5765469241021671
86,1562731200,26,18,0,44,28,-0.6888636908608293,-1.1390159865579579
86,1562745600,35,134,99,169,28,-0.22221409382607396,-0.9272429961755065
86,1562760000,255,871,616,1126,28,2.214733801799871,0.6940910181925409
86,1562774400,491,623,132,1114,28,-0.06666422814782218,0.6737608111158255
86,1562788800,950,886,0,1836,28,-0.6888636908608293,1.8969616035648644
86,1562803200,296,123,0,419,28,-0.6888636908608293,-0.5036970154106039
86,1562817600,26,20,0,46,28,-0.6888636908608293,-1.1356276187118386
86,1562832000,34,134,100,168,28,-0.2175004615327936,-0.9289371800985662
86,1562846400,229,928,699,1157,28,2.60596528214214,0.7466107198073888
86,1562860800,480,661,181,1141,28,0.16430375422291532,0.719503777038435
86,1562875200,911,779,0,1690,28,-0.6888636908608293,1.6496107507981614
86,1562889600,180,130,0,310,28,-0.6888636908608293,-0.6883630630241014
86,1562904000,32,19,0,51,28,-0.6888636908608293,-1.1271566990965405
86,1562918400,29,137,108,166,28,-0.17979140318655074,-0.9323255479446854
86,1562932800,227,821,594,1048,28,2.1110338913477027,0.5619446721938913
86,1562947200,569,735,166,1304,28,0.09359926982370996,0.9956557564971517
86,1562961600,999,870,0,1869,28,-0.6888636908608293,1.9528696730258317
86,1562976000,278,184,0,462,28,-0.6888636908608293,-0.4308471067190406
86,1562990400,63,56,0,119,28,-0.6888636908608293,-1.011952192328487
86,1563004800,18,72,54,90,28,-0.43432754702369003,-1.0610835260972158
86,1563019200,73,552,479,625,28,1.5689661776204618,-0.15469512726032406
86,1563033600,479,969,490,1448,28,1.6208161328465458,1.2396182414177355
86,1563048000,648,683,35,1331,28,-0.5238865605960168,1.0413987224197612
86,1563062400,177,306,129,483,28,-0.08080512502766324,-0.39526924433478877
86,1563076800,54,42,0,96,28,-0.6888636908608293,-1.0509184225588581
86,1563091200,10,45,35,55,28,-0.5238865605960168,-1.1203799634043021
86,1563105600,73,330,257,403,28,0.5225398085122225,-0.5308039581795576
86,1563120000,435,678,243,1113,28,0.45654895640629745,0.672066627192766
86,1563134400,572,565,0,1137,28,-0.6888636908608293,0.7127270413461966
86,1563148800,209,118,0,327,28,-0.6888636908608293,-0.659561936332088
86,1563163200,15,15,0,30,28,-0.6888636908608293,-1.1627345614807925
86,1563177600,38,160,122,198,28,-0.11380055108062574,-0.8781116624067778
86,1563192000,213,826,613,1039,28,2.2005929049200295,0.5466970168863547
86,1563206400,433,525,92,958,28,-0.25520951987903645,0.4094681191185263
86,1563220800,921,802,0,1723,28,-0.6888636908608293,1.7055188202591285
86,1563235200,279,136,0,415,29,-0.6269389999001854,-0.4349401288878001
86,1563249600,19,20,1,39,29,-0.6217991758781247,-1.0740487359820425
86,1563264000,34,129,95,163,29,-0.13865571780442615,-0.8632788761956435
86,1563278400,236,843,607,1079,29,2.492934181490613,0.6936984751296921
86,1563279564,32,25,0,57,29,-0.6269389999001854,-1.0434531111743395
86,1563292800,422,661,239,1083,29,0.6014789413723036,0.7004975028647372
86,1563307200,940,890,0,1830,29,-0.6269389999001854,1.970215932384416
86,1563321600,317,144,0,461,29,-0.6269389999001854,-0.35675130993478105
86,1563336000,26,18,0,44,29,-0.6269389999001854,-1.0655499513132363
86,1563350400,34,133,99,167,29,-0.11809642171618366,-0.8564798484605983
86,1563364800,251,886,635,1137,29,2.6368492541083106,0.7922843772878465
86,1563379200,463,617,154,1080,29,0.16459389949715064,0.6953982320634534
86,1563393600,983,932,0,1915,29,-0.6269389999001854,2.114695271754125
86,1563408000,242,128,0,370,29,-0.6269389999001854,-0.5114291909070579
86,1563422400,17,25,8,42,29,-0.5858204077237004,-1.0689494651807587
86,1563436800,29,158,129,187,29,0.03609829894563505,-0.8224847097853727
86,1563451200,249,942,693,1191,29,2.9349590473878266,0.8840712517109558
86,1563465600,433,588,155,1021,29,0.16973372351921126,0.5951125729715376
86,1563480000,969,867,0,1836,29,-0.6269389999001854,1.9804144739869836
86,1563494400,313,131,0,444,29,-0.6269389999001854,-0.3856471778087229
86,1563508800,27,35,8,62,29,-0.5858204077237004,-1.0349543265055332
86,1563523200,31,135,104,166,29,-0.09239730160588054,-0.8581796053943597
86,1563537600,220,783,563,1003,29,2.266781924519946,0.5645169481638346
86,1563552000,599,736,137,1335,29,0.07721689112212005,1.1288362501725806
86,1563566400,1039,946,0,1985,29,-0.6269389999001854,2.2336782571174147
86,1563580800,338,192,0,530,29,-0.6269389999001854,-0.23946808150525248
86,1563595200,39,42,3,81,29,-0.6115195278340035,-1.0026589447640688
86,1563609600,13,46,33,59,29,-0.4573248071721848,-1.040053597306817
86,1563624000,100,409,309,509,29,0.9612666229165473,-0.2751629771142394
86,1563638400,419,551,132,970,29,0.05151777101181692,0.5084249693497122
86,1563652800,519,507,0,1026,29,-0.6269389999001854,0.6036113576403441
86,1563667200,225,152,0,377,29,-0.6269389999001854,-0.49953089237072884
86,1563681600,46,34,0,80,29,-0.6269389999001854,-1.00435870169783
86,1563696000,9,32,23,41,29,-0.5087230473927911,-1.07064922211452
86,1563710400,73,300,227,373,29,0.5398010531075762,-0.5063299201057739
86,1563724800,364,496,132,860,29,0.05151777101181692,0.32145170663597106
86,1563739200,443,347,0,790,29,-0.6269389999001854,0.2024687212726812
86,1563753600,146,101,0,247,29,-0.6269389999001854,-0.7204992937596957
86,1563768000,13,14,1,27,29,-0.6217991758781247,-1.094445819187178
86,1563782400,35,101,66,136,29,-0.2877106144441842,-0.9091723134071982
86,1563796800,212,783,571,995,29,2.3079005166964306,0.5509188926937443
86,1563811200,412,533,121,945,29,-0.0050202932308499384,0.46593104600568014
86,1563825600,949,741,0,1690,29,-0.6269389999001854,1.7322499616578362
86,1563840000,179,109,0,288,30,-0.6816381850736292,-0.7191377751173316
86,1563854400,45,45,0,90,30,-0.6816381850736292,-1.0500307875194754
86,1563868800,35,144,109,179,30,-0.1189640481350533,-0.9012960496215421
86,1563883200,237,867,630,1104,30,2.5705150834704336,0.6445425184187765
86,1563897600,446,576,130,1022,30,-0.010558939183584552,0.5075060183330401
86,1563912000,969,821,0,1790,30,-0.6816381850736292,1.790969824014083
86,1563926400,277,162,0,439,30,-0.6816381850736292,-0.4667900737399391
86,1563940800,18,26,8,44,30,-0.640341000711165,-1.1269049217139129
86,1563955200,35,149,114,184,30,-0.09315330790851312,-0.8929401654699728
86,1563969600,232,883,651,1115,30,2.678920192421902,0.6629254635522289
86,1563984000,479,651,172,1130,30,0.20625127871935295,0.6879931160069368
86,1563998400,1322,839,0,2161,30,-0.6816381850736292,2.410976428060524
86,1564012800,489,170,0,659,30,-0.6816381850736292,-0.0991311710708903
86,1564027200,48,32,0,80,30,-0.6816381850736292,-1.066742555822614
86,1564041600,58,141,83,199,30,-0.25317989731306223,-0.867872513015265
86,1564056000,300,877,577,1177,30,2.2969212370691077,0.7665384270316882
86,1564070400,507,641,134,1148,30,0.01008965299764759,0.7180742989525862
86,1564084800,981,875,0,1856,30,-0.6816381850736292,1.9012674948147976
86,1564099200,413,183,0,596,30,-0.6816381850736292,-0.20441531138066335
86,1564113600,59,35,0,94,30,-0.6816381850736292,-1.0433460801982202
86,1564128000,37,134,97,171,30,-0.18090982467874972,-0.914665464264053
86,1564142400,252,760,508,1012,30,1.9407330219428531,0.49079425002990157
86,1564156800,632,766,134,1398,30,0.01008965299764759,1.1358685065310508
86,1564171200,1001,820,0,1821,30,-0.6816381850736292,1.8427763057538125
86,1564185600,149,175,26,324,30,-0.5474223358956203,-0.6589754092260327
86,1564200000,340,111,0,451,30,-0.6816381850736292,-0.44673595177617276
86,1564214400,15,47,32,62,30,-0.5164494476237721,-1.0968237387682636
86,1564228800,118,469,351,587,30,1.1302757788294913,-0.21945590285348807
86,1564243200,474,858,384,1332,30,1.3006266643246565,1.0255708357303361
86,1564257600,723,732,9,1455,30,-0.6351788526658568,1.2311255858589407
86,1564272000,323,204,0,527,30,-0.6816381850736292,-0.31972651267231955
86,1564286400,51,38,0,89,30,-0.6816381850736292,-1.0517019643497894
86,1564300800,11,33,22,44,30,-0.5680709280768524,-1.1269049217139129
86,1564315200,62,354,292,416,30,0.8257090441563172,-0.5052271408371578
86,1564329600,404,697,293,1101,30,0.8308711922016253,0.639528987927835
86,1564336033,282,112,0,394,30,-0.6816381850736292,-0.5419930311040627
86,1564336697,37,13,0,50,30,-0.6816381850736292,-1.1168778607320298
86,1564344000,274,504,230,778,30,0.5056558653472191,0.0997388717364588
86,1564358400,192,115,0,307,30,-0.6816381850736292,-0.6873854153413683
86,1564372800,24,14,0,38,30,-0.6816381850736292,-1.1369319826957962
86,1564387200,31,139,108,170,30,-0.12412619618036133,-0.9163366410943669
86,1564401600,202,803,601,1005,30,2.4208127901565004,0.4790960122177046
86,1564416000,423,538,115,961,30,-0.08799115986320509,0.4055642316838948
86,1564430400,990,768,0,1758,30,-0.6816381850736292,1.7374921654440394
86,1564444800,271,115,0,386,31,-0.642809616517253,-0.5773119177367741
86,1564459200,27,23,0,50,31,-0.642809616517253,-1.1156578445783485
86,1564472983,33,89,56,122,31,-0.3839104614182443,-1.0002980031122968
86,1564473600,23,133,110,156,31,-0.13425770471562878,-0.9458225224199946
86,1564488000,208,849,641,1057,31,2.3206610695267575,0.4977777159260128
86,1564502400,453,591,138,1044,31,-0.004808127166124411,0.476948855661309
86,1564516800,952,845,0,1797,31,-0.642809616517253,1.6834205309937655
86,1564531200,262,150,0,412,31,-0.642809616517253,-0.5356541972073665
86,1564545600,31,20,0,51,31,-0.642809616517253,-1.1140556245579867
86,1564560000,28,132,104,160,31,-0.16199689990480828,-0.9394136423385473
86,1564574400,247,805,558,1052,31,1.936935536076441,0.48976661582420367
86,1564588800,486,607,121,1093,31,-0.08340251353546635,0.5554576366590386
86,1564603200,969,761,0,1730,31,-0.642809616517253,1.5760717896295233
86,1564617600,322,133,0,455,31,-0.642809616517253,-0.4667587363318079
86,1564632000,30,19,0,49,31,-0.642809616517253,-1.1172600645987103
86,1564646400,28,118,90,146,31,-0.22672168867956047,-0.961844722623613
86,1564660800,225,853,628,1078,31,2.260559479950202,0.5314243363536112
86,1564675200,460,600,140,1060,31,0.004438271230268758,0.5025843759870983
86,1564689600,1052,875,0,1927,31,-0.642809616517253,1.8917091336408034
86,1564704000,321,150,0,471,31,-0.642809616517253,-0.44112321600601867
86,1564718400,45,27,0,72,31,-0.642809616517253,-1.0804090041303882
86,1564732800,34,126,92,160,31,-0.21747529028316728,-0.9394136423385473
86,1564747200,197,843,646,1040,31,2.3437770655177403,0.4705399755798617
86,1564761600,536,688,152,1224,31,0.05991666160862777,0.7653484593264381
86,1564776000,1023,843,0,1866,31,-0.642809616517253,1.7939737123987318
86,1565395200,6289,6312,23,12601,32,-0.5465636080975943,4.2748229590048625
86,1565409600,48,44,0,92,32,-0.6908915413495423,-0.4039760902684149
86,1565424000,12,57,45,69,32,-0.40851080237833975,-0.41257888650578683
86,1565438400,114,450,336,564,32,1.417551309635437,-0.22743175009278246
86,1565452800,532,976,444,1508,32,2.095265083166323,0.12565693025848249
86,1565467200,780,594,0,1374,32,-0.6908915413495423,0.07553629131031565
86,1565481600,296,205,0,501,32,-0.6908915413495423,-0.2509959310908012
86,1565496000,63,45,0,108,32,-0.6908915413495423,-0.3979915363641562
86,1565510400,16,50,34,66,32,-0.47753720523796706,-0.41370099036283536
86,1565524800,80,316,236,396,32,0.790038556366098,-0.2902695660874991
86,1565539200,405,651,246,1056,32,0.8527898316930319,-0.043406717536826574
86,1565553600,543,500,0,1043,32,-0.6908915413495423,-0.048269167584036786
86,1565568000,212,100,0,312,32,-0.6908915413495423,-0.3216884740848574
86,1565582400,15,52,37,67,32,-0.45871182263988686,-0.4133269557438192
86,1565583006,1,1,0,2,32,-0.6908915413495423,-0.43763920597987027
86,1565583087,0,0,0,0,32,-0.6908915413495423,-0.4383872752179026
86,1565596800,32,141,109,173,32,-0.006902640285962694,-0.37367928612810514
86,1565611200,191,721,530,912,32,2.634926050977955,-0.09726770267515512
86,1565625600,414,576,162,990,32,0.325679118946787,-0.06809300239189382
86,1565640000,921,686,0,1607,32,-0.6908915413495423,0.16268635754108338
86,1565654400,241,135,0,376,33,-0.5467068340917696,-0.5508556396516465
86,1565668800,29,18,0,47,33,-0.5467068340917696,-1.051164662665991
86,1565683200,73,118,45,191,33,-0.23348149598771117,-0.8321844215898037
86,1565697600,239,793,554,1032,33,3.309445106122639,0.44672101413987275
86,1565712000,413,552,139,965,33,0.420811432496322,0.3448343741947023
86,1565726400,958,797,0,1755,33,-0.5467068340917696,1.5461843078765625
86,1565740800,242,127,0,369,33,-0.5467068340917696,-0.561500512481739
86,1565755200,22,25,3,47,33,-0.5258251448848323,-1.051164662665991
86,1565769600,24,129,105,153,33,0.1841522881510334,-0.8899708740960197
86,1565772559,43,72,29,115,33,-0.3448505050913764,-0.9477573266022358
86,1565772643,41,165,124,206,33,0.31640298646163584,-0.8093739798110342
86,1565784000,177,715,538,892,33,3.1980760970189737,0.2338235575380241
86,1565798400,567,603,36,1170,33,-0.29612656360852285,0.6565770785045522
86,1565812800,1413,780,0,2193,33,-0.5467068340917696,2.212249207816632
86,1565827200,464,127,0,591,33,-0.5467068340917696,-0.22390597415595045
86,1565841600,31,19,0,50,33,-0.5467068340917696,-1.046602574310237
86,1565856000,37,135,98,172,33,0.13542834666817988,-0.8610776478429117
86,1565870400,415,822,407,1237,33,2.2862423349827146,0.7584637184497225
86,1565884800,743,654,0,1397,33,-0.5467068340917696,1.0017750974232638
86,1565899200,1547,833,0,2380,33,-0.5467068340917696,2.4966193819919584
86,1565913600,494,137,0,631,33,-0.5467068340917696,-0.16307812941256514
86,1565928000,42,32,0,74,33,-0.5467068340917696,-1.0101058674642058
86,1565942400,41,105,64,146,33,-0.10123079767710873,-0.9006157469261122
86,1565945964,86,65,0,151,33,-0.5467068340917696,-0.893012266333189
86,1565946048,35,192,157,227,33,0.5461015677379454,-0.7774393613207569
86,1565956800,291,541,250,832,33,1.1934339331529995,0.1425817904229461
86,1565971200,915,633,0,1548,33,-0.5467068340917696,1.2314002113295435
86,1565985600,1381,692,0,2073,33,-0.5467068340917696,2.029765673586476
86,1566000000,527,164,0,691,33,-0.5467068340917696,-0.07183636229748715
86,1566014400,85,45,0,130,33,-0.5467068340917696,-0.9249468848234663
86,1566028800,27,57,30,84,33,-0.3378899420223973,-0.9948989062783594
86,1566043200,179,431,252,610,33,1.2073550592909577,-0.19501274790284243
86,1566057600,846,710,0,1556,33,-0.5467068340917696,1.2435657802782205
86,1566072000,1058,613,0,1671,33,-0.5467068340917696,1.4184458339154533
86,1566086400,507,185,0,692,33,-0.5467068340917696,-0.07031566617890252
86,1566100800,65,33,0,98,33,-0.5467068340917696,-0.9736091606181746
86,1566115200,19,35,16,54,33,-0.4353378249881044,-1.0405197898358984
86,1566129600,118,337,219,455,33,0.9776564780146482,-0.4307206462834606
86,1566144000,618,592,0,1210,33,-0.5467068340917696,0.7174049232479375
86,1566158400,803,403,0,1206,33,-0.5467068340917696,0.711322138773599
86,1566172800,291,98,0,389,33,-0.5467068340917696,-0.5310865901100463
86,1566187200,19,12,0,31,33,-0.5467068340917696,-1.075495800563345
86,1566201600,39,122,83,161,33,0.03101990063349373,-0.8778053051473427
86,1566216000,350,798,448,1148,33,2.5716254208108564,0.6231217638956902
86,1566230400,562,578,16,1140,33,-0.4353378249881044,0.6109561949470131
86,1566244800,908,705,0,1613,33,-0.5467068340917696,1.3302454590375445
86,1566259200,262,121,0,383,34,-0.6977351852138571,-0.5465125690580797
86,1566273600,19,19,0,38,34,-0.6977351852138571,-1.1650369091074098
86,1566288000,25,95,70,120,34,-0.338795299906991,-1.0180253268348154
86,1566302400,228,852,624,1080,34,2.501957506664492,0.7030858802589728
86,1566316800,428,678,250,1106,34,0.5841929765963789,0.7496993087844295
86,1566331200,988,722,0,1710,34,-0.6977351852138571,1.8325651099142712
86,1566345600,258,80,0,338,34,-0.6977351852138571,-0.627189656890601
86,1566360000,21,10,0,31,34,-0.6977351852138571,-1.177586678325802
86,1566374400,30,123,93,153,34,-0.2208579090204493,-0.9588621290909664
86,1566388800,208,825,617,1033,34,2.4660635181338053,0.6188231440783394
86,1566403200,475,630,155,1105,34,0.09706027510848923,0.7479064846103735
86,1566417600,917,726,0,1643,34,-0.6977351852138571,1.7124458902525173
86,1566432000,248,73,0,321,34,-0.6977351852138571,-0.6576676678495534
86,1566446400,27,12,0,39,34,-0.6977351852138571,-1.1632440849333539
86,1566460800,23,126,103,149,34,-0.16958078254803985,-0.9660334257871905
86,1566475200,206,841,635,1047,34,2.5583623457841425,0.6439226825151237
86,1566489600,484,703,219,1187,34,0.42523388453190963,0.8949180668829679
86,1566504000,930,799,0,1729,34,-0.6977351852138571,1.8666287692213355
86,1566518400,298,103,0,401,34,-0.6977351852138571,-0.5142417339250711
86,1566532800,35,18,0,53,34,-0.6977351852138571,-1.1381445464965694
86,1566547200,22,112,90,134,34,-0.23624104696217213,-0.9929257883980309
86,1566561600,218,726,508,944,34,1.9071428395845427,0.4592617925873528
86,1566576000,555,753,198,1308,34,0.3175519189398498,1.1118497919437473
86,1566590400,915,765,0,1680,34,-0.6977351852138571,1.7787803846925903
86,1566604800,147,166,19,313,34,-0.6003086449162791,-0.6720102612420017
86,1566619200,350,106,0,456,34,-0.6977351852138571,-0.4156364043519895
86,1566633600,22,69,47,91,34,-0.45673269079353274,-1.0700172278824402
86,1566648000,112,445,333,557,34,1.0097931263173772,-0.23456116277233058
86,1566662400,451,768,317,1219,34,0.9277497239615221,0.9522884404527608
86,1566676800,805,636,0,1441,34,-0.6977351852138571,1.3502954070931994
86,1566691200,300,179,0,479,34,-0.6977351852138571,-0.37440144834870087
86,1566705600,64,39,0,103,34,-0.6977351852138571,-1.0485033377937678
86,1566720000,11,44,33,55,34,-0.5285206678549059,-1.1345588981484573
86,1566734400,78,363,285,441,34,0.763662919249812,-0.44252876696282994
86,1566748800,343,579,236,922,34,0.5124049995350057,0.4198196607581201
86,1566763200,579,441,0,1020,34,-0.6977351852138571,0.595516429815611
86,1566777600,230,100,0,330,34,-0.6977351852138571,-0.6415322502830492
86,1566792000,16,13,0,29,34,-0.6977351852138571,-1.181172326673914
86,1566806400,17,112,95,129,34,-0.2106024837259674,-1.0018899092683111
86,1566820800,215,791,576,1006,34,2.255827299596927,0.5704168913788266
86,1566835200,393,605,212,998,34,0.38933989600122304,0.5560742979863783
86,1566849600,884,684,0,1568,34,-0.6977351852138571,1.5779840771983151
86,1566864000,254,132,0,386,35,-0.534298886403964,-0.38100198335203195
86,1566878400,15,14,0,29,35,-0.534298886403964,-1.0593945422381934
86,1566892800,28,122,94,150,35,0.02686418981919372,-0.8294631707389623
86,1566907200,230,807,577,1037,35,2.9102872304126532,0.8560668004992039
86,1566921600,501,620,119,1121,35,0.1761096888147144,1.0156885790606538
86,1566936000,940,718,0,1658,35,-0.534298886403964,2.0361278062927792
86,1566950400,273,107,0,380,35,-0.534298886403964,-0.39240353896356406
86,1566964800,24,18,0,42,35,-0.534298886403964,-1.0346911717465406
86,1566979200,29,122,93,151,35,0.020894369859372895,-0.8275629114703736
86,1566993600,232,841,609,1073,35,3.1013214691269195,0.9244761341683967
86,1567008000,444,624,180,1068,35,0.5402687063637848,0.9149748378254532
86,1567022400,1010,717,0,1727,35,-0.534298886403964,2.1672456958253985
86,1567036800,274,116,0,390,35,-0.534298886403964,-0.37340094627767717
86,1567051200,18,19,1,37,35,-0.5283290664441431,-1.044192468089484
86,1567065600,26,123,97,149,35,0.0447736496986562,-0.831363430007551
86,1567080000,214,782,568,996,35,2.8565588507742654,0.7781561704870678
86,1567094400,500,649,149,1149,35,0.3552042876093392,1.068895838581137
86,1567108800,1210,649,0,1859,35,-0.534298886403964,2.4180799192791054
86,1567123200,274,139,0,413,35,-0.534298886403964,-0.32969498310013734
86,1567137600,27,23,0,50,35,-0.534298886403964,-1.019489097597831
86,1567152000,18,129,111,147,35,0.12835112913614777,-0.8351639485447283
86,1567166400,179,718,539,897,35,2.6834340719394616,0.5900305028967876
86,1567180800,605,843,238,1448,35,0.8865182640333927,1.6370733598891547
86,1567195200,886,606,0,1492,35,-0.534298886403964,1.720684767707057
86,1567209600,257,80,0,337,35,-0.534298886403964,-0.4741146875128776
86,1567224000,64,16,0,80,35,-0.534298886403964,-0.9624813195401705
86,1567238400,10,41,31,51,35,-0.3492344676495184,-1.0175888383292424
86,1567252800,123,174,51,297,35,-0.22983806845310184,-0.5501250582564251
86,1567267200,490,330,0,820,35,-0.534298886403964,0.4437105392154586
86,1567281600,717,195,0,912,35,-0.534298886403964,0.6185343919256179
86,1567296000,310,63,0,373,35,-0.534298886403964,-0.4057053538436849
86,1567310400,47,22,0,69,35,-0.534298886403964,-0.983384171494646
86,1567324800,13,36,23,49,35,-0.396993027328085,-1.0213893568664199
86,1567339200,78,195,117,273,35,0.16417004889507272,-0.5957312807025537
86,1567353600,408,263,0,671,35,-0.534298886403964,0.16057190819574413
86,1567368000,640,163,0,803,35,-0.534298886403964,0.41140613164945095
86,1567382400,235,52,0,287,35,-0.534298886403964,-0.569127650942312
86,1567396800,31,21,0,52,35,-0.534298886403964,-1.0156885790606538
86,1567411200,17,44,27,61,35,-0.37311374748880166,-0.9985862456433555
86,1567425600,95,216,121,311,35,0.18804932873435604,-0.5235214284961835
86,1567440000,351,365,14,716,35,-0.4507214069664724,0.2460835752822351
86,1567454400,439,183,0,622,35,-0.534298886403964,0.06745920403489843
86,1567468800,179,53,0,232,36,-0.6855408336045586,-0.8190958157547132
86,1567483200,11,10,0,21,36,-0.6855408336045586,-1.1748509186373963
86,1567497600,36,133,97,169,36,-0.17709492861548673,-0.9253165336770309
86,1567512000,216,807,591,1023,36,2.412309989576282,0.5145643092699427
86,1567526400,440,597,157,1037,36,0.13740769302723818,0.53816891325268
86,1567540800,932,646,0,1578,36,-0.6855408336045586,1.4503182528713132
86,1567555200,237,118,0,355,36,-0.6855408336045586,-0.61171250933495
86,1567569600,19,20,1,39,36,-0.6802991232438466,-1.1445021420881627
86,1567584000,24,137,113,161,36,-0.09322756284409342,-0.9388048788100236
86,1567598400,230,754,524,984,36,2.061115395408572,0.44880862674660316
86,1567612800,475,662,187,1137,36,0.29465900384860066,0.7067732274150891
86,1567627200,930,741,0,1671,36,-0.6855408336045586,1.6071202650423537
86,1567641600,253,154,0,407,36,-0.6855408336045586,-0.5240382659704973
86,1567656000,22,20,0,42,36,-0.6855408336045586,-1.1394440126632905
86,1567670400,36,131,95,167,36,-0.1875783493369109,-0.9286886199602791
86,1567684800,229,791,562,1020,36,2.2603003891156312,0.5095061798450704
86,1567699200,505,624,119,1129,36,-0.06177730067982092,0.6932848822820964
86,1567713600,1008,840,0,1848,36,-0.6855408336045586,1.9055499011098178
86,1567728000,346,150,0,496,36,-0.6855408336045586,-0.3739804263659532
86,1567742400,33,23,0,56,36,-0.6855408336045586,-1.1158394086805532
86,1567756800,30,135,105,165,36,-0.13516124572979007,-0.9320607062435273
86,1567771200,265,833,568,1098,36,2.2917506512799037,0.6410175448917496
86,1567785600,581,697,116,1278,36,-0.07750243176195717,0.9445053103840859
86,1567800000,901,751,0,1652,36,-0.6855408336045586,1.575085445351496
86,1567814400,266,132,0,398,36,-0.6855408336045586,-0.5392126542451141
86,1567828800,52,36,0,88,36,-0.6855408336045586,-1.0618860281485822
86,1567843200,19,62,43,81,36,-0.4601472880939392,-1.073688330139951
86,1567857600,135,482,347,617,36,1.1333326615625339,-0.1699692062294382
86,1567872000,580,1006,426,1586,36,1.5474277800587883,1.463806598004306
86,1567886400,941,744,0,1685,36,-0.6855408336045586,1.6307248690250908
86,1567900800,334,211,0,545,36,-0.6855408336045586,-0.29136431242637273
86,1567915200,64,31,0,95,36,-0.6855408336045586,-1.0500837261572136
86,1567929600,16,35,19,51,36,-0.5859483367510291,-1.1242696243886736
86,1567944000,89,391,302,480,36,0.8974556953304901,-0.40095711663193867
86,1567958400,474,748,274,1222,36,0.7506878052305518,0.8500868944531368
86,1567972800,666,474,0,1140,36,-0.6855408336045586,0.7118313568399613
86,1567987200,201,110,0,311,36,-0.6855408336045586,-0.68589840756641
86,1568001600,19,15,0,34,36,-0.6855408336045586,-1.1529323577962831
86,1568016000,36,141,105,177,36,-0.13516124572979007,-0.9118281885440382
86,1568030400,199,792,593,991,36,2.422793410297706,0.4606109287379718
86,1568044800,473,622,149,1095,36,0.09547401014154154,0.6359594154668773
86,1568059200,986,801,0,1787,36,-0.6855408336045586,1.8027012694707483
86,1568073600,278,82,0,360,37,-0.5678459638481395,-0.5907262379840083
86,1568088000,24,10,0,34,37,-0.5678459638481395,-1.1069212513277202
86,1568102400,35,130,95,165,37,-0.06126139029067067,-0.8994931938184372
86,1568116800,279,877,598,1156,37,2.620970614966243,0.669676309934994
86,1568131200,480,665,185,1145,37,0.4186608372900893,0.6522586867853596
86,1568145600,1013,789,0,1802,37,-0.5678459638481395,1.6925658149044356
86,1568160000,300,91,0,391,37,-0.5678459638481395,-0.5416402091077657
86,1568174400,30,12,0,42,37,-0.5678459638481395,-1.094253889037077
86,1568188800,35,139,104,174,37,-0.013269167532594668,-0.8852424112414635
86,1568203200,265,872,607,1137,37,2.6689628377243193,0.6395913244947163
86,1568217600,542,651,109,1193,37,0.013393178444114216,0.728262860529219
86,1568232000,964,810,0,1774,37,-0.5678459638481395,1.6482300468871842
86,1568246400,306,89,0,395,37,-0.5678459638481395,-0.535306527962444
86,1568260800,29,18,0,47,37,-0.5678459638481395,-1.0863367876054248
86,1568275200,37,133,96,170,37,-0.05592892109532888,-0.8915760923867851
86,1568275700,6,5,0,11,37,-0.5678459638481395,-1.1433399179133195
86,1568289600,241,871,630,1112,37,2.79160962921718,0.6000058173364562
86,1568304000,502,617,115,1119,37,0.04538799361616488,0.611089759340769
86,1568318400,1070,881,0,1951,37,-0.5678459638481395,1.9284954375676657
86,1568332800,346,96,0,442,37,-0.5678459638481395,-0.460885774504915
86,1568347200,27,10,0,37,37,-0.5678459638481395,-1.102170990468729
86,1568361600,34,128,94,162,37,-0.06659385948601244,-0.9042434546774284
86,1568376000,230,847,617,1077,37,2.722287529677737,0.544586107314892
86,1568390400,596,801,205,1397,37,0.5253102211969248,1.0512805989406215
86,1568404800,1110,1104,0,2214,37,-0.5678459638481395,2.3449349728725624
86,1568419200,470,108,0,578,37,-0.5678459638481395,-0.24554061556397996
86,1568433600,90,28,0,118,37,-0.5678459638481395,-0.9739139472759661
86,1568448000,24,55,31,79,37,-0.4025394187925444,-1.0356673384428519
86,1568462400,158,330,172,488,37,0.34933873775064617,-0.3880484413337164
86,1568476800,761,488,0,1249,37,-0.5678459638481395,0.8169343965637217
86,1568491200,1272,421,0,1693,37,-0.5678459638481395,1.5199730036944215
86,1568505600,532,84,0,616,37,-0.5678459638481395,-0.18537064468342457
86,1568520000,103,20,0,123,37,-0.5678459638481395,-0.9659968458443141
86,1568534400,20,29,9,49,37,-0.5198537410900635,-1.083169947032764
86,1568548800,124,246,122,370,37,0.08271527798355732,-0.5748920351207042
86,1568563200,585,429,0,1014,37,-0.5678459638481395,0.44483062927607653
86,1568577600,940,272,0,1212,37,-0.5678459638481395,0.7583478459694967
86,1568592000,330,62,0,392,37,-0.5678459638481395,-0.5400567888214353
86,1568606400,26,8,0,34,37,-0.5678459638481395,-1.1069212513277202
86,1568620800,39,139,100,178,37,-0.034599044313961776,-0.8789087300961419
86,1568635200,241,764,523,1005,37,2.22103542531561,0.4305798466991029
86,1568649600,453,620,167,1073,37,0.3226763917739373,0.5382524261695704
86,1568664000,1014,730,0,1744,37,-0.5678459638481395,1.600727438297272
86,1568678400,284,97,0,381,38,-0.6703486762041749,-0.6205272797844974
86,1568692800,19,19,0,38,38,-0.6703486762041749,-1.129404502444578
86,1568707200,34,113,79,147,38,-0.29439119674807745,-0.9676913325613454
86,1568721600,256,892,636,1148,38,2.356346981189217,0.5173993376507268
86,1568736000,462,715,253,1177,38,0.5336670491425675,0.5604239424820455
86,1568750400,991,844,0,1835,38,-0.6703486762041749,1.5366373900340369
86,1568764800,328,145,0,473,38,-0.6703486762041749,-0.4840354299747965
86,1568779200,24,21,0,45,38,-0.6703486762041749,-1.1190192530025356
86,1568793600,35,132,97,167,38,-0.2087299988973211,-0.938019191298367
86,1568808000,239,796,557,1035,38,1.9803895017331195,0.3497517395148984
86,1568822400,524,701,177,1225,38,0.17198643599492944,0.6316370815131939
86,1568836800,1114,890,0,2004,38,-0.6703486762041749,1.787366983706205
86,1568851200,401,148,0,549,38,-0.6703486762041749,-0.3712812931754783
86,1568865600,25,20,0,45,38,-0.6703486762041749,-1.1190192530025356
86,1568880000,36,137,101,173,38,-0.18969417715270856,-0.9291175489194734
86,1568883487,46,101,55,147,38,-0.4086061272157526,-0.9676913325613454
86,1568894400,205,876,671,1081,38,2.5229104214545766,0.4179976644197489
86,1568908800,535,609,74,1144,38,-0.3181859739288431,0.511464909398131
86,1568923200,1074,1007,0,2081,38,-0.6703486762041749,1.901604727568672
86,1568937600,407,168,0,575,38,-0.6703486762041749,-0.3327075095336063
86,1568952000,38,22,0,60,38,-0.6703486762041749,-1.0967651470553017
86,1568966400,28,129,101,157,38,-0.18969417715270856,-0.9528552619298563
86,1568980800,240,859,619,1099,38,2.2754447387746137,0.4447025915564295
86,1568995200,622,768,146,1390,38,0.02445881747418236,0.8764322469327662
86,1569009600,1165,1035,0,2200,38,-0.6703486762041749,2.078153968083394
86,1569024000,437,207,0,644,38,-0.6703486762041749,-0.23033862217633058
86,1569038400,86,45,0,131,38,-0.6703486762041749,-0.9914290455717282
86,1569052800,18,58,40,76,38,-0.47999045875804963,-1.073027434044919
86,1569067200,124,507,383,631,38,1.1523312558424745,-0.2496255139972666
86,1569081600,639,1144,505,1783,38,1.7329238190531566,1.459489822750293
86,1569096000,1070,1087,17,2157,38,-0.5894464337895716,2.01435886436799
86,1569110400,467,316,0,783,38,-0.6703486762041749,-0.024117240398630252
86,1569124800,76,49,0,125,38,-0.6703486762041749,-1.0003306879506217
86,1569139200,16,36,20,52,38,-0.5751695674811123,-1.1086340035604931
86,1569153600,101,413,312,514,38,0.8144454198756023,-0.42320754038569064
86,1569168000,506,857,351,1363,38,1.0000446818855744,0.8363748562277452
86,1569182400,741,627,0,1368,38,-0.6703486762041749,0.8437928915434899
86,1569196800,265,108,0,373,38,-0.6703486762041749,-0.6323961362896888
86,1569211200,21,22,1,43,38,-0.6655897207680217,-1.1219864671288335
86,1569225600,30,138,108,168,38,-0.15638148909963664,-0.9365355842352181
86,1569240000,238,862,624,1100,38,2.2992395159553793,0.4461861986195784
86,1569254400,465,595,130,1060,38,-0.05168446950426775,0.3868419160936215
86,1569268800,913,708,0,1621,38,-0.6703486762041749,1.2191454785201674
86,1569283200,151,96,0,247,39,-0.7624867366168085,-0.7696339597554007
86,1569297600,25,15,0,40,39,-0.7624867366168085,-1.1091680159848347
86,1569312000,35,125,90,160,39,-0.37284230449411876,-0.9123366790402353
86,1569326400,241,924,683,1165,39,2.194481564936493,0.7361257678707845
86,1569340800,478,630,152,1108,39,-0.10442058458737692,0.6426308828220998
86,1569355200,941,878,0,1819,39,-0.7624867366168085,1.808856554218851
86,1569369600,178,142,0,320,39,-0.7624867366168085,-0.649894896447436
86,1569384000,27,24,0,51,39,-0.7624867366168085,-1.0911251434315796
86,1569398400,38,132,94,170,39,-0.3555247741775548,-0.8959340676281853
86,1569412800,262,866,604,1128,39,1.852460341184354,0.6754361056461997
86,1569427200,376,601,225,977,39,0.2116243436899159,0.4277566733242455
86,1569441600,949,814,0,1763,39,-0.7624867366168085,1.7170019303113713
86,1569456000,200,135,0,335,39,-0.7624867366168085,-0.6252909793293612
86,1569470400,23,16,0,39,39,-0.7624867366168085,-1.1108082771260397
86,1569484800,35,138,103,173,39,-0.3165603309652858,-0.8910132842045703
86,1569499200,286,903,617,1189,39,1.908742314713187,0.7754920352597044
86,1569513600,568,634,66,1202,39,-0.47674748639350273,0.7968154300953694
86,1569528000,953,812,0,1765,39,-0.7624867366168085,1.7202824525937812
86,1569542400,211,153,0,364,39,-0.7624867366168085,-0.5777234062344163
86,1569556800,34,24,0,58,39,-0.7624867366168085,-1.0796433154431446
86,1569571200,29,131,102,160,39,-0.3208897135444268,-0.9123366790402353
86,1569585600,229,824,595,1053,39,1.813495897972085,0.5524165200558251
86,1569600000,603,809,206,1412,39,0.12936607468623695,1.1412702697484183
86,1569614400,1110,968,0,2078,39,-0.7624867366168085,2.2336841897909445
86,1569628800,199,186,0,385,39,-0.7624867366168085,-0.5432779222691114
86,1569643200,51,43,0,94,39,-0.7624867366168085,-1.0205939143597649
86,1569657600,14,67,53,81,39,-0.5330294599223356,-1.04191730919543
86,1569672000,100,635,535,735,39,1.5537329432236253,0.030813477152636767
86,1569686400,325,1003,678,1328,39,2.172834652040788,1.0034883338871987
86,1569700800,446,959,513,1405,39,1.4584865264825233,1.1297884417599833
86,1569715200,198,246,48,444,39,-0.5546763728180406,-0.44650251493801674
86,1569729600,43,92,49,135,39,-0.5503469902388997,-0.9533432075703601
86,1569744000,9,34,25,43,39,-0.6542521721382836,-1.1042472325612196
86,1569758400,57,425,368,482,39,0.8307260525070785,-0.38417259157222694
86,1569772800,305,803,498,1108,39,1.3935457877954083,0.6426308828220998
86,1569787200,344,591,247,935,39,0.30687076043101785,0.3588657053936357
86,1569801600,105,129,24,234,39,-0.6585815547174246,-0.7909573545910656
86,1569816000,20,12,0,32,39,-0.7624867366168085,-1.1222901051144747
86,1569830400,24,120,96,144,39,-0.3468660090192728,-0.9385808572995151
86,1569844800,203,771,568,974,39,1.6966025683352781,0.42283588990063053
86,1569859200,443,601,158,1044,39,-0.07844428911253094,0.5376541697849802
86,1569873600,949,753,0,1702,39,-0.7624867366168085,1.6169460006978666
86,1569888000,231,101,0,332,40,-0.6800152874849809,-0.6482824487938076
86,1569902400,20,13,0,33,40,-0.6800152874849809,-1.1176742264663535
86,1569916800,31,111,80,142,40,-0.29568368682063506,-0.9465581603583016
86,1569931200,256,923,667,1179,40,2.5243494330540024,0.6813992759173843
86,1569945600,477,703,226,1180,40,0.40572148439179606,0.6829691480835132
86,1569960000,972,790,0,1762,40,-0.6800152874849809,1.5966347487705423
86,1569974400,260,130,0,390,40,-0.6800152874849809,-0.5572298631583305
86,1569988800,17,11,0,28,40,-0.6800152874849809,-1.125523587296998
86,1570003200,34,131,97,165,40,-0.21401322167946155,-0.9104511005373366
86,1570017600,252,846,594,1098,40,2.173646847447787,0.554239630460942
86,1570032000,483,647,164,1130,40,0.10786449387692805,0.6044755397770674
86,1570046400,892,797,0,1689,40,-0.6800152874849809,1.4820340806431314
86,1570060800,233,122,0,355,40,-0.6800152874849809,-0.6121753889728425
86,1570075200,27,28,1,55,40,-0.6752111424766765,-1.0831370388115173
86,1570089600,37,125,88,162,40,-0.25725052675420046,-0.9151607170357233
86,1570104000,261,888,627,1149,40,2.3321836327218293,0.6343031109335168
86,1570118400,441,681,240,1122,40,0.4729795145080566,0.591916562448036
86,1570132800,985,861,0,1846,40,-0.6800152874849809,1.7285040107253713
86,1570147200,267,175,0,442,40,-0.6800152874849809,-0.47559651051962687
86,1570161600,29,12,0,41,40,-0.6800152874849809,-1.1051152491373222
86,1570176000,31,128,97,159,40,-0.21401322167946155,-0.9198703335341101
86,1570190400,253,874,621,1127,40,2.3033587626720036,0.5997659232786806
86,1570204800,560,819,259,1379,40,0.5642582696658387,0.9953737091431675
86,1570219200,1091,1078,0,2169,40,-0.6800152874849809,2.235572720385011
86,1570233600,355,182,0,537,40,-0.6800152874849809,-0.32645865473737984
86,1570248000,50,34,0,84,40,-0.6800152874849809,-1.0376107459937787
86,1570262400,13,42,29,55,40,-0.5406950822441555,-1.0831370388115173
86,1570276800,108,423,315,531,40,0.8332903901308808,-0.33587788773415334
86,1570291200,548,923,375,1471,40,1.12153909062914,1.1398019484270276
86,1570305600,948,860,0,1808,40,-0.6800152874849809,1.6688488684124725
86,1570320000,263,226,0,489,40,-0.6800152874849809,-0.4018125187115678
86,1570334400,53,39,0,92,40,-0.6800152874849809,-1.0250517686647473
86,1570348800,11,28,17,39,40,-0.5983448223438074,-1.10825499346958
86,1570363200,76,303,227,379,40,0.4105256294001004,-0.5744984569857485
86,1570377600,423,731,308,1154,40,0.7996613750727505,0.6421524717641613
86,1570392000,651,538,0,1189,40,-0.6800152874849809,0.6970979975786734
86,1570406400,158,103,0,261,40,-0.6800152874849809,-0.7597433725889606
86,1570420800,21,18,0,39,40,-0.6800152874849809,-1.10825499346958
86,1570435200,37,120,83,157,40,-0.28127125179572204,-0.9230100778663679
86,1570449600,224,874,650,1098,40,2.442678967912829,0.554239630460942
86,1570464000,414,594,180,1008,40,0.1847308140097972,0.4129511355093396
86,1570478400,984,779,0,1763,40,-0.6800152874849809,1.5982046209366711
86,1570492800,175,73,0,248,41,-0.7686584848747119,-0.7245922028537312
86,1570507200,0,0,0,0,41,-0.7686584848747119,-1.1223236733914874
86,1570521600,35,135,100,170,41,-0.352471088139661,-0.8496851653615738
86,1570536000,237,935,698,1172,41,2.1363295443359434,0.7572782760853285
86,1570550400,475,665,190,1140,41,0.02209756892188479,0.7059580863385212
86,1570564800,1062,749,0,1811,41,-0.7686584848747119,1.782078315091886
86,1570579200,220,86,0,306,41,-0.7686584848747119,-0.631574358937643
86,1570593600,1,1,0,2,41,-0.7686584848747119,-1.119116161532312
86,1570608000,20,120,100,140,41,-0.352471088139661,-0.8977978432492056
86,1570622400,222,793,571,1015,41,1.6077715504824286,0.5054885951400554
86,1570636800,428,581,153,1009,41,-0.13189176787008403,0.495866059562529
86,1570651200,881,653,0,1534,41,-0.7686584848747119,1.3378379225960857
86,1570665600,140,75,0,215,41,-0.7686584848747119,-0.7775161485301262
86,1570680000,0,2,2,2,41,-0.7603347369400109,-1.119116161532312
86,1570694400,29,127,98,156,41,-0.360794836074362,-0.872137748375802
86,1570708800,230,872,642,1102,41,1.9032646021643147,0.6450153610141877
86,1570723200,515,705,190,1220,41,0.02209756892188479,0.8342585607055394
86,1570737600,1048,825,0,1873,41,-0.7686584848747119,1.8815111827263251
86,1570752000,192,93,0,285,41,-0.7686584848747119,-0.6652532334589852
86,1570766400,1,1,0,2,41,-0.7686584848747119,-1.119116161532312
86,1570780800,31,117,86,148,41,-0.4107373236825681,-0.8849677958125038
86,1570795200,228,827,599,1055,41,1.7243040215682428,0.5696388323235645
86,1570809600,589,825,236,1414,41,0.2135437714200082,1.1453872110455583
86,1570824000,1211,924,0,2135,41,-0.7686584848747119,2.3016952362783094
86,1570838400,210,156,0,366,41,-0.7686584848747119,-0.5353490031623793
86,1570852800,37,47,10,84,41,-0.7270397452012067,-0.9876081753061183
86,1570867200,15,66,51,81,41,-0.5564029125398359,-0.9924194430948815
86,1570881600,67,525,458,592,41,1.1374797921718212,-0.1729001630755531
86,1570896000,302,1016,714,1318,41,2.2029195278135516,0.9914266418051366
86,1570910400,417,982,565,1399,41,1.5828003066783256,1.1213308721017425
86,1570924800,165,227,62,392,41,-0.5106222988989804,-0.4936513489930985
86,1570939200,48,52,4,100,41,-0.7520109890053098,-0.9619480804327147
86,1570953600,13,46,33,59,41,-0.631316643952145,-1.0277020735458116
86,1570968000,42,374,332,416,41,0.613083672285657,-0.45516120668299304
86,1570982400,213,895,682,1108,41,2.069739560858335,0.654637896591714
86,1570996800,369,728,359,1097,41,0.7254542694041207,0.6369965813662489
86,1571011200,98,107,9,205,41,-0.7312016191685573,-0.7935537078260034
86,1571025600,17,22,5,39,41,-0.7478491150379593,-1.059777192137566
86,1571040000,20,116,96,136,41,-0.369118584009063,-0.9042128669675565
86,1571054400,212,757,545,969,41,1.4995628273313153,0.43171582237901995
86,1571068800,485,652,167,1137,41,-0.07362553232717692,0.701146818549758
86,1571083200,992,748,0,1740,41,-0.7686584848747119,1.6682116440911574
86,1571097600,241,105,0,346,42,-0.6717890844748791,-0.6117704616177719
86,1571112000,10,15,5,25,42,-0.648311682621039,-1.089023636223188
86,1571126400,32,149,117,181,42,-0.12241788109502294,-0.8570875139850418
86,1571140800,241,892,651,1133,42,2.3849686368950898,0.5583175396733884
86,1571155200,479,613,134,1092,42,-0.04259471479196692,0.49735996908515767
86,1571169600,1018,800,0,1818,42,-0.6717890844748791,1.5767549995011456
86,1571184000,153,77,0,230,42,-0.6717890844748791,-0.7842357832820344
86,1571198400,0,1,1,1,42,-0.667093604104111,-1.124706116567518
86,1571212800,31,123,92,154,42,-0.23980489036422295,-0.8972303043724132
86,1571227200,234,923,689,1157,42,2.5633968909842735,0.5940000200177186
86,1571241600,479,640,161,1119,42,0.0841832552187691,0.5375027594725291
86,1571256000,906,712,0,1618,42,-0.6717890844748791,1.2794009966317272
86,1571270400,139,62,0,201,42,-0.6717890844748791,-0.8273521136981
86,1571284800,1,6,5,7,42,-0.648311682621039,-1.1157854964814355
86,1571299200,36,130,94,166,42,-0.23041392962268695,-0.8793890642002482
86,1571313600,231,833,602,1064,42,2.1548900987274577,0.4557304086834391
86,1571328000,535,716,181,1251,42,0.1780928626341291,0.7337564013663451
86,1571342400,1116,893,0,2009,42,-0.6717890844748791,1.8607280722414399
86,1571356800,197,88,0,285,42,-0.6717890844748791,-0.7024634324929444
86,1571371200,0,1,1,1,42,-0.667093604104111,-1.124706116567518
86,1571385600,29,114,85,143,42,-0.27267325295959893,-0.9135847745302312
86,1571400000,252,873,621,1125,42,2.2441042257720496,0.5464233795586116
86,1571414400,618,907,289,1525,42,0.6852047426770732,1.1411313852974478
86,1571428800,1168,1038,0,2206,42,-0.6717890844748791,2.153621765067817
86,1571443200,322,161,0,483,42,-0.6717890844748791,-0.4080829696522205
86,1571457600,45,31,0,76,42,-0.6717890844748791,-1.0131983654914865
86,1571472000,17,55,38,72,42,-0.493360830385695,-1.0191454455488747
86,1571486400,120,535,415,655,42,1.2768352693938414,-0.15235852718452092
86,1571500800,595,1049,454,1644,42,1.4599590038537935,1.3180570170047516
86,1571515200,1027,973,0,2000,42,-0.6717890844748791,1.847347142112316
86,1571529600,289,270,0,559,42,-0.6717890844748791,-0.29508844856184163
86,1571544000,44,53,9,97,42,-0.629529761137967,-0.9819761951901974
86,1571558400,13,37,24,50,42,-0.559097555576447,-1.0518543858645106
86,1571572800,109,356,247,465,42,0.48799456710481715,-0.43484482991046813
86,1571587200,547,732,185,1279,42,0.1968747841172011,0.7753859617680636
86,1571601600,677,593,0,1270,42,-0.6717890844748791,0.7620050316389398
86,1571616000,147,96,0,243,42,-0.6717890844748791,-0.7649077730955223
86,1571630400,11,13,2,24,42,-0.6623981237333431,-1.090510406237535
86,1571644800,35,140,105,175,42,-0.17876364554423893,-0.8660081340711244
86,1571659200,217,854,637,1071,42,2.3192319117043376,0.4661377987838688
86,1571673600,453,618,165,1071,42,0.1029651767018411,0.4661377987838688
86,1571688000,997,726,0,1723,42,-0.6717890844748791,1.435511848138172
86,1571702400,163,67,0,230,43,-0.6441423484372608,-0.7770099963971472
86,1571716800,0,1,1,1,43,-0.6391099863400946,-1.1232357154310948
86,1571731200,36,125,89,161,43,-0.19626212178947788,-0.881331282918293
86,1571745600,260,893,633,1153,43,2.5413428590688802,0.6184761986610787
86,1571760000,465,607,142,1072,43,0.0704530693603254,0.49601207970147276
86,1571774400,955,803,0,1758,43,-0.6441423484372608,1.533177334100111
86,1571788800,148,79,0,227,43,-0.6441423484372608,-0.7815457045067622
86,1571803200,0,1,1,1,43,-0.6391099863400946,-1.1232357154310948
86,1571817600,43,122,79,165,43,-0.2465857427611389,-0.875283672105473
86,1571832000,327,941,614,1268,43,2.4457279792227244,0.7923450095296551
86,1571846400,617,756,139,1373,43,0.055355983068827094,0.9510947933661813
86,1571860800,1147,853,0,2000,43,-0.6441423484372608,1.8990577882757236
86,1571875200,217,114,0,331,43,-0.6441423484372608,-0.6243078233734409
86,1571889600,0,0,0,0,43,-0.6441423484372608,-1.1247476181343
86,1571904000,41,133,92,174,43,-0.1811650354979796,-0.8616765477766278
86,1571918400,341,858,517,1199,43,1.9575888557976129,0.6880237230085093
86,1571932800,594,767,173,1361,43,0.2264562943724745,0.9329519609277213
86,1571947200,1042,856,0,1898,43,-0.6441423484372608,1.7448437125488123
86,1571961600,191,111,0,302,43,-0.6441423484372608,-0.6681530017663864
86,1571976000,0,1,1,1,43,-0.6391099863400946,-1.1232357154310948
86,1571990400,27,124,97,151,43,-0.15600322501214908,-0.8964503099503431
86,1572004800,235,873,638,1108,43,2.566504669554711,0.5504405770168532
86,1572019200,604,717,113,1321,43,-0.0754854314574915,0.8724758527995208
86,1572033600,1126,1019,0,2145,43,-0.6441423484372608,2.11828368024045
86,1572048000,324,194,0,518,43,-0.6441423484372608,-0.34158201787410375
86,1572062400,54,34,0,88,43,-0.6441423484372608,-0.9917001802522588
86,1572076800,11,53,42,64,43,-0.43278314035628457,-1.0279858451291792
86,1572091200,121,513,392,634,43,1.3285435936518504,-0.16620130430232238
86,1572105600,590,1015,425,1605,43,1.4946115428583315,1.3018562205097441
86,1572120000,996,806,0,1802,43,-0.6441423484372608,1.5997010530411313
86,1572134400,286,226,0,512,43,-0.6441423484372608,-0.3506534340933338
86,1572148800,48,35,0,83,43,-0.6441423484372608,-0.9992596937682839
86,1572163200,20,39,19,59,43,-0.5485274685911049,-1.0355453586452041
86,1572177600,86,321,235,407,43,0.5384627443967727,-0.5094032179298601
86,1572192000,308,489,181,797,43,0.2667151911498033,0.08023883632009453
86,1572206400,477,488,11,965,43,-0.5887863653684337,0.33423849045853654
86,1572220800,193,174,0,367,43,-0.6441423484372608,-0.5698793260580606
86,1572235200,13,14,1,27,43,-0.6391099863400946,-1.0839262451477645
86,1572249600,32,124,92,156,43,-0.1811650354979796,-0.888890796434318
86,1572264000,219,805,586,1024,43,2.3048218405020737,0.4234407499476322
86,1572278400,489,552,63,1041,43,-0.3271035363157965,0.44914309590211743
86,1572292800,1030,666,0,1696,43,-0.6441423484372608,1.4394393665014003
86,1572307200,224,121,0,345,44,-0.7460565023239328,-0.7137151371731123
86,1572321600,20,20,0,40,44,-0.7460565023239328,-1.137069909856304
86,1572336000,30,153,123,183,44,-0.21576583698442456,-0.9385789836474633
86,1572350400,226,894,668,1120,44,2.133896054154047,0.3620223999727027
86,1572364800,473,697,224,1170,44,0.21967609146509035,0.4314248217240456
86,1572379200,1094,811,0,1905,44,-0.7460565023239328,1.4516404214687864
86,1572393600,268,128,0,396,44,-0.7460565023239328,-0.6429246669867426
86,1572408000,24,21,0,45,44,-0.7460565023239328,-1.1301296676811698
86,1572422400,36,136,100,172,44,-0.3149258800966903,-0.9538475164327588
86,1572436800,272,947,675,1219,44,2.1640751977099537,0.49943919504036166
86,1572451200,492,684,192,1176,44,0.08171429235237275,0.4397531123342068
86,1572465600,1037,799,0,1836,44,-0.7460565023239328,1.3558650794519331
86,1572480000,276,152,0,428,44,-0.7460565023239328,-0.5985071170658831
86,1572494400,26,30,4,56,44,-0.7288112774348431,-1.1148611348958744
86,1572508800,28,126,98,154,44,-0.3235484925412352,-0.9788323882632423
86,1572523200,234,785,551,1019,44,1.6294732261481732,0.22182950803499002
86,1572537600,447,603,156,1050,44,-0.07349273164943454,0.26485900952082264
86,1572552000,922,983,61,1905,44,-0.4830668227653149,1.4516404214687864
86,1572566400,470,275,0,745,44,-0.7460565023239328,-0.15849576316236907
86,1572580800,63,53,0,116,44,-0.7460565023239328,-1.0315782287942628
86,1572595200,32,125,93,157,44,-0.3451050236525973,-0.9746682429581617
86,1572609600,239,796,557,1035,44,1.6553410634818078,0.24403828299541977
86,1572624000,565,783,218,1348,44,0.19380825413145578,0.6784974431588263
86,1572638400,1440,907,0,2347,44,-0.7460565023239328,2.0651578297506576
86,1572652800,471,234,0,705,44,-0.7460565023239328,-0.2140177005634434
86,1572667200,102,74,0,176,44,-0.7460565023239328,-0.9482953226926514
86,1572681600,21,107,86,128,44,-0.37528416720850427,-1.0149216475739404
86,1572696000,213,734,521,947,44,1.5001340394800005,0.12189002071305624
86,1572710400,827,1538,711,2365,44,2.3192822217117612,2.090142701581141
86,1572724800,1076,1320,244,2396,44,0.30590221591053884,2.1331722030669735
86,1572739200,378,397,19,775,44,-0.6641416841007567,-0.11685431011156334
86,1572750000,90,69,0,159,44,-0.7460565023239328,-0.9718921460881079
86,1572764400,21,53,32,74,44,-0.6080947032112152,-1.0898762630653909
86,1572778800,84,385,301,469,44,0.551646670580067,-0.5415971312297819
86,1572793200,462,1161,699,1623,44,2.267546547044492,1.0602107627912123
86,1572807600,809,1079,270,1888,44,0.4179961776896219,1.4280435980733297
86,1572822000,313,281,0,594,44,-0.7460565023239328,-0.36809107685142467
86,1572836400,58,34,0,92,44,-0.7460565023239328,-1.0648913912349074
86,1572850800,11,53,42,64,44,-0.5649816409884909,-1.1037567474156595
86,1572865200,179,755,576,934,44,1.737255881704984,0.1038453910577071
86,1572879600,440,660,220,1100,44,0.20243086657600065,0.3342614312721655
86,1572894000,1014,896,0,1910,44,-0.7460565023239328,1.4585806636439205
86,1572908400,376,203,0,579,44,-0.7460565023239328,-0.3889118033768275
86,1572922800,45,32,0,77,45,-0.7074508951791293,-1.0845584445988403
86,1572937200,11,51,40,62,45,-0.5080352066051466,-1.1078314382327266
86,1572951600,199,869,670,1068,45,2.632761888435082,0.45301066814658464
86,1572966000,407,674,267,1081,45,0.6236488260522056,0.47318059596261947
86,1572980400,918,894,0,1812,45,-0.7074508951791293,1.6073511523873474
86,1572994800,438,255,0,693,45,-0.7074508951791293,-0.12881417270057413
86,1573009200,44,32,0,76,45,-0.7074508951791293,-1.086109977507766
86,1573023600,14,53,39,67,45,-0.5130205988194961,-1.100073773688098
86,1573038000,195,798,603,993,45,2.298740610073661,0.3366456999771529
86,1573052400,400,681,281,1081,45,0.6934443170530996,0.47318059596261947
86,1573066800,934,865,0,1799,45,-0.7074508951791293,1.5871812245713128
86,1573081200,413,299,0,712,45,-0.7074508951791293,-0.09933504743098476
86,1573095600,45,44,0,89,45,-0.7074508951791293,-1.0659400496917313
86,1573110000,10,59,49,69,45,-0.4631666766760004,-1.0969707078702464
86,1573124400,211,814,603,1025,45,2.298740610073661,0.3862947530627771
86,1573138800,408,659,251,1067,45,0.5438825506226126,0.4514591352376589
86,1573153200,988,858,0,1846,45,-0.7074508951791293,1.6601032712908232
86,1573167600,430,302,0,732,45,-0.7074508951791293,-0.06830438925246962
86,1573182000,48,48,0,96,45,-0.7074508951791293,-1.055079319329251
86,1573196400,13,47,34,60,45,-0.537947559891244,-1.1109345040505783
86,1573210800,183,522,339,705,45,0.9825970654853746,-0.11019577779346505
86,1573225200,451,760,309,1211,45,0.8330352990548876,0.6748798741229679
86,1573239600,1138,1025,0,2163,45,-0.7074508951791293,2.151939203420288
86,1573254000,484,326,0,810,45,-0.7074508951791293,0.05271517764373941
86,1573268400,79,62,0,141,45,-0.7074508951791293,-0.9852603384275919
86,1573282800,14,35,21,49,45,-0.6027576586777883,-1.1280013660487616
86,1573297200,74,306,232,380,45,0.44916009854997074,-0.614443973194336
86,1573311600,536,1043,507,1579,45,1.820142957496102,1.2458439846076463
86,1573326000,1060,1170,110,2230,45,-0.1590577516006767,2.255891908318314
86,1573340400,490,310,0,800,45,-0.7074508951791293,0.03719984855448184
86,1573354800,82,66,0,148,45,-0.7074508951791293,-0.9743996080651115
86,1573369200,13,36,23,49,45,-0.5927868742490892,-1.1280013660487616
86,1573383600,61,260,199,321,45,0.28464215547643495,-0.7059844148209556
86,1573398000,361,751,390,1112,45,1.2368520684172026,0.521278116139318
86,1573412400,713,832,119,1545,45,-0.11418922167153057,1.1930918657041707
86,1573426800,312,190,0,502,45,-0.7074508951791293,-0.4251569583053937
86,1573441200,39,21,0,60,45,-0.7074508951791293,-1.1109345040505783
86,1573455600,10,56,46,66,45,-0.47812285331904913,-1.1016253065970236
86,1573470000,168,747,579,915,45,2.1790911969292712,0.21562613308094386
86,1573484400,429,678,249,1107,45,0.5339117661939135,0.5135204515946892
86,1573498800,861,755,0,1616,45,-0.7074508951791293,1.3032507022378994
86,1573513200,372,207,0,579,45,-0.7074508951791293,-0.3056889243181104
86,1573527600,40,25,0,65,46,-0.7219590583783502,-1.1339012901050263
86,1573542000,21,53,32,74,46,-0.5799343255826092,-1.1197462475799371
86,1573556400,186,806,620,992,46,2.0297701395391323,0.32406808997915776
86,1573570800,351,555,204,906,46,0.18344861319449887,0.18880879473941686
86,1573585200,870,819,0,1689,46,-0.7219590583783502,1.4202974944221745
86,1573599600,415,250,0,665,46,-0.7219590583783502,-0.19023178843241528
86,1573614000,51,34,0,85,46,-0.7219590583783502,-1.1024456400492726
86,1573628400,16,45,29,61,46,-0.5932491442822099,-1.140192420116177
86,1573642800,215,862,647,1077,46,2.149603507835539,0.457754602716111
86,1573657200,394,560,166,954,46,0.0147942429995564,0.26430235487322573
86,1573671600,913,609,0,1522,46,-0.7219590583783502,1.157642816456631
86,1573686000,612,1173,561,1785,46,1.7679120384469849,1.571284614689792
86,1573700400,56,33,0,89,46,-0.7219590583783502,-1.096154510038122
86,1573714800,16,68,52,84,46,-0.49116886758527106,-1.1040184225520604
86,1573729200,196,834,638,1030,46,2.109659051736737,0.38383382508508984
86,1573743600,403,657,254,1060,46,0.40536225818784427,0.43101730016872036
86,1573758000,894,887,0,1781,46,-0.7219590583783502,1.5649934846786413
86,1573772400,468,288,0,756,46,-0.7219590583783502,-0.04710858067873592
86,1573786800,60,56,0,116,46,-0.7219590583783502,-1.0536893824628544
86,1573801200,12,51,39,63,46,-0.5488664152835409,-1.1370468551106017
86,1573815600,203,820,617,1023,46,2.016455320839532,0.37282434756557603
86,1573830000,491,753,262,1244,46,0.4408684413867795,0.7204092806816544
86,1573844400,1066,952,0,2018,46,-0.7219590583783502,1.9377429378393227
86,1573858800,477,331,0,808,46,-0.7219590583783502,0.03467610946622371
86,1573873200,83,82,0,165,46,-0.7219590583783502,-0.9766230398262579
86,1573887600,17,38,21,55,46,-0.6287553274811452,-1.1496291151329032
86,1573902000,82,340,258,422,46,0.42311534978731186,-0.5724179366098228
86,1573916400,456,1055,599,1511,46,1.9365664086419274,1.1403422089259665
86,1573930800,1008,1272,264,2280,46,0.44974498718651335,2.3498119535696964
86,1573945200,449,389,0,838,46,-0.7219590583783502,0.08185958454985426
86,1573959600,84,66,0,150,46,-0.7219590583783502,-1.0002147773680732
86,1573974000,15,22,7,37,46,-0.6908911480792819,-1.1779392001830815
86,1573988400,52,234,182,286,46,0.08580660939742692,-0.786316356988948
86,1574002800,403,806,403,1209,46,1.0666649202680134,0.6653618930840854
86,1574017200,696,828,132,1524,46,-0.13610703559591844,1.1607883814622062
86,1574031600,277,198,0,475,46,-0.7219590583783502,-0.4890604639620755
86,1574046000,39,19,0,58,46,-0.7219590583783502,-1.1449107676245402
86,1574060400,11,48,37,59,46,-0.5577429610832747,-1.1433379851217524
86,1574074800,192,812,620,1004,46,2.0297701395391323,0.34294148001261
86,1574089200,368,556,188,924,46,0.11243624679662836,0.21711887978959518
86,1574103600,865,637,0,1502,46,-0.7219590583783502,1.1261871664008771
86,1574118000,335,229,0,564,46,-0.7219590583783502,-0.3490828212139715
86,1574132400,39,27,0,66,47,-0.6584332081601139,-1.1050328237327203
86,1574146800,12,63,51,75,47,-0.41332303577934154,-1.0905864514780697
86,1574161200,192,784,592,976,47,2.1867672241814,0.3556559264597321
86,1574175600,382,590,208,972,47,0.34123180860852614,0.3492353165687762
86,1574190000,886,869,0,1755,47,-0.6584332081601139,1.6060697027233808
86,1574204400,434,247,0,681,47,-0.6584332081601139,-0.1178640529982607
86,1574218800,45,34,0,79,47,-0.6584332081601139,-1.0841658415871138
86,1574233200,12,54,42,66,47,-0.45657777208183076,-1.1050328237327203
86,1574247600,202,785,583,987,47,2.1435124878789105,0.37331260365986063
86,1574262000,411,655,244,1066,47,0.5142507538184831,0.5001196490062383
86,1574276400,873,876,3,1749,47,-0.6440149627259507,1.596438787886947
86,1574290800,448,227,0,675,47,-0.6584332081601139,-0.12749496783469444
86,1574305200,71,43,0,114,47,-0.6584332081601139,-1.02798550504125
86,1574319600,9,50,41,59,47,-0.46138385389321845,-1.116268891041893
86,1574334000,213,844,631,1057,47,2.37420441482552,0.4856732767515877
86,1574348400,396,676,280,1072,47,0.6872696990284399,0.5097505638426721
86,1574362800,950,920,0,1870,47,-0.6584332081601139,1.790662237088361
86,1574377200,517,327,0,844,47,-0.6584332081601139,0.14377580005818955
86,1574391600,67,59,0,126,47,-0.6584332081601139,-1.0087236753683826
86,1574406000,14,47,33,61,47,-0.49983250838432,-1.113058586096415
86,1574420400,194,819,625,1013,47,2.345367923957194,0.41504656795107353
86,1574434800,477,734,257,1211,47,0.5767298173665231,0.7328667575533874
86,1574449200,1033,1057,24,2090,47,-0.5430872446868092,2.143795781090932
86,1574463600,499,318,0,817,47,-0.6584332081601139,0.10043668329423766
86,1574478000,76,64,0,140,47,-0.6584332081601139,-0.9862515407500373
86,1574492400,10,36,26,46,47,-0.5334750810640339,-1.1371358731874994
86,1574506800,82,359,277,441,47,0.6728514535942769,-0.5031006464556107
86,1574521200,467,977,510,1444,47,1.7926685156476092,1.1068672837015647
86,1574535600,1040,993,0,2033,47,-0.6584332081601139,2.0523020901448112
86,1574550000,415,308,0,723,47,-0.6584332081601139,-0.050447649143224436
86,1574564400,66,60,0,126,47,-0.6584332081601139,-1.0087236753683826
86,1574578800,10,27,17,37,47,-0.5767298173665231,-1.15158224544215
86,1574593200,51,225,174,276,47,0.17782502702134462,-0.7679508044575389
86,1574607600,289,506,217,795,47,0.38448654491101536,0.06512332889398058
86,1574622000,588,596,8,1184,47,-0.6199845536690123,0.6895276407894354
86,1574636400,231,126,0,357,47,-0.6584332081601139,-0.6379334541656833
86,1574650800,27,15,0,42,47,-0.6584332081601139,-1.1435564830784553
86,1574665200,7,58,51,65,47,-0.41332303577934154,-1.1066379762054592
86,1574679600,184,820,636,1004,47,2.3982348238824582,0.4006001956964229
86,1574694000,397,621,224,1018,47,0.41812911759072924,0.4230723303147683
86,1574708400,975,877,0,1852,47,-0.6584332081601139,1.7617694925790595
86,1574722800,420,202,0,622,47,-0.6584332081601139,-0.21256804888985925
86,1574737200,36,26,0,62,48,-0.6231227127642639,-0.9405325843873628
86,1574751600,16,49,33,65,48,-0.43719201741630487,-0.9358394195371466
86,1574766000,180,818,638,998,48,2.9715373972962777,0.5237348488800725
86,1574780400,466,709,243,1175,48,0.7460033166161617,0.8006315750428247
86,1574794800,994,920,0,1914,48,-0.6231227127642639,1.9567145164794
86,1574809200,447,243,0,690,48,-0.6231227127642639,0.0419032575912156
86,1574823600,48,35,0,83,48,-0.6231227127642639,-0.9076804304358498
86,1574838000,10,48,38,58,48,-0.40902069993934137,-0.9467901375209843
86,1574852400,131,591,460,722,48,1.9686384951163773,0.09196368266018774
86,1574866800,526,718,192,1244,48,0.45865587835113414,0.9085743665977958
86,1574881200,978,818,0,1796,48,-0.6231227127642639,1.7721166990375652
86,1574895600,340,202,0,542,48,-0.6231227127642639,-0.18962620835278057
86,1574910000,48,43,0,91,48,-0.6231227127642639,-0.8951653241686067
86,1574924400,11,16,5,27,48,-0.5949513952873005,-0.995286174306551
86,1574938800,67,130,63,197,48,-0.26816411255452394,-0.7293401661276365
86,1574953200,232,370,138,602,48,0.15440564959992842,-0.0957629113484578
86,1574967600,314,271,0,585,48,-0.6231227127642639,-0.12235751216634924
86,1574982000,112,99,0,211,48,-0.6231227127642639,-0.7074387301599612
86,1574996400,29,28,0,57,48,-0.6231227127642639,-0.9483545258043896
86,1575010800,7,39,32,46,48,-0.44282628091169757,-0.9655627969218488
86,1575025200,113,426,313,539,48,1.1404017612936506,-0.1943193732029967
86,1575039600,622,1139,517,1761,48,2.289791514353761,1.7173631091183768
86,1575054000,1311,1133,0,2444,48,-0.6231227127642639,2.785840306684251
86,1575068400,552,235,0,787,48,-0.6231227127642639,0.19364892108153742
86,1575082800,60,57,0,117,48,-0.6231227127642639,-0.8544912288000669
86,1575097200,11,31,20,42,48,-0.5104374428564099,-0.9718203500554703
86,1575111600,69,292,223,361,48,0.6333180467083077,-0.47278048764915426
86,1575126000,461,979,518,1440,48,2.295425777849154,1.2151944701452502
86,1575140400,1011,1052,41,2063,48,-0.39211790945316327,2.1898083707068015
86,1575154800,455,291,0,746,48,-0.6231227127642639,0.12950900146191685
86,1575169200,73,92,19,165,48,-0.5160717063518027,-0.7794005911966086
86,1575183600,22,27,5,49,48,-0.5949513952873005,-0.9608696320716327
86,1575198000,47,207,160,254,48,0.2783594464985678,-0.6401700339735299
86,1575212400,295,514,219,809,48,0.6107809927267369,0.22806546331645575
86,1575226800,490,390,0,880,48,-0.6231227127642639,0.3391370314382377
86,1575241200,191,120,0,311,48,-0.6231227127642639,-0.5509999018194233
86,1575255600,33,21,0,54,48,-0.6231227127642639,-0.9530476906546057
86,1575270000,9,40,31,49,48,-0.44846054440709027,-0.9608696320716327
86,1575284400,190,737,547,927,48,2.458819419215542,0.41266328075829056
86,1575298800,350,540,190,890,48,0.44738735136034874,0.35478091427229147
86,1575313200,774,682,0,1456,48,-0.6231227127642639,1.2402246826797363
86,1575327600,317,229,0,546,48,-0.6231227127642639,-0.18336865521915904
86,1575342000,30,28,0,58,49,-0.5637254665923138,-0.8570622629179449
86,1575356400,13,50,37,63,49,-0.37959542208496655,-0.8494721680941504
86,1575370800,212,840,628,1052,49,2.561508802343201,0.6518485880523912
86,1575385200,405,652,247,1057,49,0.6654669926864637,0.6594386828761857
86,1575399600,981,966,0,1947,49,-0.5637254665923138,2.0104755615115972
86,1575414000,454,294,0,748,49,-0.5637254665923138,0.19037082276568884
86,1575428400,53,37,0,90,49,-0.5637254665923138,-0.8084856560456604
86,1575442800,14,57,43,71,49,-0.34973649594864,-0.8373280163760792
86,1575457200,224,901,677,1125,49,2.8053566991232017,0.7626639724797901
86,1575471600,436,684,248,1120,49,0.6704434803758514,0.7550738776559958
86,1575486000,920,950,30,1870,49,-0.4144308359106809,1.8935881012251627
86,1575500400,469,372,0,841,49,-0.5637254665923138,0.33154658648826557
86,1575501687,13,4,0,17,49,-0.5637254665923138,-0.9193010404730593
86,1575501767,1,1,0,2,49,-0.5637254665923138,-0.9420713249444427
86,1575501847,2,0,0,2,49,-0.5637254665923138,-0.9420713249444427
86,1575501927,0,0,0,0,49,-0.5637254665923138,-0.9451073628739605
86,1575502008,2,0,0,2,49,-0.5637254665923138,-0.9420713249444427
86,1575502079,1,0,0,1,49,-0.5637254665923138,-0.9435893439092016
86,1575502159,3,1,0,4,49,-0.5637254665923138,-0.9390352870149249
86,1575502239,1,2,1,3,49,-0.5587489789029261,-0.9405533059796838
86,1575502320,1,0,0,1,49,-0.5637254665923138,-0.9435893439092016
86,1575502408,0,1,1,1,49,-0.5587489789029261,-0.9435893439092016
86,1575502488,1,0,0,1,49,-0.5637254665923138,-0.9435893439092016
86,1575502569,1,0,0,1,49,-0.5637254665923138,-0.9435893439092016
86,1575514800,31,37,6,68,49,-0.5338665404559872,-0.8418820732703559
86,1575529200,12,53,41,65,49,-0.3596894713274155,-0.8464361301646326
86,1575543600,211,838,627,1049,49,2.5565323146538135,0.6472945311581145
86,1575558000,435,692,257,1127,49,0.7152318695803414,0.7657000104093079
86,1575572400,996,1031,35,2027,49,-0.3895483974637421,2.1319170786923083
86,1575586800,462,323,0,785,49,-0.5637254665923138,0.24653752446176774
86,1575601200,66,58,0,124,49,-0.5637254665923138,-0.7568730112438582
86,1575615600,13,47,34,60,49,-0.39452488515312983,-0.8540262249884271
86,1575630000,193,785,592,978,49,2.382355245525242,0.5395151846602334
86,1575644400,551,786,235,1337,49,0.6057491404138106,1.0844839930086747
86,1575658800,1039,978,0,2017,49,-0.5637254665923138,2.1167368890447196
86,1575673200,514,373,0,887,49,-0.5637254665923138,0.40137545886717446
86,1575687600,93,72,0,165,49,-0.5637254665923138,-0.6946342336887437
86,1575702000,11,30,19,41,49,-0.4691722004939463,-0.8828685853188459
86,1575716400,81,415,334,496,49,1.0984214216631991,-0.19216995635355127
86,1575730800,504,1018,514,1522,49,1.9941892057529964,1.3653175014890693
86,1575745200,1102,978,0,2080,49,-0.5637254665923138,2.2123720838245293
86,1575759600,426,389,0,815,49,-0.5637254665923138,0.29207809340453444
86,1575774000,110,90,0,200,49,-0.5637254665923138,-0.6415035699221826
86,1575788400,13,26,13,39,49,-0.4990311266302729,-0.8859046232483637
86,1575802800,47,260,213,307,49,0.4962664112472797,-0.47907554069298136
86,1575817200,373,853,480,1226,49,1.8249886243138125,0.915983887920438
86,1575831600,738,716,0,1454,49,-0.5637254665923138,1.2620922118854647
86,1575846000,265,172,0,437,49,-0.5637254665923138,-0.2817330752743258
86,1575860400,38,20,0,58,49,-0.5637254665923138,-0.8570622629179449
86,1575874800,11,51,40,62,49,-0.36466595901680326,-0.8509901870589093
86,1575889200,188,769,581,957,49,2.3276138809419766,0.5076367864002967
86,1575903600,400,584,184,984,49,0.3519482682550346,0.5486232984487868
86,1575918000,918,689,0,1607,49,-0.5637254665923138,1.494349113493575
86,1575932400,339,230,0,569,49,-0.5637254665923138,-0.08135457192615236
86,1575946800,43,22,0,65,50,-0.6074806257508896,-0.921916471288587
86,1575961200,10,46,36,56,50,-0.4343818246820909,-0.9349436147942035
86,1575975600,201,836,635,1037,50,2.4457898931015314,0.4850150273179988
86,1575990000,433,641,208,1074,50,0.3926457804243917,0.5385710617299778
86,1576004400,959,878,0,1837,50,-0.6074806257508896,1.6429833389283572
86,1576018800,474,284,0,758,50,-0.6074806257508896,0.0811735786438862
86,1576033200,57,31,0,88,50,-0.6074806257508896,-0.8886248823297892
86,1576047600,10,58,48,68,50,-0.3766822243258247,-0.9175740901200481
86,1576062000,226,792,566,1018,50,2.1140171910530006,0.45751327991725277
86,1576076400,444,668,224,1112,50,0.4695785808994133,0.59357455653147
86,1576090800,929,965,36,1894,50,-0.4343818246820909,1.7254885811305953
86,1576105200,481,285,0,766,50,-0.6074806257508896,0.09275326175998978
86,1576119600,50,35,0,85,50,-0.6074806257508896,-0.892967263498328
86,1576134000,12,50,38,62,50,-0.4247652246227132,-0.9262588524571258
86,1576148400,216,897,681,1113,50,2.6669716944672186,0.5950220169209829
86,1576162800,484,718,234,1202,50,0.5176615811963018,0.7238459915876353
86,1576177200,1030,1056,26,2086,50,-0.48246482497897947,2.0034009759170814
86,1576191600,533,309,0,842,50,-0.6074806257508896,0.20276025136297385
86,1576206000,89,69,0,158,50,-0.6074806257508896,-0.7873026550638828
86,1576220400,14,48,34,62,50,-0.44399842474146867,-0.9262588524571258
86,1576234800,188,773,585,961,50,2.205374891617089,0.37500803771501473
86,1576249200,579,816,237,1395,50,0.5320864812853684,1.0032058467636342
86,1576263600,1064,1125,61,2189,50,-0.3141743239398696,2.152489396036915
86,1576278000,498,351,0,849,50,-0.6074806257508896,0.2128924740895645
86,1576292400,100,73,0,173,50,-0.6074806257508896,-0.7655907492211885
86,1576306800,12,37,25,49,50,-0.4872731250086683,-0.9450758375207942
86,1576321200,66,334,268,400,50,0.6811437822057228,-0.4370172408017493
86,1576335600,549,1060,511,1609,50,1.8495606894201138,1.3129623701194053
86,1576350000,950,995,45,1945,50,-0.39110712441489126,1.7993090609957556
86,1576364400,468,354,0,822,50,-0.6074806257508896,0.1738110435727149
86,1576378800,96,104,8,200,50,-0.5690142255133788,-0.726509318704339
86,1576383874,8,4,0,12,50,-0.6074806257508896,-0.9986318719327733
86,1576383955,0,0,0,0,50,-0.6074806257508896,-1.0160013966069286
86,1576384017,0,0,0,0,50,-0.6074806257508896,-1.0160013966069286
86,1576384088,0,0,0,0,50,-0.6074806257508896,-1.0160013966069286
86,1576384156,0,0,0,0,50,-0.6074806257508896,-1.0160013966069286
86,1576384236,1,0,0,1,50,-0.6074806257508896,-1.0145539362174156
86,1576384318,0,0,0,0,50,-0.6074806257508896,-1.0160013966069286
86,1576384408,0,0,0,0,50,-0.6074806257508896,-1.0160013966069286
86,1576393200,22,22,0,44,50,-0.6074806257508896,-0.9523131394683589
86,1576407600,55,255,200,310,50,0.35417938018688083,-0.5672886758579146
86,1576422000,435,987,552,1422,50,2.0467009906373566,1.0422872772804839
86,1576436400,850,897,47,1747,50,-0.38149052435551356,1.512711903872192
86,1576450800,317,178,0,495,50,-0.6074806257508896,-0.2995085037980192
86,1576465200,41,27,0,68,50,-0.6074806257508896,-0.9175740901200481
86,1576479600,11,50,39,61,50,-0.41995692459302436,-0.9277063128466387
86,1576494000,175,831,656,1006,50,2.5467641937249974,0.4401437552430974
86,1576508400,454,771,317,1225,50,0.9167504836604766,0.7571375805464331
86,1576522800,1027,948,0,1975,50,-0.6074806257508896,1.842732872681144
86,1576537200,454,301,0,755,50,-0.6074806257508896,0.07683119747534735
86,1576551600,41,27,0,68,51,-0.7025913018572827,-1.0617443979716459
86,1576566000,14,57,43,71,51,-0.4841954514004406,-1.0577501366590005
86,1576580400,194,734,540,928,51,2.0400542620193387,0.08327717831999264
86,1576594800,400,627,227,1027,51,0.45033562962418594,0.21508780163728589
86,1576609200,901,952,51,1853,51,-0.44356366526893515,1.3148410830522783
86,1576623600,444,278,0,722,51,-0.7025913018572827,-0.19099543181498124
86,1576638000,43,25,0,68,51,-0.7025913018572827,-1.0617443979716459
86,1576652400,11,54,43,65,51,-0.4841954514004406,-1.065738659284291
86,1576666800,202,827,625,1029,51,2.471766989666585,0.21775064251238274
86,1576681200,533,774,241,1307,51,0.5214412553543206,0.5878855241508426
86,1576695600,1079,1100,21,2179,51,-0.5959328632620807,1.7488841456930622
86,1576710000,553,316,0,869,51,-0.7025913018572827,0.004723372504636036
86,1576724400,65,35,0,100,51,-0.7025913018572827,-1.0191389439700966
86,1576738800,11,45,34,56,51,-0.5299062107983843,-1.0777214432222268
86,1576753200,184,775,591,959,51,2.299081898607686,0.12455121188399355
86,1576767600,480,746,266,1226,51,0.6484155870152752,0.48004046870942085
86,1576782000,1139,1121,0,2260,51,-0.7025913018572827,1.8567292011344838
86,1576796400,536,297,0,833,51,-0.7025913018572827,-0.04320776324710697
86,1576810800,74,28,0,102,51,-0.7025913018572827,-1.0164761030949996
86,1576825200,12,44,32,56,51,-0.5400641573312607,-1.0777214432222268
86,1576839600,178,719,541,897,51,2.045133235285777,0.042003144755991706
86,1576854000,578,970,392,1548,51,1.288366218586487,0.908757849600011
86,1576868400,1244,1247,3,2491,51,-0.6873543820579682,2.164287322208168
86,1576882800,535,245,0,780,51,-0.7025913018572827,-0.11377304643717306
86,1576897200,84,58,0,142,51,-0.7025913018572827,-0.963219285593063
86,1576911600,16,33,17,49,51,-0.6162487563278335,-1.0870413862850659
86,1576926000,68,335,267,403,51,0.6534945602817135,-0.6157185513929262
86,1576940400,572,956,384,1528,51,1.2477344324549815,0.8821294408490428
86,1576954800,1189,1077,0,2266,51,-0.7025913018572827,1.8647177237597743
86,1576969200,497,279,0,776,51,-0.7025913018572827,-0.11909872818736673
86,1576983600,72,59,0,131,51,-0.7025913018572827,-0.9778649104060956
86,1576998000,14,26,12,40,51,-0.6416436226600245,-1.0990241702230015
86,1577012400,51,296,245,347,51,0.5417571484200734,-0.6902780958956376
86,1577026800,456,830,374,1286,51,1.1969446997905995,0.5599256949623259
86,1577041200,1045,905,0,1950,51,-0.7025913018572827,1.4439888654944746
86,1577055600,401,210,0,611,51,-0.7025913018572827,-0.33878310038285553
86,1577070000,62,21,0,83,51,-0.7025913018572827,-1.0417730914084196
86,1577084400,8,39,31,47,51,-0.5451431305976989,-1.0897042271601627
86,1577098800,105,531,426,636,51,1.4610513096453852,-0.30549758944414507
86,1577113200,592,996,404,1588,51,1.349313897783745,0.9620146671019477
86,1577127600,1200,1044,0,2244,51,-0.7025913018572827,1.8354264741337092
86,1577142000,502,226,0,728,51,-0.7025913018572827,-0.18300690918969073
86,1577156400,45,29,0,74,52,-0.6609594455629297,-0.8228940336619057
86,1577170800,9,38,29,47,52,-0.46799477521402066,-0.8648018719056118
86,1577185200,92,364,272,456,52,1.1489160832268377,-0.22997572962132476
86,1577199600,513,775,262,1288,52,1.082376541727214,1.0614065451476893
86,1577214000,870,626,0,1496,52,-0.6609594455629297,1.3842521138399428
86,1577228400,155,106,0,261,52,-0.6609594455629297,-0.5326434502703125
86,1577242800,33,26,0,59,52,-0.6609594455629297,-0.8461761660195202
86,1577257200,8,14,6,22,52,-0.6210357206631554,-0.9036054258349691
86,1577271600,32,76,44,108,52,-0.368185462964585,-0.7701212003179797
86,1577286000,161,275,114,436,52,0.0975913275327816,-0.26101857276481066
86,1577300400,238,252,14,490,52,-0.5678040874634563,-0.1772028962773987
86,1577314800,92,94,2,186,52,-0.647651537263005,-0.6490541120583846
86,1577329200,16,28,12,44,52,-0.5811119957633811,-0.8694582983771346
86,1577343600,6,44,38,50,52,-0.40810918786435924,-0.8601454454340888
86,1577358000,70,442,372,512,52,1.8143114982230757,-0.1430557688195642
86,1577372400,440,888,448,1328,52,2.3200120136202167,1.1234922314346611
86,1577386800,1042,1013,0,2055,52,-0.6609594455629297,2.2518995797003742
86,1577401200,452,216,0,668,52,-0.6609594455629297,0.09907840769962593
86,1577415600,50,37,0,87,52,-0.6609594455629297,-0.8027161856186399
86,1577430000,9,40,31,49,52,-0.45468686691409593,-0.8616975875912631
86,1577444400,85,406,321,491,52,1.4749598365749943,-0.1756507541202244
86,1577458800,490,909,419,1399,52,2.1270473432713075,1.2336943245940362
86,1577473200,1156,986,0,2142,52,-0.6609594455629297,2.386935947374538
86,1577487600,509,243,0,752,52,-0.6609594455629297,0.22945834890226677
